Year,Month,Day,Hour Ending,Westbound,Eastbound,Two Way,Day of Week
2024,2,29,2400,55,16,71,Thursday
2024,2,29,2300,90,17,107,Thursday
2024,2,29,2200,141,71,212,Thursday
2024,2,29,2100,239,119,358,Thursday
2024,2,29,2000,216,206,422,Thursday
2024,2,29,1900,81,353,434,Thursday
2024,2,29,1800,72,832,904,Thursday
2024,2,29,1700,145,756,901,Thursday
2024,2,29,1600,258,425,683,Thursday
2024,2,29,1500,274,242,516,Thursday
2024,2,29,1400,231,230,461,Thursday
2024,2,29,1300,228,197,425,Thursday
2024,2,29,1200,304,142,446,Thursday
2024,2,29,1100,366,115,481,Thursday
2024,2,29,1000,458,94,552,Thursday
2024,2,29,900,670,71,741,Thursday
2024,2,29,800,360,23,383,Thursday
2024,2,29,700,85,3,88,Thursday
2024,2,29,600,37,6,43,Thursday
2024,2,29,500,10,4,14,Thursday
2024,2,29,400,24,9,33,Thursday
2024,2,29,300,11,8,19,Thursday
2024,2,29,200,20,7,27,Thursday
2024,2,29,100,13,11,24,Thursday
2024,2,28,2400,31,13,44,Wednesday
2024,2,28,2300,36,17,53,Wednesday
2024,2,28,2200,41,21,62,Wednesday
2024,2,28,2100,78,34,112,Wednesday
2024,2,28,2000,84,54,138,Wednesday
2024,2,28,1900,107,129,236,Wednesday
2024,2,28,1800,146,379,525,Wednesday
2024,2,28,1700,171,566,737,Wednesday
2024,2,28,1600,195,355,550,Wednesday
2024,2,28,1500,194,248,442,Wednesday
2024,2,28,1400,248,220,468,Wednesday
2024,2,28,1300,248,222,470,Wednesday
2024,2,28,1200,313,184,497,Wednesday
2024,2,28,1100,322,151,473,Wednesday
2024,2,28,1000,456,132,588,Wednesday
2024,2,28,900,432,102,534,Wednesday
2024,2,28,800,287,70,357,Wednesday
2024,2,28,700,101,38,139,Wednesday
2024,2,28,600,41,28,69,Wednesday
2024,2,28,500,31,41,72,Wednesday
2024,2,28,400,32,30,62,Wednesday
2024,2,28,300,17,22,39,Wednesday
2024,2,28,200,23,32,55,Wednesday
2024,2,28,100,27,36,63,Wednesday
2024,2,27,2400,42,52,94,Tuesday
2024,2,27,2300,77,88,165,Tuesday
2024,2,27,2200,66,98,164,Tuesday
2024,2,27,2100,101,120,221,Tuesday
2024,2,27,2000,110,158,268,Tuesday
2024,2,27,1900,173,253,426,Tuesday
2024,2,27,1800,185,467,652,Tuesday
2024,2,27,1700,218,542,760,Tuesday
2024,2,27,1600,252,426,678,Tuesday
2024,2,27,1500,296,348,644,Tuesday
2024,2,27,1400,250,266,516,Tuesday
2024,2,27,1300,266,248,514,Tuesday
2024,2,27,1200,342,220,562,Tuesday
2024,2,27,1100,323,194,517,Tuesday
2024,2,27,1000,387,148,535,Tuesday
2024,2,27,900,328,107,435,Tuesday
2024,2,27,800,232,80,312,Tuesday
2024,2,27,700,78,39,117,Tuesday
2024,2,27,600,50,30,80,Tuesday
2024,2,27,500,20,28,48,Tuesday
2024,2,27,400,25,15,40,Tuesday
2024,2,27,300,19,22,41,Tuesday
2024,2,27,200,21,36,57,Tuesday
2024,2,27,100,30,80,110,Tuesday
2024,2,26,2400,29,19,48,Monday
2024,2,26,2300,56,75,131,Monday
2024,2,26,2200,68,98,166,Monday
2024,2,26,2100,88,116,204,Monday
2024,2,26,2000,98,164,262,Monday
2024,2,26,1900,125,234,359,Monday
2024,2,26,1800,142,480,622,Monday
2024,2,26,1700,214,572,786,Monday
2024,2,26,1600,235,484,719,Monday
2024,2,26,1500,243,455,698,Monday
2024,2,26,1400,252,367,619,Monday
2024,2,26,1300,270,376,646,Monday
2024,2,26,1200,311,280,591,Monday
2024,2,26,1100,326,233,559,Monday
2024,2,26,1000,495,147,642,Monday
2024,2,26,900,676,89,765,Monday
2024,2,26,800,331,67,398,Monday
2024,2,26,700,85,21,106,Monday
2024,2,26,600,28,70,98,Monday
2024,2,26,500,28,63,91,Monday
2024,2,26,400,11,63,74,Monday
2024,2,26,300,19,89,108,Monday
2024,2,26,200,22,114,136,Monday
2024,2,26,100,22,90,112,Monday
2024,2,25,2400,21,14,35,Sunday
2024,2,25,2300,38,20,58,Sunday
2024,2,25,2200,57,43,100,Sunday
2024,2,25,2100,100,57,157,Sunday
2024,2,25,2000,112,115,227,Sunday
2024,2,25,1900,142,278,420,Sunday
2024,2,25,1800,159,728,887,Sunday
2024,2,25,1700,225,1044,1269,Sunday
2024,2,25,1600,287,715,1002,Sunday
2024,2,25,1500,346,747,1093,Sunday
2024,2,25,1400,340,696,1036,Sunday
2024,2,25,1300,389,612,1001,Sunday
2024,2,25,1200,398,558,956,Sunday
2024,2,25,1100,507,328,835,Sunday
2024,2,25,1000,603,165,768,Sunday
2024,2,25,900,906,128,1034,Sunday
2024,2,25,800,461,39,500,Sunday
2024,2,25,700,60,7,67,Sunday
2024,2,25,600,34,9,43,Sunday
2024,2,25,500,25,27,52,Sunday
2024,2,25,400,8,22,30,Sunday
2024,2,25,300,19,15,34,Sunday
2024,2,25,200,30,54,84,Sunday
2024,2,25,100,28,77,105,Sunday
2024,2,24,2400,44,44,88,Saturday
2024,2,24,2300,51,66,117,Saturday
2024,2,24,2200,83,77,160,Saturday
2024,2,24,2100,75,138,213,Saturday
2024,2,24,2000,86,207,293,Saturday
2024,2,24,1900,110,334,444,Saturday
2024,2,24,1800,184,788,972,Saturday
2024,2,24,1700,226,1023,1249,Saturday
2024,2,24,1600,316,728,1044,Saturday
2024,2,24,1500,327,619,946,Saturday
2024,2,24,1400,412,491,903,Saturday
2024,2,24,1300,436,461,897,Saturday
2024,2,24,1200,507,373,880,Saturday
2024,2,24,1100,573,292,865,Saturday
2024,2,24,1000,619,209,828,Saturday
2024,2,24,900,909,117,1026,Saturday
2024,2,24,800,443,84,527,Saturday
2024,2,24,700,108,45,153,Saturday
2024,2,24,600,49,32,81,Saturday
2024,2,24,500,19,33,52,Saturday
2024,2,24,400,17,40,57,Saturday
2024,2,24,300,19,37,56,Saturday
2024,2,24,200,26,33,59,Saturday
2024,2,24,100,36,42,78,Saturday
2024,2,23,2400,33,61,94,Friday
2024,2,23,2300,61,89,150,Friday
2024,2,23,2200,116,115,231,Friday
2024,2,23,2100,184,158,342,Friday
2024,2,23,2000,279,238,517,Friday
2024,2,23,1900,353,372,725,Friday
2024,2,23,1800,447,715,1162,Friday
2024,2,23,1700,456,961,1417,Friday
2024,2,23,1600,521,744,1265,Friday
2024,2,23,1500,541,554,1095,Friday
2024,2,23,1400,494,489,983,Friday
2024,2,23,1300,471,447,918,Friday
2024,2,23,1200,517,389,906,Friday
2024,2,23,1100,523,257,780,Friday
2024,2,23,1000,602,234,836,Friday
2024,2,23,900,702,141,843,Friday
2024,2,23,800,359,101,460,Friday
2024,2,23,700,126,59,185,Friday
2024,2,23,600,52,44,96,Friday
2024,2,23,500,30,28,58,Friday
2024,2,23,400,25,47,72,Friday
2024,2,23,300,17,30,47,Friday
2024,2,23,200,33,29,62,Friday
2024,2,23,100,22,56,78,Friday
2024,2,22,2400,53,67,120,Thursday
2024,2,22,2300,63,80,143,Thursday
2024,2,22,2200,101,127,228,Thursday
2024,2,22,2100,141,147,288,Thursday
2024,2,22,2000,189,214,403,Thursday
2024,2,22,1900,204,350,554,Thursday
2024,2,22,1800,283,754,1037,Thursday
2024,2,22,1700,281,792,1073,Thursday
2024,2,22,1600,368,600,968,Thursday
2024,2,22,1500,379,521,900,Thursday
2024,2,22,1400,368,419,787,Thursday
2024,2,22,1300,393,370,763,Thursday
2024,2,22,1200,459,318,777,Thursday
2024,2,22,1100,505,196,701,Thursday
2024,2,22,1000,605,205,810,Thursday
2024,2,22,900,646,134,780,Thursday
2024,2,22,800,322,74,396,Thursday
2024,2,22,700,101,39,140,Thursday
2024,2,22,600,49,38,87,Thursday
2024,2,22,500,17,31,48,Thursday
2024,2,22,400,22,55,77,Thursday
2024,2,22,300,22,35,57,Thursday
2024,2,22,200,22,41,63,Thursday
2024,2,22,100,36,51,87,Thursday
2024,2,21,2400,49,63,112,Wednesday
2024,2,21,2300,64,71,135,Wednesday
2024,2,21,2200,87,114,201,Wednesday
2024,2,21,2100,127,140,267,Wednesday
2024,2,21,2000,156,235,391,Wednesday
2024,2,21,1900,149,324,473,Wednesday
2024,2,21,1800,209,647,856,Wednesday
2024,2,21,1700,258,852,1110,Wednesday
2024,2,21,1600,295,641,936,Wednesday
2024,2,21,1500,328,469,797,Wednesday
2024,2,21,1400,339,415,754,Wednesday
2024,2,21,1300,401,369,770,Wednesday
2024,2,21,1200,453,323,776,Wednesday
2024,2,21,1100,476,223,699,Wednesday
2024,2,21,1000,586,186,772,Wednesday
2024,2,21,900,617,126,743,Wednesday
2024,2,21,800,315,73,388,Wednesday
2024,2,21,700,94,45,139,Wednesday
2024,2,21,600,54,36,90,Wednesday
2024,2,21,500,41,30,71,Wednesday
2024,2,21,400,19,45,64,Wednesday
2024,2,21,300,27,31,58,Wednesday
2024,2,21,200,16,73,89,Wednesday
2024,2,21,100,27,57,84,Wednesday
2024,2,20,2400,53,77,130,Tuesday
2024,2,20,2300,61,93,154,Tuesday
2024,2,20,2200,75,95,170,Tuesday
2024,2,20,2100,102,121,223,Tuesday
2024,2,20,2000,151,185,336,Tuesday
2024,2,20,1900,154,328,482,Tuesday
2024,2,20,1800,211,636,847,Tuesday
2024,2,20,1700,252,951,1203,Tuesday
2024,2,20,1600,285,754,1039,Tuesday
2024,2,20,1500,397,507,904,Tuesday
2024,2,20,1400,371,334,705,Tuesday
2024,2,20,1300,388,316,704,Tuesday
2024,2,20,1200,484,247,731,Tuesday
2024,2,20,1100,545,241,786,Tuesday
2024,2,20,1000,565,171,736,Tuesday
2024,2,20,900,682,130,812,Tuesday
2024,2,20,800,317,47,364,Tuesday
2024,2,20,700,104,33,137,Tuesday
2024,2,20,600,46,41,87,Tuesday
2024,2,20,500,24,24,48,Tuesday
2024,2,20,400,22,19,41,Tuesday
2024,2,20,300,16,25,41,Tuesday
2024,2,20,200,14,28,42,Tuesday
2024,2,20,100,20,45,65,Tuesday
2024,2,19,2400,20,55,75,Monday
2024,2,19,2300,41,67,108,Monday
2024,2,19,2200,63,125,188,Monday
2024,2,19,2100,109,217,326,Monday
2024,2,19,2000,115,367,482,Monday
2024,2,19,1900,165,686,851,Monday
2024,2,19,1800,233,1329,1562,Monday
2024,2,19,1700,308,1577,1885,Monday
2024,2,19,1600,435,1422,1857,Monday
2024,2,19,1500,580,1425,2005,Monday
2024,2,19,1400,654,1260,1914,Monday
2024,2,19,1300,741,1148,1889,Monday
2024,2,19,1200,806,784,1590,Monday
2024,2,19,1100,773,492,1265,Monday
2024,2,19,1000,824,217,1041,Monday
2024,2,19,900,826,118,944,Monday
2024,2,19,800,381,50,431,Monday
2024,2,19,700,103,27,130,Monday
2024,2,19,600,57,16,73,Monday
2024,2,19,500,25,18,43,Monday
2024,2,19,400,12,19,31,Monday
2024,2,19,300,18,13,31,Monday
2024,2,19,200,24,22,46,Monday
2024,2,19,100,21,22,43,Monday
2024,2,18,2400,27,42,69,Sunday
2024,2,18,2300,57,65,122,Sunday
2024,2,18,2200,84,106,190,Sunday
2024,2,18,2100,80,203,283,Sunday
2024,2,18,2000,147,356,503,Sunday
2024,2,18,1900,151,632,783,Sunday
2024,2,18,1800,207,1424,1631,Sunday
2024,2,18,1700,380,1480,1860,Sunday
2024,2,18,1600,482,1100,1582,Sunday
2024,2,18,1500,558,855,1413,Sunday
2024,2,18,1400,616,718,1334,Sunday
2024,2,18,1300,704,562,1266,Sunday
2024,2,18,1200,863,414,1277,Sunday
2024,2,18,1100,870,229,1099,Sunday
2024,2,18,1000,869,155,1024,Sunday
2024,2,18,900,1028,78,1106,Sunday
2024,2,18,800,488,39,527,Sunday
2024,2,18,700,109,14,123,Sunday
2024,2,18,600,37,21,58,Sunday
2024,2,18,500,22,25,47,Sunday
2024,2,18,400,12,15,27,Sunday
2024,2,18,300,19,21,40,Sunday
2024,2,18,200,15,27,42,Sunday
2024,2,18,100,31,36,67,Sunday
2024,2,17,2400,33,54,87,Saturday
2024,2,17,2300,48,71,119,Saturday
2024,2,17,2200,73,84,157,Saturday
2024,2,17,2100,130,143,273,Saturday
2024,2,17,2000,148,260,408,Saturday
2024,2,17,1900,199,501,700,Saturday
2024,2,17,1800,253,1209,1462,Saturday
2024,2,17,1700,352,1229,1581,Saturday
2024,2,17,1600,491,833,1324,Saturday
2024,2,17,1500,607,671,1278,Saturday
2024,2,17,1400,680,507,1187,Saturday
2024,2,17,1300,797,408,1205,Saturday
2024,2,17,1200,926,327,1253,Saturday
2024,2,17,1100,900,256,1156,Saturday
2024,2,17,1000,860,199,1059,Saturday
2024,2,17,900,1088,115,1203,Saturday
2024,2,17,800,540,61,601,Saturday
2024,2,17,700,156,38,194,Saturday
2024,2,17,600,66,36,102,Saturday
2024,2,17,500,26,34,60,Saturday
2024,2,17,400,18,44,62,Saturday
2024,2,17,300,22,24,46,Saturday
2024,2,17,200,27,38,65,Saturday
2024,2,17,100,39,45,84,Saturday
2024,2,16,2400,64,61,125,Friday
2024,2,16,2300,109,87,196,Friday
2024,2,16,2200,156,113,269,Friday
2024,2,16,2100,308,156,464,Friday
2024,2,16,2000,404,214,618,Friday
2024,2,16,1900,593,359,952,Friday
2024,2,16,1800,667,746,1413,Friday
2024,2,16,1700,744,885,1629,Friday
2024,2,16,1600,778,666,1444,Friday
2024,2,16,1500,819,466,1285,Friday
2024,2,16,1400,686,429,1115,Friday
2024,2,16,1300,638,333,971,Friday
2024,2,16,1200,661,309,970,Friday
2024,2,16,1100,642,205,847,Friday
2024,2,16,1000,607,191,798,Friday
2024,2,16,900,693,125,818,Friday
2024,2,16,800,336,71,407,Friday
2024,2,16,700,132,36,168,Friday
2024,2,16,600,59,38,97,Friday
2024,2,16,500,18,29,47,Friday
2024,2,16,400,25,32,57,Friday
2024,2,16,300,29,32,61,Friday
2024,2,16,200,23,31,54,Friday
2024,2,16,100,38,29,67,Friday
2024,2,15,2400,66,56,122,Thursday
2024,2,15,2300,71,68,139,Thursday
2024,2,15,2200,126,112,238,Thursday
2024,2,15,2100,186,108,294,Thursday
2024,2,15,2000,307,196,503,Thursday
2024,2,15,1900,289,264,553,Thursday
2024,2,15,1800,361,473,834,Thursday
2024,2,15,1700,418,679,1097,Thursday
2024,2,15,1600,438,481,919,Thursday
2024,2,15,1500,524,407,931,Thursday
2024,2,15,1400,455,330,785,Thursday
2024,2,15,1300,478,256,734,Thursday
2024,2,15,1200,481,227,708,Thursday
2024,2,15,1100,482,215,697,Thursday
2024,2,15,1000,519,164,683,Thursday
2024,2,15,900,479,115,594,Thursday
2024,2,15,800,280,75,355,Thursday
2024,2,15,700,98,34,132,Thursday
2024,2,15,600,44,32,76,Thursday
2024,2,15,500,29,32,61,Thursday
2024,2,15,400,21,32,53,Thursday
2024,2,15,300,17,28,45,Thursday
2024,2,15,200,25,29,54,Thursday
2024,2,15,100,36,43,79,Thursday
2024,2,14,2400,51,55,106,Wednesday
2024,2,14,2300,68,79,147,Wednesday
2024,2,14,2200,78,96,174,Wednesday
2024,2,14,2100,127,110,237,Wednesday
2024,2,14,2000,158,126,284,Wednesday
2024,2,14,1900,214,245,459,Wednesday
2024,2,14,1800,254,418,672,Wednesday
2024,2,14,1700,281,525,806,Wednesday
2024,2,14,1600,261,452,713,Wednesday
2024,2,14,1500,281,360,641,Wednesday
2024,2,14,1400,292,300,592,Wednesday
2024,2,14,1300,339,246,585,Wednesday
2024,2,14,1200,371,206,577,Wednesday
2024,2,14,1100,366,180,546,Wednesday
2024,2,14,1000,401,132,533,Wednesday
2024,2,14,900,366,121,487,Wednesday
2024,2,14,800,211,68,279,Wednesday
2024,2,14,700,93,45,138,Wednesday
2024,2,14,600,41,22,63,Wednesday
2024,2,14,500,25,28,53,Wednesday
2024,2,14,400,26,36,62,Wednesday
2024,2,14,300,16,35,51,Wednesday
2024,2,14,200,17,32,49,Wednesday
2024,2,14,100,29,39,68,Wednesday
2024,2,13,2400,42,72,114,Tuesday
2024,2,13,2300,58,66,124,Tuesday
2024,2,13,2200,68,93,161,Tuesday
2024,2,13,2100,91,95,186,Tuesday
2024,2,13,2000,110,145,255,Tuesday
2024,2,13,1900,152,239,391,Tuesday
2024,2,13,1800,161,404,565,Tuesday
2024,2,13,1700,193,525,718,Tuesday
2024,2,13,1600,265,443,708,Tuesday
2024,2,13,1500,220,329,549,Tuesday
2024,2,13,1400,252,281,533,Tuesday
2024,2,13,1300,290,242,532,Tuesday
2024,2,13,1200,334,203,537,Tuesday
2024,2,13,1100,333,163,496,Tuesday
2024,2,13,1000,395,149,544,Tuesday
2024,2,13,900,474,95,569,Tuesday
2024,2,13,800,220,81,301,Tuesday
2024,2,13,700,84,46,130,Tuesday
2024,2,13,600,42,57,99,Tuesday
2024,2,13,500,32,38,70,Tuesday
2024,2,13,400,15,42,57,Tuesday
2024,2,13,300,17,29,46,Tuesday
2024,2,13,200,12,36,48,Tuesday
2024,2,13,100,21,26,47,Tuesday
2024,2,12,2400,38,58,96,Monday
2024,2,12,2300,45,75,120,Monday
2024,2,12,2200,74,87,161,Monday
2024,2,12,2100,106,115,221,Monday
2024,2,12,2000,108,155,263,Monday
2024,2,12,1900,153,261,414,Monday
2024,2,12,1800,143,449,592,Monday
2024,2,12,1700,189,592,781,Monday
2024,2,12,1600,240,403,643,Monday
2024,2,12,1500,262,340,602,Monday
2024,2,12,1400,338,319,657,Monday
2024,2,12,1300,325,274,599,Monday
2024,2,12,1200,334,260,594,Monday
2024,2,12,1100,379,160,539,Monday
2024,2,12,1000,400,106,506,Monday
2024,2,12,900,458,101,559,Monday
2024,2,12,800,203,58,261,Monday
2024,2,12,700,100,25,125,Monday
2024,2,12,600,33,15,48,Monday
2024,2,12,500,16,15,31,Monday
2024,2,12,400,19,13,32,Monday
2024,2,12,300,14,18,32,Monday
2024,2,12,200,20,26,46,Monday
2024,2,12,100,21,25,46,Monday
2024,2,11,2400,28,71,99,Sunday
2024,2,11,2300,47,75,122,Sunday
2024,2,11,2200,64,72,136,Sunday
2024,2,11,2100,54,158,212,Sunday
2024,2,11,2000,89,198,287,Sunday
2024,2,11,1900,120,407,527,Sunday
2024,2,11,1800,194,607,801,Sunday
2024,2,11,1700,200,952,1152,Sunday
2024,2,11,1600,249,843,1092,Sunday
2024,2,11,1500,333,789,1122,Sunday
2024,2,11,1400,338,710,1048,Sunday
2024,2,11,1300,382,609,991,Sunday
2024,2,11,1200,447,485,932,Sunday
2024,2,11,1100,421,273,694,Sunday
2024,2,11,1000,499,152,651,Sunday
2024,2,11,900,650,83,733,Sunday
2024,2,11,800,323,34,357,Sunday
2024,2,11,700,75,31,106,Sunday
2024,2,11,600,29,16,45,Sunday
2024,2,11,500,16,13,29,Sunday
2024,2,11,400,11,16,27,Sunday
2024,2,11,300,14,19,33,Sunday
2024,2,11,200,19,23,42,Sunday
2024,2,11,100,24,27,51,Sunday
2024,2,10,2400,23,37,60,Saturday
2024,2,10,2300,40,59,99,Saturday
2024,2,10,2200,56,92,148,Saturday
2024,2,10,2100,80,92,172,Saturday
2024,2,10,2000,96,187,283,Saturday
2024,2,10,1900,119,381,500,Saturday
2024,2,10,1800,175,762,937,Saturday
2024,2,10,1700,201,1150,1351,Saturday
2024,2,10,1600,299,768,1067,Saturday
2024,2,10,1500,298,581,879,Saturday
2024,2,10,1400,401,430,831,Saturday
2024,2,10,1300,436,319,755,Saturday
2024,2,10,1200,539,293,832,Saturday
2024,2,10,1100,616,192,808,Saturday
2024,2,10,1000,702,161,863,Saturday
2024,2,10,900,922,106,1028,Saturday
2024,2,10,800,465,65,530,Saturday
2024,2,10,700,88,41,129,Saturday
2024,2,10,600,40,23,63,Saturday
2024,2,10,500,13,35,48,Saturday
2024,2,10,400,11,26,37,Saturday
2024,2,10,300,19,30,49,Saturday
2024,2,10,200,27,33,60,Saturday
2024,2,10,100,37,37,74,Saturday
2024,2,9,2400,48,53,101,Friday
2024,2,9,2300,66,79,145,Friday
2024,2,9,2200,123,79,202,Friday
2024,2,9,2100,167,123,290,Friday
2024,2,9,2000,238,300,538,Friday
2024,2,9,1900,380,257,637,Friday
2024,2,9,1800,425,545,970,Friday
2024,2,9,1700,459,737,1196,Friday
2024,2,9,1600,461,543,1004,Friday
2024,2,9,1500,457,414,871,Friday
2024,2,9,1400,439,378,817,Friday
2024,2,9,1300,438,332,770,Friday
2024,2,9,1200,449,288,737,Friday
2024,2,9,1100,441,198,639,Friday
2024,2,9,1000,479,169,648,Friday
2024,2,9,900,591,121,712,Friday
2024,2,9,800,272,77,349,Friday
2024,2,9,700,99,51,150,Friday
2024,2,9,600,39,31,70,Friday
2024,2,9,500,28,39,67,Friday
2024,2,9,400,27,46,73,Friday
2024,2,9,300,21,33,54,Friday
2024,2,9,200,34,32,66,Friday
2024,2,9,100,28,51,79,Friday
2024,2,8,2400,56,67,123,Thursday
2024,2,8,2300,56,109,165,Thursday
2024,2,8,2200,107,133,240,Thursday
2024,2,8,2100,120,109,229,Thursday
2024,2,8,2000,178,154,332,Thursday
2024,2,8,1900,187,234,421,Thursday
2024,2,8,1800,243,434,677,Thursday
2024,2,8,1700,256,550,806,Thursday
2024,2,8,1600,288,428,716,Thursday
2024,2,8,1500,314,393,707,Thursday
2024,2,8,1400,315,325,640,Thursday
2024,2,8,1300,279,265,544,Thursday
2024,2,8,1200,355,212,567,Thursday
2024,2,8,1100,390,189,579,Thursday
2024,2,8,1000,456,159,615,Thursday
2024,2,8,900,432,104,536,Thursday
2024,2,8,800,221,77,298,Thursday
2024,2,8,700,82,30,112,Thursday
2024,2,8,600,52,32,84,Thursday
2024,2,8,500,20,16,36,Thursday
2024,2,8,400,21,32,53,Thursday
2024,2,8,300,22,32,54,Thursday
2024,2,8,200,24,42,66,Thursday
2024,2,8,100,27,47,74,Thursday
2024,2,7,2400,53,61,114,Wednesday
2024,2,7,2300,70,66,136,Wednesday
2024,2,7,2200,94,67,161,Wednesday
2024,2,7,2100,120,111,231,Wednesday
2024,2,7,2000,147,137,284,Wednesday
2024,2,7,1900,146,254,400,Wednesday
2024,2,7,1800,191,412,603,Wednesday
2024,2,7,1700,251,535,786,Wednesday
2024,2,7,1600,246,440,686,Wednesday
2024,2,7,1500,292,310,602,Wednesday
2024,2,7,1400,290,242,532,Wednesday
2024,2,7,1300,271,232,503,Wednesday
2024,2,7,1200,354,194,548,Wednesday
2024,2,7,1100,323,174,497,Wednesday
2024,2,7,1000,377,155,532,Wednesday
2024,2,7,900,415,114,529,Wednesday
2024,2,7,800,203,68,271,Wednesday
2024,2,7,700,72,36,108,Wednesday
2024,2,7,600,45,54,99,Wednesday
2024,2,7,500,24,43,67,Wednesday
2024,2,7,400,15,19,34,Wednesday
2024,2,7,300,24,39,63,Wednesday
2024,2,7,200,24,31,55,Wednesday
2024,2,7,100,27,44,71,Wednesday
2024,2,6,2400,35,44,79,Tuesday
2024,2,6,2300,51,84,135,Tuesday
2024,2,6,2200,64,84,148,Tuesday
2024,2,6,2100,77,91,168,Tuesday
2024,2,6,2000,102,119,221,Tuesday
2024,2,6,1900,117,208,325,Tuesday
2024,2,6,1800,151,347,498,Tuesday
2024,2,6,1700,170,466,636,Tuesday
2024,2,6,1600,229,432,661,Tuesday
2024,2,6,1500,233,362,595,Tuesday
2024,2,6,1400,240,472,712,Tuesday
2024,2,6,1300,235,122,357,Tuesday
2024,2,6,1200,305,103,408,Tuesday
2024,2,6,1100,280,105,385,Tuesday
2024,2,6,1000,346,123,469,Tuesday
2024,2,6,900,358,99,457,Tuesday
2024,2,6,800,203,66,269,Tuesday
2024,2,6,700,86,38,124,Tuesday
2024,2,6,600,46,29,75,Tuesday
2024,2,6,500,21,32,53,Tuesday
2024,2,6,400,17,40,57,Tuesday
2024,2,6,300,14,28,42,Tuesday
2024,2,6,200,14,51,65,Tuesday
2024,2,6,100,27,36,63,Tuesday
2024,2,5,2400,33,71,104,Monday
2024,2,5,2300,56,74,130,Monday
2024,2,5,2200,63,80,143,Monday
2024,2,5,2100,94,89,183,Monday
2024,2,5,2000,114,144,258,Monday
2024,2,5,1900,113,217,330,Monday
2024,2,5,1800,161,401,562,Monday
2024,2,5,1700,200,536,736,Monday
2024,2,5,1600,256,403,659,Monday
2024,2,5,1500,298,370,668,Monday
2024,2,5,1400,277,290,567,Monday
2024,2,5,1300,317,246,563,Monday
2024,2,5,1200,359,180,539,Monday
2024,2,5,1100,373,164,537,Monday
2024,2,5,1000,424,115,539,Monday
2024,2,5,900,419,87,506,Monday
2024,2,5,800,201,53,254,Monday
2024,2,5,700,80,16,96,Monday
2024,2,5,600,44,12,56,Monday
2024,2,5,500,16,9,25,Monday
2024,2,5,400,12,11,23,Monday
2024,2,5,300,18,16,34,Monday
2024,2,5,200,15,17,32,Monday
2024,2,5,100,12,39,51,Monday
2024,2,4,2400,25,53,78,Sunday
2024,2,4,2300,40,49,89,Sunday
2024,2,4,2200,53,113,166,Sunday
2024,2,4,2100,75,150,225,Sunday
2024,2,4,2000,116,204,320,Sunday
2024,2,4,1900,114,374,488,Sunday
2024,2,4,1800,156,738,894,Sunday
2024,2,4,1700,190,1016,1206,Sunday
2024,2,4,1600,265,820,1085,Sunday
2024,2,4,1500,293,682,975,Sunday
2024,2,4,1400,303,720,1023,Sunday
2024,2,4,1300,410,516,926,Sunday
2024,2,4,1200,430,425,855,Sunday
2024,2,4,1100,416,221,637,Sunday
2024,2,4,1000,535,135,670,Sunday
2024,2,4,900,579,75,654,Sunday
2024,2,4,800,244,33,277,Sunday
2024,2,4,700,57,30,87,Sunday
2024,2,4,600,27,17,44,Sunday
2024,2,4,500,15,18,33,Sunday
2024,2,4,400,8,13,21,Sunday
2024,2,4,300,10,22,32,Sunday
2024,2,4,200,13,33,46,Sunday
2024,2,4,100,13,28,41,Sunday
2024,2,3,2400,24,44,68,Saturday
2024,2,3,2300,23,66,89,Saturday
2024,2,3,2200,54,81,135,Saturday
2024,2,3,2100,70,106,176,Saturday
2024,2,3,2000,104,149,253,Saturday
2024,2,3,1900,93,285,378,Saturday
2024,2,3,1800,157,639,796,Saturday
2024,2,3,1700,198,958,1156,Saturday
2024,2,3,1600,282,674,956,Saturday
2024,2,3,1500,280,533,813,Saturday
2024,2,3,1400,355,379,734,Saturday
2024,2,3,1300,416,323,739,Saturday
2024,2,3,1200,471,313,784,Saturday
2024,2,3,1100,513,221,734,Saturday
2024,2,3,1000,614,162,776,Saturday
2024,2,3,900,733,84,817,Saturday
2024,2,3,800,367,67,434,Saturday
2024,2,3,700,92,52,144,Saturday
2024,2,3,600,33,23,56,Saturday
2024,2,3,500,19,47,66,Saturday
2024,2,3,400,14,25,39,Saturday
2024,2,3,300,14,31,45,Saturday
2024,2,3,200,20,32,52,Saturday
2024,2,3,100,27,49,76,Saturday
2024,2,2,2400,31,59,90,Friday
2024,2,2,2300,69,62,131,Friday
2024,2,2,2200,115,90,205,Friday
2024,2,2,2100,169,99,268,Friday
2024,2,2,2000,276,162,438,Friday
2024,2,2,1900,339,275,614,Friday
2024,2,2,1800,428,482,910,Friday
2024,2,2,1700,461,641,1102,Friday
2024,2,2,1600,482,487,969,Friday
2024,2,2,1500,467,372,839,Friday
2024,2,2,1400,403,354,757,Friday
2024,2,2,1300,377,318,695,Friday
2024,2,2,1200,450,258,708,Friday
2024,2,2,1100,400,186,586,Friday
2024,2,2,1000,463,159,622,Friday
2024,2,2,900,418,106,524,Friday
2024,2,2,800,253,74,327,Friday
2024,2,2,700,100,47,147,Friday
2024,2,2,600,49,28,77,Friday
2024,2,2,500,28,39,67,Friday
2024,2,2,400,17,52,69,Friday
2024,2,2,300,20,30,50,Friday
2024,2,2,200,29,22,51,Friday
2024,2,2,100,26,48,74,Friday
2024,2,1,2400,52,52,104,Thursday
2024,2,1,2300,65,80,145,Thursday
2024,2,1,2200,96,87,183,Thursday
2024,2,1,2100,130,106,236,Thursday
2024,2,1,2000,195,142,337,Thursday
2024,2,1,1900,226,224,450,Thursday
2024,2,1,1800,249,399,648,Thursday
2024,2,1,1700,280,533,813,Thursday
2024,2,1,1600,345,459,804,Thursday
2024,2,1,1500,347,389,736,Thursday
2024,2,1,1400,295,321,616,Thursday
2024,2,1,1300,311,260,571,Thursday
2024,2,1,1200,352,201,553,Thursday
2024,2,1,1100,403,178,581,Thursday
2024,2,1,1000,395,152,547,Thursday
2024,2,1,900,337,123,460,Thursday
2024,2,1,800,197,70,267,Thursday
2024,2,1,700,79,43,122,Thursday
2024,2,1,600,54,34,88,Thursday
2024,2,1,500,34,37,71,Thursday
2024,2,1,400,20,42,62,Thursday
2024,2,1,300,16,23,39,Thursday
2024,2,1,200,31,44,75,Thursday
2024,2,1,100,27,40,67,Thursday
2024,1,31,2400,52,60,112,Wednesday
2024,1,31,2300,63,67,130,Wednesday
2024,1,31,2200,75,92,167,Wednesday
2024,1,31,2100,100,133,233,Wednesday
2024,1,31,2000,125,141,266,Wednesday
2024,1,31,1900,153,234,387,Wednesday
2024,1,31,1800,159,385,544,Wednesday
2024,1,31,1700,215,539,754,Wednesday
2024,1,31,1600,248,435,683,Wednesday
2024,1,31,1500,271,321,592,Wednesday
2024,1,31,1400,282,302,584,Wednesday
2024,1,31,1300,292,269,561,Wednesday
2024,1,31,1200,330,192,522,Wednesday
2024,1,31,1100,349,172,521,Wednesday
2024,1,31,1000,374,150,524,Wednesday
2024,1,31,900,358,109,467,Wednesday
2024,1,31,800,214,92,306,Wednesday
2024,1,31,700,78,40,118,Wednesday
2024,1,31,600,53,25,78,Wednesday
2024,1,31,500,25,34,59,Wednesday
2024,1,31,400,25,41,66,Wednesday
2024,1,31,300,18,33,51,Wednesday
2024,1,31,200,27,27,54,Wednesday
2024,1,31,100,38,60,98,Wednesday
2024,1,30,2400,59,59,118,Tuesday
2024,1,30,2300,47,46,93,Tuesday
2024,1,30,2200,62,93,155,Tuesday
2024,1,30,2100,82,116,198,Tuesday
2024,1,30,2000,120,141,261,Tuesday
2024,1,30,1900,120,201,321,Tuesday
2024,1,30,1800,147,479,626,Tuesday
2024,1,30,1700,215,603,818,Tuesday
2024,1,30,1600,240,341,581,Tuesday
2024,1,30,1500,256,330,586,Tuesday
2024,1,30,1400,269,291,560,Tuesday
2024,1,30,1300,262,276,538,Tuesday
2024,1,30,1200,315,247,562,Tuesday
2024,1,30,1100,350,195,545,Tuesday
2024,1,30,1000,401,224,625,Tuesday
2024,1,30,900,374,156,530,Tuesday
2024,1,30,800,207,75,282,Tuesday
2024,1,30,700,83,10,93,Tuesday
2024,1,30,600,56,8,64,Tuesday
2024,1,30,500,21,84,105,Tuesday
2024,1,30,400,14,77,91,Tuesday
2024,1,30,300,21,4,25,Tuesday
2024,1,30,200,25,8,33,Tuesday
2024,1,30,100,27,8,35,Tuesday
2024,1,29,2400,42,11,53,Monday
2024,1,29,2300,50,10,60,Monday
2024,1,29,2200,62,28,90,Monday
2024,1,29,2100,77,73,150,Monday
2024,1,29,2000,104,123,227,Monday
2024,1,29,1900,118,221,339,Monday
2024,1,29,1800,146,425,571,Monday
2024,1,29,1700,219,571,790,Monday
2024,1,29,1600,273,496,769,Monday
2024,1,29,1500,268,372,640,Monday
2024,1,29,1400,295,371,666,Monday
2024,1,29,1300,307,331,638,Monday
2024,1,29,1200,391,262,653,Monday
2024,1,29,1100,378,204,582,Monday
2024,1,29,1000,473,150,623,Monday
2024,1,29,900,458,90,548,Monday
2024,1,29,800,196,69,265,Monday
2024,1,29,700,80,24,104,Monday
2024,1,29,600,38,28,66,Monday
2024,1,29,500,20,14,34,Monday
2024,1,29,400,10,26,36,Monday
2024,1,29,300,16,16,32,Monday
2024,1,29,200,19,25,44,Monday
2024,1,29,100,12,37,49,Monday
2024,1,28,2400,29,50,79,Sunday
2024,1,28,2300,58,70,128,Sunday
2024,1,28,2200,35,139,174,Sunday
2024,1,28,2100,91,234,325,Sunday
2024,1,28,2000,102,273,375,Sunday
2024,1,28,1900,131,402,533,Sunday
2024,1,28,1800,210,906,1116,Sunday
2024,1,28,1700,287,1316,1603,Sunday
2024,1,28,1600,324,1089,1413,Sunday
2024,1,28,1500,430,856,1286,Sunday
2024,1,28,1400,450,911,1361,Sunday
2024,1,28,1300,515,745,1260,Sunday
2024,1,28,1200,544,520,1064,Sunday
2024,1,28,1100,615,249,864,Sunday
2024,1,28,1000,626,151,777,Sunday
2024,1,28,900,751,88,839,Sunday
2024,1,28,800,377,40,417,Sunday
2024,1,28,700,66,14,80,Sunday
2024,1,28,600,23,15,38,Sunday
2024,1,28,500,18,15,33,Sunday
2024,1,28,400,20,22,42,Sunday
2024,1,28,300,11,16,27,Sunday
2024,1,28,200,14,20,34,Sunday
2024,1,28,100,14,32,46,Sunday
2024,1,27,2400,16,33,49,Saturday
2024,1,27,2300,28,67,95,Saturday
2024,1,27,2200,54,128,182,Saturday
2024,1,27,2100,72,162,234,Saturday
2024,1,27,2000,102,240,342,Saturday
2024,1,27,1900,115,436,551,Saturday
2024,1,27,1800,213,948,1161,Saturday
2024,1,27,1700,274,1194,1468,Saturday
2024,1,27,1600,294,899,1193,Saturday
2024,1,27,1500,401,567,968,Saturday
2024,1,27,1400,469,462,931,Saturday
2024,1,27,1300,579,371,950,Saturday
2024,1,27,1200,580,284,864,Saturday
2024,1,27,1100,602,219,821,Saturday
2024,1,27,1000,765,138,903,Saturday
2024,1,27,900,1014,116,1130,Saturday
2024,1,27,800,540,54,594,Saturday
2024,1,27,700,112,32,144,Saturday
2024,1,27,600,40,30,70,Saturday
2024,1,27,500,27,39,66,Saturday
2024,1,27,400,19,27,46,Saturday
2024,1,27,300,30,35,65,Saturday
2024,1,27,200,22,31,53,Saturday
2024,1,27,100,39,35,74,Saturday
2024,1,26,2400,32,68,100,Friday
2024,1,26,2300,61,73,134,Friday
2024,1,26,2200,110,137,247,Friday
2024,1,26,2100,154,159,313,Friday
2024,1,26,2000,290,185,475,Friday
2024,1,26,1900,370,275,645,Friday
2024,1,26,1800,456,573,1029,Friday
2024,1,26,1700,522,694,1216,Friday
2024,1,26,1600,514,415,929,Friday
2024,1,26,1500,483,409,892,Friday
2024,1,26,1400,428,331,759,Friday
2024,1,26,1300,416,324,740,Friday
2024,1,26,1200,454,248,702,Friday
2024,1,26,1100,451,180,631,Friday
2024,1,26,1000,496,171,667,Friday
2024,1,26,900,514,90,604,Friday
2024,1,26,800,273,86,359,Friday
2024,1,26,700,114,35,149,Friday
2024,1,26,600,46,36,82,Friday
2024,1,26,500,34,35,69,Friday
2024,1,26,400,21,30,51,Friday
2024,1,26,300,19,50,69,Friday
2024,1,26,200,33,33,66,Friday
2024,1,26,100,33,51,84,Friday
2024,1,25,2400,54,64,118,Thursday
2024,1,25,2300,66,84,150,Thursday
2024,1,25,2200,97,108,205,Thursday
2024,1,25,2100,144,103,247,Thursday
2024,1,25,2000,192,134,326,Thursday
2024,1,25,1900,239,219,458,Thursday
2024,1,25,1800,250,367,617,Thursday
2024,1,25,1700,283,587,870,Thursday
2024,1,25,1600,294,551,845,Thursday
2024,1,25,1500,286,326,612,Thursday
2024,1,25,1400,266,228,494,Thursday
2024,1,25,1300,323,257,580,Thursday
2024,1,25,1200,310,212,522,Thursday
2024,1,25,1100,399,168,567,Thursday
2024,1,25,1000,485,161,646,Thursday
2024,1,25,900,440,97,537,Thursday
2024,1,25,800,227,65,292,Thursday
2024,1,25,700,78,34,112,Thursday
2024,1,25,600,46,37,83,Thursday
2024,1,25,500,33,31,64,Thursday
2024,1,25,400,39,18,57,Thursday
2024,1,25,300,15,44,59,Thursday
2024,1,25,200,24,41,65,Thursday
2024,1,25,100,31,54,85,Thursday
2024,1,24,2400,45,46,91,Wednesday
2024,1,24,2300,65,77,142,Wednesday
2024,1,24,2200,78,107,185,Wednesday
2024,1,24,2100,98,96,194,Wednesday
2024,1,24,2000,142,145,287,Wednesday
2024,1,24,1900,138,206,344,Wednesday
2024,1,24,1800,160,375,535,Wednesday
2024,1,24,1700,209,598,807,Wednesday
2024,1,24,1600,235,469,704,Wednesday
2024,1,24,1500,279,354,633,Wednesday
2024,1,24,1400,264,396,660,Wednesday
2024,1,24,1300,295,302,597,Wednesday
2024,1,24,1200,351,144,495,Wednesday
2024,1,24,1100,321,103,424,Wednesday
2024,1,24,1000,419,76,495,Wednesday
2024,1,24,900,409,55,464,Wednesday
2024,1,24,800,215,55,270,Wednesday
2024,1,24,700,84,42,126,Wednesday
2024,1,24,600,47,25,72,Wednesday
2024,1,24,500,23,35,58,Wednesday
2024,1,24,400,25,35,60,Wednesday
2024,1,24,300,14,41,55,Wednesday
2024,1,24,200,13,31,44,Wednesday
2024,1,24,100,30,67,97,Wednesday
2024,1,23,2400,46,50,96,Tuesday
2024,1,23,2300,54,73,127,Tuesday
2024,1,23,2200,71,78,149,Tuesday
2024,1,23,2100,83,96,179,Tuesday
2024,1,23,2000,119,118,237,Tuesday
2024,1,23,1900,119,214,333,Tuesday
2024,1,23,1800,150,335,485,Tuesday
2024,1,23,1700,168,497,665,Tuesday
2024,1,23,1600,195,404,599,Tuesday
2024,1,23,1500,234,330,564,Tuesday
2024,1,23,1400,212,324,536,Tuesday
2024,1,23,1300,264,231,495,Tuesday
2024,1,23,1200,320,258,578,Tuesday
2024,1,23,1100,357,123,480,Tuesday
2024,1,23,1000,354,128,482,Tuesday
2024,1,23,900,354,99,453,Tuesday
2024,1,23,800,186,70,256,Tuesday
2024,1,23,700,81,55,136,Tuesday
2024,1,23,600,40,46,86,Tuesday
2024,1,23,500,18,55,73,Tuesday
2024,1,23,400,21,61,82,Tuesday
2024,1,23,300,19,35,54,Tuesday
2024,1,23,200,17,33,50,Tuesday
2024,1,23,100,31,18,49,Tuesday
2024,1,22,2400,42,30,72,Monday
2024,1,22,2300,52,63,115,Monday
2024,1,22,2200,69,90,159,Monday
2024,1,22,2100,88,110,198,Monday
2024,1,22,2000,95,123,218,Monday
2024,1,22,1900,113,181,294,Monday
2024,1,22,1800,140,594,734,Monday
2024,1,22,1700,161,300,461,Monday
2024,1,22,1600,206,409,615,Monday
2024,1,22,1500,249,322,571,Monday
2024,1,22,1400,253,310,563,Monday
2024,1,22,1300,292,322,614,Monday
2024,1,22,1200,320,170,490,Monday
2024,1,22,1100,357,169,526,Monday
2024,1,22,1000,392,94,486,Monday
2024,1,22,900,418,105,523,Monday
2024,1,22,800,225,39,264,Monday
2024,1,22,700,88,30,118,Monday
2024,1,22,600,38,20,58,Monday
2024,1,22,500,14,15,29,Monday
2024,1,22,400,20,13,33,Monday
2024,1,22,300,11,28,39,Monday
2024,1,22,200,22,23,45,Monday
2024,1,22,100,15,29,44,Monday
2024,1,21,2400,31,55,86,Sunday
2024,1,21,2300,34,56,90,Sunday
2024,1,21,2200,46,123,169,Sunday
2024,1,21,2100,82,166,248,Sunday
2024,1,21,2000,87,239,326,Sunday
2024,1,21,1900,121,449,570,Sunday
2024,1,21,1800,143,967,1110,Sunday
2024,1,21,1700,209,1266,1475,Sunday
2024,1,21,1600,254,997,1251,Sunday
2024,1,21,1500,323,767,1090,Sunday
2024,1,21,1400,381,630,1011,Sunday
2024,1,21,1300,414,428,842,Sunday
2024,1,21,1200,463,378,841,Sunday
2024,1,21,1100,460,201,661,Sunday
2024,1,21,1000,582,136,718,Sunday
2024,1,21,900,802,66,868,Sunday
2024,1,21,800,395,40,435,Sunday
2024,1,21,700,65,28,93,Sunday
2024,1,21,600,28,23,51,Sunday
2024,1,21,500,13,15,28,Sunday
2024,1,21,400,14,16,30,Sunday
2024,1,21,300,17,21,38,Sunday
2024,1,21,200,29,24,53,Sunday
2024,1,21,100,37,34,71,Sunday
2024,1,20,2400,26,51,77,Saturday
2024,1,20,2300,37,54,91,Saturday
2024,1,20,2200,44,78,122,Saturday
2024,1,20,2100,72,125,197,Saturday
2024,1,20,2000,98,173,271,Saturday
2024,1,20,1900,112,314,426,Saturday
2024,1,20,1800,165,901,1066,Saturday
2024,1,20,1700,209,1106,1315,Saturday
2024,1,20,1600,274,764,1038,Saturday
2024,1,20,1500,297,586,883,Saturday
2024,1,20,1400,346,465,811,Saturday
2024,1,20,1300,382,344,726,Saturday
2024,1,20,1200,475,186,661,Saturday
2024,1,20,1100,458,177,635,Saturday
2024,1,20,1000,814,132,946,Saturday
2024,1,20,900,912,74,986,Saturday
2024,1,20,800,543,39,582,Saturday
2024,1,20,700,106,12,118,Saturday
2024,1,20,600,33,8,41,Saturday
2024,1,20,500,15,9,24,Saturday
2024,1,20,400,12,7,19,Saturday
2024,1,20,300,9,30,39,Saturday
2024,1,20,200,20,20,40,Saturday
2024,1,20,100,20,43,63,Saturday
2024,1,19,2400,35,101,136,Friday
2024,1,19,2300,61,43,104,Friday
2024,1,19,2200,101,42,143,Friday
2024,1,19,2100,165,94,259,Friday
2024,1,19,2000,280,153,433,Friday
2024,1,19,1900,369,208,577,Friday
2024,1,19,1800,415,473,888,Friday
2024,1,19,1700,413,656,1069,Friday
2024,1,19,1600,444,445,889,Friday
2024,1,19,1500,433,353,786,Friday
2024,1,19,1400,351,271,622,Friday
2024,1,19,1300,386,285,671,Friday
2024,1,19,1200,372,217,589,Friday
2024,1,19,1100,367,200,567,Friday
2024,1,19,1000,437,116,553,Friday
2024,1,19,900,457,102,559,Friday
2024,1,19,800,243,50,293,Friday
2024,1,19,700,98,37,135,Friday
2024,1,19,600,35,43,78,Friday
2024,1,19,500,19,23,42,Friday
2024,1,19,400,24,36,60,Friday
2024,1,19,300,18,36,54,Friday
2024,1,19,200,32,44,76,Friday
2024,1,19,100,36,42,78,Friday
2024,1,18,2400,60,64,124,Thursday
2024,1,18,2300,66,75,141,Thursday
2024,1,18,2200,93,87,180,Thursday
2024,1,18,2100,130,115,245,Thursday
2024,1,18,2000,182,140,322,Thursday
2024,1,18,1900,179,213,392,Thursday
2024,1,18,1800,250,337,587,Thursday
2024,1,18,1700,221,468,689,Thursday
2024,1,18,1600,251,368,619,Thursday
2024,1,18,1500,290,221,511,Thursday
2024,1,18,1400,277,246,523,Thursday
2024,1,18,1300,328,209,537,Thursday
2024,1,18,1200,276,176,452,Thursday
2024,1,18,1100,331,127,458,Thursday
2024,1,18,1000,360,98,458,Thursday
2024,1,18,900,298,93,391,Thursday
2024,1,18,800,197,46,243,Thursday
2024,1,18,700,87,23,110,Thursday
2024,1,18,600,38,21,59,Thursday
2024,1,18,500,26,24,50,Thursday
2024,1,18,400,20,25,45,Thursday
2024,1,18,300,12,25,37,Thursday
2024,1,18,200,21,22,43,Thursday
2024,1,18,100,39,28,67,Thursday
2024,1,17,2400,50,55,105,Wednesday
2024,1,17,2300,67,83,150,Wednesday
2024,1,17,2200,85,23,108,Wednesday
2024,1,17,2100,106,39,145,Wednesday
2024,1,17,2000,138,80,218,Wednesday
2024,1,17,1900,113,133,246,Wednesday
2024,1,17,1800,176,249,425,Wednesday
2024,1,17,1700,162,372,534,Wednesday
2024,1,17,1600,208,272,480,Wednesday
2024,1,17,1500,197,277,474,Wednesday
2024,1,17,1400,187,220,407,Wednesday
2024,1,17,1300,203,139,342,Wednesday
2024,1,17,1200,234,117,351,Wednesday
2024,1,17,1100,245,146,391,Wednesday
2024,1,17,1000,311,90,401,Wednesday
2024,1,17,900,262,92,354,Wednesday
2024,1,17,800,147,55,202,Wednesday
2024,1,17,700,61,53,114,Wednesday
2024,1,17,600,35,55,90,Wednesday
2024,1,17,500,17,31,48,Wednesday
2024,1,17,400,17,13,30,Wednesday
2024,1,17,300,17,15,32,Wednesday
2024,1,17,200,33,18,51,Wednesday
2024,1,17,100,35,45,80,Wednesday
2024,1,16,2400,62,53,115,Tuesday
2024,1,16,2300,58,54,112,Tuesday
2024,1,16,2200,78,80,158,Tuesday
2024,1,16,2100,69,90,159,Tuesday
2024,1,16,2000,110,118,228,Tuesday
2024,1,16,1900,93,169,262,Tuesday
2024,1,16,1800,116,260,376,Tuesday
2024,1,16,1700,147,351,498,Tuesday
2024,1,16,1600,201,313,514,Tuesday
2024,1,16,1500,221,253,474,Tuesday
2024,1,16,1400,214,192,406,Tuesday
2024,1,16,1300,232,202,434,Tuesday
2024,1,16,1200,294,163,457,Tuesday
2024,1,16,1100,310,195,505,Tuesday
2024,1,16,1000,304,117,421,Tuesday
2024,1,16,900,275,70,345,Tuesday
2024,1,16,800,165,58,223,Tuesday
2024,1,16,700,52,29,81,Tuesday
2024,1,16,600,51,36,87,Tuesday
2024,1,16,500,17,28,45,Tuesday
2024,1,16,400,26,31,57,Tuesday
2024,1,16,300,20,36,56,Tuesday
2024,1,16,200,27,38,65,Tuesday
2024,1,16,100,20,50,70,Tuesday
2024,1,15,2400,36,37,73,Monday
2024,1,15,2300,55,47,102,Monday
2024,1,15,2200,69,76,145,Monday
2024,1,15,2100,63,107,170,Monday
2024,1,15,2000,125,124,249,Monday
2024,1,15,1900,117,190,307,Monday
2024,1,15,1800,140,257,397,Monday
2024,1,15,1700,175,346,521,Monday
2024,1,15,1600,215,283,498,Monday
2024,1,15,1500,198,234,432,Monday
2024,1,15,1400,231,225,456,Monday
2024,1,15,1300,274,189,463,Monday
2024,1,15,1200,288,168,456,Monday
2024,1,15,1100,276,122,398,Monday
2024,1,15,1000,234,89,323,Monday
2024,1,15,900,157,59,216,Monday
2024,1,15,800,104,35,139,Monday
2024,1,15,700,51,30,81,Monday
2024,1,15,600,31,18,49,Monday
2024,1,15,500,11,17,28,Monday
2024,1,15,400,17,15,32,Monday
2024,1,15,300,15,12,27,Monday
2024,1,15,200,14,22,36,Monday
2024,1,15,100,20,34,54,Monday
2024,1,14,2400,33,45,78,Sunday
2024,1,14,2300,31,67,98,Sunday
2024,1,14,2200,57,92,149,Sunday
2024,1,14,2100,76,146,222,Sunday
2024,1,14,2000,73,160,233,Sunday
2024,1,14,1900,103,189,292,Sunday
2024,1,14,1800,124,300,424,Sunday
2024,1,14,1700,186,336,522,Sunday
2024,1,14,1600,252,308,560,Sunday
2024,1,14,1500,275,304,579,Sunday
2024,1,14,1400,259,294,553,Sunday
2024,1,14,1300,264,330,594,Sunday
2024,1,14,1200,280,217,497,Sunday
2024,1,14,1100,212,140,352,Sunday
2024,1,14,1000,138,65,203,Sunday
2024,1,14,900,109,39,148,Sunday
2024,1,14,800,58,26,84,Sunday
2024,1,14,700,45,14,59,Sunday
2024,1,14,600,20,13,33,Sunday
2024,1,14,500,13,14,27,Sunday
2024,1,14,400,11,4,15,Sunday
2024,1,14,300,13,12,25,Sunday
2024,1,14,200,5,25,30,Sunday
2024,1,14,100,15,26,41,Sunday
2024,1,13,2400,27,36,63,Saturday
2024,1,13,2300,36,46,82,Saturday
2024,1,13,2200,38,71,109,Saturday
2024,1,13,2100,47,86,133,Saturday
2024,1,13,2000,67,100,167,Saturday
2024,1,13,1900,67,162,229,Saturday
2024,1,13,1800,116,228,344,Saturday
2024,1,13,1700,163,282,445,Saturday
2024,1,13,1600,155,270,425,Saturday
2024,1,13,1500,208,240,448,Saturday
2024,1,13,1400,217,245,462,Saturday
2024,1,13,1300,253,188,441,Saturday
2024,1,13,1200,282,159,441,Saturday
2024,1,13,1100,201,113,314,Saturday
2024,1,13,1000,136,93,229,Saturday
2024,1,13,900,88,59,147,Saturday
2024,1,13,800,68,34,102,Saturday
2024,1,13,700,42,36,78,Saturday
2024,1,13,600,27,27,54,Saturday
2024,1,13,500,18,29,47,Saturday
2024,1,13,400,20,19,39,Saturday
2024,1,13,300,15,23,38,Saturday
2024,1,13,200,29,31,60,Saturday
2024,1,13,100,16,27,43,Saturday
2024,1,12,2400,36,49,85,Friday
2024,1,12,2300,33,75,108,Friday
2024,1,12,2200,47,63,110,Friday
2024,1,12,2100,71,87,158,Friday
2024,1,12,2000,133,106,239,Friday
2024,1,12,1900,155,179,334,Friday
2024,1,12,1800,204,238,442,Friday
2024,1,12,1700,207,269,476,Friday
2024,1,12,1600,250,293,543,Friday
2024,1,12,1500,261,262,523,Friday
2024,1,12,1400,236,237,473,Friday
2024,1,12,1300,229,208,437,Friday
2024,1,12,1200,227,181,408,Friday
2024,1,12,1100,160,121,281,Friday
2024,1,12,1000,131,96,227,Friday
2024,1,12,900,93,54,147,Friday
2024,1,12,800,74,42,116,Friday
2024,1,12,700,52,41,93,Friday
2024,1,12,600,27,26,53,Friday
2024,1,12,500,18,37,55,Friday
2024,1,12,400,23,29,52,Friday
2024,1,12,300,29,25,54,Friday
2024,1,12,200,21,37,58,Friday
2024,1,12,100,39,31,70,Friday
2024,1,11,2400,42,44,86,Thursday
2024,1,11,2300,46,111,157,Thursday
2024,1,11,2200,49,77,126,Thursday
2024,1,11,2100,92,120,212,Thursday
2024,1,11,2000,104,137,241,Thursday
2024,1,11,1900,111,153,264,Thursday
2024,1,11,1800,153,238,391,Thursday
2024,1,11,1700,187,245,432,Thursday
2024,1,11,1600,193,250,443,Thursday
2024,1,11,1500,230,269,499,Thursday
2024,1,11,1400,192,229,421,Thursday
2024,1,11,1300,246,218,464,Thursday
2024,1,11,1200,218,172,390,Thursday
2024,1,11,1100,214,140,354,Thursday
2024,1,11,1000,205,124,329,Thursday
2024,1,11,900,180,99,279,Thursday
2024,1,11,800,115,65,180,Thursday
2024,1,11,700,60,44,104,Thursday
2024,1,11,600,31,32,63,Thursday
2024,1,11,500,15,52,67,Thursday
2024,1,11,400,25,17,42,Thursday
2024,1,11,300,22,43,65,Thursday
2024,1,11,200,24,52,76,Thursday
2024,1,11,100,24,61,85,Thursday
2024,1,10,2400,46,62,108,Wednesday
2024,1,10,2300,59,83,142,Wednesday
2024,1,10,2200,88,112,200,Wednesday
2024,1,10,2100,105,148,253,Wednesday
2024,1,10,2000,118,145,263,Wednesday
2024,1,10,1900,129,199,328,Wednesday
2024,1,10,1800,128,272,400,Wednesday
2024,1,10,1700,165,443,608,Wednesday
2024,1,10,1600,196,317,513,Wednesday
2024,1,10,1500,209,331,540,Wednesday
2024,1,10,1400,201,275,476,Wednesday
2024,1,10,1300,196,215,411,Wednesday
2024,1,10,1200,221,153,374,Wednesday
2024,1,10,1100,270,135,405,Wednesday
2024,1,10,1000,297,90,387,Wednesday
2024,1,10,900,250,117,367,Wednesday
2024,1,10,800,163,88,251,Wednesday
2024,1,10,700,62,57,119,Wednesday
2024,1,10,600,40,79,119,Wednesday
2024,1,10,500,14,56,70,Wednesday
2024,1,10,400,18,4,22,Wednesday
2024,1,10,300,20,26,46,Wednesday
2024,1,10,200,23,29,52,Wednesday
2024,1,10,100,22,50,72,Wednesday
2024,1,9,2400,39,39,78,Tuesday
2024,1,9,2300,33,29,62,Tuesday
2024,1,9,2200,63,59,122,Tuesday
2024,1,9,2100,88,87,175,Tuesday
2024,1,9,2000,103,131,234,Tuesday
2024,1,9,1900,106,130,236,Tuesday
2024,1,9,1800,125,312,437,Tuesday
2024,1,9,1700,151,448,599,Tuesday
2024,1,9,1600,186,333,519,Tuesday
2024,1,9,1500,184,278,462,Tuesday
2024,1,9,1400,204,235,439,Tuesday
2024,1,9,1300,235,175,410,Tuesday
2024,1,9,1200,282,143,425,Tuesday
2024,1,9,1100,305,106,411,Tuesday
2024,1,9,1000,341,106,447,Tuesday
2024,1,9,900,345,80,425,Tuesday
2024,1,9,800,167,43,210,Tuesday
2024,1,9,700,76,24,100,Tuesday
2024,1,9,600,48,37,85,Tuesday
2024,1,9,500,22,25,47,Tuesday
2024,1,9,400,18,20,38,Tuesday
2024,1,9,300,17,26,43,Tuesday
2024,1,9,200,19,39,58,Tuesday
2024,1,9,100,26,27,53,Tuesday
2024,1,8,2400,41,60,101,Monday
2024,1,8,2300,49,65,114,Monday
2024,1,8,2200,76,44,120,Monday
2024,1,8,2100,72,75,147,Monday
2024,1,8,2000,90,124,214,Monday
2024,1,8,1900,137,160,297,Monday
2024,1,8,1800,164,340,504,Monday
2024,1,8,1700,186,433,619,Monday
2024,1,8,1600,226,390,616,Monday
2024,1,8,1500,298,332,630,Monday
2024,1,8,1400,256,302,558,Monday
2024,1,8,1300,296,260,556,Monday
2024,1,8,1200,324,226,550,Monday
2024,1,8,1100,336,149,485,Monday
2024,1,8,1000,328,115,443,Monday
2024,1,8,900,292,90,382,Monday
2024,1,8,800,179,52,231,Monday
2024,1,8,700,88,21,109,Monday
2024,1,8,600,29,22,51,Monday
2024,1,8,500,17,12,29,Monday
2024,1,8,400,18,29,47,Monday
2024,1,8,300,13,27,40,Monday
2024,1,8,200,15,18,33,Monday
2024,1,8,100,15,44,59,Monday
2024,1,7,2400,33,64,97,Sunday
2024,1,7,2300,37,61,98,Sunday
2024,1,7,2200,46,116,162,Sunday
2024,1,7,2100,75,146,221,Sunday
2024,1,7,2000,77,245,322,Sunday
2024,1,7,1900,106,362,468,Sunday
2024,1,7,1800,145,694,839,Sunday
2024,1,7,1700,182,1179,1361,Sunday
2024,1,7,1600,253,935,1188,Sunday
2024,1,7,1500,303,753,1056,Sunday
2024,1,7,1400,371,595,966,Sunday
2024,1,7,1300,398,536,934,Sunday
2024,1,7,1200,422,373,795,Sunday
2024,1,7,1100,432,187,619,Sunday
2024,1,7,1000,496,144,640,Sunday
2024,1,7,900,668,65,733,Sunday
2024,1,7,800,347,42,389,Sunday
2024,1,7,700,66,16,82,Sunday
2024,1,7,600,33,14,47,Sunday
2024,1,7,500,12,14,26,Sunday
2024,1,7,400,8,23,31,Sunday
2024,1,7,300,14,42,56,Sunday
2024,1,7,200,17,28,45,Sunday
2024,1,7,100,19,25,44,Sunday
2024,1,6,2400,29,42,71,Saturday
2024,1,6,2300,40,78,118,Saturday
2024,1,6,2200,52,97,149,Saturday
2024,1,6,2100,56,101,157,Saturday
2024,1,6,2000,97,181,278,Saturday
2024,1,6,1900,111,357,468,Saturday
2024,1,6,1800,131,825,956,Saturday
2024,1,6,1700,186,1105,1291,Saturday
2024,1,6,1600,232,873,1105,Saturday
2024,1,6,1500,304,650,954,Saturday
2024,1,6,1400,416,549,965,Saturday
2024,1,6,1300,451,519,970,Saturday
2024,1,6,1200,526,377,903,Saturday
2024,1,6,1100,550,226,776,Saturday
2024,1,6,1000,586,147,733,Saturday
2024,1,6,900,905,110,1015,Saturday
2024,1,6,800,458,67,525,Saturday
2024,1,6,700,108,47,155,Saturday
2024,1,6,600,42,34,76,Saturday
2024,1,6,500,16,25,41,Saturday
2024,1,6,400,20,22,42,Saturday
2024,1,6,300,22,35,57,Saturday
2024,1,6,200,20,53,73,Saturday
2024,1,6,100,30,45,75,Saturday
2024,1,5,2400,54,64,118,Friday
2024,1,5,2300,60,71,131,Friday
2024,1,5,2200,90,92,182,Friday
2024,1,5,2100,134,118,252,Friday
2024,1,5,2000,192,163,355,Friday
2024,1,5,1900,261,296,557,Friday
2024,1,5,1800,256,673,929,Friday
2024,1,5,1700,309,1047,1356,Friday
2024,1,5,1600,399,802,1201,Friday
2024,1,5,1500,447,661,1108,Friday
2024,1,5,1400,463,544,1007,Friday
2024,1,5,1300,452,477,929,Friday
2024,1,5,1200,539,357,896,Friday
2024,1,5,1100,516,272,788,Friday
2024,1,5,1000,564,201,765,Friday
2024,1,5,900,632,92,724,Friday
2024,1,5,800,308,45,353,Friday
2024,1,5,700,106,36,142,Friday
2024,1,5,600,57,27,84,Friday
2024,1,5,500,25,44,69,Friday
2024,1,5,400,25,24,49,Friday
2024,1,5,300,20,34,54,Friday
2024,1,5,200,23,70,93,Friday
2024,1,5,100,37,41,78,Friday
2024,1,4,2400,41,44,85,Thursday
2024,1,4,2300,62,81,143,Thursday
2024,1,4,2200,77,130,207,Thursday
2024,1,4,2100,123,124,247,Thursday
2024,1,4,2000,150,171,321,Thursday
2024,1,4,1900,191,356,547,Thursday
2024,1,4,1800,222,760,982,Thursday
2024,1,4,1700,292,994,1286,Thursday
2024,1,4,1600,334,811,1145,Thursday
2024,1,4,1500,403,659,1062,Thursday
2024,1,4,1400,457,533,990,Thursday
2024,1,4,1300,518,424,942,Thursday
2024,1,4,1200,604,322,926,Thursday
2024,1,4,1100,551,217,768,Thursday
2024,1,4,1000,630,162,792,Thursday
2024,1,4,900,680,115,795,Thursday
2024,1,4,800,325,71,396,Thursday
2024,1,4,700,91,40,131,Thursday
2024,1,4,600,57,42,99,Thursday
2024,1,4,500,21,37,58,Thursday
2024,1,4,400,24,22,46,Thursday
2024,1,4,300,18,48,66,Thursday
2024,1,4,200,15,29,44,Thursday
2024,1,4,100,34,47,81,Thursday
2024,1,3,2400,49,66,115,Wednesday
2024,1,3,2300,65,66,131,Wednesday
2024,1,3,2200,86,90,176,Wednesday
2024,1,3,2100,92,128,220,Wednesday
2024,1,3,2000,127,169,296,Wednesday
2024,1,3,1900,146,353,499,Wednesday
2024,1,3,1800,191,777,968,Wednesday
2024,1,3,1700,247,1047,1294,Wednesday
2024,1,3,1600,363,853,1216,Wednesday
2024,1,3,1500,427,645,1072,Wednesday
2024,1,3,1400,460,538,998,Wednesday
2024,1,3,1300,503,424,927,Wednesday
2024,1,3,1200,604,292,896,Wednesday
2024,1,3,1100,593,243,836,Wednesday
2024,1,3,1000,607,152,759,Wednesday
2024,1,3,900,673,106,779,Wednesday
2024,1,3,800,323,86,409,Wednesday
2024,1,3,700,87,37,124,Wednesday
2024,1,3,600,63,31,94,Wednesday
2024,1,3,500,20,30,50,Wednesday
2024,1,3,400,19,29,48,Wednesday
2024,1,3,300,14,31,45,Wednesday
2024,1,3,200,22,45,67,Wednesday
2024,1,3,100,28,41,69,Wednesday
2024,1,2,2400,43,57,100,Tuesday
2024,1,2,2300,59,70,129,Tuesday
2024,1,2,2200,68,79,147,Tuesday
2024,1,2,2100,105,150,255,Tuesday
2024,1,2,2000,128,221,349,Tuesday
2024,1,2,1900,169,395,564,Tuesday
2024,1,2,1800,197,881,1078,Tuesday
2024,1,2,1700,325,1143,1468,Tuesday
2024,1,2,1600,454,973,1427,Tuesday
2024,1,2,1500,508,867,1375,Tuesday
2024,1,2,1400,589,791,1380,Tuesday
2024,1,2,1300,627,658,1285,Tuesday
2024,1,2,1200,730,486,1216,Tuesday
2024,1,2,1100,692,276,968,Tuesday
2024,1,2,1000,626,193,819,Tuesday
2024,1,2,900,670,88,758,Tuesday
2024,1,2,800,333,69,402,Tuesday
2024,1,2,700,123,37,160,Tuesday
2024,1,2,600,64,17,81,Tuesday
2024,1,2,500,20,6,26,Tuesday
2024,1,2,400,23,10,33,Tuesday
2024,1,2,300,17,16,33,Tuesday
2024,1,2,200,12,17,29,Tuesday
2024,1,2,100,18,28,46,Tuesday
2024,1,1,2400,19,47,66,Monday
2024,1,1,2300,40,65,105,Monday
2024,1,1,2200,61,106,167,Monday
2024,1,1,2100,68,168,236,Monday
2024,1,1,2000,102,241,343,Monday
2024,1,1,1900,131,502,633,Monday
2024,1,1,1800,171,1041,1212,Monday
2024,1,1,1700,286,1451,1737,Monday
2024,1,1,1600,445,1265,1710,Monday
2024,1,1,1500,634,1155,1789,Monday
2024,1,1,1400,699,1094,1793,Monday
2024,1,1,1300,739,923,1662,Monday
2024,1,1,1200,706,568,1274,Monday
2024,1,1,1100,604,281,885,Monday
2024,1,1,1000,565,138,703,Monday
2024,1,1,900,518,54,572,Monday
2024,1,1,800,220,22,242,Monday
2024,1,1,700,67,22,89,Monday
2024,1,1,600,22,15,37,Monday
2024,1,1,500,19,16,35,Monday
2024,1,1,400,13,12,25,Monday
2024,1,1,300,11,23,34,Monday
2024,1,1,200,16,16,32,Monday
2024,1,1,100,27,32,59,Monday
2023,12,31,2400,15,38,53,Sunday
2023,12,31,2300,34,40,74,Sunday
2023,12,31,2200,18,69,87,Sunday
2023,12,31,2100,57,116,173,Sunday
2023,12,31,2000,66,157,223,Sunday
2023,12,31,1900,94,329,423,Sunday
2023,12,31,1800,140,822,962,Sunday
2023,12,31,1700,265,1092,1357,Sunday
2023,12,31,1600,349,882,1231,Sunday
2023,12,31,1500,493,792,1285,Sunday
2023,12,31,1400,580,652,1232,Sunday
2023,12,31,1300,655,597,1252,Sunday
2023,12,31,1200,737,386,1123,Sunday
2023,12,31,1100,674,233,907,Sunday
2023,12,31,1000,641,123,764,Sunday
2023,12,31,900,668,77,745,Sunday
2023,12,31,800,359,38,397,Sunday
2023,12,31,700,92,23,115,Sunday
2023,12,31,600,40,12,52,Sunday
2023,12,31,500,15,22,37,Sunday
2023,12,31,400,15,23,38,Sunday
2023,12,31,300,16,18,34,Sunday
2023,12,31,200,21,20,41,Sunday
2023,12,31,100,27,17,44,Sunday
2023,12,30,2400,24,47,71,Saturday
2023,12,30,2300,52,61,113,Saturday
2023,12,30,2200,51,113,164,Saturday
2023,12,30,2100,91,130,221,Saturday
2023,12,30,2000,126,236,362,Saturday
2023,12,30,1900,152,537,689,Saturday
2023,12,30,1800,205,1220,1425,Saturday
2023,12,30,1700,403,1396,1799,Saturday
2023,12,30,1600,556,1205,1761,Saturday
2023,12,30,1500,806,1064,1870,Saturday
2023,12,30,1400,903,901,1804,Saturday
2023,12,30,1300,997,699,1696,Saturday
2023,12,30,1200,1003,542,1545,Saturday
2023,12,30,1100,915,304,1219,Saturday
2023,12,30,1000,910,200,1110,Saturday
2023,12,30,900,1052,119,1171,Saturday
2023,12,30,800,520,60,580,Saturday
2023,12,30,700,116,42,158,Saturday
2023,12,30,600,57,36,93,Saturday
2023,12,30,500,15,35,50,Saturday
2023,12,30,400,21,33,54,Saturday
2023,12,30,300,17,23,40,Saturday
2023,12,30,200,12,39,51,Saturday
2023,12,30,100,29,42,71,Saturday
2023,12,29,2400,32,60,92,Friday
2023,12,29,2300,59,66,125,Friday
2023,12,29,2200,90,100,190,Friday
2023,12,29,2100,123,166,289,Friday
2023,12,29,2000,174,267,441,Friday
2023,12,29,1900,208,458,666,Friday
2023,12,29,1800,330,1092,1422,Friday
2023,12,29,1700,456,1490,1946,Friday
2023,12,29,1600,721,1030,1751,Friday
2023,12,29,1500,870,942,1812,Friday
2023,12,29,1400,823,805,1628,Friday
2023,12,29,1300,885,664,1549,Friday
2023,12,29,1200,1005,453,1458,Friday
2023,12,29,1100,929,302,1231,Friday
2023,12,29,1000,1012,184,1196,Friday
2023,12,29,900,1073,101,1174,Friday
2023,12,29,800,465,72,537,Friday
2023,12,29,700,136,27,163,Friday
2023,12,29,600,53,31,84,Friday
2023,12,29,500,24,29,53,Friday
2023,12,29,400,20,42,62,Friday
2023,12,29,300,13,33,46,Friday
2023,12,29,200,25,44,69,Friday
2023,12,29,100,28,51,79,Friday
2023,12,28,2400,48,67,115,Thursday
2023,12,28,2300,60,60,120,Thursday
2023,12,28,2200,100,134,234,Thursday
2023,12,28,2100,118,174,292,Thursday
2023,12,28,2000,171,282,453,Thursday
2023,12,28,1900,187,439,626,Thursday
2023,12,28,1800,295,1210,1505,Thursday
2023,12,28,1700,444,1420,1864,Thursday
2023,12,28,1600,628,1188,1816,Thursday
2023,12,28,1500,825,917,1742,Thursday
2023,12,28,1400,908,692,1600,Thursday
2023,12,28,1300,1007,563,1570,Thursday
2023,12,28,1200,1013,415,1428,Thursday
2023,12,28,1100,1063,244,1307,Thursday
2023,12,28,1000,1011,178,1189,Thursday
2023,12,28,900,1006,98,1104,Thursday
2023,12,28,800,445,58,503,Thursday
2023,12,28,700,139,36,175,Thursday
2023,12,28,600,47,37,84,Thursday
2023,12,28,500,31,30,61,Thursday
2023,12,28,400,16,35,51,Thursday
2023,12,28,300,18,30,48,Thursday
2023,12,28,200,18,36,54,Thursday
2023,12,28,100,35,51,86,Thursday
2023,12,27,2400,40,67,107,Wednesday
2023,12,27,2300,72,94,166,Wednesday
2023,12,27,2200,93,116,209,Wednesday
2023,12,27,2100,137,139,276,Wednesday
2023,12,27,2000,166,244,410,Wednesday
2023,12,27,1900,211,398,609,Wednesday
2023,12,27,1800,287,946,1233,Wednesday
2023,12,27,1700,539,1358,1897,Wednesday
2023,12,27,1600,757,1062,1819,Wednesday
2023,12,27,1500,972,904,1876,Wednesday
2023,12,27,1400,1046,753,1799,Wednesday
2023,12,27,1300,1099,615,1714,Wednesday
2023,12,27,1200,1144,428,1572,Wednesday
2023,12,27,1100,989,259,1248,Wednesday
2023,12,27,1000,987,151,1138,Wednesday
2023,12,27,900,874,87,961,Wednesday
2023,12,27,800,443,45,488,Wednesday
2023,12,27,700,137,17,154,Wednesday
2023,12,27,600,49,22,71,Wednesday
2023,12,27,500,27,16,43,Wednesday
2023,12,27,400,18,18,36,Wednesday
2023,12,27,300,18,26,44,Wednesday
2023,12,27,200,16,24,40,Wednesday
2023,12,27,100,25,31,56,Wednesday
2023,12,26,2400,48,47,95,Tuesday
2023,12,26,2300,46,67,113,Tuesday
2023,12,26,2200,90,96,186,Tuesday
2023,12,26,2100,106,179,285,Tuesday
2023,12,26,2000,133,505,638,Tuesday
2023,12,26,1900,220,513,733,Tuesday
2023,12,26,1800,299,730,1029,Tuesday
2023,12,26,1700,411,906,1317,Tuesday
2023,12,26,1600,694,750,1444,Tuesday
2023,12,26,1500,902,628,1530,Tuesday
2023,12,26,1400,973,593,1566,Tuesday
2023,12,26,1300,982,561,1543,Tuesday
2023,12,26,1200,941,410,1351,Tuesday
2023,12,26,1100,833,223,1056,Tuesday
2023,12,26,1000,688,119,807,Tuesday
2023,12,26,900,661,54,715,Tuesday
2023,12,26,800,253,31,284,Tuesday
2023,12,26,700,111,17,128,Tuesday
2023,12,26,600,38,13,51,Tuesday
2023,12,26,500,19,9,28,Tuesday
2023,12,26,400,6,11,17,Tuesday
2023,12,26,300,8,10,18,Tuesday
2023,12,26,200,12,17,29,Tuesday
2023,12,26,100,8,22,30,Tuesday
2023,12,25,2400,22,32,54,Monday
2023,12,25,2300,31,33,64,Monday
2023,12,25,2200,42,56,98,Monday
2023,12,25,2100,56,65,121,Monday
2023,12,25,2000,73,126,199,Monday
2023,12,25,1900,71,363,434,Monday
2023,12,25,1800,101,744,845,Monday
2023,12,25,1700,184,878,1062,Monday
2023,12,25,1600,397,819,1216,Monday
2023,12,25,1500,568,670,1238,Monday
2023,12,25,1400,656,461,1117,Monday
2023,12,25,1300,672,300,972,Monday
2023,12,25,1200,688,160,848,Monday
2023,12,25,1100,552,107,659,Monday
2023,12,25,1000,508,47,555,Monday
2023,12,25,900,385,38,423,Monday
2023,12,25,800,167,11,178,Monday
2023,12,25,700,49,12,61,Monday
2023,12,25,600,16,12,28,Monday
2023,12,25,500,15,10,25,Monday
2023,12,25,400,11,9,20,Monday
2023,12,25,300,14,8,22,Monday
2023,12,25,200,19,18,37,Monday
2023,12,25,100,23,16,39,Monday
2023,12,24,2400,20,27,47,Sunday
2023,12,24,2300,33,44,77,Sunday
2023,12,24,2200,51,51,102,Sunday
2023,12,24,2100,52,71,123,Sunday
2023,12,24,2000,84,122,206,Sunday
2023,12,24,1900,96,208,304,Sunday
2023,12,24,1800,126,457,583,Sunday
2023,12,24,1700,204,705,909,Sunday
2023,12,24,1600,329,708,1037,Sunday
2023,12,24,1500,458,542,1000,Sunday
2023,12,24,1400,524,437,961,Sunday
2023,12,24,1300,565,356,921,Sunday
2023,12,24,1200,628,267,895,Sunday
2023,12,24,1100,535,171,706,Sunday
2023,12,24,1000,467,104,571,Sunday
2023,12,24,900,441,66,507,Sunday
2023,12,24,800,183,35,218,Sunday
2023,12,24,700,49,20,69,Sunday
2023,12,24,600,22,14,36,Sunday
2023,12,24,500,17,13,30,Sunday
2023,12,24,400,16,22,38,Sunday
2023,12,24,300,7,13,20,Sunday
2023,12,24,200,19,23,42,Sunday
2023,12,24,100,11,39,50,Sunday
2023,12,23,2400,34,56,90,Saturday
2023,12,23,2300,48,72,120,Saturday
2023,12,23,2200,69,118,187,Saturday
2023,12,23,2100,77,156,233,Saturday
2023,12,23,2000,106,229,335,Saturday
2023,12,23,1900,144,352,496,Saturday
2023,12,23,1800,212,692,904,Saturday
2023,12,23,1700,361,1118,1479,Saturday
2023,12,23,1600,687,929,1616,Saturday
2023,12,23,1500,636,758,1394,Saturday
2023,12,23,1400,821,654,1475,Saturday
2023,12,23,1300,823,573,1396,Saturday
2023,12,23,1200,790,374,1164,Saturday
2023,12,23,1100,864,250,1114,Saturday
2023,12,23,1000,920,162,1082,Saturday
2023,12,23,900,611,102,713,Saturday
2023,12,23,800,311,57,368,Saturday
2023,12,23,700,99,35,134,Saturday
2023,12,23,600,45,45,90,Saturday
2023,12,23,500,18,15,33,Saturday
2023,12,23,400,27,27,54,Saturday
2023,12,23,300,8,40,48,Saturday
2023,12,23,200,20,36,56,Saturday
2023,12,23,100,32,77,109,Saturday
2023,12,22,2400,65,67,132,Friday
2023,12,22,2300,89,97,186,Friday
2023,12,22,2200,84,119,203,Friday
2023,12,22,2100,129,173,302,Friday
2023,12,22,2000,158,180,338,Friday
2023,12,22,1900,222,323,545,Friday
2023,12,22,1800,279,643,922,Friday
2023,12,22,1700,409,939,1348,Friday
2023,12,22,1600,534,802,1336,Friday
2023,12,22,1500,631,746,1377,Friday
2023,12,22,1400,529,591,1120,Friday
2023,12,22,1300,576,500,1076,Friday
2023,12,22,1200,580,402,982,Friday
2023,12,22,1100,595,265,860,Friday
2023,12,22,1000,628,174,802,Friday
2023,12,22,900,678,142,820,Friday
2023,12,22,800,368,71,439,Friday
2023,12,22,700,121,75,196,Friday
2023,12,22,600,64,37,101,Friday
2023,12,22,500,23,32,55,Friday
2023,12,22,400,24,42,66,Friday
2023,12,22,300,26,46,72,Friday
2023,12,22,200,34,38,72,Friday
2023,12,22,100,42,55,97,Friday
2023,12,21,2400,52,78,130,Thursday
2023,12,21,2300,66,86,152,Thursday
2023,12,21,2200,94,108,202,Thursday
2023,12,21,2100,105,147,252,Thursday
2023,12,21,2000,188,191,379,Thursday
2023,12,21,1900,174,279,453,Thursday
2023,12,21,1800,262,560,822,Thursday
2023,12,21,1700,261,816,1077,Thursday
2023,12,21,1600,334,704,1038,Thursday
2023,12,21,1500,354,633,987,Thursday
2023,12,21,1400,438,440,878,Thursday
2023,12,21,1300,450,411,861,Thursday
2023,12,21,1200,460,332,792,Thursday
2023,12,21,1100,515,223,738,Thursday
2023,12,21,1000,558,184,742,Thursday
2023,12,21,900,499,135,634,Thursday
2023,12,21,800,293,87,380,Thursday
2023,12,21,700,118,41,159,Thursday
2023,12,21,600,64,45,109,Thursday
2023,12,21,500,48,39,87,Thursday
2023,12,21,400,32,53,85,Thursday
2023,12,21,300,30,44,74,Thursday
2023,12,21,200,21,32,53,Thursday
2023,12,21,100,35,53,88,Thursday
2023,12,20,2400,56,47,103,Wednesday
2023,12,20,2300,88,75,163,Wednesday
2023,12,20,2200,74,114,188,Wednesday
2023,12,20,2100,132,133,265,Wednesday
2023,12,20,2000,150,156,306,Wednesday
2023,12,20,1900,157,253,410,Wednesday
2023,12,20,1800,218,441,659,Wednesday
2023,12,20,1700,246,653,899,Wednesday
2023,12,20,1600,303,746,1049,Wednesday
2023,12,20,1500,352,477,829,Wednesday
2023,12,20,1400,321,326,647,Wednesday
2023,12,20,1300,361,233,594,Wednesday
2023,12,20,1200,445,205,650,Wednesday
2023,12,20,1100,417,217,634,Wednesday
2023,12,20,1000,459,167,626,Wednesday
2023,12,20,900,427,126,553,Wednesday
2023,12,20,800,247,79,326,Wednesday
2023,12,20,700,100,48,148,Wednesday
2023,12,20,600,52,35,87,Wednesday
2023,12,20,500,32,38,70,Wednesday
2023,12,20,400,16,44,60,Wednesday
2023,12,20,300,17,31,48,Wednesday
2023,12,20,200,22,42,64,Wednesday
2023,12,20,100,33,47,80,Wednesday
2023,12,19,2400,48,67,115,Tuesday
2023,12,19,2300,63,94,157,Tuesday
2023,12,19,2200,85,79,164,Tuesday
2023,12,19,2100,83,106,189,Tuesday
2023,12,19,2000,116,147,263,Tuesday
2023,12,19,1900,160,280,440,Tuesday
2023,12,19,1800,179,426,605,Tuesday
2023,12,19,1700,222,633,855,Tuesday
2023,12,19,1600,243,516,759,Tuesday
2023,12,19,1500,301,417,718,Tuesday
2023,12,19,1400,298,352,650,Tuesday
2023,12,19,1300,306,295,601,Tuesday
2023,12,19,1200,389,236,625,Tuesday
2023,12,19,1100,370,209,579,Tuesday
2023,12,19,1000,429,132,561,Tuesday
2023,12,19,900,395,90,485,Tuesday
2023,12,19,800,167,75,242,Tuesday
2023,12,19,700,107,54,161,Tuesday
2023,12,19,600,52,34,86,Tuesday
2023,12,19,500,25,39,64,Tuesday
2023,12,19,400,29,24,53,Tuesday
2023,12,19,300,26,28,54,Tuesday
2023,12,19,200,23,28,51,Tuesday
2023,12,19,100,55,42,97,Tuesday
2023,12,18,2400,11,74,85,Monday
2023,12,18,2300,59,69,128,Monday
2023,12,18,2200,74,99,173,Monday
2023,12,18,2100,88,120,208,Monday
2023,12,18,2000,105,126,231,Monday
2023,12,18,1900,157,211,368,Monday
2023,12,18,1800,191,414,605,Monday
2023,12,18,1700,228,585,813,Monday
2023,12,18,1600,300,502,802,Monday
2023,12,18,1500,306,364,670,Monday
2023,12,18,1400,334,369,703,Monday
2023,12,18,1300,354,292,646,Monday
2023,12,18,1200,422,244,666,Monday
2023,12,18,1100,390,205,595,Monday
2023,12,18,1000,434,146,580,Monday
2023,12,18,900,435,99,534,Monday
2023,12,18,800,251,51,302,Monday
2023,12,18,700,87,17,104,Monday
2023,12,18,600,58,11,69,Monday
2023,12,18,500,21,18,39,Monday
2023,12,18,400,22,19,41,Monday
2023,12,18,300,17,18,35,Monday
2023,12,18,200,14,39,53,Monday
2023,12,18,100,30,41,71,Monday
2023,12,17,2400,34,42,76,Sunday
2023,12,17,2300,46,61,107,Sunday
2023,12,17,2200,67,106,173,Sunday
2023,12,17,2100,75,156,231,Sunday
2023,12,17,2000,118,182,300,Sunday
2023,12,17,1900,143,305,448,Sunday
2023,12,17,1800,178,723,901,Sunday
2023,12,17,1700,239,1148,1387,Sunday
2023,12,17,1600,300,886,1186,Sunday
2023,12,17,1500,343,673,1016,Sunday
2023,12,17,1400,396,576,972,Sunday
2023,12,17,1300,436,463,899,Sunday
2023,12,17,1200,456,397,853,Sunday
2023,12,17,1100,434,223,657,Sunday
2023,12,17,1000,523,134,657,Sunday
2023,12,17,900,669,70,739,Sunday
2023,12,17,800,337,33,370,Sunday
2023,12,17,700,90,28,118,Sunday
2023,12,17,600,27,19,46,Sunday
2023,12,17,500,14,16,30,Sunday
2023,12,17,400,13,14,27,Sunday
2023,12,17,300,7,20,27,Sunday
2023,12,17,200,15,16,31,Sunday
2023,12,17,100,12,37,49,Sunday
2023,12,16,2400,25,37,62,Saturday
2023,12,16,2300,37,69,106,Saturday
2023,12,16,2200,65,241,306,Saturday
2023,12,16,2100,66,261,327,Saturday
2023,12,16,2000,99,106,205,Saturday
2023,12,16,1900,105,129,234,Saturday
2023,12,16,1800,145,468,613,Saturday
2023,12,16,1700,207,758,965,Saturday
2023,12,16,1600,281,546,827,Saturday
2023,12,16,1500,318,540,858,Saturday
2023,12,16,1400,329,371,700,Saturday
2023,12,16,1300,414,327,741,Saturday
2023,12,16,1200,409,231,640,Saturday
2023,12,16,1100,467,195,662,Saturday
2023,12,16,1000,516,161,677,Saturday
2023,12,16,900,722,83,805,Saturday
2023,12,16,800,410,62,472,Saturday
2023,12,16,700,83,48,131,Saturday
2023,12,16,600,41,37,78,Saturday
2023,12,16,500,24,35,59,Saturday
2023,12,16,400,22,30,52,Saturday
2023,12,16,300,14,26,40,Saturday
2023,12,16,200,26,36,62,Saturday
2023,12,16,100,31,36,67,Saturday
2023,12,15,2400,53,51,104,Friday
2023,12,15,2300,71,60,131,Friday
2023,12,15,2200,97,94,191,Friday
2023,12,15,2100,128,118,246,Friday
2023,12,15,2000,180,140,320,Friday
2023,12,15,1900,268,242,510,Friday
2023,12,15,1800,311,384,695,Friday
2023,12,15,1700,366,525,891,Friday
2023,12,15,1600,383,574,957,Friday
2023,12,15,1500,379,516,895,Friday
2023,12,15,1400,344,393,737,Friday
2023,12,15,1300,379,323,702,Friday
2023,12,15,1200,360,213,573,Friday
2023,12,15,1100,380,181,561,Friday
2023,12,15,1000,462,152,614,Friday
2023,12,15,900,410,151,561,Friday
2023,12,15,800,228,83,311,Friday
2023,12,15,700,87,51,138,Friday
2023,12,15,600,58,40,98,Friday
2023,12,15,500,26,41,67,Friday
2023,12,15,400,21,29,50,Friday
2023,12,15,300,27,30,57,Friday
2023,12,15,200,26,58,84,Friday
2023,12,15,100,34,51,85,Friday
2023,12,14,2400,116,63,179,Thursday
2023,12,14,2300,107,108,215,Thursday
2023,12,14,2200,3,112,115,Thursday
2023,12,14,2100,96,75,171,Thursday
2023,12,14,2000,135,87,222,Thursday
2023,12,14,1900,160,118,278,Thursday
2023,12,14,1800,176,303,479,Thursday
2023,12,14,1700,222,361,583,Thursday
2023,12,14,1600,231,345,576,Thursday
2023,12,14,1500,237,294,531,Thursday
2023,12,14,1400,261,263,524,Thursday
2023,12,14,1300,294,254,548,Thursday
2023,12,14,1200,263,211,474,Thursday
2023,12,14,1100,285,167,452,Thursday
2023,12,14,1000,360,157,517,Thursday
2023,12,14,900,316,109,425,Thursday
2023,12,14,800,184,68,252,Thursday
2023,12,14,700,86,59,145,Thursday
2023,12,14,600,50,20,70,Thursday
2023,12,14,500,28,26,54,Thursday
2023,12,14,400,25,34,59,Thursday
2023,12,14,300,22,28,50,Thursday
2023,12,14,200,23,48,71,Thursday
2023,12,14,100,33,40,73,Thursday
2023,12,13,2400,69,62,131,Wednesday
2023,12,13,2300,67,69,136,Wednesday
2023,12,13,2200,74,107,181,Wednesday
2023,12,13,2100,114,77,191,Wednesday
2023,12,13,2000,144,128,272,Wednesday
2023,12,13,1900,136,186,322,Wednesday
2023,12,13,1800,190,328,518,Wednesday
2023,12,13,1700,213,463,676,Wednesday
2023,12,13,1600,236,403,639,Wednesday
2023,12,13,1500,254,355,609,Wednesday
2023,12,13,1400,245,290,535,Wednesday
2023,12,13,1300,280,235,515,Wednesday
2023,12,13,1200,300,174,474,Wednesday
2023,12,13,1100,341,191,532,Wednesday
2023,12,13,1000,335,182,517,Wednesday
2023,12,13,900,275,113,388,Wednesday
2023,12,13,800,197,82,279,Wednesday
2023,12,13,700,94,44,138,Wednesday
2023,12,13,600,50,46,96,Wednesday
2023,12,13,500,34,35,69,Wednesday
2023,12,13,400,21,36,57,Wednesday
2023,12,13,300,18,31,49,Wednesday
2023,12,13,200,27,30,57,Wednesday
2023,12,13,100,25,50,75,Wednesday
2023,12,12,2400,50,54,104,Tuesday
2023,12,12,2300,64,84,148,Tuesday
2023,12,12,2200,63,86,149,Tuesday
2023,12,12,2100,106,109,215,Tuesday
2023,12,12,2000,127,161,288,Tuesday
2023,12,12,1900,145,214,359,Tuesday
2023,12,12,1800,153,277,430,Tuesday
2023,12,12,1700,184,484,668,Tuesday
2023,12,12,1600,212,411,623,Tuesday
2023,12,12,1500,228,347,575,Tuesday
2023,12,12,1400,238,274,512,Tuesday
2023,12,12,1300,281,236,517,Tuesday
2023,12,12,1200,328,188,516,Tuesday
2023,12,12,1100,331,178,509,Tuesday
2023,12,12,1000,324,135,459,Tuesday
2023,12,12,900,325,102,427,Tuesday
2023,12,12,800,176,68,244,Tuesday
2023,12,12,700,71,49,120,Tuesday
2023,12,12,600,44,39,83,Tuesday
2023,12,12,500,25,48,73,Tuesday
2023,12,12,400,21,32,53,Tuesday
2023,12,12,300,17,36,53,Tuesday
2023,12,12,200,17,33,50,Tuesday
2023,12,12,100,34,45,79,Tuesday
2023,12,11,2400,39,52,91,Monday
2023,12,11,2300,59,65,124,Monday
2023,12,11,2200,66,74,140,Monday
2023,12,11,2100,96,93,189,Monday
2023,12,11,2000,108,127,235,Monday
2023,12,11,1900,97,180,277,Monday
2023,12,11,1800,125,384,509,Monday
2023,12,11,1700,173,431,604,Monday
2023,12,11,1600,233,461,694,Monday
2023,12,11,1500,276,312,588,Monday
2023,12,11,1400,273,274,547,Monday
2023,12,11,1300,308,216,524,Monday
2023,12,11,1200,366,197,563,Monday
2023,12,11,1100,371,175,546,Monday
2023,12,11,1000,358,97,455,Monday
2023,12,11,900,369,79,448,Monday
2023,12,11,800,213,44,257,Monday
2023,12,11,700,82,18,100,Monday
2023,12,11,600,41,14,55,Monday
2023,12,11,500,27,16,43,Monday
2023,12,11,400,15,9,24,Monday
2023,12,11,300,19,11,30,Monday
2023,12,11,200,14,16,30,Monday
2023,12,11,100,13,34,47,Monday
2023,12,10,2400,32,46,78,Sunday
2023,12,10,2300,53,62,115,Sunday
2023,12,10,2200,57,68,125,Sunday
2023,12,10,2100,85,129,214,Sunday
2023,12,10,2000,94,183,277,Sunday
2023,12,10,1900,121,300,421,Sunday
2023,12,10,1800,161,686,847,Sunday
2023,12,10,1700,197,1135,1332,Sunday
2023,12,10,1600,267,799,1066,Sunday
2023,12,10,1500,301,616,917,Sunday
2023,12,10,1400,353,478,831,Sunday
2023,12,10,1300,373,431,804,Sunday
2023,12,10,1200,391,319,710,Sunday
2023,12,10,1100,402,187,589,Sunday
2023,12,10,1000,491,114,605,Sunday
2023,12,10,900,702,62,764,Sunday
2023,12,10,800,366,25,391,Sunday
2023,12,10,700,81,18,99,Sunday
2023,12,10,600,24,18,42,Sunday
2023,12,10,500,18,20,38,Sunday
2023,12,10,400,17,24,41,Sunday
2023,12,10,300,17,7,24,Sunday
2023,12,10,200,23,20,43,Sunday
2023,12,10,100,16,36,52,Sunday
2023,12,9,2400,24,37,61,Saturday
2023,12,9,2300,26,37,63,Saturday
2023,12,9,2200,53,36,89,Saturday
2023,12,9,2100,64,57,121,Saturday
2023,12,9,2000,72,75,147,Saturday
2023,12,9,1900,82,152,234,Saturday
2023,12,9,1800,120,456,576,Saturday
2023,12,9,1700,198,744,942,Saturday
2023,12,9,1600,298,606,904,Saturday
2023,12,9,1500,256,448,704,Saturday
2023,12,9,1400,280,358,638,Saturday
2023,12,9,1300,319,359,678,Saturday
2023,12,9,1200,363,248,611,Saturday
2023,12,9,1100,410,207,617,Saturday
2023,12,9,1000,475,148,623,Saturday
2023,12,9,900,607,91,698,Saturday
2023,12,9,800,381,57,438,Saturday
2023,12,9,700,68,42,110,Saturday
2023,12,9,600,30,29,59,Saturday
2023,12,9,500,20,32,52,Saturday
2023,12,9,400,13,38,51,Saturday
2023,12,9,300,15,39,54,Saturday
2023,12,9,200,22,99,121,Saturday
2023,12,9,100,37,8,45,Saturday
2023,12,8,2400,42,9,51,Friday
2023,12,8,2300,52,34,86,Friday
2023,12,8,2200,89,86,175,Friday
2023,12,8,2100,127,109,236,Friday
2023,12,8,2000,186,154,340,Friday
2023,12,8,1900,212,216,428,Friday
2023,12,8,1800,244,417,661,Friday
2023,12,8,1700,332,596,928,Friday
2023,12,8,1600,409,486,895,Friday
2023,12,8,1500,375,448,823,Friday
2023,12,8,1400,335,301,636,Friday
2023,12,8,1300,310,258,568,Friday
2023,12,8,1200,352,250,602,Friday
2023,12,8,1100,399,193,592,Friday
2023,12,8,1000,438,141,579,Friday
2023,12,8,900,440,107,547,Friday
2023,12,8,800,204,70,274,Friday
2023,12,8,700,77,64,141,Friday
2023,12,8,600,51,45,96,Friday
2023,12,8,500,28,52,80,Friday
2023,12,8,400,20,24,44,Friday
2023,12,8,300,14,61,75,Friday
2023,12,8,200,26,37,63,Friday
2023,12,8,100,45,42,87,Friday
2023,12,7,2400,40,60,100,Thursday
2023,12,7,2300,49,63,112,Thursday
2023,12,7,2200,72,103,175,Thursday
2023,12,7,2100,123,98,221,Thursday
2023,12,7,2000,147,110,257,Thursday
2023,12,7,1900,197,178,375,Thursday
2023,12,7,1800,191,296,487,Thursday
2023,12,7,1700,200,441,641,Thursday
2023,12,7,1600,234,408,642,Thursday
2023,12,7,1500,240,335,575,Thursday
2023,12,7,1400,257,313,570,Thursday
2023,12,7,1300,232,227,459,Thursday
2023,12,7,1200,246,192,438,Thursday
2023,12,7,1100,284,134,418,Thursday
2023,12,7,1000,326,122,448,Thursday
2023,12,7,900,425,115,540,Thursday
2023,12,7,800,177,87,264,Thursday
2023,12,7,700,59,53,112,Thursday
2023,12,7,600,45,40,85,Thursday
2023,12,7,500,23,30,53,Thursday
2023,12,7,400,18,32,50,Thursday
2023,12,7,300,16,71,87,Thursday
2023,12,7,200,22,26,48,Thursday
2023,12,7,100,23,45,68,Thursday
2023,12,6,2400,42,90,132,Wednesday
2023,12,6,2300,48,168,216,Wednesday
2023,12,6,2200,54,250,304,Wednesday
2023,12,6,2100,88,219,307,Wednesday
2023,12,6,2000,92,176,268,Wednesday
2023,12,6,1900,104,204,308,Wednesday
2023,12,6,1800,111,283,394,Wednesday
2023,12,6,1700,141,359,500,Wednesday
2023,12,6,1600,154,285,439,Wednesday
2023,12,6,1500,198,337,535,Wednesday
2023,12,6,1400,200,261,461,Wednesday
2023,12,6,1300,230,214,444,Wednesday
2023,12,6,1200,276,145,421,Wednesday
2023,12,6,1100,258,117,375,Wednesday
2023,12,6,1000,267,61,328,Wednesday
2023,12,6,900,309,69,378,Wednesday
2023,12,6,800,187,33,220,Wednesday
2023,12,6,700,68,19,87,Wednesday
2023,12,6,600,33,12,45,Wednesday
2023,12,6,500,25,14,39,Wednesday
2023,12,6,400,14,5,19,Wednesday
2023,12,6,300,18,12,30,Wednesday
2023,12,6,200,23,10,33,Wednesday
2023,12,6,100,29,12,41,Wednesday
2023,12,5,2400,27,36,63,Tuesday
2023,12,5,2300,42,72,114,Tuesday
2023,12,5,2200,71,118,189,Tuesday
2023,12,5,2100,82,102,184,Tuesday
2023,12,5,2000,91,80,171,Tuesday
2023,12,5,1900,85,145,230,Tuesday
2023,12,5,1800,103,181,284,Tuesday
2023,12,5,1700,157,213,370,Tuesday
2023,12,5,1600,192,270,462,Tuesday
2023,12,5,1500,196,290,486,Tuesday
2023,12,5,1400,219,237,456,Tuesday
2023,12,5,1300,241,163,404,Tuesday
2023,12,5,1200,301,145,446,Tuesday
2023,12,5,1100,298,142,440,Tuesday
2023,12,5,1000,257,99,356,Tuesday
2023,12,5,900,239,101,340,Tuesday
2023,12,5,800,174,46,220,Tuesday
2023,12,5,700,70,23,93,Tuesday
2023,12,5,600,55,15,70,Tuesday
2023,12,5,500,28,9,37,Tuesday
2023,12,5,400,17,12,29,Tuesday
2023,12,5,300,20,12,32,Tuesday
2023,12,5,200,20,13,33,Tuesday
2023,12,5,100,32,61,93,Tuesday
2023,12,4,2400,32,46,78,Monday
2023,12,4,2300,62,47,109,Monday
2023,12,4,2200,68,62,130,Monday
2023,12,4,2100,93,78,171,Monday
2023,12,4,2000,106,97,203,Monday
2023,12,4,1900,137,137,274,Monday
2023,12,4,1800,145,246,391,Monday
2023,12,4,1700,185,360,545,Monday
2023,12,4,1600,231,392,623,Monday
2023,12,4,1500,266,316,582,Monday
2023,12,4,1400,281,296,577,Monday
2023,12,4,1300,254,243,497,Monday
2023,12,4,1200,351,210,561,Monday
2023,12,4,1100,291,196,487,Monday
2023,12,4,1000,352,129,481,Monday
2023,12,4,900,289,92,381,Monday
2023,12,4,800,178,44,222,Monday
2023,12,4,700,99,14,113,Monday
2023,12,4,600,50,16,66,Monday
2023,12,4,500,27,12,39,Monday
2023,12,4,400,11,11,22,Monday
2023,12,4,300,16,48,64,Monday
2023,12,4,200,19,49,68,Monday
2023,12,4,100,19,29,48,Monday
2023,12,3,2400,23,11,34,Sunday
2023,12,3,2300,39,24,63,Sunday
2023,12,3,2200,54,46,100,Sunday
2023,12,3,2100,80,136,216,Sunday
2023,12,3,2000,105,133,238,Sunday
2023,12,3,1900,134,133,267,Sunday
2023,12,3,1800,131,360,491,Sunday
2023,12,3,1700,211,829,1040,Sunday
2023,12,3,1600,247,616,863,Sunday
2023,12,3,1500,331,551,882,Sunday
2023,12,3,1400,335,504,839,Sunday
2023,12,3,1300,370,414,784,Sunday
2023,12,3,1200,417,304,721,Sunday
2023,12,3,1100,443,160,603,Sunday
2023,12,3,1000,403,115,518,Sunday
2023,12,3,900,417,58,475,Sunday
2023,12,3,800,263,33,296,Sunday
2023,12,3,700,69,22,91,Sunday
2023,12,3,600,28,15,43,Sunday
2023,12,3,500,15,19,34,Sunday
2023,12,3,400,12,13,25,Sunday
2023,12,3,300,8,22,30,Sunday
2023,12,3,200,17,27,44,Sunday
2023,12,3,100,19,25,44,Sunday
2023,12,2,2400,21,53,74,Saturday
2023,12,2,2300,42,111,153,Saturday
2023,12,2,2200,48,82,130,Saturday
2023,12,2,2100,60,43,103,Saturday
2023,12,2,2000,85,110,195,Saturday
2023,12,2,1900,105,177,282,Saturday
2023,12,2,1800,120,402,522,Saturday
2023,12,2,1700,146,687,833,Saturday
2023,12,2,1600,230,548,778,Saturday
2023,12,2,1500,277,500,777,Saturday
2023,12,2,1400,385,350,735,Saturday
2023,12,2,1300,380,286,666,Saturday
2023,12,2,1200,453,224,677,Saturday
2023,12,2,1100,420,206,626,Saturday
2023,12,2,1000,432,145,577,Saturday
2023,12,2,900,462,94,556,Saturday
2023,12,2,800,301,43,344,Saturday
2023,12,2,700,85,31,116,Saturday
2023,12,2,600,35,17,52,Saturday
2023,12,2,500,24,12,36,Saturday
2023,12,2,400,20,27,47,Saturday
2023,12,2,300,17,35,52,Saturday
2023,12,2,200,16,26,42,Saturday
2023,12,2,100,44,56,100,Saturday
2023,12,1,2400,39,59,98,Friday
2023,12,1,2300,64,60,124,Friday
2023,12,1,2200,64,85,149,Friday
2023,12,1,2100,119,94,213,Friday
2023,12,1,2000,157,148,305,Friday
2023,12,1,1900,189,236,425,Friday
2023,12,1,1800,261,381,642,Friday
2023,12,1,1700,295,463,758,Friday
2023,12,1,1600,333,484,817,Friday
2023,12,1,1500,339,403,742,Friday
2023,12,1,1400,350,317,667,Friday
2023,12,1,1300,361,266,627,Friday
2023,12,1,1200,342,252,594,Friday
2023,12,1,1100,365,176,541,Friday
2023,12,1,1000,305,173,478,Friday
2023,12,1,900,296,114,410,Friday
2023,12,1,800,200,69,269,Friday
2023,12,1,700,94,35,129,Friday
2023,12,1,600,45,27,72,Friday
2023,12,1,500,23,35,58,Friday
2023,12,1,400,24,34,58,Friday
2023,12,1,300,25,38,63,Friday
2023,12,1,200,25,32,57,Friday
2023,12,1,100,30,29,59,Friday
2023,11,30,2400,47,45,92,Thursday
2023,11,30,2300,55,93,148,Thursday
2023,11,30,2200,75,87,162,Thursday
2023,11,30,2100,102,109,211,Thursday
2023,11,30,2000,125,144,269,Thursday
2023,11,30,1900,162,207,369,Thursday
2023,11,30,1800,164,310,474,Thursday
2023,11,30,1700,192,446,638,Thursday
2023,11,30,1600,245,415,660,Thursday
2023,11,30,1500,244,316,560,Thursday
2023,11,30,1400,228,304,532,Thursday
2023,11,30,1300,265,233,498,Thursday
2023,11,30,1200,320,256,576,Thursday
2023,11,30,1100,274,274,548,Thursday
2023,11,30,1000,296,133,429,Thursday
2023,11,30,900,265,89,354,Thursday
2023,11,30,800,176,49,225,Thursday
2023,11,30,700,108,14,122,Thursday
2023,11,30,600,54,9,63,Thursday
2023,11,30,500,19,13,32,Thursday
2023,11,30,400,24,16,40,Thursday
2023,11,30,300,16,19,35,Thursday
2023,11,30,200,24,29,53,Thursday
2023,11,30,100,24,12,36,Thursday
2023,11,29,2400,37,38,75,Wednesday
2023,11,29,2300,64,94,158,Wednesday
2023,11,29,2200,60,115,175,Wednesday
2023,11,29,2100,103,110,213,Wednesday
2023,11,29,2000,119,127,246,Wednesday
2023,11,29,1900,112,195,307,Wednesday
2023,11,29,1800,186,300,486,Wednesday
2023,11,29,1700,238,361,599,Wednesday
2023,11,29,1600,213,368,581,Wednesday
2023,11,29,1500,270,286,556,Wednesday
2023,11,29,1400,263,285,548,Wednesday
2023,11,29,1300,282,259,541,Wednesday
2023,11,29,1200,305,195,500,Wednesday
2023,11,29,1100,294,206,500,Wednesday
2023,11,29,1000,280,167,447,Wednesday
2023,11,29,900,276,184,460,Wednesday
2023,11,29,800,181,45,226,Wednesday
2023,11,29,700,101,22,123,Wednesday
2023,11,29,600,43,31,74,Wednesday
2023,11,29,500,27,16,43,Wednesday
2023,11,29,400,25,25,50,Wednesday
2023,11,29,300,12,13,25,Wednesday
2023,11,29,200,19,21,40,Wednesday
2023,11,29,100,30,14,44,Wednesday
2023,11,28,2400,43,48,91,Tuesday
2023,11,28,2300,61,104,165,Tuesday
2023,11,28,2200,57,84,141,Tuesday
2023,11,28,2100,82,113,195,Tuesday
2023,11,28,2000,125,127,252,Tuesday
2023,11,28,1900,127,196,323,Tuesday
2023,11,28,1800,140,289,429,Tuesday
2023,11,28,1700,172,382,554,Tuesday
2023,11,28,1600,210,367,577,Tuesday
2023,11,28,1500,256,344,600,Tuesday
2023,11,28,1400,267,258,525,Tuesday
2023,11,28,1300,281,243,524,Tuesday
2023,11,28,1200,316,211,527,Tuesday
2023,11,28,1100,365,164,529,Tuesday
2023,11,28,1000,287,145,432,Tuesday
2023,11,28,900,235,175,410,Tuesday
2023,11,28,800,193,53,246,Tuesday
2023,11,28,700,107,32,139,Tuesday
2023,11,28,600,52,23,75,Tuesday
2023,11,28,500,18,27,45,Tuesday
2023,11,28,400,16,15,31,Tuesday
2023,11,28,300,14,19,33,Tuesday
2023,11,28,200,24,12,36,Tuesday
2023,11,28,100,22,13,35,Tuesday
2023,11,27,2400,39,49,88,Monday
2023,11,27,2300,53,71,124,Monday
2023,11,27,2200,41,91,132,Monday
2023,11,27,2100,105,106,211,Monday
2023,11,27,2000,121,134,255,Monday
2023,11,27,1900,109,183,292,Monday
2023,11,27,1800,145,313,458,Monday
2023,11,27,1700,189,344,533,Monday
2023,11,27,1600,233,337,570,Monday
2023,11,27,1500,220,303,523,Monday
2023,11,27,1400,265,247,512,Monday
2023,11,27,1300,295,248,543,Monday
2023,11,27,1200,346,209,555,Monday
2023,11,27,1100,313,155,468,Monday
2023,11,27,1000,323,126,449,Monday
2023,11,27,900,268,99,367,Monday
2023,11,27,800,194,35,229,Monday
2023,11,27,700,106,17,123,Monday
2023,11,27,600,56,17,73,Monday
2023,11,27,500,13,15,28,Monday
2023,11,27,400,23,15,38,Monday
2023,11,27,300,14,13,27,Monday
2023,11,27,200,17,24,41,Monday
2023,11,27,100,11,10,21,Monday
2023,11,26,2400,18,35,53,Sunday
2023,11,26,2300,34,69,103,Sunday
2023,11,26,2200,51,84,135,Sunday
2023,11,26,2100,100,121,221,Sunday
2023,11,26,2000,121,161,282,Sunday
2023,11,26,1900,133,272,405,Sunday
2023,11,26,1800,180,518,698,Sunday
2023,11,26,1700,226,847,1073,Sunday
2023,11,26,1600,287,746,1033,Sunday
2023,11,26,1500,351,628,979,Sunday
2023,11,26,1400,402,535,937,Sunday
2023,11,26,1300,391,433,824,Sunday
2023,11,26,1200,493,338,831,Sunday
2023,11,26,1100,483,186,669,Sunday
2023,11,26,1000,460,152,612,Sunday
2023,11,26,900,389,81,470,Sunday
2023,11,26,800,253,20,273,Sunday
2023,11,26,700,104,18,122,Sunday
2023,11,26,600,44,12,56,Sunday
2023,11,26,500,23,13,36,Sunday
2023,11,26,400,8,18,26,Sunday
2023,11,26,300,15,14,29,Sunday
2023,11,26,200,13,13,26,Sunday
2023,11,26,100,21,7,28,Sunday
2023,11,25,2400,22,28,50,Saturday
2023,11,25,2300,32,45,77,Saturday
2023,11,25,2200,41,58,99,Saturday
2023,11,25,2100,66,72,138,Saturday
2023,11,25,2000,108,140,248,Saturday
2023,11,25,1900,139,230,369,Saturday
2023,11,25,1800,128,467,595,Saturday
2023,11,25,1700,172,700,872,Saturday
2023,11,25,1600,263,602,865,Saturday
2023,11,25,1500,308,542,850,Saturday
2023,11,25,1400,372,463,835,Saturday
2023,11,25,1300,400,357,757,Saturday
2023,11,25,1200,522,289,811,Saturday
2023,11,25,1100,483,239,722,Saturday
2023,11,25,1000,587,207,794,Saturday
2023,11,25,900,479,171,650,Saturday
2023,11,25,800,341,41,382,Saturday
2023,11,25,700,91,22,113,Saturday
2023,11,25,600,45,32,77,Saturday
2023,11,25,500,17,17,34,Saturday
2023,11,25,400,10,21,31,Saturday
2023,11,25,300,13,17,30,Saturday
2023,11,25,200,13,30,43,Saturday
2023,11,25,100,20,15,35,Saturday
2023,11,24,2400,42,44,86,Friday
2023,11,24,2300,50,102,152,Friday
2023,11,24,2200,59,82,141,Friday
2023,11,24,2100,122,113,235,Friday
2023,11,24,2000,203,139,342,Friday
2023,11,24,1900,212,245,457,Friday
2023,11,24,1800,288,495,783,Friday
2023,11,24,1700,288,570,858,Friday
2023,11,24,1600,359,553,912,Friday
2023,11,24,1500,369,492,861,Friday
2023,11,24,1400,412,379,791,Friday
2023,11,24,1300,427,343,770,Friday
2023,11,24,1200,457,293,750,Friday
2023,11,24,1100,444,190,634,Friday
2023,11,24,1000,454,204,658,Friday
2023,11,24,900,369,189,558,Friday
2023,11,24,800,237,42,279,Friday
2023,11,24,700,143,28,171,Friday
2023,11,24,600,53,41,94,Friday
2023,11,24,500,29,28,57,Friday
2023,11,24,400,21,24,45,Friday
2023,11,24,300,24,29,53,Friday
2023,11,24,200,21,18,39,Friday
2023,11,24,100,27,8,35,Friday
2023,11,23,2400,45,47,92,Thursday
2023,11,23,2300,52,104,156,Thursday
2023,11,23,2200,64,106,170,Thursday
2023,11,23,2100,127,105,232,Thursday
2023,11,23,2000,181,161,342,Thursday
2023,11,23,1900,179,217,396,Thursday
2023,11,23,1800,192,392,584,Thursday
2023,11,23,1700,234,514,748,Thursday
2023,11,23,1600,308,427,735,Thursday
2023,11,23,1500,311,392,703,Thursday
2023,11,23,1400,312,342,654,Thursday
2023,11,23,1300,337,266,603,Thursday
2023,11,23,1200,352,229,581,Thursday
2023,11,23,1100,343,177,520,Thursday
2023,11,23,1000,389,166,555,Thursday
2023,11,23,900,351,184,535,Thursday
2023,11,23,800,213,91,304,Thursday
2023,11,23,700,139,47,186,Thursday
2023,11,23,600,77,61,138,Thursday
2023,11,23,500,26,38,64,Thursday
2023,11,23,400,30,24,54,Thursday
2023,11,23,300,20,35,55,Thursday
2023,11,23,200,27,32,59,Thursday
2023,11,23,100,31,23,54,Thursday
2023,11,22,2400,42,65,107,Wednesday
2023,11,22,2300,62,98,160,Wednesday
2023,11,22,2200,70,118,188,Wednesday
2023,11,22,2100,90,123,213,Wednesday
2023,11,22,2000,118,155,273,Wednesday
2023,11,22,1900,120,201,321,Wednesday
2023,11,22,1800,151,328,479,Wednesday
2023,11,22,1700,214,453,667,Wednesday
2023,11,22,1600,209,395,604,Wednesday
2023,11,22,1500,230,304,534,Wednesday
2023,11,22,1400,267,350,617,Wednesday
2023,11,22,1300,305,242,547,Wednesday
2023,11,22,1200,295,172,467,Wednesday
2023,11,22,1100,326,141,467,Wednesday
2023,11,22,1000,323,172,495,Wednesday
2023,11,22,900,313,188,501,Wednesday
2023,11,22,800,172,40,212,Wednesday
2023,11,22,700,88,30,118,Wednesday
2023,11,22,600,50,23,73,Wednesday
2023,11,22,500,26,14,40,Wednesday
2023,11,22,400,6,16,22,Wednesday
2023,11,22,300,20,27,47,Wednesday
2023,11,22,200,14,14,28,Wednesday
2023,11,22,100,23,15,38,Wednesday
2023,11,21,2400,32,36,68,Tuesday
2023,11,21,2300,44,98,142,Tuesday
2023,11,21,2200,60,93,153,Tuesday
2023,11,21,2100,91,106,197,Tuesday
2023,11,21,2000,133,129,262,Tuesday
2023,11,21,1900,136,197,333,Tuesday
2023,11,21,1800,159,312,471,Tuesday
2023,11,21,1700,213,423,636,Tuesday
2023,11,21,1600,222,361,583,Tuesday
2023,11,21,1500,251,361,612,Tuesday
2023,11,21,1400,263,304,567,Tuesday
2023,11,21,1300,298,293,591,Tuesday
2023,11,21,1200,350,217,567,Tuesday
2023,11,21,1100,348,172,520,Tuesday
2023,11,21,1000,341,168,509,Tuesday
2023,11,21,900,285,154,439,Tuesday
2023,11,21,800,177,41,218,Tuesday
2023,11,21,700,81,37,118,Tuesday
2023,11,21,600,44,27,71,Tuesday
2023,11,21,500,29,26,55,Tuesday
2023,11,21,400,14,17,31,Tuesday
2023,11,21,300,17,24,41,Tuesday
2023,11,21,200,17,14,31,Tuesday
2023,11,21,100,18,16,34,Tuesday
2023,11,20,2400,33,28,61,Monday
2023,11,20,2300,38,93,131,Monday
2023,11,20,2200,46,70,116,Monday
2023,11,20,2100,116,107,223,Monday
2023,11,20,2000,133,127,260,Monday
2023,11,20,1900,144,202,346,Monday
2023,11,20,1800,182,345,527,Monday
2023,11,20,1700,208,484,692,Monday
2023,11,20,1600,261,407,668,Monday
2023,11,20,1500,288,356,644,Monday
2023,11,20,1400,328,289,617,Monday
2023,11,20,1300,335,270,605,Monday
2023,11,20,1200,376,183,559,Monday
2023,11,20,1100,413,144,557,Monday
2023,11,20,1000,355,125,480,Monday
2023,11,20,900,332,104,436,Monday
2023,11,20,800,198,46,244,Monday
2023,11,20,700,79,14,93,Monday
2023,11,20,600,47,11,58,Monday
2023,11,20,500,21,13,34,Monday
2023,11,20,400,17,11,28,Monday
2023,11,20,300,17,18,35,Monday
2023,11,20,200,12,21,33,Monday
2023,11,20,100,16,9,25,Monday
2023,11,19,2400,20,40,60,Sunday
2023,11,19,2300,37,68,105,Sunday
2023,11,19,2200,37,115,152,Sunday
2023,11,19,2100,76,110,186,Sunday
2023,11,19,2000,106,147,253,Sunday
2023,11,19,1900,127,257,384,Sunday
2023,11,19,1800,161,463,624,Sunday
2023,11,19,1700,247,779,1026,Sunday
2023,11,19,1600,326,708,1034,Sunday
2023,11,19,1500,299,605,904,Sunday
2023,11,19,1400,326,538,864,Sunday
2023,11,19,1300,430,463,893,Sunday
2023,11,19,1200,494,312,806,Sunday
2023,11,19,1100,439,232,671,Sunday
2023,11,19,1000,434,165,599,Sunday
2023,11,19,900,442,95,537,Sunday
2023,11,19,800,209,28,237,Sunday
2023,11,19,700,78,19,97,Sunday
2023,11,19,600,26,12,38,Sunday
2023,11,19,500,20,11,31,Sunday
2023,11,19,400,10,11,21,Sunday
2023,11,19,300,10,14,24,Sunday
2023,11,19,200,10,13,23,Sunday
2023,11,19,100,19,8,27,Sunday
2023,11,18,2400,14,26,40,Saturday
2023,11,18,2300,27,59,86,Saturday
2023,11,18,2200,33,82,115,Saturday
2023,11,18,2100,72,103,175,Saturday
2023,11,18,2000,106,129,235,Saturday
2023,11,18,1900,101,262,363,Saturday
2023,11,18,1800,140,505,645,Saturday
2023,11,18,1700,184,718,902,Saturday
2023,11,18,1600,292,658,950,Saturday
2023,11,18,1500,293,509,802,Saturday
2023,11,18,1400,401,409,810,Saturday
2023,11,18,1300,415,371,786,Saturday
2023,11,18,1200,496,267,763,Saturday
2023,11,18,1100,471,229,700,Saturday
2023,11,18,1000,516,174,690,Saturday
2023,11,18,900,492,179,671,Saturday
2023,11,18,800,283,39,322,Saturday
2023,11,18,700,107,35,142,Saturday
2023,11,18,600,49,16,65,Saturday
2023,11,18,500,15,17,32,Saturday
2023,11,18,400,9,15,24,Saturday
2023,11,18,300,10,24,34,Saturday
2023,11,18,200,22,26,48,Saturday
2023,11,18,100,36,10,46,Saturday
2023,11,17,2400,33,40,73,Friday
2023,11,17,2300,49,79,128,Friday
2023,11,17,2200,68,88,156,Friday
2023,11,17,2100,143,142,285,Friday
2023,11,17,2000,198,157,355,Friday
2023,11,17,1900,222,240,462,Friday
2023,11,17,1800,258,425,683,Friday
2023,11,17,1700,278,547,825,Friday
2023,11,17,1600,375,493,868,Friday
2023,11,17,1500,372,410,782,Friday
2023,11,17,1400,367,386,753,Friday
2023,11,17,1300,373,353,726,Friday
2023,11,17,1200,403,281,684,Friday
2023,11,17,1100,392,224,616,Friday
2023,11,17,1000,373,199,572,Friday
2023,11,17,900,335,177,512,Friday
2023,11,17,800,200,62,262,Friday
2023,11,17,700,105,25,130,Friday
2023,11,17,600,47,29,76,Friday
2023,11,17,500,16,22,38,Friday
2023,11,17,400,19,23,42,Friday
2023,11,17,300,19,20,39,Friday
2023,11,17,200,21,21,42,Friday
2023,11,17,100,26,13,39,Friday
2023,11,16,2400,40,52,92,Thursday
2023,11,16,2300,49,103,152,Thursday
2023,11,16,2200,63,120,183,Thursday
2023,11,16,2100,106,129,235,Thursday
2023,11,16,2000,149,175,324,Thursday
2023,11,16,1900,144,233,377,Thursday
2023,11,16,1800,201,408,609,Thursday
2023,11,16,1700,242,534,776,Thursday
2023,11,16,1600,310,365,675,Thursday
2023,11,16,1500,289,343,632,Thursday
2023,11,16,1400,311,351,662,Thursday
2023,11,16,1300,324,402,726,Thursday
2023,11,16,1200,386,216,602,Thursday
2023,11,16,1100,358,244,602,Thursday
2023,11,16,1000,316,224,540,Thursday
2023,11,16,900,266,192,458,Thursday
2023,11,16,800,177,28,205,Thursday
2023,11,16,700,91,20,111,Thursday
2023,11,16,600,56,22,78,Thursday
2023,11,16,500,16,29,45,Thursday
2023,11,16,400,12,37,49,Thursday
2023,11,16,300,16,19,35,Thursday
2023,11,16,200,14,4,18,Thursday
2023,11,16,100,32,6,38,Thursday
2023,11,15,2400,31,12,43,Wednesday
2023,11,15,2300,41,12,53,Wednesday
2023,11,15,2200,50,70,120,Wednesday
2023,11,15,2100,99,117,216,Wednesday
2023,11,15,2000,136,137,273,Wednesday
2023,11,15,1900,111,196,307,Wednesday
2023,11,15,1800,147,342,489,Wednesday
2023,11,15,1700,167,391,558,Wednesday
2023,11,15,1600,246,364,610,Wednesday
2023,11,15,1500,261,314,575,Wednesday
2023,11,15,1400,274,303,577,Wednesday
2023,11,15,1300,274,263,537,Wednesday
2023,11,15,1200,299,217,516,Wednesday
2023,11,15,1100,315,194,509,Wednesday
2023,11,15,1000,323,176,499,Wednesday
2023,11,15,900,269,211,480,Wednesday
2023,11,15,800,167,54,221,Wednesday
2023,11,15,700,109,29,138,Wednesday
2023,11,15,600,54,31,85,Wednesday
2023,11,15,500,20,16,36,Wednesday
2023,11,15,400,17,24,41,Wednesday
2023,11,15,300,14,21,35,Wednesday
2023,11,15,200,14,20,34,Wednesday
2023,11,15,100,25,13,38,Wednesday
2023,11,14,2400,38,43,81,Tuesday
2023,11,14,2300,45,97,142,Tuesday
2023,11,14,2200,54,97,151,Tuesday
2023,11,14,2100,83,100,183,Tuesday
2023,11,14,2000,149,163,312,Tuesday
2023,11,14,1900,142,235,377,Tuesday
2023,11,14,1800,176,421,597,Tuesday
2023,11,14,1700,215,516,731,Tuesday
2023,11,14,1600,236,466,702,Tuesday
2023,11,14,1500,271,437,708,Tuesday
2023,11,14,1400,291,423,714,Tuesday
2023,11,14,1300,346,305,651,Tuesday
2023,11,14,1200,411,234,645,Tuesday
2023,11,14,1100,438,187,625,Tuesday
2023,11,14,1000,418,173,591,Tuesday
2023,11,14,900,314,133,447,Tuesday
2023,11,14,800,201,48,249,Tuesday
2023,11,14,700,90,24,114,Tuesday
2023,11,14,600,53,50,103,Tuesday
2023,11,14,500,18,24,42,Tuesday
2023,11,14,400,14,8,22,Tuesday
2023,11,14,300,15,3,18,Tuesday
2023,11,14,200,12,10,22,Tuesday
2023,11,14,100,20,10,30,Tuesday
2023,11,13,2400,26,54,80,Monday
2023,11,13,2300,43,50,93,Monday
2023,11,13,2200,49,122,171,Monday
2023,11,13,2100,97,141,238,Monday
2023,11,13,2000,114,141,255,Monday
2023,11,13,1900,115,303,418,Monday
2023,11,13,1800,168,527,695,Monday
2023,11,13,1700,244,666,910,Monday
2023,11,13,1600,343,754,1097,Monday
2023,11,13,1500,398,707,1105,Monday
2023,11,13,1400,445,626,1071,Monday
2023,11,13,1300,490,559,1049,Monday
2023,11,13,1200,577,393,970,Monday
2023,11,13,1100,590,271,861,Monday
2023,11,13,1000,540,153,693,Monday
2023,11,13,900,482,94,576,Monday
2023,11,13,800,217,36,253,Monday
2023,11,13,700,102,8,110,Monday
2023,11,13,600,38,8,46,Monday
2023,11,13,500,17,12,29,Monday
2023,11,13,400,4,8,12,Monday
2023,11,13,300,18,9,27,Monday
2023,11,13,200,10,10,20,Monday
2023,11,13,100,10,6,16,Monday
2023,11,12,2400,19,24,43,Sunday
2023,11,12,2300,44,63,107,Sunday
2023,11,12,2200,51,100,151,Sunday
2023,11,12,2100,60,114,174,Sunday
2023,11,12,2000,107,157,264,Sunday
2023,11,12,1900,119,339,458,Sunday
2023,11,12,1800,160,696,856,Sunday
2023,11,12,1700,284,1020,1304,Sunday
2023,11,12,1600,329,905,1234,Sunday
2023,11,12,1500,394,855,1249,Sunday
2023,11,12,1400,485,727,1212,Sunday
2023,11,12,1300,540,563,1103,Sunday
2023,11,12,1200,667,376,1043,Sunday
2023,11,12,1100,621,190,811,Sunday
2023,11,12,1000,560,129,689,Sunday
2023,11,12,900,523,69,592,Sunday
2023,11,12,800,266,23,289,Sunday
2023,11,12,700,74,9,83,Sunday
2023,11,12,600,31,11,42,Sunday
2023,11,12,500,9,4,13,Sunday
2023,11,12,400,7,17,24,Sunday
2023,11,12,300,9,11,20,Sunday
2023,11,12,200,9,17,26,Sunday
2023,11,12,100,12,10,22,Sunday
2023,11,11,2400,14,47,61,Saturday
2023,11,11,2300,23,89,112,Saturday
2023,11,11,2200,37,91,128,Saturday
2023,11,11,2100,72,119,191,Saturday
2023,11,11,2000,97,199,296,Saturday
2023,11,11,1900,102,159,261,Saturday
2023,11,11,1800,144,518,662,Saturday
2023,11,11,1700,220,660,880,Saturday
2023,11,11,1600,333,675,1008,Saturday
2023,11,11,1500,397,510,907,Saturday
2023,11,11,1400,466,481,947,Saturday
2023,11,11,1300,462,472,934,Saturday
2023,11,11,1200,606,353,959,Saturday
2023,11,11,1100,604,249,853,Saturday
2023,11,11,1000,601,197,798,Saturday
2023,11,11,900,600,137,737,Saturday
2023,11,11,800,238,47,285,Saturday
2023,11,11,700,94,22,116,Saturday
2023,11,11,600,34,29,63,Saturday
2023,11,11,500,17,20,37,Saturday
2023,11,11,400,13,23,36,Saturday
2023,11,11,300,11,24,35,Saturday
2023,11,11,200,17,22,39,Saturday
2023,11,11,100,43,27,70,Saturday
2023,11,10,2400,40,58,98,Friday
2023,11,10,2300,63,96,159,Friday
2023,11,10,2200,79,119,198,Friday
2023,11,10,2100,160,153,313,Friday
2023,11,10,2000,227,200,427,Friday
2023,11,10,1900,310,312,622,Friday
2023,11,10,1800,332,504,836,Friday
2023,11,10,1700,390,687,1077,Friday
2023,11,10,1600,456,609,1065,Friday
2023,11,10,1500,506,592,1098,Friday
2023,11,10,1400,529,443,972,Friday
2023,11,10,1300,548,371,919,Friday
2023,11,10,1200,599,294,893,Friday
2023,11,10,1100,593,222,815,Friday
2023,11,10,1000,489,179,668,Friday
2023,11,10,900,434,222,656,Friday
2023,11,10,800,249,41,290,Friday
2023,11,10,700,115,28,143,Friday
2023,11,10,600,66,42,108,Friday
2023,11,10,500,27,17,44,Friday
2023,11,10,400,17,21,38,Friday
2023,11,10,300,22,19,41,Friday
2023,11,10,200,19,24,43,Friday
2023,11,10,100,27,22,49,Friday
2023,11,9,2400,37,49,86,Thursday
2023,11,9,2300,56,107,163,Thursday
2023,11,9,2200,82,136,218,Thursday
2023,11,9,2100,140,137,277,Thursday
2023,11,9,2000,194,179,373,Thursday
2023,11,9,1900,247,276,523,Thursday
2023,11,9,1800,282,376,658,Thursday
2023,11,9,1700,307,510,817,Thursday
2023,11,9,1600,339,471,810,Thursday
2023,11,9,1500,354,435,789,Thursday
2023,11,9,1400,372,361,733,Thursday
2023,11,9,1300,427,260,687,Thursday
2023,11,9,1200,455,209,664,Thursday
2023,11,9,1100,407,161,568,Thursday
2023,11,9,1000,389,173,562,Thursday
2023,11,9,900,316,183,499,Thursday
2023,11,9,800,200,50,250,Thursday
2023,11,9,700,123,21,144,Thursday
2023,11,9,600,47,33,80,Thursday
2023,11,9,500,18,25,43,Thursday
2023,11,9,400,20,17,37,Thursday
2023,11,9,300,17,33,50,Thursday
2023,11,9,200,21,19,40,Thursday
2023,11,9,100,32,15,47,Thursday
2023,11,8,2400,34,65,99,Wednesday
2023,11,8,2300,52,91,143,Wednesday
2023,11,8,2200,63,96,159,Wednesday
2023,11,8,2100,129,133,262,Wednesday
2023,11,8,2000,161,148,309,Wednesday
2023,11,8,1900,161,267,428,Wednesday
2023,11,8,1800,174,316,490,Wednesday
2023,11,8,1700,220,399,619,Wednesday
2023,11,8,1600,235,356,591,Wednesday
2023,11,8,1500,259,346,605,Wednesday
2023,11,8,1400,287,260,547,Wednesday
2023,11,8,1300,308,246,554,Wednesday
2023,11,8,1200,353,200,553,Wednesday
2023,11,8,1100,370,175,545,Wednesday
2023,11,8,1000,284,179,463,Wednesday
2023,11,8,900,240,182,422,Wednesday
2023,11,8,800,161,43,204,Wednesday
2023,11,8,700,90,36,126,Wednesday
2023,11,8,600,52,20,72,Wednesday
2023,11,8,500,24,31,55,Wednesday
2023,11,8,400,14,22,36,Wednesday
2023,11,8,300,19,23,42,Wednesday
2023,11,8,200,15,20,35,Wednesday
2023,11,8,100,27,13,40,Wednesday
2023,11,7,2400,36,55,91,Tuesday
2023,11,7,2300,39,87,126,Tuesday
2023,11,7,2200,47,103,150,Tuesday
2023,11,7,2100,107,124,231,Tuesday
2023,11,7,2000,117,138,255,Tuesday
2023,11,7,1900,150,216,366,Tuesday
2023,11,7,1800,142,293,435,Tuesday
2023,11,7,1700,226,359,585,Tuesday
2023,11,7,1600,225,337,562,Tuesday
2023,11,7,1500,224,317,541,Tuesday
2023,11,7,1400,241,281,522,Tuesday
2023,11,7,1300,238,266,504,Tuesday
2023,11,7,1200,321,190,511,Tuesday
2023,11,7,1100,315,169,484,Tuesday
2023,11,7,1000,289,155,444,Tuesday
2023,11,7,900,198,188,386,Tuesday
2023,11,7,800,148,37,185,Tuesday
2023,11,7,700,85,35,120,Tuesday
2023,11,7,600,59,33,92,Tuesday
2023,11,7,500,24,15,39,Tuesday
2023,11,7,400,24,14,38,Tuesday
2023,11,7,300,10,12,22,Tuesday
2023,11,7,200,14,12,26,Tuesday
2023,11,7,100,16,13,29,Tuesday
2023,11,6,2400,34,48,82,Monday
2023,11,6,2300,38,93,131,Monday
2023,11,6,2200,57,76,133,Monday
2023,11,6,2100,116,102,218,Monday
2023,11,6,2000,127,126,253,Monday
2023,11,6,1900,135,207,342,Monday
2023,11,6,1800,167,319,486,Monday
2023,11,6,1700,186,396,582,Monday
2023,11,6,1600,255,365,620,Monday
2023,11,6,1500,275,335,610,Monday
2023,11,6,1400,309,320,629,Monday
2023,11,6,1300,362,251,613,Monday
2023,11,6,1200,377,219,596,Monday
2023,11,6,1100,407,158,565,Monday
2023,11,6,1000,337,121,458,Monday
2023,11,6,900,305,115,420,Monday
2023,11,6,800,186,42,228,Monday
2023,11,6,700,98,26,124,Monday
2023,11,6,600,47,19,66,Monday
2023,11,6,500,27,9,36,Monday
2023,11,6,400,15,7,22,Monday
2023,11,6,300,14,15,29,Monday
2023,11,6,200,16,19,35,Monday
2023,11,6,100,18,11,29,Monday
2023,11,5,2400,21,37,58,Sunday
2023,11,5,2300,39,95,134,Sunday
2023,11,5,2200,37,100,137,Sunday
2023,11,5,2100,84,143,227,Sunday
2023,11,5,2000,107,196,303,Sunday
2023,11,5,1900,146,308,454,Sunday
2023,11,5,1800,171,444,615,Sunday
2023,11,5,1700,254,573,827,Sunday
2023,11,5,1600,344,610,954,Sunday
2023,11,5,1500,315,563,878,Sunday
2023,11,5,1400,404,485,889,Sunday
2023,11,5,1300,417,420,837,Sunday
2023,11,5,1200,474,362,836,Sunday
2023,11,5,1100,441,226,667,Sunday
2023,11,5,1000,422,121,543,Sunday
2023,11,5,900,326,95,421,Sunday
2023,11,5,800,155,35,190,Sunday
2023,11,5,700,70,23,93,Sunday
2023,11,5,600,34,14,48,Sunday
2023,11,5,500,15,6,21,Sunday
2023,11,5,400,8,16,24,Sunday
2023,11,5,300,11,13,24,Sunday
2023,11,5,200,18,16,34,Sunday
2023,11,5,100,20,7,27,Sunday
2023,11,4,2400,23,26,49,Saturday
2023,11,4,2300,23,55,78,Saturday
2023,11,4,2200,39,76,115,Saturday
2023,11,4,2100,61,106,167,Saturday
2023,11,4,2000,89,151,240,Saturday
2023,11,4,1900,117,266,383,Saturday
2023,11,4,1800,146,342,488,Saturday
2023,11,4,1700,203,437,640,Saturday
2023,11,4,1600,265,569,834,Saturday
2023,11,4,1500,330,492,822,Saturday
2023,11,4,1400,369,393,762,Saturday
2023,11,4,1300,399,313,712,Saturday
2023,11,4,1200,404,225,629,Saturday
2023,11,4,1100,442,192,634,Saturday
2023,11,4,1000,366,152,518,Saturday
2023,11,4,900,269,131,400,Saturday
2023,11,4,800,159,28,187,Saturday
2023,11,4,700,66,26,92,Saturday
2023,11,4,600,32,19,51,Saturday
2023,11,4,500,14,12,26,Saturday
2023,11,4,400,10,17,27,Saturday
2023,11,4,300,17,11,28,Saturday
2023,11,4,200,18,22,40,Saturday
2023,11,4,100,24,12,36,Saturday
2023,11,3,2400,34,43,77,Friday
2023,11,3,2300,50,101,151,Friday
2023,11,3,2200,45,96,141,Friday
2023,11,3,2100,111,131,242,Friday
2023,11,3,2000,182,187,369,Friday
2023,11,3,1900,239,279,518,Friday
2023,11,3,1800,238,348,586,Friday
2023,11,3,1700,310,456,766,Friday
2023,11,3,1600,366,442,808,Friday
2023,11,3,1500,343,385,728,Friday
2023,11,3,1400,353,357,710,Friday
2023,11,3,1300,353,311,664,Friday
2023,11,3,1200,357,260,617,Friday
2023,11,3,1100,352,211,563,Friday
2023,11,3,1000,277,203,480,Friday
2023,11,3,900,246,137,383,Friday
2023,11,3,800,183,60,243,Friday
2023,11,3,700,103,24,127,Friday
2023,11,3,600,53,30,83,Friday
2023,11,3,500,24,48,72,Friday
2023,11,3,400,22,26,48,Friday
2023,11,3,300,12,21,33,Friday
2023,11,3,200,27,24,51,Friday
2023,11,3,100,32,54,86,Friday
2023,11,2,2400,46,72,118,Thursday
2023,11,2,2300,51,40,91,Thursday
2023,11,2,2200,59,80,139,Thursday
2023,11,2,2100,102,98,200,Thursday
2023,11,2,2000,140,153,293,Thursday
2023,11,2,1900,146,196,342,Thursday
2023,11,2,1800,175,273,448,Thursday
2023,11,2,1700,193,311,504,Thursday
2023,11,2,1600,234,244,478,Thursday
2023,11,2,1500,258,279,537,Thursday
2023,11,2,1400,225,256,481,Thursday
2023,11,2,1300,269,173,442,Thursday
2023,11,2,1200,240,177,417,Thursday
2023,11,2,1100,287,166,453,Thursday
2023,11,2,1000,221,150,371,Thursday
2023,11,2,900,200,175,375,Thursday
2023,11,2,800,173,48,221,Thursday
2023,11,2,700,95,21,116,Thursday
2023,11,2,600,52,25,77,Thursday
2023,11,2,500,15,25,40,Thursday
2023,11,2,400,16,18,34,Thursday
2023,11,2,300,17,27,44,Thursday
2023,11,2,200,26,18,44,Thursday
2023,11,2,100,30,15,45,Thursday
2023,11,1,2400,46,54,100,Wednesday
2023,11,1,2300,53,111,164,Wednesday
2023,11,1,2200,58,116,174,Wednesday
2023,11,1,2100,98,143,241,Wednesday
2023,11,1,2000,145,192,337,Wednesday
2023,11,1,1900,145,279,424,Wednesday
2023,11,1,1800,179,332,511,Wednesday
2023,11,1,1700,226,349,575,Wednesday
2023,11,1,1600,257,328,585,Wednesday
2023,11,1,1500,257,324,581,Wednesday
2023,11,1,1400,267,261,528,Wednesday
2023,11,1,1300,326,272,598,Wednesday
2023,11,1,1200,322,213,535,Wednesday
2023,11,1,1100,328,208,536,Wednesday
2023,11,1,1000,269,186,455,Wednesday
2023,11,1,900,226,167,393,Wednesday
2023,11,1,800,190,46,236,Wednesday
2023,11,1,700,86,24,110,Wednesday
2023,11,1,600,69,27,96,Wednesday
2023,11,1,500,20,18,38,Wednesday
2023,11,1,400,12,25,37,Wednesday
2023,11,1,300,13,15,28,Wednesday
2023,11,1,200,14,22,36,Wednesday
2023,11,1,100,25,17,42,Wednesday
2023,10,31,2400,34,45,79,Tuesday
2023,10,31,2300,47,109,156,Tuesday
2023,10,31,2200,52,110,162,Tuesday
2023,10,31,2100,90,118,208,Tuesday
2023,10,31,2000,136,138,274,Tuesday
2023,10,31,1900,124,225,349,Tuesday
2023,10,31,1800,150,316,466,Tuesday
2023,10,31,1700,197,340,537,Tuesday
2023,10,31,1600,203,321,524,Tuesday
2023,10,31,1500,257,249,506,Tuesday
2023,10,31,1400,260,249,509,Tuesday
2023,10,31,1300,293,222,515,Tuesday
2023,10,31,1200,351,198,549,Tuesday
2023,10,31,1100,305,173,478,Tuesday
2023,10,31,1000,218,154,372,Tuesday
2023,10,31,900,166,138,304,Tuesday
2023,10,31,800,160,30,190,Tuesday
2023,10,31,700,85,28,113,Tuesday
2023,10,31,600,53,22,75,Tuesday
2023,10,31,500,12,32,44,Tuesday
2023,10,31,400,21,23,44,Tuesday
2023,10,31,300,15,18,33,Tuesday
2023,10,31,200,24,19,43,Tuesday
2023,10,31,100,16,18,34,Tuesday
2023,10,30,2400,40,47,87,Monday
2023,10,30,2300,46,95,141,Monday
2023,10,30,2200,61,98,159,Monday
2023,10,30,2100,106,135,241,Monday
2023,10,30,2000,138,197,335,Monday
2023,10,30,1900,154,233,387,Monday
2023,10,30,1800,198,297,495,Monday
2023,10,30,1700,218,399,617,Monday
2023,10,30,1600,313,370,683,Monday
2023,10,30,1500,304,331,635,Monday
2023,10,30,1400,308,257,565,Monday
2023,10,30,1300,312,223,535,Monday
2023,10,30,1200,374,198,572,Monday
2023,10,30,1100,354,140,494,Monday
2023,10,30,1000,280,129,409,Monday
2023,10,30,900,224,104,328,Monday
2023,10,30,800,159,38,197,Monday
2023,10,30,700,100,19,119,Monday
2023,10,30,600,48,21,69,Monday
2023,10,30,500,16,9,25,Monday
2023,10,30,400,13,22,35,Monday
2023,10,30,300,14,19,33,Monday
2023,10,30,200,13,17,30,Monday
2023,10,30,100,16,11,27,Monday
2023,10,29,2400,25,32,57,Sunday
2023,10,29,2300,43,117,160,Sunday
2023,10,29,2200,47,132,179,Sunday
2023,10,29,2100,108,147,255,Sunday
2023,10,29,2000,124,190,314,Sunday
2023,10,29,1900,164,361,525,Sunday
2023,10,29,1800,177,482,659,Sunday
2023,10,29,1700,254,516,770,Sunday
2023,10,29,1600,309,487,796,Sunday
2023,10,29,1500,394,541,935,Sunday
2023,10,29,1400,388,429,817,Sunday
2023,10,29,1300,402,417,819,Sunday
2023,10,29,1200,439,352,791,Sunday
2023,10,29,1100,355,224,579,Sunday
2023,10,29,1000,291,157,448,Sunday
2023,10,29,900,203,96,299,Sunday
2023,10,29,800,111,26,137,Sunday
2023,10,29,700,45,28,73,Sunday
2023,10,29,600,34,19,53,Sunday
2023,10,29,500,12,9,21,Sunday
2023,10,29,400,8,20,28,Sunday
2023,10,29,300,8,14,22,Sunday
2023,10,29,200,16,15,31,Sunday
2023,10,29,100,13,7,20,Sunday
2023,10,28,2400,24,23,47,Saturday
2023,10,28,2300,41,78,119,Saturday
2023,10,28,2200,47,88,135,Saturday
2023,10,28,2100,76,98,174,Saturday
2023,10,28,2000,97,201,298,Saturday
2023,10,28,1900,124,338,462,Saturday
2023,10,28,1800,146,397,543,Saturday
2023,10,28,1700,192,407,599,Saturday
2023,10,28,1600,246,460,706,Saturday
2023,10,28,1500,325,403,728,Saturday
2023,10,28,1400,331,356,687,Saturday
2023,10,28,1300,408,287,695,Saturday
2023,10,28,1200,452,269,721,Saturday
2023,10,28,1100,383,228,611,Saturday
2023,10,28,1000,320,200,520,Saturday
2023,10,28,900,224,126,350,Saturday
2023,10,28,800,169,33,202,Saturday
2023,10,28,700,82,24,106,Saturday
2023,10,28,600,47,21,68,Saturday
2023,10,28,500,13,19,32,Saturday
2023,10,28,400,20,23,43,Saturday
2023,10,28,300,10,21,31,Saturday
2023,10,28,200,21,28,49,Saturday
2023,10,28,100,36,19,55,Saturday
2023,10,27,2400,26,48,74,Friday
2023,10,27,2300,45,89,134,Friday
2023,10,27,2200,60,101,161,Friday
2023,10,27,2100,111,135,246,Friday
2023,10,27,2000,151,238,389,Friday
2023,10,27,1900,211,340,551,Friday
2023,10,27,1800,287,442,729,Friday
2023,10,27,1700,323,478,801,Friday
2023,10,27,1600,343,474,817,Friday
2023,10,27,1500,386,409,795,Friday
2023,10,27,1400,371,425,796,Friday
2023,10,27,1300,380,326,706,Friday
2023,10,27,1200,448,305,753,Friday
2023,10,27,1100,386,240,626,Friday
2023,10,27,1000,285,187,472,Friday
2023,10,27,900,226,146,372,Friday
2023,10,27,800,165,28,193,Friday
2023,10,27,700,85,9,94,Friday
2023,10,27,600,56,34,90,Friday
2023,10,27,500,11,19,30,Friday
2023,10,27,400,21,16,37,Friday
2023,10,27,300,16,22,38,Friday
2023,10,27,200,20,21,41,Friday
2023,10,27,100,34,18,52,Friday
2023,10,26,2400,48,62,110,Thursday
2023,10,26,2300,54,95,149,Thursday
2023,10,26,2200,61,118,179,Thursday
2023,10,26,2100,104,140,244,Thursday
2023,10,26,2000,174,217,391,Thursday
2023,10,26,1900,160,279,439,Thursday
2023,10,26,1800,221,376,597,Thursday
2023,10,26,1700,273,407,680,Thursday
2023,10,26,1600,295,353,648,Thursday
2023,10,26,1500,313,334,647,Thursday
2023,10,26,1400,287,298,585,Thursday
2023,10,26,1300,327,286,613,Thursday
2023,10,26,1200,368,257,625,Thursday
2023,10,26,1100,347,159,506,Thursday
2023,10,26,1000,263,186,449,Thursday
2023,10,26,900,208,128,336,Thursday
2023,10,26,800,168,40,208,Thursday
2023,10,26,700,97,23,120,Thursday
2023,10,26,600,44,33,77,Thursday
2023,10,26,500,17,28,45,Thursday
2023,10,26,400,20,16,36,Thursday
2023,10,26,300,18,22,40,Thursday
2023,10,26,200,33,24,57,Thursday
2023,10,26,100,32,20,52,Thursday
2023,10,25,2400,33,48,81,Wednesday
2023,10,25,2300,40,139,179,Wednesday
2023,10,25,2200,69,102,171,Wednesday
2023,10,25,2100,105,176,281,Wednesday
2023,10,25,2000,161,248,409,Wednesday
2023,10,25,1900,173,345,518,Wednesday
2023,10,25,1800,212,365,577,Wednesday
2023,10,25,1700,244,413,657,Wednesday
2023,10,25,1600,289,528,817,Wednesday
2023,10,25,1500,332,390,722,Wednesday
2023,10,25,1400,352,394,746,Wednesday
2023,10,25,1300,389,277,666,Wednesday
2023,10,25,1200,393,206,599,Wednesday
2023,10,25,1100,393,160,553,Wednesday
2023,10,25,1000,282,170,452,Wednesday
2023,10,25,900,223,125,348,Wednesday
2023,10,25,800,156,35,191,Wednesday
2023,10,25,700,92,28,120,Wednesday
2023,10,25,600,49,25,74,Wednesday
2023,10,25,500,13,18,31,Wednesday
2023,10,25,400,19,19,38,Wednesday
2023,10,25,300,17,3,20,Wednesday
2023,10,25,200,19,20,39,Wednesday
2023,10,25,100,23,18,41,Wednesday
2023,10,24,2400,32,86,118,Tuesday
2023,10,24,2300,39,123,162,Tuesday
2023,10,24,2200,46,83,129,Tuesday
2023,10,24,2100,84,141,225,Tuesday
2023,10,24,2000,114,174,288,Tuesday
2023,10,24,1900,135,243,378,Tuesday
2023,10,24,1800,147,274,421,Tuesday
2023,10,24,1700,180,338,518,Tuesday
2023,10,24,1600,215,398,613,Tuesday
2023,10,24,1500,216,383,599,Tuesday
2023,10,24,1400,211,204,415,Tuesday
2023,10,24,1300,275,211,486,Tuesday
2023,10,24,1200,286,181,467,Tuesday
2023,10,24,1100,249,161,410,Tuesday
2023,10,24,1000,178,63,241,Tuesday
2023,10,24,900,140,70,210,Tuesday
2023,10,24,800,109,49,158,Tuesday
2023,10,24,700,62,37,99,Tuesday
2023,10,24,600,20,39,59,Tuesday
2023,10,24,500,9,20,29,Tuesday
2023,10,24,400,10,19,29,Tuesday
2023,10,24,300,9,28,37,Tuesday
2023,10,24,200,9,24,33,Tuesday
2023,10,24,100,34,62,96,Tuesday
2023,10,23,2400,39,107,146,Monday
2023,10,23,2300,51,76,127,Monday
2023,10,23,2200,61,62,123,Monday
2023,10,23,2100,99,100,199,Monday
2023,10,23,2000,68,126,194,Monday
2023,10,23,1900,109,198,307,Monday
2023,10,23,1800,167,314,481,Monday
2023,10,23,1700,175,406,581,Monday
2023,10,23,1600,293,352,645,Monday
2023,10,23,1500,348,381,729,Monday
2023,10,23,1400,392,389,781,Monday
2023,10,23,1300,366,345,711,Monday
2023,10,23,1200,439,284,723,Monday
2023,10,23,1100,420,216,636,Monday
2023,10,23,1000,348,142,490,Monday
2023,10,23,900,289,143,432,Monday
2023,10,23,800,223,43,266,Monday
2023,10,23,700,99,22,121,Monday
2023,10,23,600,50,27,77,Monday
2023,10,23,500,16,9,25,Monday
2023,10,23,400,15,17,32,Monday
2023,10,23,300,11,28,39,Monday
2023,10,23,200,15,14,29,Monday
2023,10,23,100,19,18,37,Monday
2023,10,22,2400,22,42,64,Sunday
2023,10,22,2300,46,101,147,Sunday
2023,10,22,2200,63,148,211,Sunday
2023,10,22,2100,126,253,379,Sunday
2023,10,22,2000,169,413,582,Sunday
2023,10,22,1900,180,587,767,Sunday
2023,10,22,1800,275,717,992,Sunday
2023,10,22,1700,366,720,1086,Sunday
2023,10,22,1600,420,795,1215,Sunday
2023,10,22,1500,506,720,1226,Sunday
2023,10,22,1400,498,649,1147,Sunday
2023,10,22,1300,555,538,1093,Sunday
2023,10,22,1200,635,399,1034,Sunday
2023,10,22,1100,545,299,844,Sunday
2023,10,22,1000,432,155,587,Sunday
2023,10,22,900,275,92,367,Sunday
2023,10,22,800,207,36,243,Sunday
2023,10,22,700,80,14,94,Sunday
2023,10,22,600,37,17,54,Sunday
2023,10,22,500,16,11,27,Sunday
2023,10,22,400,8,16,24,Sunday
2023,10,22,300,12,22,34,Sunday
2023,10,22,200,13,24,37,Sunday
2023,10,22,100,13,19,32,Sunday
2023,10,21,2400,23,27,50,Saturday
2023,10,21,2300,38,104,142,Saturday
2023,10,21,2200,65,102,167,Saturday
2023,10,21,2100,86,176,262,Saturday
2023,10,21,2000,130,322,452,Saturday
2023,10,21,1900,166,484,650,Saturday
2023,10,21,1800,209,607,816,Saturday
2023,10,21,1700,270,744,1014,Saturday
2023,10,21,1600,392,656,1048,Saturday
2023,10,21,1500,440,503,943,Saturday
2023,10,21,1400,539,499,1038,Saturday
2023,10,21,1300,574,441,1015,Saturday
2023,10,21,1200,681,329,1010,Saturday
2023,10,21,1100,642,256,898,Saturday
2023,10,21,1000,509,230,739,Saturday
2023,10,21,900,370,202,572,Saturday
2023,10,21,800,214,56,270,Saturday
2023,10,21,700,126,28,154,Saturday
2023,10,21,600,50,22,72,Saturday
2023,10,21,500,17,30,47,Saturday
2023,10,21,400,16,35,51,Saturday
2023,10,21,300,14,19,33,Saturday
2023,10,21,200,19,38,57,Saturday
2023,10,21,100,25,15,40,Saturday
2023,10,20,2400,49,64,113,Friday
2023,10,20,2300,74,107,181,Friday
2023,10,20,2200,72,133,205,Friday
2023,10,20,2100,164,197,361,Friday
2023,10,20,2000,263,335,598,Friday
2023,10,20,1900,312,518,830,Friday
2023,10,20,1800,392,596,988,Friday
2023,10,20,1700,491,661,1152,Friday
2023,10,20,1600,462,556,1018,Friday
2023,10,20,1500,503,587,1090,Friday
2023,10,20,1400,496,531,1027,Friday
2023,10,20,1300,565,407,972,Friday
2023,10,20,1200,633,351,984,Friday
2023,10,20,1100,615,273,888,Friday
2023,10,20,1000,495,243,738,Friday
2023,10,20,900,355,195,550,Friday
2023,10,20,800,274,59,333,Friday
2023,10,20,700,123,42,165,Friday
2023,10,20,600,67,26,93,Friday
2023,10,20,500,23,28,51,Friday
2023,10,20,400,24,30,54,Friday
2023,10,20,300,18,30,48,Friday
2023,10,20,200,27,24,51,Friday
2023,10,20,100,26,21,47,Friday
2023,10,19,2400,42,68,110,Thursday
2023,10,19,2300,58,119,177,Thursday
2023,10,19,2200,99,128,227,Thursday
2023,10,19,2100,149,218,367,Thursday
2023,10,19,2000,195,294,489,Thursday
2023,10,19,1900,238,420,658,Thursday
2023,10,19,1800,286,529,815,Thursday
2023,10,19,1700,338,498,836,Thursday
2023,10,19,1600,359,515,874,Thursday
2023,10,19,1500,396,391,787,Thursday
2023,10,19,1400,420,358,778,Thursday
2023,10,19,1300,470,386,856,Thursday
2023,10,19,1200,526,342,868,Thursday
2023,10,19,1100,507,205,712,Thursday
2023,10,19,1000,442,201,643,Thursday
2023,10,19,900,305,169,474,Thursday
2023,10,19,800,206,48,254,Thursday
2023,10,19,700,99,24,123,Thursday
2023,10,19,600,76,28,104,Thursday
2023,10,19,500,16,28,44,Thursday
2023,10,19,400,17,25,42,Thursday
2023,10,19,300,20,31,51,Thursday
2023,10,19,200,27,30,57,Thursday
2023,10,19,100,27,14,41,Thursday
2023,10,18,2400,52,59,111,Wednesday
2023,10,18,2300,55,123,178,Wednesday
2023,10,18,2200,71,147,218,Wednesday
2023,10,18,2100,105,161,266,Wednesday
2023,10,18,2000,169,238,407,Wednesday
2023,10,18,1900,179,296,475,Wednesday
2023,10,18,1800,222,378,600,Wednesday
2023,10,18,1700,257,453,710,Wednesday
2023,10,18,1600,298,431,729,Wednesday
2023,10,18,1500,328,430,758,Wednesday
2023,10,18,1400,391,418,809,Wednesday
2023,10,18,1300,411,365,776,Wednesday
2023,10,18,1200,471,308,779,Wednesday
2023,10,18,1100,461,244,705,Wednesday
2023,10,18,1000,385,199,584,Wednesday
2023,10,18,900,291,184,475,Wednesday
2023,10,18,800,207,56,263,Wednesday
2023,10,18,700,95,45,140,Wednesday
2023,10,18,600,55,32,87,Wednesday
2023,10,18,500,23,42,65,Wednesday
2023,10,18,400,17,27,44,Wednesday
2023,10,18,300,15,29,44,Wednesday
2023,10,18,200,16,30,46,Wednesday
2023,10,18,100,28,17,45,Wednesday
2023,10,17,2400,51,52,103,Tuesday
2023,10,17,2300,46,123,169,Tuesday
2023,10,17,2200,78,129,207,Tuesday
2023,10,17,2100,118,213,331,Tuesday
2023,10,17,2000,180,281,461,Tuesday
2023,10,17,1900,182,358,540,Tuesday
2023,10,17,1800,193,485,678,Tuesday
2023,10,17,1700,263,494,757,Tuesday
2023,10,17,1600,293,468,761,Tuesday
2023,10,17,1500,349,342,691,Tuesday
2023,10,17,1400,390,359,749,Tuesday
2023,10,17,1300,403,306,709,Tuesday
2023,10,17,1200,471,241,712,Tuesday
2023,10,17,1100,447,211,658,Tuesday
2023,10,17,1000,335,208,543,Tuesday
2023,10,17,900,273,205,478,Tuesday
2023,10,17,800,203,40,243,Tuesday
2023,10,17,700,110,33,143,Tuesday
2023,10,17,600,56,34,90,Tuesday
2023,10,17,500,20,27,47,Tuesday
2023,10,17,400,19,25,44,Tuesday
2023,10,17,300,16,26,42,Tuesday
2023,10,17,200,22,27,49,Tuesday
2023,10,17,100,30,28,58,Tuesday
2023,10,16,2400,38,48,86,Monday
2023,10,16,2300,52,129,181,Monday
2023,10,16,2200,63,92,155,Monday
2023,10,16,2100,105,165,270,Monday
2023,10,16,2000,163,276,439,Monday
2023,10,16,1900,179,419,598,Monday
2023,10,16,1800,242,543,785,Monday
2023,10,16,1700,281,557,838,Monday
2023,10,16,1600,369,540,909,Monday
2023,10,16,1500,364,542,906,Monday
2023,10,16,1400,476,409,885,Monday
2023,10,16,1300,491,369,860,Monday
2023,10,16,1200,580,297,877,Monday
2023,10,16,1100,621,192,813,Monday
2023,10,16,1000,507,174,681,Monday
2023,10,16,900,350,148,498,Monday
2023,10,16,800,261,63,324,Monday
2023,10,16,700,152,27,179,Monday
2023,10,16,600,70,21,91,Monday
2023,10,16,500,28,7,35,Monday
2023,10,16,400,16,15,31,Monday
2023,10,16,300,17,24,41,Monday
2023,10,16,200,18,16,34,Monday
2023,10,16,100,16,14,30,Monday
2023,10,15,2400,18,43,61,Sunday
2023,10,15,2300,49,88,137,Sunday
2023,10,15,2200,53,156,209,Sunday
2023,10,15,2100,100,280,380,Sunday
2023,10,15,2000,178,532,710,Sunday
2023,10,15,1900,215,645,860,Sunday
2023,10,15,1800,267,815,1082,Sunday
2023,10,15,1700,374,887,1261,Sunday
2023,10,15,1600,465,843,1308,Sunday
2023,10,15,1500,536,815,1351,Sunday
2023,10,15,1400,560,644,1204,Sunday
2023,10,15,1300,649,490,1139,Sunday
2023,10,15,1200,645,375,1020,Sunday
2023,10,15,1100,615,297,912,Sunday
2023,10,15,1000,542,186,728,Sunday
2023,10,15,900,325,117,442,Sunday
2023,10,15,800,273,27,300,Sunday
2023,10,15,700,119,29,148,Sunday
2023,10,15,600,55,14,69,Sunday
2023,10,15,500,21,11,32,Sunday
2023,10,15,400,21,15,36,Sunday
2023,10,15,300,18,22,40,Sunday
2023,10,15,200,16,17,33,Sunday
2023,10,15,100,28,19,47,Sunday
2023,10,14,2400,21,31,52,Saturday
2023,10,14,2300,36,86,122,Saturday
2023,10,14,2200,66,135,201,Saturday
2023,10,14,2100,119,241,360,Saturday
2023,10,14,2000,147,325,472,Saturday
2023,10,14,1900,171,524,695,Saturday
2023,10,14,1800,253,674,927,Saturday
2023,10,14,1700,287,780,1067,Saturday
2023,10,14,1600,380,705,1085,Saturday
2023,10,14,1500,465,584,1049,Saturday
2023,10,14,1400,509,496,1005,Saturday
2023,10,14,1300,577,465,1042,Saturday
2023,10,14,1200,631,355,986,Saturday
2023,10,14,1100,694,277,971,Saturday
2023,10,14,1000,593,234,827,Saturday
2023,10,14,900,439,208,647,Saturday
2023,10,14,800,274,63,337,Saturday
2023,10,14,700,159,29,188,Saturday
2023,10,14,600,36,31,67,Saturday
2023,10,14,500,20,35,55,Saturday
2023,10,14,400,14,33,47,Saturday
2023,10,14,300,18,39,57,Saturday
2023,10,14,200,23,33,56,Saturday
2023,10,14,100,26,34,60,Saturday
2023,10,13,2400,39,50,89,Friday
2023,10,13,2300,58,113,171,Friday
2023,10,13,2200,88,150,238,Friday
2023,10,13,2100,165,263,428,Friday
2023,10,13,2000,249,346,595,Friday
2023,10,13,1900,316,517,833,Friday
2023,10,13,1800,389,619,1008,Friday
2023,10,13,1700,406,738,1144,Friday
2023,10,13,1600,459,644,1103,Friday
2023,10,13,1500,478,625,1103,Friday
2023,10,13,1400,463,497,960,Friday
2023,10,13,1300,563,479,1042,Friday
2023,10,13,1200,626,339,965,Friday
2023,10,13,1100,637,287,924,Friday
2023,10,13,1000,567,260,827,Friday
2023,10,13,900,407,189,596,Friday
2023,10,13,800,283,49,332,Friday
2023,10,13,700,155,42,197,Friday
2023,10,13,600,71,39,110,Friday
2023,10,13,500,27,35,62,Friday
2023,10,13,400,22,31,53,Friday
2023,10,13,300,17,34,51,Friday
2023,10,13,200,24,31,55,Friday
2023,10,13,100,35,27,62,Friday
2023,10,12,2400,47,52,99,Thursday
2023,10,12,2300,62,123,185,Thursday
2023,10,12,2200,85,181,266,Thursday
2023,10,12,2100,149,247,396,Thursday
2023,10,12,2000,206,313,519,Thursday
2023,10,12,1900,260,413,673,Thursday
2023,10,12,1800,262,567,829,Thursday
2023,10,12,1700,301,619,920,Thursday
2023,10,12,1600,390,577,967,Thursday
2023,10,12,1500,409,534,943,Thursday
2023,10,12,1400,455,368,823,Thursday
2023,10,12,1300,496,354,850,Thursday
2023,10,12,1200,628,290,918,Thursday
2023,10,12,1100,558,226,784,Thursday
2023,10,12,1000,513,212,725,Thursday
2023,10,12,900,361,211,572,Thursday
2023,10,12,800,268,58,326,Thursday
2023,10,12,700,140,43,183,Thursday
2023,10,12,600,71,43,114,Thursday
2023,10,12,500,17,35,52,Thursday
2023,10,12,400,23,25,48,Thursday
2023,10,12,300,15,20,35,Thursday
2023,10,12,200,25,39,64,Thursday
2023,10,12,100,30,18,48,Thursday
2023,10,11,2400,36,62,98,Wednesday
2023,10,11,2300,57,110,167,Wednesday
2023,10,11,2200,69,142,211,Wednesday
2023,10,11,2100,114,218,332,Wednesday
2023,10,11,2000,198,329,527,Wednesday
2023,10,11,1900,228,371,599,Wednesday
2023,10,11,1800,232,460,692,Wednesday
2023,10,11,1700,266,498,764,Wednesday
2023,10,11,1600,324,544,868,Wednesday
2023,10,11,1500,393,511,904,Wednesday
2023,10,11,1400,393,446,839,Wednesday
2023,10,11,1300,448,346,794,Wednesday
2023,10,11,1200,541,251,792,Wednesday
2023,10,11,1100,511,246,757,Wednesday
2023,10,11,1000,450,222,672,Wednesday
2023,10,11,900,326,198,524,Wednesday
2023,10,11,800,253,54,307,Wednesday
2023,10,11,700,140,36,176,Wednesday
2023,10,11,600,69,40,109,Wednesday
2023,10,11,500,25,42,67,Wednesday
2023,10,11,400,18,38,56,Wednesday
2023,10,11,300,18,32,50,Wednesday
2023,10,11,200,17,32,49,Wednesday
2023,10,11,100,33,23,56,Wednesday
2023,10,10,2400,47,63,110,Tuesday
2023,10,10,2300,51,123,174,Tuesday
2023,10,10,2200,80,125,205,Tuesday
2023,10,10,2100,124,215,339,Tuesday
2023,10,10,2000,175,341,516,Tuesday
2023,10,10,1900,196,533,729,Tuesday
2023,10,10,1800,243,678,921,Tuesday
2023,10,10,1700,314,704,1018,Tuesday
2023,10,10,1600,367,692,1059,Tuesday
2023,10,10,1500,461,616,1077,Tuesday
2023,10,10,1400,521,562,1083,Tuesday
2023,10,10,1300,599,472,1071,Tuesday
2023,10,10,1200,670,391,1061,Tuesday
2023,10,10,1100,706,307,1013,Tuesday
2023,10,10,1000,662,196,858,Tuesday
2023,10,10,900,426,129,555,Tuesday
2023,10,10,800,326,69,395,Tuesday
2023,10,10,700,173,34,207,Tuesday
2023,10,10,600,69,29,98,Tuesday
2023,10,10,500,36,21,57,Tuesday
2023,10,10,400,17,24,41,Tuesday
2023,10,10,300,14,36,50,Tuesday
2023,10,10,200,14,37,51,Tuesday
2023,10,10,100,23,48,71,Tuesday
2023,10,9,2400,34,117,151,Monday
2023,10,9,2300,68,229,297,Monday
2023,10,9,2200,83,324,407,Monday
2023,10,9,2100,139,469,608,Monday
2023,10,9,2000,177,877,1054,Monday
2023,10,9,1900,208,1359,1567,Monday
2023,10,9,1800,332,1764,2096,Monday
2023,10,9,1700,498,1733,2231,Monday
2023,10,9,1600,574,1731,2305,Monday
2023,10,9,1500,767,1577,2344,Monday
2023,10,9,1400,960,1367,2327,Monday
2023,10,9,1300,966,1137,2103,Monday
2023,10,9,1200,1064,808,1872,Monday
2023,10,9,1100,1079,482,1561,Monday
2023,10,9,1000,866,241,1107,Monday
2023,10,9,900,680,125,805,Monday
2023,10,9,800,436,51,487,Monday
2023,10,9,700,289,28,317,Monday
2023,10,9,600,149,16,165,Monday
2023,10,9,500,47,15,62,Monday
2023,10,9,400,19,28,47,Monday
2023,10,9,300,14,18,32,Monday
2023,10,9,200,20,31,51,Monday
2023,10,9,100,32,45,77,Monday
2023,10,8,2400,44,79,123,Sunday
2023,10,8,2300,59,101,160,Sunday
2023,10,8,2200,93,210,303,Sunday
2023,10,8,2100,120,546,666,Sunday
2023,10,8,2000,147,924,1071,Sunday
2023,10,8,1900,217,1180,1397,Sunday
2023,10,8,1800,291,1257,1548,Sunday
2023,10,8,1700,399,1181,1580,Sunday
2023,10,8,1600,512,1033,1545,Sunday
2023,10,8,1500,665,876,1541,Sunday
2023,10,8,1400,827,687,1514,Sunday
2023,10,8,1300,867,639,1506,Sunday
2023,10,8,1200,909,496,1405,Sunday
2023,10,8,1100,1006,326,1332,Sunday
2023,10,8,1000,870,205,1075,Sunday
2023,10,8,900,667,108,775,Sunday
2023,10,8,800,384,42,426,Sunday
2023,10,8,700,308,28,336,Sunday
2023,10,8,600,100,22,122,Sunday
2023,10,8,500,40,16,56,Sunday
2023,10,8,400,19,25,44,Sunday
2023,10,8,300,15,22,37,Sunday
2023,10,8,200,21,36,57,Sunday
2023,10,8,100,27,49,76,Sunday
2023,10,7,2400,39,65,104,Saturday
2023,10,7,2300,73,128,201,Saturday
2023,10,7,2200,102,213,315,Saturday
2023,10,7,2100,125,536,661,Saturday
2023,10,7,2000,183,848,1031,Saturday
2023,10,7,1900,262,1029,1291,Saturday
2023,10,7,1800,332,1146,1478,Saturday
2023,10,7,1700,491,1133,1624,Saturday
2023,10,7,1600,621,905,1526,Saturday
2023,10,7,1500,784,852,1636,Saturday
2023,10,7,1400,1032,648,1680,Saturday
2023,10,7,1300,1029,546,1575,Saturday
2023,10,7,1200,1171,451,1622,Saturday
2023,10,7,1100,1252,374,1626,Saturday
2023,10,7,1000,995,249,1244,Saturday
2023,10,7,900,829,127,956,Saturday
2023,10,7,800,518,85,603,Saturday
2023,10,7,700,306,44,350,Saturday
2023,10,7,600,128,51,179,Saturday
2023,10,7,500,42,48,90,Saturday
2023,10,7,400,28,38,66,Saturday
2023,10,7,300,27,32,59,Saturday
2023,10,7,200,30,54,84,Saturday
2023,10,7,100,31,68,99,Saturday
2023,10,6,2400,63,144,207,Friday
2023,10,6,2300,99,177,276,Friday
2023,10,6,2200,201,237,438,Friday
2023,10,6,2100,379,398,777,Friday
2023,10,6,2000,568,673,1241,Friday
2023,10,6,1900,744,842,1586,Friday
2023,10,6,1800,797,978,1775,Friday
2023,10,6,1700,928,1034,1962,Friday
2023,10,6,1600,993,1003,1996,Friday
2023,10,6,1500,1015,912,1927,Friday
2023,10,6,1400,887,892,1779,Friday
2023,10,6,1300,1014,442,1456,Friday
2023,10,6,1200,1186,353,1539,Friday
2023,10,6,1100,1067,318,1385,Friday
2023,10,6,1000,789,213,1002,Friday
2023,10,6,900,625,157,782,Friday
2023,10,6,800,459,123,582,Friday
2023,10,6,700,286,47,333,Friday
2023,10,6,600,106,69,175,Friday
2023,10,6,500,56,44,100,Friday
2023,10,6,400,41,42,83,Friday
2023,10,6,300,33,46,79,Friday
2023,10,6,200,34,58,92,Friday
2023,10,6,100,41,75,116,Friday
2023,10,5,2400,63,120,183,Thursday
2023,10,5,2300,118,138,256,Thursday
2023,10,5,2200,160,183,343,Thursday
2023,10,5,2100,236,325,561,Thursday
2023,10,5,2000,310,494,804,Thursday
2023,10,5,1900,381,672,1053,Thursday
2023,10,5,1800,411,755,1166,Thursday
2023,10,5,1700,447,681,1128,Thursday
2023,10,5,1600,501,636,1137,Thursday
2023,10,5,1500,476,565,1041,Thursday
2023,10,5,1400,541,468,1009,Thursday
2023,10,5,1300,580,365,945,Thursday
2023,10,5,1200,741,341,1082,Thursday
2023,10,5,1100,718,251,969,Thursday
2023,10,5,1000,650,197,847,Thursday
2023,10,5,900,519,157,676,Thursday
2023,10,5,800,363,98,461,Thursday
2023,10,5,700,234,50,284,Thursday
2023,10,5,600,118,51,169,Thursday
2023,10,5,500,49,44,93,Thursday
2023,10,5,400,31,46,77,Thursday
2023,10,5,300,33,36,69,Thursday
2023,10,5,200,27,65,92,Thursday
2023,10,5,100,39,61,100,Thursday
2023,10,4,2400,57,90,147,Wednesday
2023,10,4,2300,61,141,202,Wednesday
2023,10,4,2200,110,141,251,Wednesday
2023,10,4,2100,128,268,396,Wednesday
2023,10,4,2000,169,433,602,Wednesday
2023,10,4,1900,193,623,816,Wednesday
2023,10,4,1800,264,695,959,Wednesday
2023,10,4,1700,335,706,1041,Wednesday
2023,10,4,1600,337,583,920,Wednesday
2023,10,4,1500,450,492,942,Wednesday
2023,10,4,1400,441,438,879,Wednesday
2023,10,4,1300,527,357,884,Wednesday
2023,10,4,1200,582,326,908,Wednesday
2023,10,4,1100,692,259,951,Wednesday
2023,10,4,1000,622,207,829,Wednesday
2023,10,4,900,492,139,631,Wednesday
2023,10,4,800,363,82,445,Wednesday
2023,10,4,700,206,47,253,Wednesday
2023,10,4,600,91,40,131,Wednesday
2023,10,4,500,32,43,75,Wednesday
2023,10,4,400,34,32,66,Wednesday
2023,10,4,300,22,32,54,Wednesday
2023,10,4,200,25,34,59,Wednesday
2023,10,4,100,30,58,88,Wednesday
2023,10,3,2400,44,85,129,Tuesday
2023,10,3,2300,64,112,176,Tuesday
2023,10,3,2200,98,148,246,Tuesday
2023,10,3,2100,126,223,349,Tuesday
2023,10,3,2000,168,387,555,Tuesday
2023,10,3,1900,171,629,800,Tuesday
2023,10,3,1800,239,738,977,Tuesday
2023,10,3,1700,278,665,943,Tuesday
2023,10,3,1600,345,620,965,Tuesday
2023,10,3,1500,367,482,849,Tuesday
2023,10,3,1400,459,419,878,Tuesday
2023,10,3,1300,529,365,894,Tuesday
2023,10,3,1200,645,268,913,Tuesday
2023,10,3,1100,704,235,939,Tuesday
2023,10,3,1000,635,163,798,Tuesday
2023,10,3,900,524,135,659,Tuesday
2023,10,3,800,356,82,438,Tuesday
2023,10,3,700,209,43,252,Tuesday
2023,10,3,600,110,30,140,Tuesday
2023,10,3,500,30,21,51,Tuesday
2023,10,3,400,25,27,52,Tuesday
2023,10,3,300,17,34,51,Tuesday
2023,10,3,200,30,30,60,Tuesday
2023,10,3,100,28,68,96,Tuesday
2023,10,2,2400,41,83,124,Monday
2023,10,2,2300,61,111,172,Monday
2023,10,2,2200,94,163,257,Monday
2023,10,2,2100,129,287,416,Monday
2023,10,2,2000,149,535,684,Monday
2023,10,2,1900,216,757,973,Monday
2023,10,2,1800,254,972,1226,Monday
2023,10,2,1700,359,980,1339,Monday
2023,10,2,1600,475,842,1317,Monday
2023,10,2,1500,521,710,1231,Monday
2023,10,2,1400,670,581,1251,Monday
2023,10,2,1300,781,441,1222,Monday
2023,10,2,1200,932,361,1293,Monday
2023,10,2,1100,969,303,1272,Monday
2023,10,2,1000,791,192,983,Monday
2023,10,2,900,581,137,718,Monday
2023,10,2,800,423,61,484,Monday
2023,10,2,700,230,30,260,Monday
2023,10,2,600,105,25,130,Monday
2023,10,2,500,36,12,48,Monday
2023,10,2,400,26,18,44,Monday
2023,10,2,300,19,22,41,Monday
2023,10,2,200,16,61,77,Monday
2023,10,2,100,22,63,85,Monday
2023,10,1,2400,32,117,149,Sunday
2023,10,1,2300,66,154,220,Sunday
2023,10,1,2200,84,224,308,Sunday
2023,10,1,2100,115,591,706,Sunday
2023,10,1,2000,188,1043,1231,Sunday
2023,10,1,1900,247,1339,1586,Sunday
2023,10,1,1800,341,1469,1810,Sunday
2023,10,1,1700,463,1427,1890,Sunday
2023,10,1,1600,582,1283,1865,Sunday
2023,10,1,1500,725,1056,1781,Sunday
2023,10,1,1400,816,859,1675,Sunday
2023,10,1,1300,931,687,1618,Sunday
2023,10,1,1200,1117,533,1650,Sunday
2023,10,1,1100,1044,344,1388,Sunday
2023,10,1,1000,989,198,1187,Sunday
2023,10,1,900,733,101,834,Sunday
2023,10,1,800,494,52,546,Sunday
2023,10,1,700,295,43,338,Sunday
2023,10,1,600,142,32,174,Sunday
2023,10,1,500,69,27,96,Sunday
2023,10,1,400,34,30,64,Sunday
2023,10,1,300,13,29,42,Sunday
2023,10,1,200,20,41,61,Sunday
2023,10,1,100,25,54,79,Sunday
2023,9,30,2400,29,84,113,Saturday
2023,9,30,2300,59,136,195,Saturday
2023,9,30,2200,65,199,264,Saturday
2023,9,30,2100,107,391,498,Saturday
2023,9,30,2000,136,497,633,Saturday
2023,9,30,1900,215,786,1001,Saturday
2023,9,30,1800,283,952,1235,Saturday
2023,9,30,1700,407,913,1320,Saturday
2023,9,30,1600,464,913,1377,Saturday
2023,9,30,1500,583,798,1381,Saturday
2023,9,30,1400,667,626,1293,Saturday
2023,9,30,1300,827,523,1350,Saturday
2023,9,30,1200,888,439,1327,Saturday
2023,9,30,1100,935,311,1246,Saturday
2023,9,30,1000,800,218,1018,Saturday
2023,9,30,900,664,141,805,Saturday
2023,9,30,800,437,83,520,Saturday
2023,9,30,700,234,65,299,Saturday
2023,9,30,600,105,49,154,Saturday
2023,9,30,500,51,40,91,Saturday
2023,9,30,400,28,36,64,Saturday
2023,9,30,300,20,36,56,Saturday
2023,9,30,200,32,59,91,Saturday
2023,9,30,100,43,75,118,Saturday
2023,9,29,2400,51,107,158,Friday
2023,9,29,2300,75,172,247,Friday
2023,9,29,2200,137,212,349,Friday
2023,9,29,2100,222,407,629,Friday
2023,9,29,2000,323,722,1045,Friday
2023,9,29,1900,425,926,1351,Friday
2023,9,29,1800,551,986,1537,Friday
2023,9,29,1700,588,956,1544,Friday
2023,9,29,1600,659,955,1614,Friday
2023,9,29,1500,747,778,1525,Friday
2023,9,29,1400,738,607,1345,Friday
2023,9,29,1300,857,536,1393,Friday
2023,9,29,1200,954,464,1418,Friday
2023,9,29,1100,1056,370,1426,Friday
2023,9,29,1000,956,235,1191,Friday
2023,9,29,900,701,164,865,Friday
2023,9,29,800,481,79,560,Friday
2023,9,29,700,264,56,320,Friday
2023,9,29,600,117,56,173,Friday
2023,9,29,500,59,37,96,Friday
2023,9,29,400,25,48,73,Friday
2023,9,29,300,26,32,58,Friday
2023,9,29,200,34,49,83,Friday
2023,9,29,100,40,64,104,Friday
2023,9,28,2400,41,80,121,Thursday
2023,9,28,2300,87,150,237,Thursday
2023,9,28,2200,129,148,277,Thursday
2023,9,28,2100,189,347,536,Thursday
2023,9,28,2000,271,519,790,Thursday
2023,9,28,1900,332,689,1021,Thursday
2023,9,28,1800,375,903,1278,Thursday
2023,9,28,1700,429,797,1226,Thursday
2023,9,28,1600,495,782,1277,Thursday
2023,9,28,1500,546,698,1244,Thursday
2023,9,28,1400,592,665,1257,Thursday
2023,9,28,1300,610,554,1164,Thursday
2023,9,28,1200,810,383,1193,Thursday
2023,9,28,1100,937,323,1260,Thursday
2023,9,28,1000,778,207,985,Thursday
2023,9,28,900,592,144,736,Thursday
2023,9,28,800,413,102,515,Thursday
2023,9,28,700,230,50,280,Thursday
2023,9,28,600,108,49,157,Thursday
2023,9,28,500,43,45,88,Thursday
2023,9,28,400,32,38,70,Thursday
2023,9,28,300,27,35,62,Thursday
2023,9,28,200,30,55,85,Thursday
2023,9,28,100,25,57,82,Thursday
2023,9,27,2400,48,96,144,Wednesday
2023,9,27,2300,66,149,215,Wednesday
2023,9,27,2200,104,188,292,Wednesday
2023,9,27,2100,159,359,518,Wednesday
2023,9,27,2000,199,595,794,Wednesday
2023,9,27,1900,236,809,1045,Wednesday
2023,9,27,1800,292,855,1147,Wednesday
2023,9,27,1700,347,824,1171,Wednesday
2023,9,27,1600,395,738,1133,Wednesday
2023,9,27,1500,469,676,1145,Wednesday
2023,9,27,1400,512,516,1028,Wednesday
2023,9,27,1300,577,434,1011,Wednesday
2023,9,27,1200,733,348,1081,Wednesday
2023,9,27,1100,888,278,1166,Wednesday
2023,9,27,1000,804,201,1005,Wednesday
2023,9,27,900,588,165,753,Wednesday
2023,9,27,800,391,76,467,Wednesday
2023,9,27,700,242,54,296,Wednesday
2023,9,27,600,134,59,193,Wednesday
2023,9,27,500,60,43,103,Wednesday
2023,9,27,400,27,39,66,Wednesday
2023,9,27,300,18,40,58,Wednesday
2023,9,27,200,25,57,82,Wednesday
2023,9,27,100,27,70,97,Wednesday
2023,9,26,2400,45,87,132,Tuesday
2023,9,26,2300,70,137,207,Tuesday
2023,9,26,2200,106,188,294,Tuesday
2023,9,26,2100,141,393,534,Tuesday
2023,9,26,2000,156,555,711,Tuesday
2023,9,26,1900,201,771,972,Tuesday
2023,9,26,1800,264,870,1134,Tuesday
2023,9,26,1700,306,787,1093,Tuesday
2023,9,26,1600,311,802,1113,Tuesday
2023,9,26,1500,490,785,1275,Tuesday
2023,9,26,1400,527,554,1081,Tuesday
2023,9,26,1300,613,453,1066,Tuesday
2023,9,26,1200,800,400,1200,Tuesday
2023,9,26,1100,889,253,1142,Tuesday
2023,9,26,1000,857,204,1061,Tuesday
2023,9,26,900,671,120,791,Tuesday
2023,9,26,800,409,81,490,Tuesday
2023,9,26,700,259,53,312,Tuesday
2023,9,26,600,118,56,174,Tuesday
2023,9,26,500,53,41,94,Tuesday
2023,9,26,400,32,31,63,Tuesday
2023,9,26,300,32,53,85,Tuesday
2023,9,26,200,18,52,70,Tuesday
2023,9,26,100,41,49,90,Tuesday
2023,9,25,2400,43,113,156,Monday
2023,9,25,2300,70,174,244,Monday
2023,9,25,2200,99,221,320,Monday
2023,9,25,2100,135,418,553,Monday
2023,9,25,2000,176,712,888,Monday
2023,9,25,1900,205,888,1093,Monday
2023,9,25,1800,269,1034,1303,Monday
2023,9,25,1700,366,954,1320,Monday
2023,9,25,1600,473,871,1344,Monday
2023,9,25,1500,519,601,1120,Monday
2023,9,25,1400,595,605,1200,Monday
2023,9,25,1300,681,597,1278,Monday
2023,9,25,1200,818,503,1321,Monday
2023,9,25,1100,996,349,1345,Monday
2023,9,25,1000,979,213,1192,Monday
2023,9,25,900,748,180,928,Monday
2023,9,25,800,507,49,556,Monday
2023,9,25,700,329,33,362,Monday
2023,9,25,600,130,23,153,Monday
2023,9,25,500,55,22,77,Monday
2023,9,25,400,16,18,34,Monday
2023,9,25,300,19,21,40,Monday
2023,9,25,200,20,31,51,Monday
2023,9,25,100,32,40,72,Monday
2023,9,24,2400,34,57,91,Sunday
2023,9,24,2300,52,169,221,Sunday
2023,9,24,2200,98,311,409,Sunday
2023,9,24,2100,139,646,785,Sunday
2023,9,24,2000,216,1023,1239,Sunday
2023,9,24,1900,273,1199,1472,Sunday
2023,9,24,1800,391,1483,1874,Sunday
2023,9,24,1700,486,1446,1932,Sunday
2023,9,24,1600,641,1433,2074,Sunday
2023,9,24,1500,703,1293,1996,Sunday
2023,9,24,1400,871,1211,2082,Sunday
2023,9,24,1300,842,1032,1874,Sunday
2023,9,24,1200,1079,829,1908,Sunday
2023,9,24,1100,1062,520,1582,Sunday
2023,9,24,1000,939,338,1277,Sunday
2023,9,24,900,710,190,900,Sunday
2023,9,24,800,533,58,591,Sunday
2023,9,24,700,293,19,312,Sunday
2023,9,24,600,122,45,167,Sunday
2023,9,24,500,46,8,54,Sunday
2023,9,24,400,15,20,35,Sunday
2023,9,24,300,21,31,52,Sunday
2023,9,24,200,16,20,36,Sunday
2023,9,24,100,21,21,42,Sunday
2023,9,23,2400,40,52,92,Saturday
2023,9,23,2300,54,126,180,Saturday
2023,9,23,2200,107,190,297,Saturday
2023,9,23,2100,149,424,573,Saturday
2023,9,23,2000,189,742,931,Saturday
2023,9,23,1900,289,975,1264,Saturday
2023,9,23,1800,369,1187,1556,Saturday
2023,9,23,1700,498,1190,1688,Saturday
2023,9,23,1600,629,1156,1785,Saturday
2023,9,23,1500,694,1027,1721,Saturday
2023,9,23,1400,781,882,1663,Saturday
2023,9,23,1300,910,787,1697,Saturday
2023,9,23,1200,1098,527,1625,Saturday
2023,9,23,1100,1078,414,1492,Saturday
2023,9,23,1000,1098,341,1439,Saturday
2023,9,23,900,773,270,1043,Saturday
2023,9,23,800,566,66,632,Saturday
2023,9,23,700,354,39,393,Saturday
2023,9,23,600,139,31,170,Saturday
2023,9,23,500,47,52,99,Saturday
2023,9,23,400,26,29,55,Saturday
2023,9,23,300,23,33,56,Saturday
2023,9,23,200,29,41,70,Saturday
2023,9,23,100,44,32,76,Saturday
2023,9,22,2400,54,65,119,Friday
2023,9,22,2300,95,154,249,Friday
2023,9,22,2200,138,264,402,Friday
2023,9,22,2100,262,476,738,Friday
2023,9,22,2000,422,801,1223,Friday
2023,9,22,1900,568,979,1547,Friday
2023,9,22,1800,664,1120,1784,Friday
2023,9,22,1700,719,1283,2002,Friday
2023,9,22,1600,783,1045,1828,Friday
2023,9,22,1500,820,942,1762,Friday
2023,9,22,1400,865,845,1710,Friday
2023,9,22,1300,960,504,1464,Friday
2023,9,22,1200,1254,471,1725,Friday
2023,9,22,1100,1164,399,1563,Friday
2023,9,22,1000,1042,309,1351,Friday
2023,9,22,900,779,185,964,Friday
2023,9,22,800,551,87,638,Friday
2023,9,22,700,400,57,457,Friday
2023,9,22,600,157,51,208,Friday
2023,9,22,500,76,42,118,Friday
2023,9,22,400,27,44,71,Friday
2023,9,22,300,26,35,61,Friday
2023,9,22,200,32,46,78,Friday
2023,9,22,100,60,85,145,Friday
2023,9,21,2400,58,115,173,Thursday
2023,9,21,2300,84,124,208,Thursday
2023,9,21,2200,149,217,366,Thursday
2023,9,21,2100,239,435,674,Thursday
2023,9,21,2000,331,764,1095,Thursday
2023,9,21,1900,345,945,1290,Thursday
2023,9,21,1800,418,1012,1430,Thursday
2023,9,21,1700,519,953,1472,Thursday
2023,9,21,1600,549,863,1412,Thursday
2023,9,21,1500,571,617,1188,Thursday
2023,9,21,1400,636,591,1227,Thursday
2023,9,21,1300,823,445,1268,Thursday
2023,9,21,1200,845,390,1235,Thursday
2023,9,21,1100,996,279,1275,Thursday
2023,9,21,1000,988,237,1225,Thursday
2023,9,21,900,753,155,908,Thursday
2023,9,21,800,548,87,635,Thursday
2023,9,21,700,323,49,372,Thursday
2023,9,21,600,169,49,218,Thursday
2023,9,21,500,59,37,96,Thursday
2023,9,21,400,31,97,128,Thursday
2023,9,21,300,30,39,69,Thursday
2023,9,21,200,29,15,44,Thursday
2023,9,21,100,44,24,68,Thursday
2023,9,20,2400,54,88,142,Wednesday
2023,9,20,2300,71,116,187,Wednesday
2023,9,20,2200,113,193,306,Wednesday
2023,9,20,2100,141,340,481,Wednesday
2023,9,20,2000,231,539,770,Wednesday
2023,9,20,1900,233,720,953,Wednesday
2023,9,20,1800,313,882,1195,Wednesday
2023,9,20,1700,362,755,1117,Wednesday
2023,9,20,1600,465,720,1185,Wednesday
2023,9,20,1500,495,641,1136,Wednesday
2023,9,20,1400,517,513,1030,Wednesday
2023,9,20,1300,641,481,1122,Wednesday
2023,9,20,1200,864,406,1270,Wednesday
2023,9,20,1100,893,287,1180,Wednesday
2023,9,20,1000,856,250,1106,Wednesday
2023,9,20,900,602,160,762,Wednesday
2023,9,20,800,405,95,500,Wednesday
2023,9,20,700,186,50,236,Wednesday
2023,9,20,600,104,35,139,Wednesday
2023,9,20,500,49,40,89,Wednesday
2023,9,20,400,34,36,70,Wednesday
2023,9,20,300,33,47,80,Wednesday
2023,9,20,200,22,42,64,Wednesday
2023,9,20,100,33,81,114,Wednesday
2023,9,19,2400,63,86,149,Tuesday
2023,9,19,2300,73,156,229,Tuesday
2023,9,19,2200,91,200,291,Tuesday
2023,9,19,2100,137,337,474,Tuesday
2023,9,19,2000,194,527,721,Tuesday
2023,9,19,1900,212,709,921,Tuesday
2023,9,19,1800,285,867,1152,Tuesday
2023,9,19,1700,383,879,1262,Tuesday
2023,9,19,1600,399,952,1351,Tuesday
2023,9,19,1500,492,765,1257,Tuesday
2023,9,19,1400,525,547,1072,Tuesday
2023,9,19,1300,667,500,1167,Tuesday
2023,9,19,1200,914,381,1295,Tuesday
2023,9,19,1100,781,339,1120,Tuesday
2023,9,19,1000,862,209,1071,Tuesday
2023,9,19,900,647,144,791,Tuesday
2023,9,19,800,406,94,500,Tuesday
2023,9,19,700,257,48,305,Tuesday
2023,9,19,600,132,44,176,Tuesday
2023,9,19,500,43,40,83,Tuesday
2023,9,19,400,31,44,75,Tuesday
2023,9,19,300,26,41,67,Tuesday
2023,9,19,200,37,54,91,Tuesday
2023,9,19,100,42,89,131,Tuesday
2023,9,18,2400,72,115,187,Monday
2023,9,18,2300,85,171,256,Monday
2023,9,18,2200,112,209,321,Monday
2023,9,18,2100,176,400,576,Monday
2023,9,18,2000,216,538,754,Monday
2023,9,18,1900,241,896,1137,Monday
2023,9,18,1800,290,1024,1314,Monday
2023,9,18,1700,370,1085,1455,Monday
2023,9,18,1600,499,769,1268,Monday
2023,9,18,1500,578,735,1313,Monday
2023,9,18,1400,611,716,1327,Monday
2023,9,18,1300,730,793,1523,Monday
2023,9,18,1200,947,611,1558,Monday
2023,9,18,1100,1002,463,1465,Monday
2023,9,18,1000,1024,293,1317,Monday
2023,9,18,900,754,181,935,Monday
2023,9,18,800,527,85,612,Monday
2023,9,18,700,320,54,374,Monday
2023,9,18,600,167,19,186,Monday
2023,9,18,500,40,17,57,Monday
2023,9,18,400,23,18,41,Monday
2023,9,18,300,20,11,31,Monday
2023,9,18,200,18,36,54,Monday
2023,9,18,100,17,39,56,Monday
2023,9,17,2400,39,67,106,Sunday
2023,9,17,2300,56,153,209,Sunday
2023,9,17,2200,91,344,435,Sunday
2023,9,17,2100,165,648,813,Sunday
2023,9,17,2000,241,1161,1402,Sunday
2023,9,17,1900,287,1407,1694,Sunday
2023,9,17,1800,401,1586,1987,Sunday
2023,9,17,1700,498,1756,2254,Sunday
2023,9,17,1600,679,1655,2334,Sunday
2023,9,17,1500,828,1462,2290,Sunday
2023,9,17,1400,912,1260,2172,Sunday
2023,9,17,1300,959,1145,2104,Sunday
2023,9,17,1200,1153,958,2111,Sunday
2023,9,17,1100,1151,650,1801,Sunday
2023,9,17,1000,1035,405,1440,Sunday
2023,9,17,900,829,182,1011,Sunday
2023,9,17,800,536,75,611,Sunday
2023,9,17,700,337,29,366,Sunday
2023,9,17,600,154,21,175,Sunday
2023,9,17,500,50,26,76,Sunday
2023,9,17,400,21,14,35,Sunday
2023,9,17,300,8,32,40,Sunday
2023,9,17,200,16,41,57,Sunday
2023,9,17,100,18,54,72,Sunday
2023,9,16,2400,41,115,156,Saturday
2023,9,16,2300,51,190,241,Saturday
2023,9,16,2200,96,357,453,Saturday
2023,9,16,2100,146,692,838,Saturday
2023,9,16,2000,224,1047,1271,Saturday
2023,9,16,1900,276,1268,1544,Saturday
2023,9,16,1800,403,1414,1817,Saturday
2023,9,16,1700,472,1368,1840,Saturday
2023,9,16,1600,707,1223,1930,Saturday
2023,9,16,1500,828,905,1733,Saturday
2023,9,16,1400,859,743,1602,Saturday
2023,9,16,1300,1045,643,1688,Saturday
2023,9,16,1200,1163,490,1653,Saturday
2023,9,16,1100,1373,358,1731,Saturday
2023,9,16,1000,1259,283,1542,Saturday
2023,9,16,900,1007,170,1177,Saturday
2023,9,16,800,671,86,757,Saturday
2023,9,16,700,369,58,427,Saturday
2023,9,16,600,195,36,231,Saturday
2023,9,16,500,59,22,81,Saturday
2023,9,16,400,22,41,63,Saturday
2023,9,16,300,16,36,52,Saturday
2023,9,16,200,30,45,75,Saturday
2023,9,16,100,32,66,98,Saturday
2023,9,15,2400,77,104,181,Friday
2023,9,15,2300,106,152,258,Friday
2023,9,15,2200,225,266,491,Friday
2023,9,15,2100,309,483,792,Friday
2023,9,15,2000,543,777,1320,Friday
2023,9,15,1900,669,939,1608,Friday
2023,9,15,1800,769,1100,1869,Friday
2023,9,15,1700,836,1150,1986,Friday
2023,9,15,1600,910,1004,1914,Friday
2023,9,15,1500,848,888,1736,Friday
2023,9,15,1400,919,710,1629,Friday
2023,9,15,1300,995,626,1621,Friday
2023,9,15,1200,1184,545,1729,Friday
2023,9,15,1100,1266,428,1694,Friday
2023,9,15,1000,1036,320,1356,Friday
2023,9,15,900,841,275,1116,Friday
2023,9,15,800,574,72,646,Friday
2023,9,15,700,371,38,409,Friday
2023,9,15,600,191,41,232,Friday
2023,9,15,500,46,32,78,Friday
2023,9,15,400,31,29,60,Friday
2023,9,15,300,13,22,35,Friday
2023,9,15,200,26,30,56,Friday
2023,9,15,100,28,22,50,Friday
2023,9,14,2400,55,88,143,Thursday
2023,9,14,2300,93,161,254,Thursday
2023,9,14,2200,141,248,389,Thursday
2023,9,14,2100,258,453,711,Thursday
2023,9,14,2000,384,732,1116,Thursday
2023,9,14,1900,453,909,1362,Thursday
2023,9,14,1800,483,1014,1497,Thursday
2023,9,14,1700,545,1003,1548,Thursday
2023,9,14,1600,699,916,1615,Thursday
2023,9,14,1500,738,851,1589,Thursday
2023,9,14,1400,711,651,1362,Thursday
2023,9,14,1300,780,545,1325,Thursday
2023,9,14,1200,1025,496,1521,Thursday
2023,9,14,1100,1127,386,1513,Thursday
2023,9,14,1000,993,303,1296,Thursday
2023,9,14,900,789,262,1051,Thursday
2023,9,14,800,591,69,660,Thursday
2023,9,14,700,341,50,391,Thursday
2023,9,14,600,186,32,218,Thursday
2023,9,14,500,46,23,69,Thursday
2023,9,14,400,32,26,58,Thursday
2023,9,14,300,26,36,62,Thursday
2023,9,14,200,27,29,56,Thursday
2023,9,14,100,27,22,49,Thursday
2023,9,13,2400,55,58,113,Wednesday
2023,9,13,2300,81,168,249,Wednesday
2023,9,13,2200,95,211,306,Wednesday
2023,9,13,2100,186,399,585,Wednesday
2023,9,13,2000,276,620,896,Wednesday
2023,9,13,1900,291,774,1065,Wednesday
2023,9,13,1800,373,968,1341,Wednesday
2023,9,13,1700,411,1070,1481,Wednesday
2023,9,13,1600,496,935,1431,Wednesday
2023,9,13,1500,588,806,1394,Wednesday
2023,9,13,1400,624,579,1203,Wednesday
2023,9,13,1300,694,581,1275,Wednesday
2023,9,13,1200,947,454,1401,Wednesday
2023,9,13,1100,1047,355,1402,Wednesday
2023,9,13,1000,963,302,1265,Wednesday
2023,9,13,900,742,237,979,Wednesday
2023,9,13,800,552,69,621,Wednesday
2023,9,13,700,319,46,365,Wednesday
2023,9,13,600,156,30,186,Wednesday
2023,9,13,500,47,34,81,Wednesday
2023,9,13,400,22,34,56,Wednesday
2023,9,13,300,20,24,44,Wednesday
2023,9,13,200,21,36,57,Wednesday
2023,9,13,100,30,26,56,Wednesday
2023,9,12,2400,50,81,131,Tuesday
2023,9,12,2300,74,139,213,Tuesday
2023,9,12,2200,85,209,294,Tuesday
2023,9,12,2100,191,418,609,Tuesday
2023,9,12,2000,227,613,840,Tuesday
2023,9,12,1900,265,878,1143,Tuesday
2023,9,12,1800,311,1012,1323,Tuesday
2023,9,12,1700,403,961,1364,Tuesday
2023,9,12,1600,440,911,1351,Tuesday
2023,9,12,1500,571,738,1309,Tuesday
2023,9,12,1400,556,606,1162,Tuesday
2023,9,12,1300,642,561,1203,Tuesday
2023,9,12,1200,881,433,1314,Tuesday
2023,9,12,1100,996,346,1342,Tuesday
2023,9,12,1000,919,284,1203,Tuesday
2023,9,12,900,738,229,967,Tuesday
2023,9,12,800,490,68,558,Tuesday
2023,9,12,700,325,36,361,Tuesday
2023,9,12,600,142,40,182,Tuesday
2023,9,12,500,37,31,68,Tuesday
2023,9,12,400,25,30,55,Tuesday
2023,9,12,300,14,24,38,Tuesday
2023,9,12,200,20,33,53,Tuesday
2023,9,12,100,31,19,50,Tuesday
2023,9,11,2400,46,84,130,Monday
2023,9,11,2300,70,160,230,Monday
2023,9,11,2200,90,221,311,Monday
2023,9,11,2100,168,482,650,Monday
2023,9,11,2000,219,738,957,Monday
2023,9,11,1900,293,950,1243,Monday
2023,9,11,1800,355,1017,1372,Monday
2023,9,11,1700,411,1069,1480,Monday
2023,9,11,1600,534,1017,1551,Monday
2023,9,11,1500,641,894,1535,Monday
2023,9,11,1400,762,747,1509,Monday
2023,9,11,1300,799,497,1296,Monday
2023,9,11,1200,1032,482,1514,Monday
2023,9,11,1100,1096,367,1463,Monday
2023,9,11,1000,999,254,1253,Monday
2023,9,11,900,797,219,1016,Monday
2023,9,11,800,576,87,663,Monday
2023,9,11,700,343,19,362,Monday
2023,9,11,600,176,29,205,Monday
2023,9,11,500,45,27,72,Monday
2023,9,11,400,27,19,46,Monday
2023,9,11,300,18,25,43,Monday
2023,9,11,200,14,28,42,Monday
2023,9,11,100,25,28,53,Monday
2023,9,10,2400,40,69,109,Sunday
2023,9,10,2300,67,180,247,Sunday
2023,9,10,2200,106,381,487,Sunday
2023,9,10,2100,201,654,855,Sunday
2023,9,10,2000,238,1090,1328,Sunday
2023,9,10,1900,313,1472,1785,Sunday
2023,9,10,1800,458,1580,2038,Sunday
2023,9,10,1700,533,1647,2180,Sunday
2023,9,10,1600,630,1363,1993,Sunday
2023,9,10,1500,755,1163,1918,Sunday
2023,9,10,1400,857,1029,1886,Sunday
2023,9,10,1300,913,880,1793,Sunday
2023,9,10,1200,1145,686,1831,Sunday
2023,9,10,1100,1129,492,1621,Sunday
2023,9,10,1000,988,331,1319,Sunday
2023,9,10,900,853,153,1006,Sunday
2023,9,10,800,527,72,599,Sunday
2023,9,10,700,323,35,358,Sunday
2023,9,10,600,150,28,178,Sunday
2023,9,10,500,52,20,72,Sunday
2023,9,10,400,35,21,56,Sunday
2023,9,10,300,20,39,59,Sunday
2023,9,10,200,24,26,50,Sunday
2023,9,10,100,31,51,82,Sunday
2023,9,9,2400,53,94,147,Saturday
2023,9,9,2300,83,153,236,Saturday
2023,9,9,2200,123,300,423,Saturday
2023,9,9,2100,152,577,729,Saturday
2023,9,9,2000,203,941,1144,Saturday
2023,9,9,1900,308,1124,1432,Saturday
2023,9,9,1800,371,1262,1633,Saturday
2023,9,9,1700,494,1207,1701,Saturday
2023,9,9,1600,588,1060,1648,Saturday
2023,9,9,1500,771,920,1691,Saturday
2023,9,9,1400,875,766,1641,Saturday
2023,9,9,1300,901,640,1541,Saturday
2023,9,9,1200,1220,550,1770,Saturday
2023,9,9,1100,1075,369,1444,Saturday
2023,9,9,1000,1191,291,1482,Saturday
2023,9,9,900,922,205,1127,Saturday
2023,9,9,800,658,95,753,Saturday
2023,9,9,700,350,62,412,Saturday
2023,9,9,600,180,42,222,Saturday
2023,9,9,500,57,43,100,Saturday
2023,9,9,400,25,34,59,Saturday
2023,9,9,300,28,36,64,Saturday
2023,9,9,200,36,43,79,Saturday
2023,9,9,100,28,92,120,Saturday
2023,9,8,2400,71,85,156,Friday
2023,9,8,2300,94,137,231,Friday
2023,9,8,2200,189,304,493,Friday
2023,9,8,2100,261,497,758,Friday
2023,9,8,2000,464,716,1180,Friday
2023,9,8,1900,643,963,1606,Friday
2023,9,8,1800,692,1076,1768,Friday
2023,9,8,1700,789,1023,1812,Friday
2023,9,8,1600,774,967,1741,Friday
2023,9,8,1500,867,821,1688,Friday
2023,9,8,1400,821,784,1605,Friday
2023,9,8,1300,918,632,1550,Friday
2023,9,8,1200,1095,529,1624,Friday
2023,9,8,1100,1228,387,1615,Friday
2023,9,8,1000,1060,272,1332,Friday
2023,9,8,900,821,273,1094,Friday
2023,9,8,800,503,75,578,Friday
2023,9,8,700,354,49,403,Friday
2023,9,8,600,192,42,234,Friday
2023,9,8,500,61,43,104,Friday
2023,9,8,400,33,30,63,Friday
2023,9,8,300,28,35,63,Friday
2023,9,8,200,22,45,67,Friday
2023,9,8,100,36,18,54,Friday
2023,9,7,2400,78,90,168,Thursday
2023,9,7,2300,102,175,277,Thursday
2023,9,7,2200,149,244,393,Thursday
2023,9,7,2100,241,483,724,Thursday
2023,9,7,2000,321,783,1104,Thursday
2023,9,7,1900,356,929,1285,Thursday
2023,9,7,1800,459,1122,1581,Thursday
2023,9,7,1700,542,1097,1639,Thursday
2023,9,7,1600,570,966,1536,Thursday
2023,9,7,1500,666,761,1427,Thursday
2023,9,7,1400,754,607,1361,Thursday
2023,9,7,1300,826,562,1388,Thursday
2023,9,7,1200,977,462,1439,Thursday
2023,9,7,1100,1145,379,1524,Thursday
2023,9,7,1000,1006,279,1285,Thursday
2023,9,7,900,783,262,1045,Thursday
2023,9,7,800,566,71,637,Thursday
2023,9,7,700,340,43,383,Thursday
2023,9,7,600,175,43,218,Thursday
2023,9,7,500,55,36,91,Thursday
2023,9,7,400,16,27,43,Thursday
2023,9,7,300,29,21,50,Thursday
2023,9,7,200,23,35,58,Thursday
2023,9,7,100,30,33,63,Thursday
2023,9,6,2400,53,74,127,Wednesday
2023,9,6,2300,82,147,229,Wednesday
2023,9,6,2200,136,267,403,Wednesday
2023,9,6,2100,179,443,622,Wednesday
2023,9,6,2000,274,596,870,Wednesday
2023,9,6,1900,302,777,1079,Wednesday
2023,9,6,1800,388,851,1239,Wednesday
2023,9,6,1700,412,878,1290,Wednesday
2023,9,6,1600,454,800,1254,Wednesday
2023,9,6,1500,600,639,1239,Wednesday
2023,9,6,1400,661,689,1350,Wednesday
2023,9,6,1300,653,605,1258,Wednesday
2023,9,6,1200,834,564,1398,Wednesday
2023,9,6,1100,916,441,1357,Wednesday
2023,9,6,1000,887,278,1165,Wednesday
2023,9,6,900,682,269,951,Wednesday
2023,9,6,800,433,63,496,Wednesday
2023,9,6,700,284,41,325,Wednesday
2023,9,6,600,130,33,163,Wednesday
2023,9,6,500,44,36,80,Wednesday
2023,9,6,400,19,30,49,Wednesday
2023,9,6,300,13,34,47,Wednesday
2023,9,6,200,14,38,52,Wednesday
2023,9,6,100,28,32,60,Wednesday
2023,9,5,2400,55,61,116,Tuesday
2023,9,5,2300,85,159,244,Tuesday
2023,9,5,2200,105,236,341,Tuesday
2023,9,5,2100,166,450,616,Tuesday
2023,9,5,2000,224,584,808,Tuesday
2023,9,5,1900,290,743,1033,Tuesday
2023,9,5,1800,347,931,1278,Tuesday
2023,9,5,1700,438,1007,1445,Tuesday
2023,9,5,1600,515,1068,1583,Tuesday
2023,9,5,1500,662,1001,1663,Tuesday
2023,9,5,1400,695,863,1558,Tuesday
2023,9,5,1300,802,709,1511,Tuesday
2023,9,5,1200,974,632,1606,Tuesday
2023,9,5,1100,1007,407,1414,Tuesday
2023,9,5,1000,940,296,1236,Tuesday
2023,9,5,900,680,204,884,Tuesday
2023,9,5,800,460,86,546,Tuesday
2023,9,5,700,327,59,386,Tuesday
2023,9,5,600,145,29,174,Tuesday
2023,9,5,500,47,20,67,Tuesday
2023,9,5,400,26,33,59,Tuesday
2023,9,5,300,17,28,45,Tuesday
2023,9,5,200,21,39,60,Tuesday
2023,9,5,100,38,78,116,Tuesday
2023,9,4,2400,40,152,192,Monday
2023,9,4,2300,60,263,323,Monday
2023,9,4,2200,90,454,544,Monday
2023,9,4,2100,162,758,920,Monday
2023,9,4,2000,201,1259,1460,Monday
2023,9,4,1900,279,1572,1851,Monday
2023,9,4,1800,391,1875,2266,Monday
2023,9,4,1700,489,1890,2379,Monday
2023,9,4,1600,632,1843,2475,Monday
2023,9,4,1500,774,2011,2785,Monday
2023,9,4,1400,882,1787,2669,Monday
2023,9,4,1300,998,1739,2737,Monday
2023,9,4,1200,1033,1310,2343,Monday
2023,9,4,1100,1184,789,1973,Monday
2023,9,4,1000,998,478,1476,Monday
2023,9,4,900,826,239,1065,Monday
2023,9,4,800,519,89,608,Monday
2023,9,4,700,330,45,375,Monday
2023,9,4,600,163,26,189,Monday
2023,9,4,500,68,21,89,Monday
2023,9,4,400,16,21,37,Monday
2023,9,4,300,29,26,55,Monday
2023,9,4,200,20,47,67,Monday
2023,9,4,100,28,90,118,Monday
2023,9,3,2400,42,129,171,Sunday
2023,9,3,2300,93,279,372,Sunday
2023,9,3,2200,122,505,627,Sunday
2023,9,3,2100,170,936,1106,Sunday
2023,9,3,2000,310,1270,1580,Sunday
2023,9,3,1900,344,1634,1978,Sunday
2023,9,3,1800,444,1789,2233,Sunday
2023,9,3,1700,649,1765,2414,Sunday
2023,9,3,1600,799,1633,2432,Sunday
2023,9,3,1500,953,1456,2409,Sunday
2023,9,3,1400,1129,1283,2412,Sunday
2023,9,3,1300,1166,1043,2209,Sunday
2023,9,3,1200,1315,766,2081,Sunday
2023,9,3,1100,1296,507,1803,Sunday
2023,9,3,1000,1292,330,1622,Sunday
2023,9,3,900,978,207,1185,Sunday
2023,9,3,800,706,101,807,Sunday
2023,9,3,700,403,33,436,Sunday
2023,9,3,600,240,29,269,Sunday
2023,9,3,500,78,27,105,Sunday
2023,9,3,400,34,20,54,Sunday
2023,9,3,300,19,29,48,Sunday
2023,9,3,200,22,52,74,Sunday
2023,9,3,100,32,77,109,Sunday
2023,9,2,2400,66,141,207,Saturday
2023,9,2,2300,116,289,405,Saturday
2023,9,2,2200,158,552,710,Saturday
2023,9,2,2100,225,820,1045,Saturday
2023,9,2,2000,302,1172,1474,Saturday
2023,9,2,1900,406,1453,1859,Saturday
2023,9,2,1800,502,1536,2038,Saturday
2023,9,2,1700,645,1366,2011,Saturday
2023,9,2,1600,914,1174,2088,Saturday
2023,9,2,1500,1336,980,2316,Saturday
2023,9,2,1400,1425,827,2252,Saturday
2023,9,2,1300,1398,691,2089,Saturday
2023,9,2,1200,1486,571,2057,Saturday
2023,9,2,1100,1516,437,1953,Saturday
2023,9,2,1000,1380,301,1681,Saturday
2023,9,2,900,1234,214,1448,Saturday
2023,9,2,800,894,95,989,Saturday
2023,9,2,700,567,44,611,Saturday
2023,9,2,600,309,36,345,Saturday
2023,9,2,500,81,48,129,Saturday
2023,9,2,400,45,62,107,Saturday
2023,9,2,300,32,48,80,Saturday
2023,9,2,200,40,78,118,Saturday
2023,9,2,100,57,81,138,Saturday
2023,9,1,2400,96,130,226,Friday
2023,9,1,2300,199,219,418,Friday
2023,9,1,2200,381,383,764,Friday
2023,9,1,2100,583,629,1212,Friday
2023,9,1,2000,1020,937,1957,Friday
2023,9,1,1900,1137,1084,2221,Friday
2023,9,1,1800,1229,1163,2392,Friday
2023,9,1,1700,1330,1094,2424,Friday
2023,9,1,1600,1333,1033,2366,Friday
2023,9,1,1500,1251,847,2098,Friday
2023,9,1,1400,1280,759,2039,Friday
2023,9,1,1300,1343,643,1986,Friday
2023,9,1,1200,1410,555,1965,Friday
2023,9,1,1100,1296,458,1754,Friday
2023,9,1,1000,1275,354,1629,Friday
2023,9,1,900,935,312,1247,Friday
2023,9,1,800,641,85,726,Friday
2023,9,1,700,399,63,462,Friday
2023,9,1,600,207,54,261,Friday
2023,9,1,500,72,41,113,Friday
2023,9,1,400,32,39,71,Friday
2023,9,1,300,28,36,64,Friday
2023,9,1,200,53,73,126,Friday
2023,9,1,100,37,35,72,Friday
2023,8,31,2400,78,98,176,Thursday
2023,8,31,2300,99,223,322,Thursday
2023,8,31,2200,152,543,695,Thursday
2023,8,31,2100,321,1142,1463,Thursday
2023,8,31,2000,523,309,832,Thursday
2023,8,31,1900,647,230,877,Thursday
2023,8,31,1800,679,205,884,Thursday
2023,8,31,1700,712,581,1293,Thursday
2023,8,31,1600,790,828,1618,Thursday
2023,8,31,1500,863,741,1604,Thursday
2023,8,31,1400,728,679,1407,Thursday
2023,8,31,1300,848,603,1451,Thursday
2023,8,31,1200,939,440,1379,Thursday
2023,8,31,1100,1001,343,1344,Thursday
2023,8,31,1000,910,284,1194,Thursday
2023,8,31,900,703,281,984,Thursday
2023,8,31,800,466,85,551,Thursday
2023,8,31,700,335,51,386,Thursday
2023,8,31,600,157,33,190,Thursday
2023,8,31,500,47,30,77,Thursday
2023,8,31,400,25,45,70,Thursday
2023,8,31,300,29,31,60,Thursday
2023,8,31,200,30,55,85,Thursday
2023,8,31,100,45,38,83,Thursday
2023,8,30,2400,67,84,151,Wednesday
2023,8,30,2300,68,165,233,Wednesday
2023,8,30,2200,125,263,388,Wednesday
2023,8,30,2100,233,488,721,Wednesday
2023,8,30,2000,276,686,962,Wednesday
2023,8,30,1900,374,864,1238,Wednesday
2023,8,30,1800,426,952,1378,Wednesday
2023,8,30,1700,530,933,1463,Wednesday
2023,8,30,1600,542,768,1310,Wednesday
2023,8,30,1500,662,825,1487,Wednesday
2023,8,30,1400,672,671,1343,Wednesday
2023,8,30,1300,700,632,1332,Wednesday
2023,8,30,1200,900,526,1426,Wednesday
2023,8,30,1100,894,359,1253,Wednesday
2023,8,30,1000,738,290,1028,Wednesday
2023,8,30,900,652,261,913,Wednesday
2023,8,30,800,527,81,608,Wednesday
2023,8,30,700,316,58,374,Wednesday
2023,8,30,600,169,32,201,Wednesday
2023,8,30,500,55,38,93,Wednesday
2023,8,30,400,27,33,60,Wednesday
2023,8,30,300,18,32,50,Wednesday
2023,8,30,200,36,50,86,Wednesday
2023,8,30,100,34,42,76,Wednesday
2023,8,29,2400,57,94,151,Tuesday
2023,8,29,2300,75,238,313,Tuesday
2023,8,29,2200,113,427,540,Tuesday
2023,8,29,2100,211,617,828,Tuesday
2023,8,29,2000,261,909,1170,Tuesday
2023,8,29,1900,353,1036,1389,Tuesday
2023,8,29,1800,386,1133,1519,Tuesday
2023,8,29,1700,490,1042,1532,Tuesday
2023,8,29,1600,559,951,1510,Tuesday
2023,8,29,1500,637,721,1358,Tuesday
2023,8,29,1400,729,680,1409,Tuesday
2023,8,29,1300,849,568,1417,Tuesday
2023,8,29,1200,915,467,1382,Tuesday
2023,8,29,1100,983,424,1407,Tuesday
2023,8,29,1000,915,292,1207,Tuesday
2023,8,29,900,788,277,1065,Tuesday
2023,8,29,800,552,86,638,Tuesday
2023,8,29,700,407,45,452,Tuesday
2023,8,29,600,193,42,235,Tuesday
2023,8,29,500,61,31,92,Tuesday
2023,8,29,400,32,44,76,Tuesday
2023,8,29,300,17,42,59,Tuesday
2023,8,29,200,27,46,73,Tuesday
2023,8,29,100,39,37,76,Tuesday
2023,8,28,2400,59,106,165,Monday
2023,8,28,2300,89,223,312,Monday
2023,8,28,2200,129,368,497,Monday
2023,8,28,2100,206,679,885,Monday
2023,8,28,2000,273,863,1136,Monday
2023,8,28,1900,374,1176,1550,Monday
2023,8,28,1800,464,1213,1677,Monday
2023,8,28,1700,513,1143,1656,Monday
2023,8,28,1600,645,1019,1664,Monday
2023,8,28,1500,749,935,1684,Monday
2023,8,28,1400,881,711,1592,Monday
2023,8,28,1300,955,662,1617,Monday
2023,8,28,1200,1110,557,1667,Monday
2023,8,28,1100,1143,431,1574,Monday
2023,8,28,1000,1001,281,1282,Monday
2023,8,28,900,754,212,966,Monday
2023,8,28,800,624,102,726,Monday
2023,8,28,700,398,42,440,Monday
2023,8,28,600,171,29,200,Monday
2023,8,28,500,76,27,103,Monday
2023,8,28,400,25,33,58,Monday
2023,8,28,300,17,30,47,Monday
2023,8,28,200,22,46,68,Monday
2023,8,28,100,36,41,77,Monday
2023,8,27,2400,44,105,149,Sunday
2023,8,27,2300,97,320,417,Sunday
2023,8,27,2200,125,570,695,Sunday
2023,8,27,2100,178,883,1061,Sunday
2023,8,27,2000,268,1226,1494,Sunday
2023,8,27,1900,377,1479,1856,Sunday
2023,8,27,1800,436,1586,2022,Sunday
2023,8,27,1700,585,1668,2253,Sunday
2023,8,27,1600,796,1517,2313,Sunday
2023,8,27,1500,895,1347,2242,Sunday
2023,8,27,1400,972,1215,2187,Sunday
2023,8,27,1300,1062,1064,2126,Sunday
2023,8,27,1200,1234,842,2076,Sunday
2023,8,27,1100,1137,487,1624,Sunday
2023,8,27,1000,969,312,1281,Sunday
2023,8,27,900,800,192,992,Sunday
2023,8,27,800,507,89,596,Sunday
2023,8,27,700,345,35,380,Sunday
2023,8,27,600,189,22,211,Sunday
2023,8,27,500,56,23,79,Sunday
2023,8,27,400,30,15,45,Sunday
2023,8,27,300,33,26,59,Sunday
2023,8,27,200,23,45,68,Sunday
2023,8,27,100,32,76,108,Sunday
2023,8,26,2400,42,124,166,Saturday
2023,8,26,2300,96,235,331,Saturday
2023,8,26,2200,147,413,560,Saturday
2023,8,26,2100,186,761,947,Saturday
2023,8,26,2000,250,1110,1360,Saturday
2023,8,26,1900,385,1285,1670,Saturday
2023,8,26,1800,422,1271,1693,Saturday
2023,8,26,1700,573,1326,1899,Saturday
2023,8,26,1600,669,1185,1854,Saturday
2023,8,26,1500,988,1021,2009,Saturday
2023,8,26,1400,1038,759,1797,Saturday
2023,8,26,1300,997,689,1686,Saturday
2023,8,26,1200,1111,625,1736,Saturday
2023,8,26,1100,1304,444,1748,Saturday
2023,8,26,1000,1196,326,1522,Saturday
2023,8,26,900,967,216,1183,Saturday
2023,8,26,800,700,89,789,Saturday
2023,8,26,700,427,57,484,Saturday
2023,8,26,600,206,44,250,Saturday
2023,8,26,500,56,48,104,Saturday
2023,8,26,400,34,42,76,Saturday
2023,8,26,300,29,58,87,Saturday
2023,8,26,200,36,63,99,Saturday
2023,8,26,100,51,84,135,Saturday
2023,8,25,2400,95,115,210,Friday
2023,8,25,2300,118,230,348,Friday
2023,8,25,2200,189,418,607,Friday
2023,8,25,2100,363,623,986,Friday
2023,8,25,2000,562,921,1483,Friday
2023,8,25,1900,756,1066,1822,Friday
2023,8,25,1800,823,1245,2068,Friday
2023,8,25,1700,851,1165,2016,Friday
2023,8,25,1600,963,1105,2068,Friday
2023,8,25,1500,1034,849,1883,Friday
2023,8,25,1400,1074,763,1837,Friday
2023,8,25,1300,1010,698,1708,Friday
2023,8,25,1200,1089,561,1650,Friday
2023,8,25,1100,1133,405,1538,Friday
2023,8,25,1000,1033,316,1349,Friday
2023,8,25,900,879,271,1150,Friday
2023,8,25,800,567,85,652,Friday
2023,8,25,700,406,57,463,Friday
2023,8,25,600,208,40,248,Friday
2023,8,25,500,72,33,105,Friday
2023,8,25,400,46,34,80,Friday
2023,8,25,300,21,41,62,Friday
2023,8,25,200,34,39,73,Friday
2023,8,25,100,41,31,72,Friday
2023,8,24,2400,61,77,138,Thursday
2023,8,24,2300,112,248,360,Thursday
2023,8,24,2200,168,388,556,Thursday
2023,8,24,2100,273,545,818,Thursday
2023,8,24,2000,420,858,1278,Thursday
2023,8,24,1900,502,1046,1548,Thursday
2023,8,24,1800,582,1084,1666,Thursday
2023,8,24,1700,601,1100,1701,Thursday
2023,8,24,1600,678,995,1673,Thursday
2023,8,24,1500,813,851,1664,Thursday
2023,8,24,1400,775,756,1531,Thursday
2023,8,24,1300,865,640,1505,Thursday
2023,8,24,1200,1008,511,1519,Thursday
2023,8,24,1100,1156,426,1582,Thursday
2023,8,24,1000,910,315,1225,Thursday
2023,8,24,900,804,263,1067,Thursday
2023,8,24,800,574,82,656,Thursday
2023,8,24,700,385,62,447,Thursday
2023,8,24,600,192,32,224,Thursday
2023,8,24,500,67,24,91,Thursday
2023,8,24,400,28,38,66,Thursday
2023,8,24,300,23,41,64,Thursday
2023,8,24,200,35,38,73,Thursday
2023,8,24,100,34,45,79,Thursday
2023,8,23,2400,56,79,135,Wednesday
2023,8,23,2300,73,183,256,Wednesday
2023,8,23,2200,109,308,417,Wednesday
2023,8,23,2100,246,500,746,Wednesday
2023,8,23,2000,361,651,1012,Wednesday
2023,8,23,1900,371,951,1322,Wednesday
2023,8,23,1800,416,1042,1458,Wednesday
2023,8,23,1700,505,941,1446,Wednesday
2023,8,23,1600,675,1027,1702,Wednesday
2023,8,23,1500,714,906,1620,Wednesday
2023,8,23,1400,713,844,1557,Wednesday
2023,8,23,1300,723,597,1320,Wednesday
2023,8,23,1200,925,490,1415,Wednesday
2023,8,23,1100,994,362,1356,Wednesday
2023,8,23,1000,895,360,1255,Wednesday
2023,8,23,900,716,261,977,Wednesday
2023,8,23,800,494,76,570,Wednesday
2023,8,23,700,310,49,359,Wednesday
2023,8,23,600,181,31,212,Wednesday
2023,8,23,500,51,38,89,Wednesday
2023,8,23,400,19,28,47,Wednesday
2023,8,23,300,13,87,100,Wednesday
2023,8,23,200,23,60,83,Wednesday
2023,8,23,100,34,22,56,Wednesday
2023,8,22,2400,50,37,87,Tuesday
2023,8,22,2300,74,57,131,Tuesday
2023,8,22,2200,102,189,291,Tuesday
2023,8,22,2100,195,409,604,Tuesday
2023,8,22,2000,279,706,985,Tuesday
2023,8,22,1900,319,930,1249,Tuesday
2023,8,22,1800,343,991,1334,Tuesday
2023,8,22,1700,435,916,1351,Tuesday
2023,8,22,1600,538,872,1410,Tuesday
2023,8,22,1500,586,650,1236,Tuesday
2023,8,22,1400,649,704,1353,Tuesday
2023,8,22,1300,722,642,1364,Tuesday
2023,8,22,1200,815,607,1422,Tuesday
2023,8,22,1100,822,497,1319,Tuesday
2023,8,22,1000,709,323,1032,Tuesday
2023,8,22,900,539,263,802,Tuesday
2023,8,22,800,396,68,464,Tuesday
2023,8,22,700,272,53,325,Tuesday
2023,8,22,600,129,38,167,Tuesday
2023,8,22,500,40,32,72,Tuesday
2023,8,22,400,19,35,54,Tuesday
2023,8,22,300,32,35,67,Tuesday
2023,8,22,200,21,53,74,Tuesday
2023,8,22,100,30,44,74,Tuesday
2023,8,21,2400,49,101,150,Monday
2023,8,21,2300,63,224,287,Monday
2023,8,21,2200,112,386,498,Monday
2023,8,21,2100,201,620,821,Monday
2023,8,21,2000,249,866,1115,Monday
2023,8,21,1900,343,1175,1518,Monday
2023,8,21,1800,393,1361,1754,Monday
2023,8,21,1700,537,1318,1855,Monday
2023,8,21,1600,807,1242,2049,Monday
2023,8,21,1500,791,1014,1805,Monday
2023,8,21,1400,791,893,1684,Monday
2023,8,21,1300,878,810,1688,Monday
2023,8,21,1200,926,598,1524,Monday
2023,8,21,1100,1027,408,1435,Monday
2023,8,21,1000,992,291,1283,Monday
2023,8,21,900,765,220,985,Monday
2023,8,21,800,526,101,627,Monday
2023,8,21,700,357,58,415,Monday
2023,8,21,600,161,30,191,Monday
2023,8,21,500,65,13,78,Monday
2023,8,21,400,30,27,57,Monday
2023,8,21,300,14,39,53,Monday
2023,8,21,200,26,55,81,Monday
2023,8,21,100,31,46,77,Monday
2023,8,20,2400,39,110,149,Sunday
2023,8,20,2300,88,362,450,Sunday
2023,8,20,2200,137,539,676,Sunday
2023,8,20,2100,194,971,1165,Sunday
2023,8,20,2000,288,1314,1602,Sunday
2023,8,20,1900,345,1740,2085,Sunday
2023,8,20,1800,471,1902,2373,Sunday
2023,8,20,1700,517,2002,2519,Sunday
2023,8,20,1600,680,1827,2507,Sunday
2023,8,20,1500,842,1621,2463,Sunday
2023,8,20,1400,947,1405,2352,Sunday
2023,8,20,1300,1112,1161,2273,Sunday
2023,8,20,1200,1193,914,2107,Sunday
2023,8,20,1100,1100,559,1659,Sunday
2023,8,20,1000,1027,335,1362,Sunday
2023,8,20,900,836,179,1015,Sunday
2023,8,20,800,511,66,577,Sunday
2023,8,20,700,370,46,416,Sunday
2023,8,20,600,209,31,240,Sunday
2023,8,20,500,62,27,89,Sunday
2023,8,20,400,43,26,69,Sunday
2023,8,20,300,26,77,103,Sunday
2023,8,20,200,25,82,107,Sunday
2023,8,20,100,26,109,135,Sunday
2023,8,19,2400,52,170,222,Saturday
2023,8,19,2300,94,377,471,Saturday
2023,8,19,2200,157,580,737,Saturday
2023,8,19,2100,208,988,1196,Saturday
2023,8,19,2000,274,1383,1657,Saturday
2023,8,19,1900,287,1495,1782,Saturday
2023,8,19,1800,433,1611,2044,Saturday
2023,8,19,1700,555,1554,2109,Saturday
2023,8,19,1600,704,1451,2155,Saturday
2023,8,19,1500,870,1142,2012,Saturday
2023,8,19,1400,922,928,1850,Saturday
2023,8,19,1300,1133,915,2048,Saturday
2023,8,19,1200,1224,755,1979,Saturday
2023,8,19,1100,1229,543,1772,Saturday
2023,8,19,1000,1241,362,1603,Saturday
2023,8,19,900,905,269,1174,Saturday
2023,8,19,800,667,111,778,Saturday
2023,8,19,700,373,82,455,Saturday
2023,8,19,600,213,59,272,Saturday
2023,8,19,500,57,97,154,Saturday
2023,8,19,400,48,81,129,Saturday
2023,8,19,300,42,95,137,Saturday
2023,8,19,200,27,117,144,Saturday
2023,8,19,100,42,241,283,Saturday
2023,8,18,2400,77,208,285,Friday
2023,8,18,2300,159,474,633,Friday
2023,8,18,2200,209,558,767,Friday
2023,8,18,2100,312,764,1076,Friday
2023,8,18,2000,594,1091,1685,Friday
2023,8,18,1900,714,1072,1786,Friday
2023,8,18,1800,805,1315,2120,Friday
2023,8,18,1700,842,1426,2268,Friday
2023,8,18,1600,938,1312,2250,Friday
2023,8,18,1500,1077,1286,2363,Friday
2023,8,18,1400,1016,1033,2049,Friday
2023,8,18,1300,1097,1060,2157,Friday
2023,8,18,1200,1286,836,2122,Friday
2023,8,18,1100,1286,602,1888,Friday
2023,8,18,1000,1126,405,1531,Friday
2023,8,18,900,823,314,1137,Friday
2023,8,18,800,596,103,699,Friday
2023,8,18,700,379,70,449,Friday
2023,8,18,600,193,57,250,Friday
2023,8,18,500,50,37,87,Friday
2023,8,18,400,45,42,87,Friday
2023,8,18,300,35,49,84,Friday
2023,8,18,200,29,56,85,Friday
2023,8,18,100,52,37,89,Friday
2023,8,17,2400,71,114,185,Thursday
2023,8,17,2300,125,349,474,Thursday
2023,8,17,2200,165,500,665,Thursday
2023,8,17,2100,323,843,1166,Thursday
2023,8,17,2000,493,974,1467,Thursday
2023,8,17,1900,559,1217,1776,Thursday
2023,8,17,1800,595,1432,2027,Thursday
2023,8,17,1700,689,1433,2122,Thursday
2023,8,17,1600,812,1394,2206,Thursday
2023,8,17,1500,961,1047,2008,Thursday
2023,8,17,1400,1004,879,1883,Thursday
2023,8,17,1300,1034,797,1831,Thursday
2023,8,17,1200,1245,628,1873,Thursday
2023,8,17,1100,1216,460,1676,Thursday
2023,8,17,1000,1178,351,1529,Thursday
2023,8,17,900,965,284,1249,Thursday
2023,8,17,800,688,93,781,Thursday
2023,8,17,700,423,63,486,Thursday
2023,8,17,600,249,45,294,Thursday
2023,8,17,500,70,41,111,Thursday
2023,8,17,400,40,54,94,Thursday
2023,8,17,300,35,28,63,Thursday
2023,8,17,200,35,50,85,Thursday
2023,8,17,100,42,49,91,Thursday
2023,8,16,2400,71,221,292,Wednesday
2023,8,16,2300,108,403,511,Wednesday
2023,8,16,2200,158,481,639,Wednesday
2023,8,16,2100,224,680,904,Wednesday
2023,8,16,2000,412,923,1335,Wednesday
2023,8,16,1900,445,1113,1558,Wednesday
2023,8,16,1800,505,1278,1783,Wednesday
2023,8,16,1700,595,1247,1842,Wednesday
2023,8,16,1600,833,1009,1842,Wednesday
2023,8,16,1500,858,857,1715,Wednesday
2023,8,16,1400,870,769,1639,Wednesday
2023,8,16,1300,830,756,1586,Wednesday
2023,8,16,1200,1048,575,1623,Wednesday
2023,8,16,1100,1017,440,1457,Wednesday
2023,8,16,1000,1070,368,1438,Wednesday
2023,8,16,900,873,316,1189,Wednesday
2023,8,16,800,668,90,758,Wednesday
2023,8,16,700,434,74,508,Wednesday
2023,8,16,600,277,40,317,Wednesday
2023,8,16,500,81,43,124,Wednesday
2023,8,16,400,30,23,53,Wednesday
2023,8,16,300,31,31,62,Wednesday
2023,8,16,200,34,37,71,Wednesday
2023,8,16,100,38,37,75,Wednesday
2023,8,15,2400,61,113,174,Tuesday
2023,8,15,2300,128,253,381,Tuesday
2023,8,15,2200,135,412,547,Tuesday
2023,8,15,2100,224,704,928,Tuesday
2023,8,15,2000,320,1155,1475,Tuesday
2023,8,15,1900,354,1198,1552,Tuesday
2023,8,15,1800,498,1303,1801,Tuesday
2023,8,15,1700,526,1259,1785,Tuesday
2023,8,15,1600,617,1072,1689,Tuesday
2023,8,15,1500,721,864,1585,Tuesday
2023,8,15,1400,808,812,1620,Tuesday
2023,8,15,1300,1001,670,1671,Tuesday
2023,8,15,1200,1046,530,1576,Tuesday
2023,8,15,1100,1230,429,1659,Tuesday
2023,8,15,1000,1065,303,1368,Tuesday
2023,8,15,900,812,295,1107,Tuesday
2023,8,15,800,659,106,765,Tuesday
2023,8,15,700,394,61,455,Tuesday
2023,8,15,600,238,42,280,Tuesday
2023,8,15,500,71,32,103,Tuesday
2023,8,15,400,36,49,85,Tuesday
2023,8,15,300,29,37,66,Tuesday
2023,8,15,200,21,61,82,Tuesday
2023,8,15,100,53,42,95,Tuesday
2023,8,14,2400,68,172,240,Monday
2023,8,14,2300,121,248,369,Monday
2023,8,14,2200,135,487,622,Monday
2023,8,14,2100,231,837,1068,Monday
2023,8,14,2000,361,1053,1414,Monday
2023,8,14,1900,391,1331,1722,Monday
2023,8,14,1800,482,1460,1942,Monday
2023,8,14,1700,613,1528,2141,Monday
2023,8,14,1600,800,1314,2114,Monday
2023,8,14,1500,868,1057,1925,Monday
2023,8,14,1400,1015,888,1903,Monday
2023,8,14,1300,1110,813,1923,Monday
2023,8,14,1200,1434,595,2029,Monday
2023,8,14,1100,1234,481,1715,Monday
2023,8,14,1000,1144,302,1446,Monday
2023,8,14,900,902,261,1163,Monday
2023,8,14,800,689,107,796,Monday
2023,8,14,700,412,63,475,Monday
2023,8,14,600,204,30,234,Monday
2023,8,14,500,78,22,100,Monday
2023,8,14,400,41,28,69,Monday
2023,8,14,300,24,45,69,Monday
2023,8,14,200,18,44,62,Monday
2023,8,14,100,43,48,91,Monday
2023,8,13,2400,46,130,176,Sunday
2023,8,13,2300,85,432,517,Sunday
2023,8,13,2200,146,660,806,Sunday
2023,8,13,2100,206,1223,1429,Sunday
2023,8,13,2000,316,1559,1875,Sunday
2023,8,13,1900,412,1982,2394,Sunday
2023,8,13,1800,500,2073,2573,Sunday
2023,8,13,1700,636,2171,2807,Sunday
2023,8,13,1600,819,1835,2654,Sunday
2023,8,13,1500,1024,1617,2641,Sunday
2023,8,13,1400,1262,1347,2609,Sunday
2023,8,13,1300,1320,1308,2628,Sunday
2023,8,13,1200,1434,933,2367,Sunday
2023,8,13,1100,1420,526,1946,Sunday
2023,8,13,1000,1218,367,1585,Sunday
2023,8,13,900,964,197,1161,Sunday
2023,8,13,800,633,82,715,Sunday
2023,8,13,700,418,36,454,Sunday
2023,8,13,600,234,31,265,Sunday
2023,8,13,500,88,24,112,Sunday
2023,8,13,400,37,37,74,Sunday
2023,8,13,300,25,51,76,Sunday
2023,8,13,200,31,51,82,Sunday
2023,8,13,100,45,112,157,Sunday
2023,8,12,2400,60,161,221,Saturday
2023,8,12,2300,105,324,429,Saturday
2023,8,12,2200,129,586,715,Saturday
2023,8,12,2100,190,933,1123,Saturday
2023,8,12,2000,278,1191,1469,Saturday
2023,8,12,1900,375,1457,1832,Saturday
2023,8,12,1800,519,1597,2116,Saturday
2023,8,12,1700,619,1439,2058,Saturday
2023,8,12,1600,754,1381,2135,Saturday
2023,8,12,1500,926,1182,2108,Saturday
2023,8,12,1400,1116,977,2093,Saturday
2023,8,12,1300,1231,821,2052,Saturday
2023,8,12,1200,1457,691,2148,Saturday
2023,8,12,1100,1489,475,1964,Saturday
2023,8,12,1000,1311,311,1622,Saturday
2023,8,12,900,1063,236,1299,Saturday
2023,8,12,800,789,92,881,Saturday
2023,8,12,700,439,61,500,Saturday
2023,8,12,600,233,39,272,Saturday
2023,8,12,500,77,39,116,Saturday
2023,8,12,400,28,77,105,Saturday
2023,8,12,300,25,38,63,Saturday
2023,8,12,200,37,52,89,Saturday
2023,8,12,100,43,113,156,Saturday
2023,8,11,2400,75,94,169,Friday
2023,8,11,2300,130,259,389,Friday
2023,8,11,2200,252,450,702,Friday
2023,8,11,2100,398,693,1091,Friday
2023,8,11,2000,637,1021,1658,Friday
2023,8,11,1900,788,1374,2162,Friday
2023,8,11,1800,872,1464,2336,Friday
2023,8,11,1700,919,1437,2356,Friday
2023,8,11,1600,1031,1369,2400,Friday
2023,8,11,1500,1097,1110,2207,Friday
2023,8,11,1400,1199,969,2168,Friday
2023,8,11,1300,1251,901,2152,Friday
2023,8,11,1200,1467,669,2136,Friday
2023,8,11,1100,1471,516,1987,Friday
2023,8,11,1000,1339,372,1711,Friday
2023,8,11,900,999,307,1306,Friday
2023,8,11,800,725,105,830,Friday
2023,8,11,700,461,56,517,Friday
2023,8,11,600,262,38,300,Friday
2023,8,11,500,85,32,117,Friday
2023,8,11,400,50,54,104,Friday
2023,8,11,300,27,43,70,Friday
2023,8,11,200,31,59,90,Friday
2023,8,11,100,37,36,73,Friday
2023,8,10,2400,65,95,160,Thursday
2023,8,10,2300,121,309,430,Thursday
2023,8,10,2200,185,457,642,Thursday
2023,8,10,2100,300,731,1031,Thursday
2023,8,10,2000,509,979,1488,Thursday
2023,8,10,1900,576,1168,1744,Thursday
2023,8,10,1800,604,1257,1861,Thursday
2023,8,10,1700,684,1306,1990,Thursday
2023,8,10,1600,823,1125,1948,Thursday
2023,8,10,1500,927,1037,1964,Thursday
2023,8,10,1400,974,868,1842,Thursday
2023,8,10,1300,1072,672,1744,Thursday
2023,8,10,1200,1362,564,1926,Thursday
2023,8,10,1100,1320,414,1734,Thursday
2023,8,10,1000,1161,322,1483,Thursday
2023,8,10,900,904,280,1184,Thursday
2023,8,10,800,628,82,710,Thursday
2023,8,10,700,430,60,490,Thursday
2023,8,10,600,210,35,245,Thursday
2023,8,10,500,66,31,97,Thursday
2023,8,10,400,28,32,60,Thursday
2023,8,10,300,32,44,76,Thursday
2023,8,10,200,23,51,74,Thursday
2023,8,10,100,29,42,71,Thursday
2023,8,9,2400,63,104,167,Wednesday
2023,8,9,2300,111,276,387,Wednesday
2023,8,9,2200,129,430,559,Wednesday
2023,8,9,2100,255,612,867,Wednesday
2023,8,9,2000,342,837,1179,Wednesday
2023,8,9,1900,382,1120,1502,Wednesday
2023,8,9,1800,463,1152,1615,Wednesday
2023,8,9,1700,552,1204,1756,Wednesday
2023,8,9,1600,671,1103,1774,Wednesday
2023,8,9,1500,724,965,1689,Wednesday
2023,8,9,1400,894,835,1729,Wednesday
2023,8,9,1300,900,817,1717,Wednesday
2023,8,9,1200,1158,717,1875,Wednesday
2023,8,9,1100,1222,505,1727,Wednesday
2023,8,9,1000,1029,349,1378,Wednesday
2023,8,9,900,791,328,1119,Wednesday
2023,8,9,800,581,105,686,Wednesday
2023,8,9,700,391,63,454,Wednesday
2023,8,9,600,209,34,243,Wednesday
2023,8,9,500,50,29,79,Wednesday
2023,8,9,400,17,45,62,Wednesday
2023,8,9,300,24,46,70,Wednesday
2023,8,9,200,34,46,80,Wednesday
2023,8,9,100,49,43,92,Wednesday
2023,8,8,2400,49,109,158,Tuesday
2023,8,8,2300,101,317,418,Tuesday
2023,8,8,2200,125,428,553,Tuesday
2023,8,8,2100,205,698,903,Tuesday
2023,8,8,2000,329,963,1292,Tuesday
2023,8,8,1900,381,1338,1719,Tuesday
2023,8,8,1800,411,1436,1847,Tuesday
2023,8,8,1700,542,1601,2143,Tuesday
2023,8,8,1600,763,1558,2321,Tuesday
2023,8,8,1500,836,1304,2140,Tuesday
2023,8,8,1400,956,1107,2063,Tuesday
2023,8,8,1300,1198,909,2107,Tuesday
2023,8,8,1200,1285,707,1992,Tuesday
2023,8,8,1100,1304,545,1849,Tuesday
2023,8,8,1000,1130,351,1481,Tuesday
2023,8,8,900,895,228,1123,Tuesday
2023,8,8,800,675,157,832,Tuesday
2023,8,8,700,428,101,529,Tuesday
2023,8,8,600,217,41,258,Tuesday
2023,8,8,500,71,27,98,Tuesday
2023,8,8,400,39,23,62,Tuesday
2023,8,8,300,13,51,64,Tuesday
2023,8,8,200,24,60,84,Tuesday
2023,8,8,100,31,105,136,Tuesday
2023,8,7,2400,57,245,302,Monday
2023,8,7,2300,74,402,476,Monday
2023,8,7,2200,143,853,996,Monday
2023,8,7,2100,211,1292,1503,Monday
2023,8,7,2000,318,1843,2161,Monday
2023,8,7,1900,395,2218,2613,Monday
2023,8,7,1800,481,2214,2695,Monday
2023,8,7,1700,711,2153,2864,Monday
2023,8,7,1600,918,2182,3100,Monday
2023,8,7,1500,1067,2081,3148,Monday
2023,8,7,1400,1239,1841,3080,Monday
2023,8,7,1300,1452,1649,3101,Monday
2023,8,7,1200,1546,1282,2828,Monday
2023,8,7,1100,1598,824,2422,Monday
2023,8,7,1000,1387,459,1846,Monday
2023,8,7,900,1094,287,1381,Monday
2023,8,7,800,729,116,845,Monday
2023,8,7,700,491,58,549,Monday
2023,8,7,600,262,34,296,Monday
2023,8,7,500,61,36,97,Monday
2023,8,7,400,55,24,79,Monday
2023,8,7,300,36,42,78,Monday
2023,8,7,200,38,64,102,Monday
2023,8,7,100,42,115,157,Monday
2023,8,6,2400,60,223,283,Sunday
2023,8,6,2300,108,502,610,Sunday
2023,8,6,2200,157,724,881,Sunday
2023,8,6,2100,210,1049,1259,Sunday
2023,8,6,2000,286,1566,1852,Sunday
2023,8,6,1900,383,1887,2270,Sunday
2023,8,6,1800,529,1961,2490,Sunday
2023,8,6,1700,721,1840,2561,Sunday
2023,8,6,1600,1117,1796,2913,Sunday
2023,8,6,1500,1066,1494,2560,Sunday
2023,8,6,1400,1179,1240,2419,Sunday
2023,8,6,1300,1301,1060,2361,Sunday
2023,8,6,1200,1504,888,2392,Sunday
2023,8,6,1100,1496,550,2046,Sunday
2023,8,6,1000,1341,367,1708,Sunday
2023,8,6,900,1099,206,1305,Sunday
2023,8,6,800,742,145,887,Sunday
2023,8,6,700,498,77,575,Sunday
2023,8,6,600,235,41,276,Sunday
2023,8,6,500,101,42,143,Sunday
2023,8,6,400,29,43,72,Sunday
2023,8,6,300,33,124,157,Sunday
2023,8,6,200,32,536,568,Sunday
2023,8,6,100,49,354,403,Sunday
2023,8,5,2400,74,424,498,Saturday
2023,8,5,2300,127,256,383,Saturday
2023,8,5,2200,184,422,606,Saturday
2023,8,5,2100,234,719,953,Saturday
2023,8,5,2000,281,884,1165,Saturday
2023,8,5,1900,408,1081,1489,Saturday
2023,8,5,1800,558,1308,1866,Saturday
2023,8,5,1700,744,1438,2182,Saturday
2023,8,5,1600,901,1423,2324,Saturday
2023,8,5,1500,1125,1140,2265,Saturday
2023,8,5,1400,1536,980,2516,Saturday
2023,8,5,1300,1493,767,2260,Saturday
2023,8,5,1200,1738,640,2378,Saturday
2023,8,5,1100,1823,495,2318,Saturday
2023,8,5,1000,1661,311,1972,Saturday
2023,8,5,900,1361,248,1609,Saturday
2023,8,5,800,1010,136,1146,Saturday
2023,8,5,700,606,68,674,Saturday
2023,8,5,600,325,44,369,Saturday
2023,8,5,500,95,35,130,Saturday
2023,8,5,400,67,51,118,Saturday
2023,8,5,300,44,82,126,Saturday
2023,8,5,200,50,97,147,Saturday
2023,8,5,100,66,120,186,Saturday
2023,8,4,2400,116,168,284,Friday
2023,8,4,2300,196,309,505,Friday
2023,8,4,2200,331,538,869,Friday
2023,8,4,2100,533,838,1371,Friday
2023,8,4,2000,919,996,1915,Friday
2023,8,4,1900,1089,1214,2303,Friday
2023,8,4,1800,1289,1376,2665,Friday
2023,8,4,1700,1371,1391,2762,Friday
2023,8,4,1600,1290,1332,2622,Friday
2023,8,4,1500,1466,1217,2683,Friday
2023,8,4,1400,1537,1024,2561,Friday
2023,8,4,1300,1550,930,2480,Friday
2023,8,4,1200,1708,766,2474,Friday
2023,8,4,1100,1808,553,2361,Friday
2023,8,4,1000,1615,387,2002,Friday
2023,8,4,900,1299,339,1638,Friday
2023,8,4,800,966,119,1085,Friday
2023,8,4,700,594,82,676,Friday
2023,8,4,600,283,37,320,Friday
2023,8,4,500,91,52,143,Friday
2023,8,4,400,42,49,91,Friday
2023,8,4,300,38,51,89,Friday
2023,8,4,200,47,73,120,Friday
2023,8,4,100,55,67,122,Friday
2023,8,3,2400,89,140,229,Thursday
2023,8,3,2300,176,304,480,Thursday
2023,8,3,2200,263,465,728,Thursday
2023,8,3,2100,487,773,1260,Thursday
2023,8,3,2000,775,980,1755,Thursday
2023,8,3,1900,886,1259,2145,Thursday
2023,8,3,1800,906,1382,2288,Thursday
2023,8,3,1700,866,1393,2259,Thursday
2023,8,3,1600,1031,1210,2241,Thursday
2023,8,3,1500,1110,998,2108,Thursday
2023,8,3,1400,1077,911,1988,Thursday
2023,8,3,1300,1333,810,2143,Thursday
2023,8,3,1200,1341,596,1937,Thursday
2023,8,3,1100,1408,443,1851,Thursday
2023,8,3,1000,1214,384,1598,Thursday
2023,8,3,900,1061,237,1298,Thursday
2023,8,3,800,754,112,866,Thursday
2023,8,3,700,464,74,538,Thursday
2023,8,3,600,253,36,289,Thursday
2023,8,3,500,98,46,144,Thursday
2023,8,3,400,44,41,85,Thursday
2023,8,3,300,32,34,66,Thursday
2023,8,3,200,35,42,77,Thursday
2023,8,3,100,45,49,94,Thursday
2023,8,2,2400,71,117,188,Wednesday
2023,8,2,2300,125,306,431,Wednesday
2023,8,2,2200,171,467,638,Wednesday
2023,8,2,2100,280,730,1010,Wednesday
2023,8,2,2000,450,969,1419,Wednesday
2023,8,2,1900,520,1175,1695,Wednesday
2023,8,2,1800,540,1183,1723,Wednesday
2023,8,2,1700,579,1141,1720,Wednesday
2023,8,2,1600,730,1091,1821,Wednesday
2023,8,2,1500,762,887,1649,Wednesday
2023,8,2,1400,886,832,1718,Wednesday
2023,8,2,1300,1019,662,1681,Wednesday
2023,8,2,1200,1291,535,1826,Wednesday
2023,8,2,1100,1230,376,1606,Wednesday
2023,8,2,1000,1112,345,1457,Wednesday
2023,8,2,900,898,302,1200,Wednesday
2023,8,2,800,620,105,725,Wednesday
2023,8,2,700,414,68,482,Wednesday
2023,8,2,600,213,30,243,Wednesday
2023,8,2,500,70,43,113,Wednesday
2023,8,2,400,34,37,71,Wednesday
2023,8,2,300,27,39,66,Wednesday
2023,8,2,200,30,43,73,Wednesday
2023,8,2,100,29,49,78,Wednesday
2023,8,1,2400,74,126,200,Tuesday
2023,8,1,2300,121,302,423,Tuesday
2023,8,1,2200,140,425,565,Tuesday
2023,8,1,2100,249,684,933,Tuesday
2023,8,1,2000,341,914,1255,Tuesday
2023,8,1,1900,393,1184,1577,Tuesday
2023,8,1,1800,473,1171,1644,Tuesday
2023,8,1,1700,562,1214,1776,Tuesday
2023,8,1,1600,678,1049,1727,Tuesday
2023,8,1,1500,787,901,1688,Tuesday
2023,8,1,1400,844,737,1581,Tuesday
2023,8,1,1300,997,685,1682,Tuesday
2023,8,1,1200,1158,579,1737,Tuesday
2023,8,1,1100,1222,441,1663,Tuesday
2023,8,1,1000,1024,305,1329,Tuesday
2023,8,1,900,856,310,1166,Tuesday
2023,8,1,800,600,92,692,Tuesday
2023,8,1,700,426,51,477,Tuesday
2023,8,1,600,217,36,253,Tuesday
2023,8,1,500,66,41,107,Tuesday
2023,8,1,400,30,47,77,Tuesday
2023,8,1,300,18,52,70,Tuesday
2023,8,1,200,27,69,96,Tuesday
2023,8,1,100,46,29,75,Tuesday
2023,7,31,2400,60,147,207,Monday
2023,7,31,2300,110,317,427,Monday
2023,7,31,2200,155,496,651,Monday
2023,7,31,2100,251,793,1044,Monday
2023,7,31,2000,309,1110,1419,Monday
2023,7,31,1900,438,1310,1748,Monday
2023,7,31,1800,489,1497,1986,Monday
2023,7,31,1700,605,1385,1990,Monday
2023,7,31,1600,734,1220,1954,Monday
2023,7,31,1500,937,1033,1970,Monday
2023,7,31,1400,1073,881,1954,Monday
2023,7,31,1300,1163,771,1934,Monday
2023,7,31,1200,1322,626,1948,Monday
2023,7,31,1100,1221,475,1696,Monday
2023,7,31,1000,1189,303,1492,Monday
2023,7,31,900,909,247,1156,Monday
2023,7,31,800,668,103,771,Monday
2023,7,31,700,407,75,482,Monday
2023,7,31,600,238,33,271,Monday
2023,7,31,500,70,19,89,Monday
2023,7,31,400,42,39,81,Monday
2023,7,31,300,19,38,57,Monday
2023,7,31,200,19,71,90,Monday
2023,7,31,100,21,19,40,Monday
2023,7,30,2400,51,125,176,Sunday
2023,7,30,2300,90,375,465,Sunday
2023,7,30,2200,146,544,690,Sunday
2023,7,30,2100,226,931,1157,Sunday
2023,7,30,2000,332,1284,1616,Sunday
2023,7,30,1900,389,1635,2024,Sunday
2023,7,30,1800,550,2083,2633,Sunday
2023,7,30,1700,678,1909,2587,Sunday
2023,7,30,1600,833,1824,2657,Sunday
2023,7,30,1500,1015,1524,2539,Sunday
2023,7,30,1400,1087,1360,2447,Sunday
2023,7,30,1300,1183,1165,2348,Sunday
2023,7,30,1200,1337,823,2160,Sunday
2023,7,30,1100,1312,532,1844,Sunday
2023,7,30,1000,1169,348,1517,Sunday
2023,7,30,900,916,195,1111,Sunday
2023,7,30,800,619,102,721,Sunday
2023,7,30,700,359,48,407,Sunday
2023,7,30,600,178,31,209,Sunday
2023,7,30,500,56,26,82,Sunday
2023,7,30,400,37,29,66,Sunday
2023,7,30,300,31,36,67,Sunday
2023,7,30,200,31,64,95,Sunday
2023,7,30,100,42,83,125,Sunday
2023,7,29,2400,62,189,251,Saturday
2023,7,29,2300,120,355,475,Saturday
2023,7,29,2200,152,604,756,Saturday
2023,7,29,2100,202,1110,1312,Saturday
2023,7,29,2000,284,1563,1847,Saturday
2023,7,29,1900,362,1390,1752,Saturday
2023,7,29,1800,481,1338,1819,Saturday
2023,7,29,1700,634,1300,1934,Saturday
2023,7,29,1600,801,1348,2149,Saturday
2023,7,29,1500,984,1106,2090,Saturday
2023,7,29,1400,1101,966,2067,Saturday
2023,7,29,1300,1283,736,2019,Saturday
2023,7,29,1200,1519,595,2114,Saturday
2023,7,29,1100,1552,437,1989,Saturday
2023,7,29,1000,1389,345,1734,Saturday
2023,7,29,900,1207,247,1454,Saturday
2023,7,29,800,879,111,990,Saturday
2023,7,29,700,497,64,561,Saturday
2023,7,29,600,250,46,296,Saturday
2023,7,29,500,96,50,146,Saturday
2023,7,29,400,49,49,98,Saturday
2023,7,29,300,22,62,84,Saturday
2023,7,29,200,39,59,98,Saturday
2023,7,29,100,53,99,152,Saturday
2023,7,28,2400,83,155,238,Friday
2023,7,28,2300,141,289,430,Friday
2023,7,28,2200,225,393,618,Friday
2023,7,28,2100,390,618,1008,Friday
2023,7,28,2000,702,871,1573,Friday
2023,7,28,1900,866,1040,1906,Friday
2023,7,28,1800,934,1250,2184,Friday
2023,7,28,1700,863,1254,2117,Friday
2023,7,28,1600,1007,1249,2256,Friday
2023,7,28,1500,1124,1034,2158,Friday
2023,7,28,1400,1132,889,2021,Friday
2023,7,28,1300,1294,853,2147,Friday
2023,7,28,1200,1355,720,2075,Friday
2023,7,28,1100,1425,515,1940,Friday
2023,7,28,1000,1159,328,1487,Friday
2023,7,28,900,962,307,1269,Friday
2023,7,28,800,659,89,748,Friday
2023,7,28,700,409,74,483,Friday
2023,7,28,600,158,38,196,Friday
2023,7,28,500,72,28,100,Friday
2023,7,28,400,49,60,109,Friday
2023,7,28,300,39,33,72,Friday
2023,7,28,200,41,49,90,Friday
2023,7,28,100,46,50,96,Friday
2023,7,27,2400,67,142,209,Thursday
2023,7,27,2300,104,317,421,Thursday
2023,7,27,2200,200,367,567,Thursday
2023,7,27,2100,391,544,935,Thursday
2023,7,27,2000,538,879,1417,Thursday
2023,7,27,1900,572,1082,1654,Thursday
2023,7,27,1800,636,1264,1900,Thursday
2023,7,27,1700,675,1339,2014,Thursday
2023,7,27,1600,809,1167,1976,Thursday
2023,7,27,1500,900,1002,1902,Thursday
2023,7,27,1400,972,839,1811,Thursday
2023,7,27,1300,1005,791,1796,Thursday
2023,7,27,1200,1275,559,1834,Thursday
2023,7,27,1100,1260,474,1734,Thursday
2023,7,27,1000,1131,284,1415,Thursday
2023,7,27,900,872,260,1132,Thursday
2023,7,27,800,661,96,757,Thursday
2023,7,27,700,451,58,509,Thursday
2023,7,27,600,223,35,258,Thursday
2023,7,27,500,81,29,110,Thursday
2023,7,27,400,43,26,69,Thursday
2023,7,27,300,29,34,63,Thursday
2023,7,27,200,34,44,78,Thursday
2023,7,27,100,49,33,82,Thursday
2023,7,26,2400,71,110,181,Wednesday
2023,7,26,2300,106,357,463,Wednesday
2023,7,26,2200,163,498,661,Wednesday
2023,7,26,2100,263,662,925,Wednesday
2023,7,26,2000,364,977,1341,Wednesday
2023,7,26,1900,446,1114,1560,Wednesday
2023,7,26,1800,502,1284,1786,Wednesday
2023,7,26,1700,559,1115,1674,Wednesday
2023,7,26,1600,675,1043,1718,Wednesday
2023,7,26,1500,803,943,1746,Wednesday
2023,7,26,1400,901,815,1716,Wednesday
2023,7,26,1300,992,743,1735,Wednesday
2023,7,26,1200,1229,608,1837,Wednesday
2023,7,26,1100,1165,414,1579,Wednesday
2023,7,26,1000,1119,339,1458,Wednesday
2023,7,26,900,866,287,1153,Wednesday
2023,7,26,800,676,116,792,Wednesday
2023,7,26,700,441,76,517,Wednesday
2023,7,26,600,234,39,273,Wednesday
2023,7,26,500,81,33,114,Wednesday
2023,7,26,400,38,42,80,Wednesday
2023,7,26,300,15,40,55,Wednesday
2023,7,26,200,31,51,82,Wednesday
2023,7,26,100,43,38,81,Wednesday
2023,7,25,2400,57,120,177,Tuesday
2023,7,25,2300,84,296,380,Tuesday
2023,7,25,2200,129,499,628,Tuesday
2023,7,25,2100,248,655,903,Tuesday
2023,7,25,2000,332,811,1143,Tuesday
2023,7,25,1900,387,1066,1453,Tuesday
2023,7,25,1800,456,1316,1772,Tuesday
2023,7,25,1700,534,1291,1825,Tuesday
2023,7,25,1600,665,1221,1886,Tuesday
2023,7,25,1500,730,1008,1738,Tuesday
2023,7,25,1400,791,870,1661,Tuesday
2023,7,25,1300,988,744,1732,Tuesday
2023,7,25,1200,1191,616,1807,Tuesday
2023,7,25,1100,1144,467,1611,Tuesday
2023,7,25,1000,1087,311,1398,Tuesday
2023,7,25,900,882,288,1170,Tuesday
2023,7,25,800,633,95,728,Tuesday
2023,7,25,700,427,65,492,Tuesday
2023,7,25,600,198,57,255,Tuesday
2023,7,25,500,78,30,108,Tuesday
2023,7,25,400,29,57,86,Tuesday
2023,7,25,300,31,66,97,Tuesday
2023,7,25,200,42,91,133,Tuesday
2023,7,25,100,37,65,102,Tuesday
2023,7,24,2400,59,152,211,Monday
2023,7,24,2300,101,319,420,Monday
2023,7,24,2200,146,572,718,Monday
2023,7,24,2100,226,770,996,Monday
2023,7,24,2000,315,1063,1378,Monday
2023,7,24,1900,392,1283,1675,Monday
2023,7,24,1800,517,1511,2028,Monday
2023,7,24,1700,605,1323,1928,Monday
2023,7,24,1600,746,1300,2046,Monday
2023,7,24,1500,903,1047,1950,Monday
2023,7,24,1400,1002,909,1911,Monday
2023,7,24,1300,1175,848,2023,Monday
2023,7,24,1200,1392,605,1997,Monday
2023,7,24,1100,1296,444,1740,Monday
2023,7,24,1000,1127,348,1475,Monday
2023,7,24,900,956,269,1225,Monday
2023,7,24,800,703,120,823,Monday
2023,7,24,700,423,67,490,Monday
2023,7,24,600,217,33,250,Monday
2023,7,24,500,82,22,104,Monday
2023,7,24,400,33,30,63,Monday
2023,7,24,300,20,35,55,Monday
2023,7,24,200,34,77,111,Monday
2023,7,24,100,35,56,91,Monday
2023,7,23,2400,48,162,210,Sunday
2023,7,23,2300,98,412,510,Sunday
2023,7,23,2200,138,663,801,Sunday
2023,7,23,2100,200,1112,1312,Sunday
2023,7,23,2000,307,1481,1788,Sunday
2023,7,23,1900,458,1758,2216,Sunday
2023,7,23,1800,505,1986,2491,Sunday
2023,7,23,1700,687,1976,2663,Sunday
2023,7,23,1600,851,1725,2576,Sunday
2023,7,23,1500,1023,1610,2633,Sunday
2023,7,23,1400,1103,1396,2499,Sunday
2023,7,23,1300,1230,1189,2419,Sunday
2023,7,23,1200,1355,952,2307,Sunday
2023,7,23,1100,1432,579,2011,Sunday
2023,7,23,1000,1123,312,1435,Sunday
2023,7,23,900,1022,186,1208,Sunday
2023,7,23,800,666,104,770,Sunday
2023,7,23,700,425,50,475,Sunday
2023,7,23,600,199,28,227,Sunday
2023,7,23,500,74,20,94,Sunday
2023,7,23,400,41,33,74,Sunday
2023,7,23,300,29,53,82,Sunday
2023,7,23,200,36,104,140,Sunday
2023,7,23,100,32,68,100,Sunday
2023,7,22,2400,74,163,237,Saturday
2023,7,22,2300,99,299,398,Saturday
2023,7,22,2200,138,555,693,Saturday
2023,7,22,2100,202,903,1105,Saturday
2023,7,22,2000,299,1215,1514,Saturday
2023,7,22,1900,366,1735,2101,Saturday
2023,7,22,1800,452,1367,1819,Saturday
2023,7,22,1700,395,1216,1611,Saturday
2023,7,22,1600,538,1160,1698,Saturday
2023,7,22,1500,690,867,1557,Saturday
2023,7,22,1400,787,938,1725,Saturday
2023,7,22,1300,886,849,1735,Saturday
2023,7,22,1200,1103,716,1819,Saturday
2023,7,22,1100,1178,475,1653,Saturday
2023,7,22,1000,1248,310,1558,Saturday
2023,7,22,900,1341,246,1587,Saturday
2023,7,22,800,839,99,938,Saturday
2023,7,22,700,489,74,563,Saturday
2023,7,22,600,267,32,299,Saturday
2023,7,22,500,90,48,138,Saturday
2023,7,22,400,62,39,101,Saturday
2023,7,22,300,38,50,88,Saturday
2023,7,22,200,29,51,80,Saturday
2023,7,22,100,47,123,170,Saturday
2023,7,21,2400,85,121,206,Friday
2023,7,21,2300,155,275,430,Friday
2023,7,21,2200,216,463,679,Friday
2023,7,21,2100,400,721,1121,Friday
2023,7,21,2000,714,922,1636,Friday
2023,7,21,1900,845,1467,2312,Friday
2023,7,21,1800,958,1280,2238,Friday
2023,7,21,1700,991,1073,2064,Friday
2023,7,21,1600,1159,1134,2293,Friday
2023,7,21,1500,1179,1018,2197,Friday
2023,7,21,1400,1211,946,2157,Friday
2023,7,21,1300,1302,859,2161,Friday
2023,7,21,1200,1449,687,2136,Friday
2023,7,21,1100,1508,477,1985,Friday
2023,7,21,1000,1307,342,1649,Friday
2023,7,21,900,1018,311,1329,Friday
2023,7,21,800,742,111,853,Friday
2023,7,21,700,516,44,560,Friday
2023,7,21,600,239,47,286,Friday
2023,7,21,500,97,30,127,Friday
2023,7,21,400,58,35,93,Friday
2023,7,21,300,42,49,91,Friday
2023,7,21,200,45,49,94,Friday
2023,7,21,100,52,55,107,Friday
2023,7,20,2400,62,118,180,Thursday
2023,7,20,2300,141,359,500,Thursday
2023,7,20,2200,202,446,648,Thursday
2023,7,20,2100,375,635,1010,Thursday
2023,7,20,2000,559,895,1454,Thursday
2023,7,20,1900,619,1182,1801,Thursday
2023,7,20,1800,713,1248,1961,Thursday
2023,7,20,1700,686,1030,1716,Thursday
2023,7,20,1600,678,939,1617,Thursday
2023,7,20,1500,742,1019,1761,Thursday
2023,7,20,1400,871,851,1722,Thursday
2023,7,20,1300,848,751,1599,Thursday
2023,7,20,1200,909,529,1438,Thursday
2023,7,20,1100,1327,405,1732,Thursday
2023,7,20,1000,1189,338,1527,Thursday
2023,7,20,900,962,258,1220,Thursday
2023,7,20,800,713,105,818,Thursday
2023,7,20,700,441,58,499,Thursday
2023,7,20,600,245,29,274,Thursday
2023,7,20,500,89,25,114,Thursday
2023,7,20,400,54,37,91,Thursday
2023,7,20,300,31,31,62,Thursday
2023,7,20,200,32,44,76,Thursday
2023,7,20,100,43,68,111,Thursday
2023,7,19,2400,66,135,201,Wednesday
2023,7,19,2300,111,321,432,Wednesday
2023,7,19,2200,162,486,648,Wednesday
2023,7,19,2100,266,706,972,Wednesday
2023,7,19,2000,381,1048,1429,Wednesday
2023,7,19,1900,421,945,1366,Wednesday
2023,7,19,1800,512,1064,1576,Wednesday
2023,7,19,1700,553,1100,1653,Wednesday
2023,7,19,1600,702,962,1664,Wednesday
2023,7,19,1500,825,886,1711,Wednesday
2023,7,19,1400,880,709,1589,Wednesday
2023,7,19,1300,1080,633,1713,Wednesday
2023,7,19,1200,1188,556,1744,Wednesday
2023,7,19,1100,1262,407,1669,Wednesday
2023,7,19,1000,1106,296,1402,Wednesday
2023,7,19,900,872,323,1195,Wednesday
2023,7,19,800,660,112,772,Wednesday
2023,7,19,700,413,45,458,Wednesday
2023,7,19,600,206,40,246,Wednesday
2023,7,19,500,95,28,123,Wednesday
2023,7,19,400,42,35,77,Wednesday
2023,7,19,300,28,41,69,Wednesday
2023,7,19,200,35,38,73,Wednesday
2023,7,19,100,37,54,91,Wednesday
2023,7,18,2400,58,106,164,Tuesday
2023,7,18,2300,118,275,393,Tuesday
2023,7,18,2200,171,491,662,Tuesday
2023,7,18,2100,232,897,1129,Tuesday
2023,7,18,2000,311,1144,1455,Tuesday
2023,7,18,1900,399,1046,1445,Tuesday
2023,7,18,1800,448,1071,1519,Tuesday
2023,7,18,1700,524,950,1474,Tuesday
2023,7,18,1600,629,902,1531,Tuesday
2023,7,18,1500,769,919,1688,Tuesday
2023,7,18,1400,895,707,1602,Tuesday
2023,7,18,1300,1038,592,1630,Tuesday
2023,7,18,1200,1205,539,1744,Tuesday
2023,7,18,1100,1270,406,1676,Tuesday
2023,7,18,1000,1202,318,1520,Tuesday
2023,7,18,900,874,277,1151,Tuesday
2023,7,18,800,634,118,752,Tuesday
2023,7,18,700,430,67,497,Tuesday
2023,7,18,600,229,38,267,Tuesday
2023,7,18,500,60,32,92,Tuesday
2023,7,18,400,43,36,79,Tuesday
2023,7,18,300,26,47,73,Tuesday
2023,7,18,200,30,54,84,Tuesday
2023,7,18,100,41,32,73,Tuesday
2023,7,17,2400,62,112,174,Monday
2023,7,17,2300,108,274,382,Monday
2023,7,17,2200,149,363,512,Monday
2023,7,17,2100,252,533,785,Monday
2023,7,17,2000,310,895,1205,Monday
2023,7,17,1900,437,1261,1698,Monday
2023,7,17,1800,523,1219,1742,Monday
2023,7,17,1700,570,1164,1734,Monday
2023,7,17,1600,870,1142,2012,Monday
2023,7,17,1500,957,1189,2146,Monday
2023,7,17,1400,1121,1150,2271,Monday
2023,7,17,1300,1336,926,2262,Monday
2023,7,17,1200,1371,614,1985,Monday
2023,7,17,1100,1349,448,1797,Monday
2023,7,17,1000,1212,314,1526,Monday
2023,7,17,900,981,242,1223,Monday
2023,7,17,800,719,104,823,Monday
2023,7,17,700,408,75,483,Monday
2023,7,17,600,185,27,212,Monday
2023,7,17,500,67,25,92,Monday
2023,7,17,400,31,14,45,Monday
2023,7,17,300,37,29,66,Monday
2023,7,17,200,29,59,88,Monday
2023,7,17,100,36,47,83,Monday
2023,7,16,2400,54,138,192,Sunday
2023,7,16,2300,116,343,459,Sunday
2023,7,16,2200,185,584,769,Sunday
2023,7,16,2100,274,1040,1314,Sunday
2023,7,16,2000,361,1413,1774,Sunday
2023,7,16,1900,469,1569,2038,Sunday
2023,7,16,1800,550,1735,2285,Sunday
2023,7,16,1700,726,1658,2384,Sunday
2023,7,16,1600,874,1565,2439,Sunday
2023,7,16,1500,1057,1439,2496,Sunday
2023,7,16,1400,1213,1203,2416,Sunday
2023,7,16,1300,1296,1072,2368,Sunday
2023,7,16,1200,1426,775,2201,Sunday
2023,7,16,1100,1311,539,1850,Sunday
2023,7,16,1000,1297,311,1608,Sunday
2023,7,16,900,1005,175,1180,Sunday
2023,7,16,800,651,94,745,Sunday
2023,7,16,700,394,47,441,Sunday
2023,7,16,600,187,21,208,Sunday
2023,7,16,500,75,18,93,Sunday
2023,7,16,400,42,14,56,Sunday
2023,7,16,300,36,31,67,Sunday
2023,7,16,200,33,53,86,Sunday
2023,7,16,100,46,94,140,Sunday
2023,7,15,2400,56,145,201,Saturday
2023,7,15,2300,100,273,373,Saturday
2023,7,15,2200,157,514,671,Saturday
2023,7,15,2100,198,705,903,Saturday
2023,7,15,2000,305,941,1246,Saturday
2023,7,15,1900,365,1273,1638,Saturday
2023,7,15,1800,425,1206,1631,Saturday
2023,7,15,1700,516,1309,1825,Saturday
2023,7,15,1600,679,1062,1741,Saturday
2023,7,15,1500,803,1110,1913,Saturday
2023,7,15,1400,772,819,1591,Saturday
2023,7,15,1300,1071,816,1887,Saturday
2023,7,15,1200,1207,619,1826,Saturday
2023,7,15,1100,1427,473,1900,Saturday
2023,7,15,1000,1392,357,1749,Saturday
2023,7,15,900,1112,204,1316,Saturday
2023,7,15,800,769,102,871,Saturday
2023,7,15,700,417,64,481,Saturday
2023,7,15,600,207,43,250,Saturday
2023,7,15,500,75,29,104,Saturday
2023,7,15,400,39,56,95,Saturday
2023,7,15,300,45,56,101,Saturday
2023,7,15,200,31,60,91,Saturday
2023,7,15,100,44,81,125,Saturday
2023,7,14,2400,65,145,210,Friday
2023,7,14,2300,145,278,423,Friday
2023,7,14,2200,238,351,589,Friday
2023,7,14,2100,387,777,1164,Friday
2023,7,14,2000,585,1232,1817,Friday
2023,7,14,1900,803,1198,2001,Friday
2023,7,14,1800,864,1072,1936,Friday
2023,7,14,1700,925,991,1916,Friday
2023,7,14,1600,1035,1003,2038,Friday
2023,7,14,1500,1130,977,2107,Friday
2023,7,14,1400,1209,966,2175,Friday
2023,7,14,1300,1182,817,1999,Friday
2023,7,14,1200,1483,650,2133,Friday
2023,7,14,1100,1545,502,2047,Friday
2023,7,14,1000,1291,373,1664,Friday
2023,7,14,900,970,269,1239,Friday
2023,7,14,800,703,100,803,Friday
2023,7,14,700,410,76,486,Friday
2023,7,14,600,213,39,252,Friday
2023,7,14,500,74,30,104,Friday
2023,7,14,400,32,47,79,Friday
2023,7,14,300,43,42,85,Friday
2023,7,14,200,45,55,100,Friday
2023,7,14,100,56,46,102,Friday
2023,7,13,2400,85,83,168,Thursday
2023,7,13,2300,112,285,397,Thursday
2023,7,13,2200,193,374,567,Thursday
2023,7,13,2100,296,587,883,Thursday
2023,7,13,2000,508,831,1339,Thursday
2023,7,13,1900,538,1095,1633,Thursday
2023,7,13,1800,638,1139,1777,Thursday
2023,7,13,1700,710,1167,1877,Thursday
2023,7,13,1600,731,1140,1871,Thursday
2023,7,13,1500,932,986,1918,Thursday
2023,7,13,1400,931,835,1766,Thursday
2023,7,13,1300,1082,760,1842,Thursday
2023,7,13,1200,1325,612,1937,Thursday
2023,7,13,1100,1226,475,1701,Thursday
2023,7,13,1000,1049,334,1383,Thursday
2023,7,13,900,882,295,1177,Thursday
2023,7,13,800,591,110,701,Thursday
2023,7,13,700,360,66,426,Thursday
2023,7,13,600,205,44,249,Thursday
2023,7,13,500,62,43,105,Thursday
2023,7,13,400,41,66,107,Thursday
2023,7,13,300,40,64,104,Thursday
2023,7,13,200,36,78,114,Thursday
2023,7,13,100,39,155,194,Thursday
2023,7,12,2400,72,352,424,Wednesday
2023,7,12,2300,97,199,296,Wednesday
2023,7,12,2200,145,254,399,Wednesday
2023,7,12,2100,253,400,653,Wednesday
2023,7,12,2000,331,651,982,Wednesday
2023,7,12,1900,383,834,1217,Wednesday
2023,7,12,1800,499,959,1458,Wednesday
2023,7,12,1700,524,1024,1548,Wednesday
2023,7,12,1600,672,930,1602,Wednesday
2023,7,12,1500,754,881,1635,Wednesday
2023,7,12,1400,834,718,1552,Wednesday
2023,7,12,1300,959,670,1629,Wednesday
2023,7,12,1200,1107,630,1737,Wednesday
2023,7,12,1100,1053,418,1471,Wednesday
2023,7,12,1000,1050,328,1378,Wednesday
2023,7,12,900,796,329,1125,Wednesday
2023,7,12,800,576,91,667,Wednesday
2023,7,12,700,360,51,411,Wednesday
2023,7,12,600,193,38,231,Wednesday
2023,7,12,500,61,33,94,Wednesday
2023,7,12,400,28,33,61,Wednesday
2023,7,12,300,38,56,94,Wednesday
2023,7,12,200,28,65,93,Wednesday
2023,7,12,100,35,42,77,Wednesday
2023,7,11,2400,54,61,115,Tuesday
2023,7,11,2300,120,185,305,Tuesday
2023,7,11,2200,120,326,446,Tuesday
2023,7,11,2100,230,504,734,Tuesday
2023,7,11,2000,292,714,1006,Tuesday
2023,7,11,1900,374,971,1345,Tuesday
2023,7,11,1800,416,1164,1580,Tuesday
2023,7,11,1700,482,1014,1496,Tuesday
2023,7,11,1600,634,852,1486,Tuesday
2023,7,11,1500,694,904,1598,Tuesday
2023,7,11,1400,825,801,1626,Tuesday
2023,7,11,1300,920,728,1648,Tuesday
2023,7,11,1200,1022,668,1690,Tuesday
2023,7,11,1100,1014,478,1492,Tuesday
2023,7,11,1000,852,354,1206,Tuesday
2023,7,11,900,722,300,1022,Tuesday
2023,7,11,800,508,98,606,Tuesday
2023,7,11,700,325,63,388,Tuesday
2023,7,11,600,146,37,183,Tuesday
2023,7,11,500,56,40,96,Tuesday
2023,7,11,400,34,34,68,Tuesday
2023,7,11,300,22,32,54,Tuesday
2023,7,11,200,37,32,69,Tuesday
2023,7,11,100,36,31,67,Tuesday
2023,7,10,2400,53,91,144,Monday
2023,7,10,2300,84,229,313,Monday
2023,7,10,2200,126,369,495,Monday
2023,7,10,2100,225,624,849,Monday
2023,7,10,2000,311,1009,1320,Monday
2023,7,10,1900,380,1406,1786,Monday
2023,7,10,1800,420,1251,1671,Monday
2023,7,10,1700,617,1171,1788,Monday
2023,7,10,1600,742,1109,1851,Monday
2023,7,10,1500,903,935,1838,Monday
2023,7,10,1400,1104,963,2067,Monday
2023,7,10,1300,1330,732,2062,Monday
2023,7,10,1200,1342,641,1983,Monday
2023,7,10,1100,1091,457,1548,Monday
2023,7,10,1000,1098,289,1387,Monday
2023,7,10,900,962,226,1188,Monday
2023,7,10,800,622,108,730,Monday
2023,7,10,700,399,59,458,Monday
2023,7,10,600,199,32,231,Monday
2023,7,10,500,70,27,97,Monday
2023,7,10,400,37,26,63,Monday
2023,7,10,300,24,36,60,Monday
2023,7,10,200,16,47,63,Monday
2023,7,10,100,38,48,86,Monday
2023,7,9,2400,45,140,185,Sunday
2023,7,9,2300,84,296,380,Sunday
2023,7,9,2200,159,555,714,Sunday
2023,7,9,2100,238,873,1111,Sunday
2023,7,9,2000,363,1185,1548,Sunday
2023,7,9,1900,393,1651,2044,Sunday
2023,7,9,1800,511,2003,2514,Sunday
2023,7,9,1700,686,1851,2537,Sunday
2023,7,9,1600,791,1438,2229,Sunday
2023,7,9,1500,989,1443,2432,Sunday
2023,7,9,1400,1149,1317,2466,Sunday
2023,7,9,1300,1230,1125,2355,Sunday
2023,7,9,1200,1308,891,2199,Sunday
2023,7,9,1100,1235,590,1825,Sunday
2023,7,9,1000,1098,351,1449,Sunday
2023,7,9,900,839,215,1054,Sunday
2023,7,9,800,612,100,712,Sunday
2023,7,9,700,355,61,416,Sunday
2023,7,9,600,161,26,187,Sunday
2023,7,9,500,66,19,85,Sunday
2023,7,9,400,31,24,55,Sunday
2023,7,9,300,31,37,68,Sunday
2023,7,9,200,30,49,79,Sunday
2023,7,9,100,42,88,130,Sunday
2023,7,8,2400,71,183,254,Saturday
2023,7,8,2300,112,300,412,Saturday
2023,7,8,2200,164,524,688,Saturday
2023,7,8,2100,189,804,993,Saturday
2023,7,8,2000,273,1246,1519,Saturday
2023,7,8,1900,341,1145,1486,Saturday
2023,7,8,1800,438,1147,1585,Saturday
2023,7,8,1700,561,1434,1995,Saturday
2023,7,8,1600,705,1043,1748,Saturday
2023,7,8,1500,708,1051,1759,Saturday
2023,7,8,1400,764,840,1604,Saturday
2023,7,8,1300,823,852,1675,Saturday
2023,7,8,1200,917,604,1521,Saturday
2023,7,8,1100,1038,463,1501,Saturday
2023,7,8,1000,1219,288,1507,Saturday
2023,7,8,900,1011,198,1209,Saturday
2023,7,8,800,701,124,825,Saturday
2023,7,8,700,404,69,473,Saturday
2023,7,8,600,199,33,232,Saturday
2023,7,8,500,93,44,137,Saturday
2023,7,8,400,46,46,92,Saturday
2023,7,8,300,29,61,90,Saturday
2023,7,8,200,43,52,95,Saturday
2023,7,8,100,47,150,197,Saturday
2023,7,7,2400,91,100,191,Friday
2023,7,7,2300,139,254,393,Friday
2023,7,7,2200,219,390,609,Friday
2023,7,7,2100,359,590,949,Friday
2023,7,7,2000,545,896,1441,Friday
2023,7,7,1900,677,1233,1910,Friday
2023,7,7,1800,739,1228,1967,Friday
2023,7,7,1700,793,1137,1930,Friday
2023,7,7,1600,892,1083,1975,Friday
2023,7,7,1500,930,1138,2068,Friday
2023,7,7,1400,851,933,1784,Friday
2023,7,7,1300,887,896,1783,Friday
2023,7,7,1200,1063,734,1797,Friday
2023,7,7,1100,1254,575,1829,Friday
2023,7,7,1000,1221,387,1608,Friday
2023,7,7,900,916,302,1218,Friday
2023,7,7,800,603,101,704,Friday
2023,7,7,700,376,63,439,Friday
2023,7,7,600,192,48,240,Friday
2023,7,7,500,80,41,121,Friday
2023,7,7,400,44,45,89,Friday
2023,7,7,300,26,44,70,Friday
2023,7,7,200,36,61,97,Friday
2023,7,7,100,39,52,91,Friday
2023,7,6,2400,73,151,224,Thursday
2023,7,6,2300,117,352,469,Thursday
2023,7,6,2200,185,601,786,Thursday
2023,7,6,2100,344,1044,1388,Thursday
2023,7,6,2000,370,1172,1542,Thursday
2023,7,6,1900,431,1328,1759,Thursday
2023,7,6,1800,618,1274,1892,Thursday
2023,7,6,1700,684,1097,1781,Thursday
2023,7,6,1600,741,1008,1749,Thursday
2023,7,6,1500,838,1054,1892,Thursday
2023,7,6,1400,971,887,1858,Thursday
2023,7,6,1300,993,853,1846,Thursday
2023,7,6,1200,1264,642,1906,Thursday
2023,7,6,1100,1172,533,1705,Thursday
2023,7,6,1000,1092,338,1430,Thursday
2023,7,6,900,856,294,1150,Thursday
2023,7,6,800,616,109,725,Thursday
2023,7,6,700,403,67,470,Thursday
2023,7,6,600,243,35,278,Thursday
2023,7,6,500,81,35,116,Thursday
2023,7,6,400,38,32,70,Thursday
2023,7,6,300,28,33,61,Thursday
2023,7,6,200,41,49,90,Thursday
2023,7,6,100,43,60,103,Thursday
2023,7,5,2400,77,145,222,Wednesday
2023,7,5,2300,109,400,509,Wednesday
2023,7,5,2200,137,582,719,Wednesday
2023,7,5,2100,273,878,1151,Wednesday
2023,7,5,2000,341,1295,1636,Wednesday
2023,7,5,1900,412,1401,1813,Wednesday
2023,7,5,1800,467,1282,1749,Wednesday
2023,7,5,1700,563,1173,1736,Wednesday
2023,7,5,1600,740,1057,1797,Wednesday
2023,7,5,1500,1003,930,1933,Wednesday
2023,7,5,1400,991,773,1764,Wednesday
2023,7,5,1300,949,729,1678,Wednesday
2023,7,5,1200,1009,691,1700,Wednesday
2023,7,5,1100,1103,411,1514,Wednesday
2023,7,5,1000,1044,332,1376,Wednesday
2023,7,5,900,944,298,1242,Wednesday
2023,7,5,800,690,93,783,Wednesday
2023,7,5,700,468,59,527,Wednesday
2023,7,5,600,233,44,277,Wednesday
2023,7,5,500,81,35,116,Wednesday
2023,7,5,400,39,28,67,Wednesday
2023,7,5,300,22,37,59,Wednesday
2023,7,5,200,34,54,88,Wednesday
2023,7,5,100,43,61,104,Wednesday
2023,7,4,2400,61,163,224,Tuesday
2023,7,4,2300,92,345,437,Tuesday
2023,7,4,2200,158,568,726,Tuesday
2023,7,4,2100,256,768,1024,Tuesday
2023,7,4,2000,339,1073,1412,Tuesday
2023,7,4,1900,359,1399,1758,Tuesday
2023,7,4,1800,483,1596,2079,Tuesday
2023,7,4,1700,579,1286,1865,Tuesday
2023,7,4,1600,730,1164,1894,Tuesday
2023,7,4,1500,809,1077,1886,Tuesday
2023,7,4,1400,1200,939,2139,Tuesday
2023,7,4,1300,972,809,1781,Tuesday
2023,7,4,1200,1046,675,1721,Tuesday
2023,7,4,1100,1060,497,1557,Tuesday
2023,7,4,1000,1169,347,1516,Tuesday
2023,7,4,900,898,277,1175,Tuesday
2023,7,4,800,659,157,816,Tuesday
2023,7,4,700,410,89,499,Tuesday
2023,7,4,600,213,38,251,Tuesday
2023,7,4,500,78,27,105,Tuesday
2023,7,4,400,38,15,53,Tuesday
2023,7,4,300,18,37,55,Tuesday
2023,7,4,200,17,49,66,Tuesday
2023,7,4,100,23,101,124,Tuesday
2023,7,3,2400,49,217,266,Monday
2023,7,3,2300,122,448,570,Monday
2023,7,3,2200,134,782,916,Monday
2023,7,3,2100,247,1176,1423,Monday
2023,7,3,2000,310,1766,2076,Monday
2023,7,3,1900,380,2008,2388,Monday
2023,7,3,1800,547,2321,2868,Monday
2023,7,3,1700,687,2339,3026,Monday
2023,7,3,1600,932,1971,2903,Monday
2023,7,3,1500,1116,1815,2931,Monday
2023,7,3,1400,1583,1789,3372,Monday
2023,7,3,1300,1489,1649,3138,Monday
2023,7,3,1200,1186,1099,2285,Monday
2023,7,3,1100,1198,691,1889,Monday
2023,7,3,1000,1233,431,1664,Monday
2023,7,3,900,919,251,1170,Monday
2023,7,3,800,722,125,847,Monday
2023,7,3,700,451,58,509,Monday
2023,7,3,600,209,25,234,Monday
2023,7,3,500,106,21,127,Monday
2023,7,3,400,40,29,69,Monday
2023,7,3,300,31,52,83,Monday
2023,7,3,200,25,69,94,Monday
2023,7,3,100,34,116,150,Monday
2023,7,2,2400,66,273,339,Sunday
2023,7,2,2300,146,464,610,Sunday
2023,7,2,2200,172,855,1027,Sunday
2023,7,2,2100,241,1336,1577,Sunday
2023,7,2,2000,327,1580,1907,Sunday
2023,7,2,1900,382,1803,2185,Sunday
2023,7,2,1800,526,1843,2369,Sunday
2023,7,2,1700,729,1768,2497,Sunday
2023,7,2,1600,987,1583,2570,Sunday
2023,7,2,1500,1148,1401,2549,Sunday
2023,7,2,1400,1266,1144,2410,Sunday
2023,7,2,1300,1396,917,2313,Sunday
2023,7,2,1200,1491,717,2208,Sunday
2023,7,2,1100,1429,489,1918,Sunday
2023,7,2,1000,1303,308,1611,Sunday
2023,7,2,900,1119,170,1289,Sunday
2023,7,2,800,670,94,764,Sunday
2023,7,2,700,410,54,464,Sunday
2023,7,2,600,213,33,246,Sunday
2023,7,2,500,105,15,120,Sunday
2023,7,2,400,53,22,75,Sunday
2023,7,2,300,37,40,77,Sunday
2023,7,2,200,29,43,72,Sunday
2023,7,2,100,50,79,129,Sunday
2023,7,1,2400,74,182,256,Saturday
2023,7,1,2300,109,290,399,Saturday
2023,7,1,2200,175,538,713,Saturday
2023,7,1,2100,231,862,1093,Saturday
2023,7,1,2000,288,1137,1425,Saturday
2023,7,1,1900,378,1254,1632,Saturday
2023,7,1,1800,542,1434,1976,Saturday
2023,7,1,1700,673,1262,1935,Saturday
2023,7,1,1600,1052,1107,2159,Saturday
2023,7,1,1500,1400,979,2379,Saturday
2023,7,1,1400,1457,870,2327,Saturday
2023,7,1,1300,1263,663,1926,Saturday
2023,7,1,1200,1537,593,2130,Saturday
2023,7,1,1100,1630,415,2045,Saturday
2023,7,1,1000,1711,323,2034,Saturday
2023,7,1,900,1444,183,1627,Saturday
2023,7,1,800,1062,126,1188,Saturday
2023,7,1,700,561,65,626,Saturday
2023,7,1,600,259,45,304,Saturday
2023,7,1,500,120,40,160,Saturday
2023,7,1,400,72,55,127,Saturday
2023,7,1,300,61,50,111,Saturday
2023,7,1,200,56,65,121,Saturday
2023,7,1,100,90,104,194,Saturday
2023,6,30,2400,137,193,330,Friday
2023,6,30,2300,218,305,523,Friday
2023,6,30,2200,380,457,837,Friday
2023,6,30,2100,588,686,1274,Friday
2023,6,30,2000,898,904,1802,Friday
2023,6,30,1900,1245,1004,2249,Friday
2023,6,30,1800,1484,1206,2690,Friday
2023,6,30,1700,1311,1098,2409,Friday
2023,6,30,1600,1543,1012,2555,Friday
2023,6,30,1500,1620,894,2514,Friday
2023,6,30,1400,1637,798,2435,Friday
2023,6,30,1300,1676,754,2430,Friday
2023,6,30,1200,1761,614,2375,Friday
2023,6,30,1100,1763,511,2274,Friday
2023,6,30,1000,1601,387,1988,Friday
2023,6,30,900,1309,311,1620,Friday
2023,6,30,800,914,86,1000,Friday
2023,6,30,700,588,79,667,Friday
2023,6,30,600,265,33,298,Friday
2023,6,30,500,88,31,119,Friday
2023,6,30,400,77,38,115,Friday
2023,6,30,300,47,35,82,Friday
2023,6,30,200,33,83,116,Friday
2023,6,30,100,59,51,110,Friday
2023,6,29,2400,104,130,234,Thursday
2023,6,29,2300,205,259,464,Thursday
2023,6,29,2200,286,364,650,Thursday
2023,6,29,2100,613,629,1242,Thursday
2023,6,29,2000,885,824,1709,Thursday
2023,6,29,1900,1064,1113,2177,Thursday
2023,6,29,1800,883,1106,1989,Thursday
2023,6,29,1700,983,1041,2024,Thursday
2023,6,29,1600,1142,998,2140,Thursday
2023,6,29,1500,1143,808,1951,Thursday
2023,6,29,1400,1143,736,1879,Thursday
2023,6,29,1300,1160,697,1857,Thursday
2023,6,29,1200,1375,524,1899,Thursday
2023,6,29,1100,1389,415,1804,Thursday
2023,6,29,1000,1350,303,1653,Thursday
2023,6,29,900,1013,287,1300,Thursday
2023,6,29,800,702,88,790,Thursday
2023,6,29,700,440,76,516,Thursday
2023,6,29,600,200,40,240,Thursday
2023,6,29,500,84,40,124,Thursday
2023,6,29,400,42,22,64,Thursday
2023,6,29,300,32,40,72,Thursday
2023,6,29,200,32,49,81,Thursday
2023,6,29,100,42,36,78,Thursday
2023,6,28,2400,77,99,176,Wednesday
2023,6,28,2300,115,249,364,Wednesday
2023,6,28,2200,180,329,509,Wednesday
2023,6,28,2100,290,534,824,Wednesday
2023,6,28,2000,400,672,1072,Wednesday
2023,6,28,1900,502,861,1363,Wednesday
2023,6,28,1800,524,1074,1598,Wednesday
2023,6,28,1700,534,976,1510,Wednesday
2023,6,28,1600,734,820,1554,Wednesday
2023,6,28,1500,719,746,1465,Wednesday
2023,6,28,1400,773,623,1396,Wednesday
2023,6,28,1300,888,506,1394,Wednesday
2023,6,28,1200,1031,501,1532,Wednesday
2023,6,28,1100,1118,410,1528,Wednesday
2023,6,28,1000,994,260,1254,Wednesday
2023,6,28,900,844,302,1146,Wednesday
2023,6,28,800,589,68,657,Wednesday
2023,6,28,700,355,56,411,Wednesday
2023,6,28,600,160,43,203,Wednesday
2023,6,28,500,78,38,116,Wednesday
2023,6,28,400,32,34,66,Wednesday
2023,6,28,300,20,49,69,Wednesday
2023,6,28,200,24,35,59,Wednesday
2023,6,28,100,39,38,77,Wednesday
2023,6,27,2400,64,108,172,Tuesday
2023,6,27,2300,103,256,359,Tuesday
2023,6,27,2200,140,318,458,Tuesday
2023,6,27,2100,222,533,755,Tuesday
2023,6,27,2000,324,707,1031,Tuesday
2023,6,27,1900,355,922,1277,Tuesday
2023,6,27,1800,381,972,1353,Tuesday
2023,6,27,1700,495,949,1444,Tuesday
2023,6,27,1600,559,794,1353,Tuesday
2023,6,27,1500,580,743,1323,Tuesday
2023,6,27,1400,650,606,1256,Tuesday
2023,6,27,1300,805,563,1368,Tuesday
2023,6,27,1200,872,451,1323,Tuesday
2023,6,27,1100,907,377,1284,Tuesday
2023,6,27,1000,923,288,1211,Tuesday
2023,6,27,900,751,233,984,Tuesday
2023,6,27,800,564,94,658,Tuesday
2023,6,27,700,346,56,402,Tuesday
2023,6,27,600,151,32,183,Tuesday
2023,6,27,500,67,29,96,Tuesday
2023,6,27,400,36,28,64,Tuesday
2023,6,27,300,34,31,65,Tuesday
2023,6,27,200,21,38,59,Tuesday
2023,6,27,100,31,34,65,Tuesday
2023,6,26,2400,68,118,186,Monday
2023,6,26,2300,84,265,349,Monday
2023,6,26,2200,119,325,444,Monday
2023,6,26,2100,198,515,713,Monday
2023,6,26,2000,289,1067,1356,Monday
2023,6,26,1900,289,963,1252,Monday
2023,6,26,1800,357,1021,1378,Monday
2023,6,26,1700,482,1016,1498,Monday
2023,6,26,1600,643,937,1580,Monday
2023,6,26,1500,684,754,1438,Monday
2023,6,26,1400,783,677,1460,Monday
2023,6,26,1300,850,607,1457,Monday
2023,6,26,1200,1072,533,1605,Monday
2023,6,26,1100,1040,384,1424,Monday
2023,6,26,1000,981,271,1252,Monday
2023,6,26,900,754,213,967,Monday
2023,6,26,800,609,73,682,Monday
2023,6,26,700,361,69,430,Monday
2023,6,26,600,138,25,163,Monday
2023,6,26,500,67,19,86,Monday
2023,6,26,400,46,17,63,Monday
2023,6,26,300,22,31,53,Monday
2023,6,26,200,25,55,80,Monday
2023,6,26,100,23,71,94,Monday
2023,6,25,2400,55,130,185,Sunday
2023,6,25,2300,88,273,361,Sunday
2023,6,25,2200,118,444,562,Sunday
2023,6,25,2100,247,832,1079,Sunday
2023,6,25,2000,278,990,1268,Sunday
2023,6,25,1900,362,1323,1685,Sunday
2023,6,25,1800,419,1464,1883,Sunday
2023,6,25,1700,649,1541,2190,Sunday
2023,6,25,1600,725,1413,2138,Sunday
2023,6,25,1500,820,1234,2054,Sunday
2023,6,25,1400,941,1222,2163,Sunday
2023,6,25,1300,948,1088,2036,Sunday
2023,6,25,1200,1108,834,1942,Sunday
2023,6,25,1100,1087,572,1659,Sunday
2023,6,25,1000,984,349,1333,Sunday
2023,6,25,900,695,163,858,Sunday
2023,6,25,800,527,81,608,Sunday
2023,6,25,700,258,42,300,Sunday
2023,6,25,600,134,20,154,Sunday
2023,6,25,500,61,25,86,Sunday
2023,6,25,400,36,15,51,Sunday
2023,6,25,300,18,28,46,Sunday
2023,6,25,200,16,34,50,Sunday
2023,6,25,100,27,66,93,Sunday
2023,6,24,2400,68,153,221,Saturday
2023,6,24,2300,72,222,294,Saturday
2023,6,24,2200,132,428,560,Saturday
2023,6,24,2100,217,718,935,Saturday
2023,6,24,2000,234,954,1188,Saturday
2023,6,24,1900,356,1257,1613,Saturday
2023,6,24,1800,408,1296,1704,Saturday
2023,6,24,1700,591,1190,1781,Saturday
2023,6,24,1600,739,1054,1793,Saturday
2023,6,24,1500,918,882,1800,Saturday
2023,6,24,1400,980,813,1793,Saturday
2023,6,24,1300,1184,643,1827,Saturday
2023,6,24,1200,1281,511,1792,Saturday
2023,6,24,1100,1368,392,1760,Saturday
2023,6,24,1000,1227,260,1487,Saturday
2023,6,24,900,1039,217,1256,Saturday
2023,6,24,800,686,106,792,Saturday
2023,6,24,700,419,55,474,Saturday
2023,6,24,600,169,43,212,Saturday
2023,6,24,500,64,37,101,Saturday
2023,6,24,400,38,39,77,Saturday
2023,6,24,300,30,36,66,Saturday
2023,6,24,200,36,50,86,Saturday
2023,6,24,100,43,63,106,Saturday
2023,6,23,2400,67,156,223,Friday
2023,6,23,2300,122,259,381,Friday
2023,6,23,2200,229,381,610,Friday
2023,6,23,2100,376,583,959,Friday
2023,6,23,2000,617,802,1419,Friday
2023,6,23,1900,704,992,1696,Friday
2023,6,23,1800,848,1119,1967,Friday
2023,6,23,1700,882,1089,1971,Friday
2023,6,23,1600,989,948,1937,Friday
2023,6,23,1500,1001,823,1824,Friday
2023,6,23,1400,1086,731,1817,Friday
2023,6,23,1300,957,661,1618,Friday
2023,6,23,1200,1262,568,1830,Friday
2023,6,23,1100,1376,459,1835,Friday
2023,6,23,1000,1146,305,1451,Friday
2023,6,23,900,932,257,1189,Friday
2023,6,23,800,602,78,680,Friday
2023,6,23,700,400,44,444,Friday
2023,6,23,600,164,40,204,Friday
2023,6,23,500,72,39,111,Friday
2023,6,23,400,54,22,76,Friday
2023,6,23,300,29,26,55,Friday
2023,6,23,200,36,30,66,Friday
2023,6,23,100,48,32,80,Friday
2023,6,22,2400,51,123,174,Thursday
2023,6,22,2300,120,237,357,Thursday
2023,6,22,2200,165,317,482,Thursday
2023,6,22,2100,312,587,899,Thursday
2023,6,22,2000,426,784,1210,Thursday
2023,6,22,1900,450,921,1371,Thursday
2023,6,22,1800,519,1028,1547,Thursday
2023,6,22,1700,634,961,1595,Thursday
2023,6,22,1600,739,940,1679,Thursday
2023,6,22,1500,719,761,1480,Thursday
2023,6,22,1400,839,608,1447,Thursday
2023,6,22,1300,915,504,1419,Thursday
2023,6,22,1200,1214,469,1683,Thursday
2023,6,22,1100,1245,362,1607,Thursday
2023,6,22,1000,1106,290,1396,Thursday
2023,6,22,900,835,243,1078,Thursday
2023,6,22,800,580,86,666,Thursday
2023,6,22,700,306,52,358,Thursday
2023,6,22,600,167,51,218,Thursday
2023,6,22,500,49,33,82,Thursday
2023,6,22,400,39,34,73,Thursday
2023,6,22,300,27,39,66,Thursday
2023,6,22,200,27,38,65,Thursday
2023,6,22,100,35,30,65,Thursday
2023,6,21,2400,65,92,157,Wednesday
2023,6,21,2300,74,213,287,Wednesday
2023,6,21,2200,120,289,409,Wednesday
2023,6,21,2100,198,553,751,Wednesday
2023,6,21,2000,291,691,982,Wednesday
2023,6,21,1900,305,728,1033,Wednesday
2023,6,21,1800,424,963,1387,Wednesday
2023,6,21,1700,475,921,1396,Wednesday
2023,6,21,1600,566,861,1427,Wednesday
2023,6,21,1500,659,728,1387,Wednesday
2023,6,21,1400,716,593,1309,Wednesday
2023,6,21,1300,745,478,1223,Wednesday
2023,6,21,1200,968,425,1393,Wednesday
2023,6,21,1100,1084,322,1406,Wednesday
2023,6,21,1000,963,248,1211,Wednesday
2023,6,21,900,760,256,1016,Wednesday
2023,6,21,800,492,67,559,Wednesday
2023,6,21,700,269,51,320,Wednesday
2023,6,21,600,107,40,147,Wednesday
2023,6,21,500,48,38,86,Wednesday
2023,6,21,400,32,27,59,Wednesday
2023,6,21,300,17,43,60,Wednesday
2023,6,21,200,24,32,56,Wednesday
2023,6,21,100,23,30,53,Wednesday
2023,6,20,2400,56,86,142,Tuesday
2023,6,20,2300,65,164,229,Tuesday
2023,6,20,2200,125,266,391,Tuesday
2023,6,20,2100,168,426,594,Tuesday
2023,6,20,2000,266,518,784,Tuesday
2023,6,20,1900,293,689,982,Tuesday
2023,6,20,1800,365,838,1203,Tuesday
2023,6,20,1700,413,809,1222,Tuesday
2023,6,20,1600,517,801,1318,Tuesday
2023,6,20,1500,570,638,1208,Tuesday
2023,6,20,1400,602,566,1168,Tuesday
2023,6,20,1300,694,468,1162,Tuesday
2023,6,20,1200,785,452,1237,Tuesday
2023,6,20,1100,906,351,1257,Tuesday
2023,6,20,1000,722,274,996,Tuesday
2023,6,20,900,534,233,767,Tuesday
2023,6,20,800,389,78,467,Tuesday
2023,6,20,700,199,57,256,Tuesday
2023,6,20,600,91,37,128,Tuesday
2023,6,20,500,48,35,83,Tuesday
2023,6,20,400,20,28,48,Tuesday
2023,6,20,300,25,29,54,Tuesday
2023,6,20,200,28,42,70,Tuesday
2023,6,20,100,25,29,54,Tuesday
2023,6,19,2400,49,72,121,Monday
2023,6,19,2300,69,175,244,Monday
2023,6,19,2200,127,216,343,Monday
2023,6,19,2100,157,365,522,Monday
2023,6,19,2000,254,634,888,Monday
2023,6,19,1900,312,793,1105,Monday
2023,6,19,1800,377,986,1363,Monday
2023,6,19,1700,482,1045,1527,Monday
2023,6,19,1600,598,919,1517,Monday
2023,6,19,1500,699,851,1550,Monday
2023,6,19,1400,713,806,1519,Monday
2023,6,19,1300,828,703,1531,Monday
2023,6,19,1200,1075,633,1708,Monday
2023,6,19,1100,1022,435,1457,Monday
2023,6,19,1000,945,287,1232,Monday
2023,6,19,900,641,196,837,Monday
2023,6,19,800,470,87,557,Monday
2023,6,19,700,251,44,295,Monday
2023,6,19,600,137,24,161,Monday
2023,6,19,500,47,27,74,Monday
2023,6,19,400,33,22,55,Monday
2023,6,19,300,16,17,33,Monday
2023,6,19,200,19,32,51,Monday
2023,6,19,100,23,33,56,Monday
2023,6,18,2400,44,87,131,Sunday
2023,6,18,2300,82,221,303,Sunday
2023,6,18,2200,100,355,455,Sunday
2023,6,18,2100,186,562,748,Sunday
2023,6,18,2000,268,877,1145,Sunday
2023,6,18,1900,304,1016,1320,Sunday
2023,6,18,1800,434,1248,1682,Sunday
2023,6,18,1700,532,1256,1788,Sunday
2023,6,18,1600,647,1229,1876,Sunday
2023,6,18,1500,754,1257,2011,Sunday
2023,6,18,1400,812,1179,1991,Sunday
2023,6,18,1300,872,1238,2110,Sunday
2023,6,18,1200,950,953,1903,Sunday
2023,6,18,1100,819,628,1447,Sunday
2023,6,18,1000,782,378,1160,Sunday
2023,6,18,900,588,211,799,Sunday
2023,6,18,800,375,101,476,Sunday
2023,6,18,700,202,41,243,Sunday
2023,6,18,600,80,17,97,Sunday
2023,6,18,500,26,14,40,Sunday
2023,6,18,400,31,17,48,Sunday
2023,6,18,300,23,25,48,Sunday
2023,6,18,200,20,43,63,Sunday
2023,6,18,100,29,44,73,Sunday
2023,6,17,2400,47,119,166,Saturday
2023,6,17,2300,85,225,310,Saturday
2023,6,17,2200,154,359,513,Saturday
2023,6,17,2100,180,671,851,Saturday
2023,6,17,2000,227,859,1086,Saturday
2023,6,17,1900,314,1106,1420,Saturday
2023,6,17,1800,391,1189,1580,Saturday
2023,6,17,1700,495,1157,1652,Saturday
2023,6,17,1600,636,1048,1684,Saturday
2023,6,17,1500,728,871,1599,Saturday
2023,6,17,1400,869,767,1636,Saturday
2023,6,17,1300,1028,668,1696,Saturday
2023,6,17,1200,1229,519,1748,Saturday
2023,6,17,1100,1203,404,1607,Saturday
2023,6,17,1000,1081,320,1401,Saturday
2023,6,17,900,925,217,1142,Saturday
2023,6,17,800,551,90,641,Saturday
2023,6,17,700,343,66,409,Saturday
2023,6,17,600,162,37,199,Saturday
2023,6,17,500,68,36,104,Saturday
2023,6,17,400,33,36,69,Saturday
2023,6,17,300,33,32,65,Saturday
2023,6,17,200,29,43,72,Saturday
2023,6,17,100,33,108,141,Saturday
2023,6,16,2400,82,80,162,Friday
2023,6,16,2300,101,207,308,Friday
2023,6,16,2200,187,297,484,Friday
2023,6,16,2100,360,439,799,Friday
2023,6,16,2000,601,722,1323,Friday
2023,6,16,1900,724,903,1627,Friday
2023,6,16,1800,725,1096,1821,Friday
2023,6,16,1700,807,1023,1830,Friday
2023,6,16,1600,910,1019,1929,Friday
2023,6,16,1500,904,897,1801,Friday
2023,6,16,1400,876,790,1666,Friday
2023,6,16,1300,982,682,1664,Friday
2023,6,16,1200,1201,562,1763,Friday
2023,6,16,1100,1293,378,1671,Friday
2023,6,16,1000,1066,304,1370,Friday
2023,6,16,900,861,291,1152,Friday
2023,6,16,800,571,84,655,Friday
2023,6,16,700,329,49,378,Friday
2023,6,16,600,144,37,181,Friday
2023,6,16,500,67,35,102,Friday
2023,6,16,400,58,33,91,Friday
2023,6,16,300,24,33,57,Friday
2023,6,16,200,33,37,70,Friday
2023,6,16,100,34,37,71,Friday
2023,6,15,2400,61,93,154,Thursday
2023,6,15,2300,116,246,362,Thursday
2023,6,15,2200,172,326,498,Thursday
2023,6,15,2100,290,504,794,Thursday
2023,6,15,2000,436,714,1150,Thursday
2023,6,15,1900,467,903,1370,Thursday
2023,6,15,1800,560,950,1510,Thursday
2023,6,15,1700,532,955,1487,Thursday
2023,6,15,1600,669,855,1524,Thursday
2023,6,15,1500,806,796,1602,Thursday
2023,6,15,1400,782,624,1406,Thursday
2023,6,15,1300,801,569,1370,Thursday
2023,6,15,1200,1005,435,1440,Thursday
2023,6,15,1100,1087,323,1410,Thursday
2023,6,15,1000,1020,269,1289,Thursday
2023,6,15,900,793,267,1060,Thursday
2023,6,15,800,492,79,571,Thursday
2023,6,15,700,332,71,403,Thursday
2023,6,15,600,138,30,168,Thursday
2023,6,15,500,44,28,72,Thursday
2023,6,15,400,40,45,85,Thursday
2023,6,15,300,34,50,84,Thursday
2023,6,15,200,32,42,74,Thursday
2023,6,15,100,41,26,67,Thursday
2023,6,14,2400,50,104,154,Wednesday
2023,6,14,2300,89,181,270,Wednesday
2023,6,14,2200,115,230,345,Wednesday
2023,6,14,2100,230,312,542,Wednesday
2023,6,14,2000,294,464,758,Wednesday
2023,6,14,1900,347,632,979,Wednesday
2023,6,14,1800,389,656,1045,Wednesday
2023,6,14,1700,514,849,1363,Wednesday
2023,6,14,1600,549,737,1286,Wednesday
2023,6,14,1500,599,679,1278,Wednesday
2023,6,14,1400,658,623,1281,Wednesday
2023,6,14,1300,690,566,1256,Wednesday
2023,6,14,1200,863,522,1385,Wednesday
2023,6,14,1100,837,416,1253,Wednesday
2023,6,14,1000,649,350,999,Wednesday
2023,6,14,900,509,281,790,Wednesday
2023,6,14,800,350,69,419,Wednesday
2023,6,14,700,201,69,270,Wednesday
2023,6,14,600,84,52,136,Wednesday
2023,6,14,500,37,28,65,Wednesday
2023,6,14,400,22,38,60,Wednesday
2023,6,14,300,33,28,61,Wednesday
2023,6,14,200,33,45,78,Wednesday
2023,6,14,100,49,18,67,Wednesday
2023,6,13,2400,59,103,162,Tuesday
2023,6,13,2300,82,187,269,Tuesday
2023,6,13,2200,107,251,358,Tuesday
2023,6,13,2100,194,412,606,Tuesday
2023,6,13,2000,290,792,1082,Tuesday
2023,6,13,1900,281,647,928,Tuesday
2023,6,13,1800,365,1013,1378,Tuesday
2023,6,13,1700,469,1116,1585,Tuesday
2023,6,13,1600,475,880,1355,Tuesday
2023,6,13,1500,619,701,1320,Tuesday
2023,6,13,1400,587,647,1234,Tuesday
2023,6,13,1300,725,556,1281,Tuesday
2023,6,13,1200,879,494,1373,Tuesday
2023,6,13,1100,964,357,1321,Tuesday
2023,6,13,1000,867,329,1196,Tuesday
2023,6,13,900,750,265,1015,Tuesday
2023,6,13,800,505,89,594,Tuesday
2023,6,13,700,300,77,377,Tuesday
2023,6,13,600,131,38,169,Tuesday
2023,6,13,500,49,35,84,Tuesday
2023,6,13,400,41,44,85,Tuesday
2023,6,13,300,35,34,69,Tuesday
2023,6,13,200,35,32,67,Tuesday
2023,6,13,100,42,27,69,Tuesday
2023,6,12,2400,68,123,191,Monday
2023,6,12,2300,104,249,353,Monday
2023,6,12,2200,114,370,484,Monday
2023,6,12,2100,230,555,785,Monday
2023,6,12,2000,292,741,1033,Monday
2023,6,12,1900,352,908,1260,Monday
2023,6,12,1800,371,1048,1419,Monday
2023,6,12,1700,482,1007,1489,Monday
2023,6,12,1600,574,995,1569,Monday
2023,6,12,1500,644,825,1469,Monday
2023,6,12,1400,738,717,1455,Monday
2023,6,12,1300,846,604,1450,Monday
2023,6,12,1200,954,563,1517,Monday
2023,6,12,1100,1158,413,1571,Monday
2023,6,12,1000,930,298,1228,Monday
2023,6,12,900,700,217,917,Monday
2023,6,12,800,514,89,603,Monday
2023,6,12,700,256,56,312,Monday
2023,6,12,600,158,28,186,Monday
2023,6,12,500,53,20,73,Monday
2023,6,12,400,33,28,61,Monday
2023,6,12,300,27,27,54,Monday
2023,6,12,200,22,55,77,Monday
2023,6,12,100,21,52,73,Monday
2023,6,11,2400,52,105,157,Sunday
2023,6,11,2300,79,259,338,Sunday
2023,6,11,2200,140,449,589,Sunday
2023,6,11,2100,175,607,782,Sunday
2023,6,11,2000,244,1059,1303,Sunday
2023,6,11,1900,317,1286,1603,Sunday
2023,6,11,1800,384,1461,1845,Sunday
2023,6,11,1700,512,1629,2141,Sunday
2023,6,11,1600,656,1414,2070,Sunday
2023,6,11,1500,729,1245,1974,Sunday
2023,6,11,1400,882,1123,2005,Sunday
2023,6,11,1300,921,920,1841,Sunday
2023,6,11,1200,989,827,1816,Sunday
2023,6,11,1100,1017,552,1569,Sunday
2023,6,11,1000,902,281,1183,Sunday
2023,6,11,900,646,170,816,Sunday
2023,6,11,800,386,75,461,Sunday
2023,6,11,700,237,35,272,Sunday
2023,6,11,600,114,23,137,Sunday
2023,6,11,500,33,12,45,Sunday
2023,6,11,400,30,14,44,Sunday
2023,6,11,300,22,43,65,Sunday
2023,6,11,200,25,43,68,Sunday
2023,6,11,100,29,47,76,Sunday
2023,6,10,2400,42,134,176,Saturday
2023,6,10,2300,94,274,368,Saturday
2023,6,10,2200,116,378,494,Saturday
2023,6,10,2100,190,570,760,Saturday
2023,6,10,2000,217,741,958,Saturday
2023,6,10,1900,317,1028,1345,Saturday
2023,6,10,1800,380,1169,1549,Saturday
2023,6,10,1700,470,1101,1571,Saturday
2023,6,10,1600,603,1025,1628,Saturday
2023,6,10,1500,699,873,1572,Saturday
2023,6,10,1400,811,699,1510,Saturday
2023,6,10,1300,944,628,1572,Saturday
2023,6,10,1200,1185,481,1666,Saturday
2023,6,10,1100,1068,357,1425,Saturday
2023,6,10,1000,1047,251,1298,Saturday
2023,6,10,900,857,197,1054,Saturday
2023,6,10,800,539,86,625,Saturday
2023,6,10,700,280,51,331,Saturday
2023,6,10,600,102,36,138,Saturday
2023,6,10,500,42,31,73,Saturday
2023,6,10,400,37,38,75,Saturday
2023,6,10,300,31,29,60,Saturday
2023,6,10,200,24,50,74,Saturday
2023,6,10,100,42,64,106,Saturday
2023,6,9,2400,64,96,160,Friday
2023,6,9,2300,101,162,263,Friday
2023,6,9,2200,187,302,489,Friday
2023,6,9,2100,315,605,920,Friday
2023,6,9,2000,577,660,1237,Friday
2023,6,9,1900,678,784,1462,Friday
2023,6,9,1800,791,852,1643,Friday
2023,6,9,1700,778,937,1715,Friday
2023,6,9,1600,849,788,1637,Friday
2023,6,9,1500,879,773,1652,Friday
2023,6,9,1400,844,679,1523,Friday
2023,6,9,1300,928,618,1546,Friday
2023,6,9,1200,1101,484,1585,Friday
2023,6,9,1100,1096,352,1448,Friday
2023,6,9,1000,950,273,1223,Friday
2023,6,9,900,790,254,1044,Friday
2023,6,9,800,484,77,561,Friday
2023,6,9,700,303,59,362,Friday
2023,6,9,600,114,36,150,Friday
2023,6,9,500,43,45,88,Friday
2023,6,9,400,29,23,52,Friday
2023,6,9,300,46,22,68,Friday
2023,6,9,200,38,43,81,Friday
2023,6,9,100,48,36,84,Friday
2023,6,8,2400,85,91,176,Thursday
2023,6,8,2300,116,193,309,Thursday
2023,6,8,2200,145,287,432,Thursday
2023,6,8,2100,288,423,711,Thursday
2023,6,8,2000,441,622,1063,Thursday
2023,6,8,1900,522,735,1257,Thursday
2023,6,8,1800,516,879,1395,Thursday
2023,6,8,1700,591,895,1486,Thursday
2023,6,8,1600,620,813,1433,Thursday
2023,6,8,1500,697,743,1440,Thursday
2023,6,8,1400,737,703,1440,Thursday
2023,6,8,1300,787,599,1386,Thursday
2023,6,8,1200,1017,472,1489,Thursday
2023,6,8,1100,1016,378,1394,Thursday
2023,6,8,1000,951,248,1199,Thursday
2023,6,8,900,768,225,993,Thursday
2023,6,8,800,501,58,559,Thursday
2023,6,8,700,284,65,349,Thursday
2023,6,8,600,116,23,139,Thursday
2023,6,8,500,40,34,74,Thursday
2023,6,8,400,26,33,59,Thursday
2023,6,8,300,27,23,50,Thursday
2023,6,8,200,28,33,61,Thursday
2023,6,8,100,33,22,55,Thursday
2023,6,7,2400,66,102,168,Wednesday
2023,6,7,2300,94,193,287,Wednesday
2023,6,7,2200,129,294,423,Wednesday
2023,6,7,2100,243,445,688,Wednesday
2023,6,7,2000,276,613,889,Wednesday
2023,6,7,1900,317,766,1083,Wednesday
2023,6,7,1800,396,814,1210,Wednesday
2023,6,7,1700,456,789,1245,Wednesday
2023,6,7,1600,549,796,1345,Wednesday
2023,6,7,1500,566,689,1255,Wednesday
2023,6,7,1400,603,482,1085,Wednesday
2023,6,7,1300,736,522,1258,Wednesday
2023,6,7,1200,881,431,1312,Wednesday
2023,6,7,1100,944,322,1266,Wednesday
2023,6,7,1000,895,278,1173,Wednesday
2023,6,7,900,655,231,886,Wednesday
2023,6,7,800,440,98,538,Wednesday
2023,6,7,700,244,63,307,Wednesday
2023,6,7,600,128,41,169,Wednesday
2023,6,7,500,58,18,76,Wednesday
2023,6,7,400,38,27,65,Wednesday
2023,6,7,300,26,44,70,Wednesday
2023,6,7,200,26,43,69,Wednesday
2023,6,7,100,32,39,71,Wednesday
2023,6,6,2400,59,86,145,Tuesday
2023,6,6,2300,98,162,260,Tuesday
2023,6,6,2200,137,228,365,Tuesday
2023,6,6,2100,193,458,651,Tuesday
2023,6,6,2000,258,569,827,Tuesday
2023,6,6,1900,272,741,1013,Tuesday
2023,6,6,1800,307,866,1173,Tuesday
2023,6,6,1700,388,788,1176,Tuesday
2023,6,6,1600,436,723,1159,Tuesday
2023,6,6,1500,538,628,1166,Tuesday
2023,6,6,1400,597,555,1152,Tuesday
2023,6,6,1300,695,469,1164,Tuesday
2023,6,6,1200,889,402,1291,Tuesday
2023,6,6,1100,936,289,1225,Tuesday
2023,6,6,1000,759,240,999,Tuesday
2023,6,6,900,645,247,892,Tuesday
2023,6,6,800,403,79,482,Tuesday
2023,6,6,700,237,46,283,Tuesday
2023,6,6,600,129,44,173,Tuesday
2023,6,6,500,32,32,64,Tuesday
2023,6,6,400,27,30,57,Tuesday
2023,6,6,300,32,27,59,Tuesday
2023,6,6,200,27,33,60,Tuesday
2023,6,6,100,35,23,58,Tuesday
2023,6,5,2400,54,78,132,Monday
2023,6,5,2300,92,214,306,Monday
2023,6,5,2200,103,303,406,Monday
2023,6,5,2100,222,430,652,Monday
2023,6,5,2000,238,636,874,Monday
2023,6,5,1900,281,865,1146,Monday
2023,6,5,1800,401,884,1285,Monday
2023,6,5,1700,417,1000,1417,Monday
2023,6,5,1600,565,805,1370,Monday
2023,6,5,1500,582,704,1286,Monday
2023,6,5,1400,701,632,1333,Monday
2023,6,5,1300,732,501,1233,Monday
2023,6,5,1200,945,446,1391,Monday
2023,6,5,1100,968,292,1260,Monday
2023,6,5,1000,890,252,1142,Monday
2023,6,5,900,660,196,856,Monday
2023,6,5,800,500,85,585,Monday
2023,6,5,700,256,63,319,Monday
2023,6,5,600,133,24,157,Monday
2023,6,5,500,38,16,54,Monday
2023,6,5,400,29,20,49,Monday
2023,6,5,300,20,25,45,Monday
2023,6,5,200,26,33,59,Monday
2023,6,5,100,24,47,71,Monday
2023,6,4,2400,30,98,128,Sunday
2023,6,4,2300,101,244,345,Sunday
2023,6,4,2200,109,405,514,Sunday
2023,6,4,2100,160,665,825,Sunday
2023,6,4,2000,235,921,1156,Sunday
2023,6,4,1900,331,1167,1498,Sunday
2023,6,4,1800,436,1318,1754,Sunday
2023,6,4,1700,507,1324,1831,Sunday
2023,6,4,1600,629,1361,1990,Sunday
2023,6,4,1500,779,1178,1957,Sunday
2023,6,4,1400,857,958,1815,Sunday
2023,6,4,1300,880,864,1744,Sunday
2023,6,4,1200,958,702,1660,Sunday
2023,6,4,1100,1009,461,1470,Sunday
2023,6,4,1000,884,259,1143,Sunday
2023,6,4,900,731,168,899,Sunday
2023,6,4,800,388,73,461,Sunday
2023,6,4,700,253,32,285,Sunday
2023,6,4,600,100,20,120,Sunday
2023,6,4,500,48,10,58,Sunday
2023,6,4,400,31,22,53,Sunday
2023,6,4,300,23,15,38,Sunday
2023,6,4,200,20,25,45,Sunday
2023,6,4,100,33,59,92,Sunday
2023,6,3,2400,26,113,139,Saturday
2023,6,3,2300,82,168,250,Saturday
2023,6,3,2200,106,312,418,Saturday
2023,6,3,2100,159,529,688,Saturday
2023,6,3,2000,190,711,901,Saturday
2023,6,3,1900,263,888,1151,Saturday
2023,6,3,1800,377,943,1320,Saturday
2023,6,3,1700,418,982,1400,Saturday
2023,6,3,1600,536,927,1463,Saturday
2023,6,3,1500,656,733,1389,Saturday
2023,6,3,1400,784,665,1449,Saturday
2023,6,3,1300,894,500,1394,Saturday
2023,6,3,1200,1027,405,1432,Saturday
2023,6,3,1100,1040,336,1376,Saturday
2023,6,3,1000,963,252,1215,Saturday
2023,6,3,900,734,174,908,Saturday
2023,6,3,800,522,67,589,Saturday
2023,6,3,700,249,44,293,Saturday
2023,6,3,600,103,39,142,Saturday
2023,6,3,500,45,37,82,Saturday
2023,6,3,400,27,34,61,Saturday
2023,6,3,300,18,32,50,Saturday
2023,6,3,200,25,40,65,Saturday
2023,6,3,100,41,56,97,Saturday
2023,6,2,2400,65,85,150,Friday
2023,6,2,2300,109,160,269,Friday
2023,6,2,2200,179,250,429,Friday
2023,6,2,2100,334,325,659,Friday
2023,6,2,2000,523,656,1179,Friday
2023,6,2,1900,581,765,1346,Friday
2023,6,2,1800,695,849,1544,Friday
2023,6,2,1700,683,830,1513,Friday
2023,6,2,1600,825,780,1605,Friday
2023,6,2,1500,840,686,1526,Friday
2023,6,2,1400,770,598,1368,Friday
2023,6,2,1300,847,456,1303,Friday
2023,6,2,1200,977,463,1440,Friday
2023,6,2,1100,1005,371,1376,Friday
2023,6,2,1000,850,280,1130,Friday
2023,6,2,900,675,234,909,Friday
2023,6,2,800,468,70,538,Friday
2023,6,2,700,267,44,311,Friday
2023,6,2,600,114,31,145,Friday
2023,6,2,500,51,32,83,Friday
2023,6,2,400,34,19,53,Friday
2023,6,2,300,22,33,55,Friday
2023,6,2,200,30,32,62,Friday
2023,6,2,100,44,40,84,Friday
2023,6,1,2400,56,87,143,Thursday
2023,6,1,2300,107,185,292,Thursday
2023,6,1,2200,150,261,411,Thursday
2023,6,1,2100,250,342,592,Thursday
2023,6,1,2000,380,514,894,Thursday
2023,6,1,1900,342,692,1034,Thursday
2023,6,1,1800,411,722,1133,Thursday
2023,6,1,1700,466,773,1239,Thursday
2023,6,1,1600,543,709,1252,Thursday
2023,6,1,1500,625,642,1267,Thursday
2023,6,1,1400,650,561,1211,Thursday
2023,6,1,1300,633,509,1142,Thursday
2023,6,1,1200,846,443,1289,Thursday
2023,6,1,1100,848,336,1184,Thursday
2023,6,1,1000,704,268,972,Thursday
2023,6,1,900,565,201,766,Thursday
2023,6,1,800,350,59,409,Thursday
2023,6,1,700,232,47,279,Thursday
2023,6,1,600,92,49,141,Thursday
2023,6,1,500,41,31,72,Thursday
2023,6,1,400,26,20,46,Thursday
2023,6,1,300,18,37,55,Thursday
2023,6,1,200,23,42,65,Thursday
2023,6,1,100,47,32,79,Thursday
2023,5,31,2400,56,76,132,Wednesday
2023,5,31,2300,83,188,271,Wednesday
2023,5,31,2200,112,265,377,Wednesday
2023,5,31,2100,180,361,541,Wednesday
2023,5,31,2000,251,454,705,Wednesday
2023,5,31,1900,310,594,904,Wednesday
2023,5,31,1800,327,692,1019,Wednesday
2023,5,31,1700,349,728,1077,Wednesday
2023,5,31,1600,446,683,1129,Wednesday
2023,5,31,1500,463,583,1046,Wednesday
2023,5,31,1400,498,504,1002,Wednesday
2023,5,31,1300,610,454,1064,Wednesday
2023,5,31,1200,753,354,1107,Wednesday
2023,5,31,1100,799,298,1097,Wednesday
2023,5,31,1000,699,245,944,Wednesday
2023,5,31,900,493,210,703,Wednesday
2023,5,31,800,320,69,389,Wednesday
2023,5,31,700,184,40,224,Wednesday
2023,5,31,600,84,43,127,Wednesday
2023,5,31,500,40,28,68,Wednesday
2023,5,31,400,13,24,37,Wednesday
2023,5,31,300,17,25,42,Wednesday
2023,5,31,200,23,39,62,Wednesday
2023,5,31,100,36,24,60,Wednesday
2023,5,30,2400,60,75,135,Tuesday
2023,5,30,2300,80,146,226,Tuesday
2023,5,30,2200,98,229,327,Tuesday
2023,5,30,2100,178,388,566,Tuesday
2023,5,30,2000,231,426,657,Tuesday
2023,5,30,1900,208,621,829,Tuesday
2023,5,30,1800,292,672,964,Tuesday
2023,5,30,1700,344,707,1051,Tuesday
2023,5,30,1600,408,675,1083,Tuesday
2023,5,30,1500,493,560,1053,Tuesday
2023,5,30,1400,498,549,1047,Tuesday
2023,5,30,1300,623,422,1045,Tuesday
2023,5,30,1200,714,354,1068,Tuesday
2023,5,30,1100,786,298,1084,Tuesday
2023,5,30,1000,692,224,916,Tuesday
2023,5,30,900,550,228,778,Tuesday
2023,5,30,800,339,85,424,Tuesday
2023,5,30,700,181,60,241,Tuesday
2023,5,30,600,87,43,130,Tuesday
2023,5,30,500,36,34,70,Tuesday
2023,5,30,400,19,26,45,Tuesday
2023,5,30,300,25,23,48,Tuesday
2023,5,30,200,28,29,57,Tuesday
2023,5,30,100,33,26,59,Tuesday
2023,5,29,2400,54,78,132,Monday
2023,5,29,2300,59,167,226,Monday
2023,5,29,2200,106,256,362,Monday
2023,5,29,2100,171,368,539,Monday
2023,5,29,2000,219,457,676,Monday
2023,5,29,1900,284,648,932,Monday
2023,5,29,1800,281,795,1076,Monday
2023,5,29,1700,386,838,1224,Monday
2023,5,29,1600,442,840,1282,Monday
2023,5,29,1500,535,726,1261,Monday
2023,5,29,1400,635,698,1333,Monday
2023,5,29,1300,726,550,1276,Monday
2023,5,29,1200,894,484,1378,Monday
2023,5,29,1100,923,339,1262,Monday
2023,5,29,1000,852,223,1075,Monday
2023,5,29,900,631,179,810,Monday
2023,5,29,800,367,75,442,Monday
2023,5,29,700,200,45,245,Monday
2023,5,29,600,75,30,105,Monday
2023,5,29,500,43,15,58,Monday
2023,5,29,400,12,20,32,Monday
2023,5,29,300,21,26,47,Monday
2023,5,29,200,17,45,62,Monday
2023,5,29,100,32,27,59,Monday
2023,5,28,2400,33,67,100,Sunday
2023,5,28,2300,64,236,300,Sunday
2023,5,28,2200,94,356,450,Sunday
2023,5,28,2100,155,556,711,Sunday
2023,5,28,2000,207,788,995,Sunday
2023,5,28,1900,311,1069,1380,Sunday
2023,5,28,1800,355,1323,1678,Sunday
2023,5,28,1700,436,1352,1788,Sunday
2023,5,28,1600,562,1302,1864,Sunday
2023,5,28,1500,704,1105,1809,Sunday
2023,5,28,1400,749,888,1637,Sunday
2023,5,28,1300,881,760,1641,Sunday
2023,5,28,1200,934,571,1505,Sunday
2023,5,28,1100,862,401,1263,Sunday
2023,5,28,1000,839,247,1086,Sunday
2023,5,28,900,575,146,721,Sunday
2023,5,28,800,332,83,415,Sunday
2023,5,28,700,171,26,197,Sunday
2023,5,28,600,76,13,89,Sunday
2023,5,28,500,29,28,57,Sunday
2023,5,28,400,28,16,44,Sunday
2023,5,28,300,16,31,47,Sunday
2023,5,28,200,28,31,59,Sunday
2023,5,28,100,29,60,89,Sunday
2023,5,27,2400,48,86,134,Saturday
2023,5,27,2300,65,179,244,Saturday
2023,5,27,2200,122,278,400,Saturday
2023,5,27,2100,150,420,570,Saturday
2023,5,27,2000,196,607,803,Saturday
2023,5,27,1900,272,790,1062,Saturday
2023,5,27,1800,310,839,1149,Saturday
2023,5,27,1700,388,892,1280,Saturday
2023,5,27,1600,493,832,1325,Saturday
2023,5,27,1500,622,781,1403,Saturday
2023,5,27,1400,703,624,1327,Saturday
2023,5,27,1300,856,525,1381,Saturday
2023,5,27,1200,990,422,1412,Saturday
2023,5,27,1100,982,345,1327,Saturday
2023,5,27,1000,823,243,1066,Saturday
2023,5,27,900,667,242,909,Saturday
2023,5,27,800,406,76,482,Saturday
2023,5,27,700,182,32,214,Saturday
2023,5,27,600,74,27,101,Saturday
2023,5,27,500,28,25,53,Saturday
2023,5,27,400,23,32,55,Saturday
2023,5,27,300,25,28,53,Saturday
2023,5,27,200,30,44,74,Saturday
2023,5,27,100,27,28,55,Saturday
2023,5,26,2400,52,77,129,Friday
2023,5,26,2300,88,176,264,Friday
2023,5,26,2200,166,220,386,Friday
2023,5,26,2100,273,366,639,Friday
2023,5,26,2000,459,488,947,Friday
2023,5,26,1900,592,733,1325,Friday
2023,5,26,1800,653,719,1372,Friday
2023,5,26,1700,678,840,1518,Friday
2023,5,26,1600,685,727,1412,Friday
2023,5,26,1500,693,698,1391,Friday
2023,5,26,1400,704,597,1301,Friday
2023,5,26,1300,697,532,1229,Friday
2023,5,26,1200,874,417,1291,Friday
2023,5,26,1100,860,304,1164,Friday
2023,5,26,1000,819,249,1068,Friday
2023,5,26,900,587,222,809,Friday
2023,5,26,800,400,74,474,Friday
2023,5,26,700,203,55,258,Friday
2023,5,26,600,77,38,115,Friday
2023,5,26,500,48,27,75,Friday
2023,5,26,400,19,34,53,Friday
2023,5,26,300,18,37,55,Friday
2023,5,26,200,22,22,44,Friday
2023,5,26,100,38,22,60,Friday
2023,5,25,2400,52,76,128,Thursday
2023,5,25,2300,85,208,293,Thursday
2023,5,25,2200,124,233,357,Thursday
2023,5,25,2100,205,328,533,Thursday
2023,5,25,2000,298,426,724,Thursday
2023,5,25,1900,314,581,895,Thursday
2023,5,25,1800,374,606,980,Thursday
2023,5,25,1700,425,727,1152,Thursday
2023,5,25,1600,424,713,1137,Thursday
2023,5,25,1500,503,553,1056,Thursday
2023,5,25,1400,556,489,1045,Thursday
2023,5,25,1300,583,456,1039,Thursday
2023,5,25,1200,738,345,1083,Thursday
2023,5,25,1100,732,307,1039,Thursday
2023,5,25,1000,629,213,842,Thursday
2023,5,25,900,460,193,653,Thursday
2023,5,25,800,290,55,345,Thursday
2023,5,25,700,159,50,209,Thursday
2023,5,25,600,60,33,93,Thursday
2023,5,25,500,31,32,63,Thursday
2023,5,25,400,22,23,45,Thursday
2023,5,25,300,16,36,52,Thursday
2023,5,25,200,17,30,47,Thursday
2023,5,25,100,30,20,50,Thursday
2023,5,24,2400,51,60,111,Wednesday
2023,5,24,2300,75,158,233,Wednesday
2023,5,24,2200,70,252,322,Wednesday
2023,5,24,2100,147,350,497,Wednesday
2023,5,24,2000,242,458,700,Wednesday
2023,5,24,1900,276,621,897,Wednesday
2023,5,24,1800,317,679,996,Wednesday
2023,5,24,1700,354,687,1041,Wednesday
2023,5,24,1600,408,724,1132,Wednesday
2023,5,24,1500,444,586,1030,Wednesday
2023,5,24,1400,547,536,1083,Wednesday
2023,5,24,1300,569,477,1046,Wednesday
2023,5,24,1200,671,419,1090,Wednesday
2023,5,24,1100,753,305,1058,Wednesday
2023,5,24,1000,662,268,930,Wednesday
2023,5,24,900,464,222,686,Wednesday
2023,5,24,800,312,84,396,Wednesday
2023,5,24,700,174,52,226,Wednesday
2023,5,24,600,80,32,112,Wednesday
2023,5,24,500,43,36,79,Wednesday
2023,5,24,400,31,23,54,Wednesday
2023,5,24,300,22,26,48,Wednesday
2023,5,24,200,23,50,73,Wednesday
2023,5,24,100,30,38,68,Wednesday
2023,5,23,2400,61,70,131,Tuesday
2023,5,23,2300,59,215,274,Tuesday
2023,5,23,2200,86,458,544,Tuesday
2023,5,23,2100,172,703,875,Tuesday
2023,5,23,2000,211,626,837,Tuesday
2023,5,23,1900,263,318,581,Tuesday
2023,5,23,1800,273,458,731,Tuesday
2023,5,23,1700,327,508,835,Tuesday
2023,5,23,1600,404,587,991,Tuesday
2023,5,23,1500,477,770,1247,Tuesday
2023,5,23,1400,533,661,1194,Tuesday
2023,5,23,1300,618,640,1258,Tuesday
2023,5,23,1200,716,477,1193,Tuesday
2023,5,23,1100,753,335,1088,Tuesday
2023,5,23,1000,601,248,849,Tuesday
2023,5,23,900,499,168,667,Tuesday
2023,5,23,800,302,109,411,Tuesday
2023,5,23,700,147,51,198,Tuesday
2023,5,23,600,53,29,82,Tuesday
2023,5,23,500,26,16,42,Tuesday
2023,5,23,400,13,21,34,Tuesday
2023,5,23,300,12,23,35,Tuesday
2023,5,23,200,13,41,54,Tuesday
2023,5,23,100,19,48,67,Tuesday
2023,5,22,2400,33,115,148,Monday
2023,5,22,2300,57,264,321,Monday
2023,5,22,2200,83,408,491,Monday
2023,5,22,2100,137,750,887,Monday
2023,5,22,2000,175,1047,1222,Monday
2023,5,22,1900,205,1478,1683,Monday
2023,5,22,1800,322,1751,2073,Monday
2023,5,22,1700,409,2363,2772,Monday
2023,5,22,1600,528,2118,2646,Monday
2023,5,22,1500,606,1992,2598,Monday
2023,5,22,1400,708,1889,2597,Monday
2023,5,22,1300,811,1684,2495,Monday
2023,5,22,1200,881,1419,2300,Monday
2023,5,22,1100,879,707,1586,Monday
2023,5,22,1000,704,387,1091,Monday
2023,5,22,900,502,145,647,Monday
2023,5,22,800,302,71,373,Monday
2023,5,22,700,138,39,177,Monday
2023,5,22,600,66,19,85,Monday
2023,5,22,500,28,16,44,Monday
2023,5,22,400,31,25,56,Monday
2023,5,22,300,24,25,49,Monday
2023,5,22,200,25,46,71,Monday
2023,5,22,100,26,81,107,Monday
2023,5,21,2400,42,141,183,Sunday
2023,5,21,2300,67,267,334,Sunday
2023,5,21,2200,78,443,521,Sunday
2023,5,21,2100,155,705,860,Sunday
2023,5,21,2000,233,931,1164,Sunday
2023,5,21,1900,299,1075,1374,Sunday
2023,5,21,1800,350,1158,1508,Sunday
2023,5,21,1700,517,1421,1938,Sunday
2023,5,21,1600,646,1200,1846,Sunday
2023,5,21,1500,839,1028,1867,Sunday
2023,5,21,1400,935,903,1838,Sunday
2023,5,21,1300,1030,710,1740,Sunday
2023,5,21,1200,1045,510,1555,Sunday
2023,5,21,1100,964,345,1309,Sunday
2023,5,21,1000,857,205,1062,Sunday
2023,5,21,900,575,110,685,Sunday
2023,5,21,800,351,68,419,Sunday
2023,5,21,700,151,28,179,Sunday
2023,5,21,600,65,20,85,Sunday
2023,5,21,500,32,13,45,Sunday
2023,5,21,400,23,13,36,Sunday
2023,5,21,300,19,33,52,Sunday
2023,5,21,200,21,37,58,Sunday
2023,5,21,100,35,64,99,Sunday
2023,5,20,2400,44,105,149,Saturday
2023,5,20,2300,69,171,240,Saturday
2023,5,20,2200,135,316,451,Saturday
2023,5,20,2100,179,543,722,Saturday
2023,5,20,2000,261,632,893,Saturday
2023,5,20,1900,345,761,1106,Saturday
2023,5,20,1800,425,802,1227,Saturday
2023,5,20,1700,526,883,1409,Saturday
2023,5,20,1600,754,813,1567,Saturday
2023,5,20,1500,911,727,1638,Saturday
2023,5,20,1400,1109,577,1686,Saturday
2023,5,20,1300,1150,504,1654,Saturday
2023,5,20,1200,1383,381,1764,Saturday
2023,5,20,1100,1287,280,1567,Saturday
2023,5,20,1000,1152,217,1369,Saturday
2023,5,20,900,698,154,852,Saturday
2023,5,20,800,467,91,558,Saturday
2023,5,20,700,226,51,277,Saturday
2023,5,20,600,98,37,135,Saturday
2023,5,20,500,33,31,64,Saturday
2023,5,20,400,26,46,72,Saturday
2023,5,20,300,31,45,76,Saturday
2023,5,20,200,39,45,84,Saturday
2023,5,20,100,62,71,133,Saturday
2023,5,19,2400,98,110,208,Friday
2023,5,19,2300,173,186,359,Friday
2023,5,19,2200,306,272,578,Friday
2023,5,19,2100,519,373,892,Friday
2023,5,19,2000,881,483,1364,Friday
2023,5,19,1900,1121,580,1701,Friday
2023,5,19,1800,1280,743,2023,Friday
2023,5,19,1700,1269,780,2049,Friday
2023,5,19,1600,1341,775,2116,Friday
2023,5,19,1500,1248,649,1897,Friday
2023,5,19,1400,1108,718,1826,Friday
2023,5,19,1300,1159,444,1603,Friday
2023,5,19,1200,1371,405,1776,Friday
2023,5,19,1100,1183,357,1540,Friday
2023,5,19,1000,1076,304,1380,Friday
2023,5,19,900,787,190,977,Friday
2023,5,19,800,522,79,601,Friday
2023,5,19,700,285,45,330,Friday
2023,5,19,600,107,40,147,Friday
2023,5,19,500,53,37,90,Friday
2023,5,19,400,26,32,58,Friday
2023,5,19,300,32,31,63,Friday
2023,5,19,200,46,56,102,Friday
2023,5,19,100,50,31,81,Friday
2023,5,18,2400,70,80,150,Thursday
2023,5,18,2300,130,193,323,Thursday
2023,5,18,2200,213,219,432,Thursday
2023,5,18,2100,470,346,816,Thursday
2023,5,18,2000,705,413,1118,Thursday
2023,5,18,1900,764,528,1292,Thursday
2023,5,18,1800,751,616,1367,Thursday
2023,5,18,1700,681,646,1327,Thursday
2023,5,18,1600,730,594,1324,Thursday
2023,5,18,1500,679,518,1197,Thursday
2023,5,18,1400,677,496,1173,Thursday
2023,5,18,1300,698,410,1108,Thursday
2023,5,18,1200,905,330,1235,Thursday
2023,5,18,1100,834,252,1086,Thursday
2023,5,18,1000,736,208,944,Thursday
2023,5,18,900,488,199,687,Thursday
2023,5,18,800,348,58,406,Thursday
2023,5,18,700,181,40,221,Thursday
2023,5,18,600,97,29,126,Thursday
2023,5,18,500,34,49,83,Thursday
2023,5,18,400,25,28,53,Thursday
2023,5,18,300,23,33,56,Thursday
2023,5,18,200,29,20,49,Thursday
2023,5,18,100,49,20,69,Thursday
2023,5,17,2400,45,68,113,Wednesday
2023,5,17,2300,76,156,232,Wednesday
2023,5,17,2200,116,177,293,Wednesday
2023,5,17,2100,191,309,500,Wednesday
2023,5,17,2000,255,372,627,Wednesday
2023,5,17,1900,294,492,786,Wednesday
2023,5,17,1800,314,638,952,Wednesday
2023,5,17,1700,387,535,922,Wednesday
2023,5,17,1600,419,576,995,Wednesday
2023,5,17,1500,477,560,1037,Wednesday
2023,5,17,1400,514,440,954,Wednesday
2023,5,17,1300,520,372,892,Wednesday
2023,5,17,1200,665,310,975,Wednesday
2023,5,17,1100,681,225,906,Wednesday
2023,5,17,1000,513,216,729,Wednesday
2023,5,17,900,430,190,620,Wednesday
2023,5,17,800,296,63,359,Wednesday
2023,5,17,700,161,57,218,Wednesday
2023,5,17,600,57,38,95,Wednesday
2023,5,17,500,40,40,80,Wednesday
2023,5,17,400,17,16,33,Wednesday
2023,5,17,300,19,26,45,Wednesday
2023,5,17,200,30,20,50,Wednesday
2023,5,17,100,31,23,54,Wednesday
2023,5,16,2400,51,68,119,Tuesday
2023,5,16,2300,60,156,216,Tuesday
2023,5,16,2200,86,186,272,Tuesday
2023,5,16,2100,154,242,396,Tuesday
2023,5,16,2000,213,380,593,Tuesday
2023,5,16,1900,239,399,638,Tuesday
2023,5,16,1800,274,532,806,Tuesday
2023,5,16,1700,311,530,841,Tuesday
2023,5,16,1600,392,500,892,Tuesday
2023,5,16,1500,437,488,925,Tuesday
2023,5,16,1400,457,506,963,Tuesday
2023,5,16,1300,529,370,899,Tuesday
2023,5,16,1200,610,251,861,Tuesday
2023,5,16,1100,625,230,855,Tuesday
2023,5,16,1000,514,223,737,Tuesday
2023,5,16,900,403,218,621,Tuesday
2023,5,16,800,261,62,323,Tuesday
2023,5,16,700,144,48,192,Tuesday
2023,5,16,600,64,33,97,Tuesday
2023,5,16,500,31,25,56,Tuesday
2023,5,16,400,18,22,40,Tuesday
2023,5,16,300,18,21,39,Tuesday
2023,5,16,200,28,21,49,Tuesday
2023,5,16,100,25,19,44,Tuesday
2023,5,15,2400,63,70,133,Monday
2023,5,15,2300,57,135,192,Monday
2023,5,15,2200,69,220,289,Monday
2023,5,15,2100,133,287,420,Monday
2023,5,15,2000,183,387,570,Monday
2023,5,15,1900,252,504,756,Monday
2023,5,15,1800,275,603,878,Monday
2023,5,15,1700,344,623,967,Monday
2023,5,15,1600,394,639,1033,Monday
2023,5,15,1500,498,566,1064,Monday
2023,5,15,1400,534,485,1019,Monday
2023,5,15,1300,632,386,1018,Monday
2023,5,15,1200,728,294,1022,Monday
2023,5,15,1100,752,249,1001,Monday
2023,5,15,1000,600,199,799,Monday
2023,5,15,900,445,155,600,Monday
2023,5,15,800,294,62,356,Monday
2023,5,15,700,155,32,187,Monday
2023,5,15,600,77,28,105,Monday
2023,5,15,500,36,15,51,Monday
2023,5,15,400,13,18,31,Monday
2023,5,15,300,23,25,48,Monday
2023,5,15,200,12,26,38,Monday
2023,5,15,100,16,15,31,Monday
2023,5,14,2400,32,77,109,Sunday
2023,5,14,2300,65,171,236,Sunday
2023,5,14,2200,90,274,364,Sunday
2023,5,14,2100,141,361,502,Sunday
2023,5,14,2000,233,602,835,Sunday
2023,5,14,1900,246,732,978,Sunday
2023,5,14,1800,329,866,1195,Sunday
2023,5,14,1700,437,980,1417,Sunday
2023,5,14,1600,520,878,1398,Sunday
2023,5,14,1500,631,885,1516,Sunday
2023,5,14,1400,654,687,1341,Sunday
2023,5,14,1300,689,589,1278,Sunday
2023,5,14,1200,769,466,1235,Sunday
2023,5,14,1100,704,290,994,Sunday
2023,5,14,1000,555,190,745,Sunday
2023,5,14,900,392,86,478,Sunday
2023,5,14,800,208,60,268,Sunday
2023,5,14,700,104,24,128,Sunday
2023,5,14,600,39,12,51,Sunday
2023,5,14,500,16,17,33,Sunday
2023,5,14,400,8,11,19,Sunday
2023,5,14,300,19,26,45,Sunday
2023,5,14,200,29,30,59,Sunday
2023,5,14,100,31,38,69,Sunday
2023,5,13,2400,43,51,94,Saturday
2023,5,13,2300,53,111,164,Saturday
2023,5,13,2200,92,222,314,Saturday
2023,5,13,2100,129,332,461,Saturday
2023,5,13,2000,204,433,637,Saturday
2023,5,13,1900,212,554,766,Saturday
2023,5,13,1800,333,679,1012,Saturday
2023,5,13,1700,368,745,1113,Saturday
2023,5,13,1600,452,706,1158,Saturday
2023,5,13,1500,527,596,1123,Saturday
2023,5,13,1400,580,537,1117,Saturday
2023,5,13,1300,685,494,1179,Saturday
2023,5,13,1200,760,401,1161,Saturday
2023,5,13,1100,769,285,1054,Saturday
2023,5,13,1000,595,226,821,Saturday
2023,5,13,900,450,232,682,Saturday
2023,5,13,800,258,45,303,Saturday
2023,5,13,700,128,42,170,Saturday
2023,5,13,600,57,27,84,Saturday
2023,5,13,500,14,37,51,Saturday
2023,5,13,400,18,19,37,Saturday
2023,5,13,300,20,31,51,Saturday
2023,5,13,200,30,37,67,Saturday
2023,5,13,100,26,28,54,Saturday
2023,5,12,2400,49,51,100,Friday
2023,5,12,2300,94,122,216,Friday
2023,5,12,2200,133,209,342,Friday
2023,5,12,2100,217,332,549,Friday
2023,5,12,2000,360,404,764,Friday
2023,5,12,1900,430,467,897,Friday
2023,5,12,1800,500,607,1107,Friday
2023,5,12,1700,632,583,1215,Friday
2023,5,12,1600,601,640,1241,Friday
2023,5,12,1500,604,612,1216,Friday
2023,5,12,1400,611,521,1132,Friday
2023,5,12,1300,596,469,1065,Friday
2023,5,12,1200,717,378,1095,Friday
2023,5,12,1100,736,323,1059,Friday
2023,5,12,1000,601,242,843,Friday
2023,5,12,900,423,236,659,Friday
2023,5,12,800,266,75,341,Friday
2023,5,12,700,161,45,206,Friday
2023,5,12,600,70,39,109,Friday
2023,5,12,500,34,22,56,Friday
2023,5,12,400,23,31,54,Friday
2023,5,12,300,24,29,53,Friday
2023,5,12,200,20,35,55,Friday
2023,5,12,100,35,15,50,Friday
2023,5,11,2400,53,64,117,Thursday
2023,5,11,2300,69,151,220,Thursday
2023,5,11,2200,110,180,290,Thursday
2023,5,11,2100,193,256,449,Thursday
2023,5,11,2000,270,314,584,Thursday
2023,5,11,1900,319,453,772,Thursday
2023,5,11,1800,301,583,884,Thursday
2023,5,11,1700,397,616,1013,Thursday
2023,5,11,1600,408,560,968,Thursday
2023,5,11,1500,511,532,1043,Thursday
2023,5,11,1400,493,343,836,Thursday
2023,5,11,1300,523,363,886,Thursday
2023,5,11,1200,607,351,958,Thursday
2023,5,11,1100,663,226,889,Thursday
2023,5,11,1000,549,224,773,Thursday
2023,5,11,900,387,195,582,Thursday
2023,5,11,800,266,60,326,Thursday
2023,5,11,700,161,50,211,Thursday
2023,5,11,600,73,29,102,Thursday
2023,5,11,500,45,29,74,Thursday
2023,5,11,400,28,31,59,Thursday
2023,5,11,300,13,35,48,Thursday
2023,5,11,200,25,20,45,Thursday
2023,5,11,100,39,21,60,Thursday
2023,5,10,2400,40,56,96,Wednesday
2023,5,10,2300,67,143,210,Wednesday
2023,5,10,2200,73,184,257,Wednesday
2023,5,10,2100,114,218,332,Wednesday
2023,5,10,2000,188,327,515,Wednesday
2023,5,10,1900,205,376,581,Wednesday
2023,5,10,1800,268,456,724,Wednesday
2023,5,10,1700,317,470,787,Wednesday
2023,5,10,1600,326,503,829,Wednesday
2023,5,10,1500,411,450,861,Wednesday
2023,5,10,1400,419,410,829,Wednesday
2023,5,10,1300,493,376,869,Wednesday
2023,5,10,1200,560,359,919,Wednesday
2023,5,10,1100,561,304,865,Wednesday
2023,5,10,1000,455,251,706,Wednesday
2023,5,10,900,300,215,515,Wednesday
2023,5,10,800,234,74,308,Wednesday
2023,5,10,700,137,41,178,Wednesday
2023,5,10,600,51,34,85,Wednesday
2023,5,10,500,32,29,61,Wednesday
2023,5,10,400,16,35,51,Wednesday
2023,5,10,300,19,34,53,Wednesday
2023,5,10,200,28,34,62,Wednesday
2023,5,10,100,35,21,56,Wednesday
2023,5,9,2400,40,52,92,Tuesday
2023,5,9,2300,55,115,170,Tuesday
2023,5,9,2200,65,162,227,Tuesday
2023,5,9,2100,130,236,366,Tuesday
2023,5,9,2000,173,315,488,Tuesday
2023,5,9,1900,204,353,557,Tuesday
2023,5,9,1800,211,478,689,Tuesday
2023,5,9,1700,254,512,766,Tuesday
2023,5,9,1600,320,454,774,Tuesday
2023,5,9,1500,409,474,883,Tuesday
2023,5,9,1400,384,329,713,Tuesday
2023,5,9,1300,460,336,796,Tuesday
2023,5,9,1200,509,335,844,Tuesday
2023,5,9,1100,512,263,775,Tuesday
2023,5,9,1000,425,225,650,Tuesday
2023,5,9,900,313,228,541,Tuesday
2023,5,9,800,200,61,261,Tuesday
2023,5,9,700,129,49,178,Tuesday
2023,5,9,600,58,28,86,Tuesday
2023,5,9,500,25,38,63,Tuesday
2023,5,9,400,22,23,45,Tuesday
2023,5,9,300,21,20,41,Tuesday
2023,5,9,200,30,30,60,Tuesday
2023,5,9,100,26,15,41,Tuesday
2023,5,8,2400,42,72,114,Monday
2023,5,8,2300,57,154,211,Monday
2023,5,8,2200,57,184,241,Monday
2023,5,8,2100,130,277,407,Monday
2023,5,8,2000,185,353,538,Monday
2023,5,8,1900,185,400,585,Monday
2023,5,8,1800,272,541,813,Monday
2023,5,8,1700,330,577,907,Monday
2023,5,8,1600,374,512,886,Monday
2023,5,8,1500,497,463,960,Monday
2023,5,8,1400,502,376,878,Monday
2023,5,8,1300,550,446,996,Monday
2023,5,8,1200,622,362,984,Monday
2023,5,8,1100,606,307,913,Monday
2023,5,8,1000,486,213,699,Monday
2023,5,8,900,332,164,496,Monday
2023,5,8,800,234,56,290,Monday
2023,5,8,700,120,46,166,Monday
2023,5,8,600,66,20,86,Monday
2023,5,8,500,24,28,52,Monday
2023,5,8,400,23,22,45,Monday
2023,5,8,300,17,19,36,Monday
2023,5,8,200,16,35,51,Monday
2023,5,8,100,18,20,38,Monday
2023,5,7,2400,36,64,100,Sunday
2023,5,7,2300,50,193,243,Sunday
2023,5,7,2200,77,279,356,Sunday
2023,5,7,2100,122,376,498,Sunday
2023,5,7,2000,198,515,713,Sunday
2023,5,7,1900,261,704,965,Sunday
2023,5,7,1800,345,880,1225,Sunday
2023,5,7,1700,432,1082,1514,Sunday
2023,5,7,1600,511,936,1447,Sunday
2023,5,7,1500,559,978,1537,Sunday
2023,5,7,1400,617,775,1392,Sunday
2023,5,7,1300,697,702,1399,Sunday
2023,5,7,1200,742,567,1309,Sunday
2023,5,7,1100,677,344,1021,Sunday
2023,5,7,1000,592,209,801,Sunday
2023,5,7,900,351,115,466,Sunday
2023,5,7,800,189,49,238,Sunday
2023,5,7,700,92,35,127,Sunday
2023,5,7,600,56,21,77,Sunday
2023,5,7,500,24,20,44,Sunday
2023,5,7,400,26,23,49,Sunday
2023,5,7,300,15,34,49,Sunday
2023,5,7,200,25,34,59,Sunday
2023,5,7,100,35,40,75,Sunday
2023,5,6,2400,26,102,128,Saturday
2023,5,6,2300,58,120,178,Saturday
2023,5,6,2200,76,212,288,Saturday
2023,5,6,2100,113,299,412,Saturday
2023,5,6,2000,174,437,611,Saturday
2023,5,6,1900,190,505,695,Saturday
2023,5,6,1800,278,682,960,Saturday
2023,5,6,1700,309,691,1000,Saturday
2023,5,6,1600,394,657,1051,Saturday
2023,5,6,1500,505,616,1121,Saturday
2023,5,6,1400,550,553,1103,Saturday
2023,5,6,1300,649,472,1121,Saturday
2023,5,6,1200,715,358,1073,Saturday
2023,5,6,1100,734,295,1029,Saturday
2023,5,6,1000,644,228,872,Saturday
2023,5,6,900,429,204,633,Saturday
2023,5,6,800,234,55,289,Saturday
2023,5,6,700,126,33,159,Saturday
2023,5,6,600,54,35,89,Saturday
2023,5,6,500,13,31,44,Saturday
2023,5,6,400,29,35,64,Saturday
2023,5,6,300,24,41,65,Saturday
2023,5,6,200,27,54,81,Saturday
2023,5,6,100,36,61,97,Saturday
2023,5,5,2400,51,80,131,Friday
2023,5,5,2300,73,155,228,Friday
2023,5,5,2200,101,216,317,Friday
2023,5,5,2100,225,294,519,Friday
2023,5,5,2000,335,341,676,Friday
2023,5,5,1900,482,502,984,Friday
2023,5,5,1800,475,574,1049,Friday
2023,5,5,1700,527,772,1299,Friday
2023,5,5,1600,603,673,1276,Friday
2023,5,5,1500,655,584,1239,Friday
2023,5,5,1400,639,503,1142,Friday
2023,5,5,1300,669,436,1105,Friday
2023,5,5,1200,710,353,1063,Friday
2023,5,5,1100,777,301,1078,Friday
2023,5,5,1000,604,218,822,Friday
2023,5,5,900,420,221,641,Friday
2023,5,5,800,296,60,356,Friday
2023,5,5,700,160,31,191,Friday
2023,5,5,600,78,37,115,Friday
2023,5,5,500,35,32,67,Friday
2023,5,5,400,13,33,46,Friday
2023,5,5,300,23,26,49,Friday
2023,5,5,200,27,25,52,Friday
2023,5,5,100,15,25,40,Friday
2023,5,4,2400,68,56,124,Thursday
2023,5,4,2300,59,190,249,Thursday
2023,5,4,2200,117,386,503,Thursday
2023,5,4,2100,158,399,557,Thursday
2023,5,4,2000,279,251,530,Thursday
2023,5,4,1900,286,220,506,Thursday
2023,5,4,1800,335,280,615,Thursday
2023,5,4,1700,375,493,868,Thursday
2023,5,4,1600,398,635,1033,Thursday
2023,5,4,1500,459,549,1008,Thursday
2023,5,4,1400,438,432,870,Thursday
2023,5,4,1300,508,395,903,Thursday
2023,5,4,1200,558,339,897,Thursday
2023,5,4,1100,611,247,858,Thursday
2023,5,4,1000,552,225,777,Thursday
2023,5,4,900,403,168,571,Thursday
2023,5,4,800,255,53,308,Thursday
2023,5,4,700,133,46,179,Thursday
2023,5,4,600,72,30,102,Thursday
2023,5,4,500,31,30,61,Thursday
2023,5,4,400,18,18,36,Thursday
2023,5,4,300,20,27,47,Thursday
2023,5,4,200,22,26,48,Thursday
2023,5,4,100,36,11,47,Thursday
2023,5,3,2400,59,51,110,Wednesday
2023,5,3,2300,73,145,218,Wednesday
2023,5,3,2200,86,155,241,Wednesday
2023,5,3,2100,140,226,366,Wednesday
2023,5,3,2000,202,331,533,Wednesday
2023,5,3,1900,189,419,608,Wednesday
2023,5,3,1800,278,510,788,Wednesday
2023,5,3,1700,301,531,832,Wednesday
2023,5,3,1600,375,523,898,Wednesday
2023,5,3,1500,405,477,882,Wednesday
2023,5,3,1400,450,395,845,Wednesday
2023,5,3,1300,477,338,815,Wednesday
2023,5,3,1200,567,289,856,Wednesday
2023,5,3,1100,533,234,767,Wednesday
2023,5,3,1000,480,223,703,Wednesday
2023,5,3,900,367,166,533,Wednesday
2023,5,3,800,221,63,284,Wednesday
2023,5,3,700,137,46,183,Wednesday
2023,5,3,600,71,23,94,Wednesday
2023,5,3,500,36,30,66,Wednesday
2023,5,3,400,14,32,46,Wednesday
2023,5,3,300,20,34,54,Wednesday
2023,5,3,200,18,30,48,Wednesday
2023,5,3,100,30,16,46,Wednesday
2023,5,2,2400,48,50,98,Tuesday
2023,5,2,2300,57,120,177,Tuesday
2023,5,2,2200,97,184,281,Tuesday
2023,5,2,2100,131,247,378,Tuesday
2023,5,2,2000,172,299,471,Tuesday
2023,5,2,1900,180,421,601,Tuesday
2023,5,2,1800,222,522,744,Tuesday
2023,5,2,1700,326,513,839,Tuesday
2023,5,2,1600,362,544,906,Tuesday
2023,5,2,1500,362,464,826,Tuesday
2023,5,2,1400,437,361,798,Tuesday
2023,5,2,1300,453,374,827,Tuesday
2023,5,2,1200,573,303,876,Tuesday
2023,5,2,1100,525,251,776,Tuesday
2023,5,2,1000,484,210,694,Tuesday
2023,5,2,900,290,192,482,Tuesday
2023,5,2,800,232,53,285,Tuesday
2023,5,2,700,124,58,182,Tuesday
2023,5,2,600,61,40,101,Tuesday
2023,5,2,500,23,18,41,Tuesday
2023,5,2,400,19,36,55,Tuesday
2023,5,2,300,27,40,67,Tuesday
2023,5,2,200,9,28,37,Tuesday
2023,5,2,100,39,18,57,Tuesday
2023,5,1,2400,45,55,100,Monday
2023,5,1,2300,67,143,210,Monday
2023,5,1,2200,72,156,228,Monday
2023,5,1,2100,127,227,354,Monday
2023,5,1,2000,169,326,495,Monday
2023,5,1,1900,212,443,655,Monday
2023,5,1,1800,268,567,835,Monday
2023,5,1,1700,298,716,1014,Monday
2023,5,1,1600,426,609,1035,Monday
2023,5,1,1500,471,587,1058,Monday
2023,5,1,1400,519,455,974,Monday
2023,5,1,1300,605,436,1041,Monday
2023,5,1,1200,645,395,1040,Monday
2023,5,1,1100,615,264,879,Monday
2023,5,1,1000,528,238,766,Monday
2023,5,1,900,353,167,520,Monday
2023,5,1,800,245,45,290,Monday
2023,5,1,700,133,43,176,Monday
2023,5,1,600,75,25,100,Monday
2023,5,1,500,33,17,50,Monday
2023,5,1,400,10,23,33,Monday
2023,5,1,300,22,27,49,Monday
2023,5,1,200,20,74,94,Monday
2023,5,1,100,19,63,82,Monday
2023,4,30,2400,25,286,311,Sunday
2023,4,30,2300,37,734,771,Sunday
2023,4,30,2200,68,245,313,Sunday
2023,4,30,2100,131,185,316,Sunday
2023,4,30,2000,196,295,491,Sunday
2023,4,30,1900,300,431,731,Sunday
2023,4,30,1800,347,669,1016,Sunday
2023,4,30,1700,350,673,1023,Sunday
2023,4,30,1600,438,771,1209,Sunday
2023,4,30,1500,520,878,1398,Sunday
2023,4,30,1400,543,888,1431,Sunday
2023,4,30,1300,605,667,1272,Sunday
2023,4,30,1200,664,534,1198,Sunday
2023,4,30,1100,603,317,920,Sunday
2023,4,30,1000,581,195,776,Sunday
2023,4,30,900,374,101,475,Sunday
2023,4,30,800,230,40,270,Sunday
2023,4,30,700,83,30,113,Sunday
2023,4,30,600,37,10,47,Sunday
2023,4,30,500,26,18,44,Sunday
2023,4,30,400,11,15,26,Sunday
2023,4,30,300,14,23,37,Sunday
2023,4,30,200,19,26,45,Sunday
2023,4,30,100,23,46,69,Sunday
2023,4,29,2400,42,59,101,Saturday
2023,4,29,2300,55,115,170,Saturday
2023,4,29,2200,92,195,287,Saturday
2023,4,29,2100,109,266,375,Saturday
2023,4,29,2000,171,371,542,Saturday
2023,4,29,1900,224,585,809,Saturday
2023,4,29,1800,261,842,1103,Saturday
2023,4,29,1700,313,890,1203,Saturday
2023,4,29,1600,382,804,1186,Saturday
2023,4,29,1500,474,656,1130,Saturday
2023,4,29,1400,496,510,1006,Saturday
2023,4,29,1300,583,382,965,Saturday
2023,4,29,1200,786,311,1097,Saturday
2023,4,29,1100,810,265,1075,Saturday
2023,4,29,1000,819,180,999,Saturday
2023,4,29,900,619,172,791,Saturday
2023,4,29,800,305,50,355,Saturday
2023,4,29,700,119,35,154,Saturday
2023,4,29,600,55,34,89,Saturday
2023,4,29,500,21,20,41,Saturday
2023,4,29,400,16,28,44,Saturday
2023,4,29,300,18,23,41,Saturday
2023,4,29,200,23,40,63,Saturday
2023,4,29,100,35,25,60,Saturday
2023,4,28,2400,49,50,99,Friday
2023,4,28,2300,84,140,224,Friday
2023,4,28,2200,126,187,313,Friday
2023,4,28,2100,204,248,452,Friday
2023,4,28,2000,341,323,664,Friday
2023,4,28,1900,466,571,1037,Friday
2023,4,28,1800,497,399,896,Friday
2023,4,28,1700,511,623,1134,Friday
2023,4,28,1600,572,592,1164,Friday
2023,4,28,1500,577,517,1094,Friday
2023,4,28,1400,548,451,999,Friday
2023,4,28,1300,592,431,1023,Friday
2023,4,28,1200,574,370,944,Friday
2023,4,28,1100,637,258,895,Friday
2023,4,28,1000,557,240,797,Friday
2023,4,28,900,362,196,558,Friday
2023,4,28,800,256,51,307,Friday
2023,4,28,700,122,43,165,Friday
2023,4,28,600,56,24,80,Friday
2023,4,28,500,39,25,64,Friday
2023,4,28,400,20,32,52,Friday
2023,4,28,300,27,36,63,Friday
2023,4,28,200,28,39,67,Friday
2023,4,28,100,34,21,55,Friday
2023,4,27,2400,46,57,103,Thursday
2023,4,27,2300,75,130,205,Thursday
2023,4,27,2200,91,158,249,Thursday
2023,4,27,2100,153,238,391,Thursday
2023,4,27,2000,223,321,544,Thursday
2023,4,27,1900,285,438,723,Thursday
2023,4,27,1800,315,517,832,Thursday
2023,4,27,1700,344,605,949,Thursday
2023,4,27,1600,405,509,914,Thursday
2023,4,27,1500,411,504,915,Thursday
2023,4,27,1400,431,388,819,Thursday
2023,4,27,1300,488,340,828,Thursday
2023,4,27,1200,543,295,838,Thursday
2023,4,27,1100,601,230,831,Thursday
2023,4,27,1000,464,226,690,Thursday
2023,4,27,900,406,183,589,Thursday
2023,4,27,800,274,66,340,Thursday
2023,4,27,700,129,43,172,Thursday
2023,4,27,600,67,27,94,Thursday
2023,4,27,500,14,29,43,Thursday
2023,4,27,400,20,27,47,Thursday
2023,4,27,300,23,19,42,Thursday
2023,4,27,200,28,32,60,Thursday
2023,4,27,100,29,25,54,Thursday
2023,4,26,2400,59,60,119,Wednesday
2023,4,26,2300,71,123,194,Wednesday
2023,4,26,2200,76,157,233,Wednesday
2023,4,26,2100,120,226,346,Wednesday
2023,4,26,2000,193,307,500,Wednesday
2023,4,26,1900,205,287,492,Wednesday
2023,4,26,1800,229,439,668,Wednesday
2023,4,26,1700,259,452,711,Wednesday
2023,4,26,1600,339,431,770,Wednesday
2023,4,26,1500,394,344,738,Wednesday
2023,4,26,1400,342,339,681,Wednesday
2023,4,26,1300,420,331,751,Wednesday
2023,4,26,1200,424,279,703,Wednesday
2023,4,26,1100,440,208,648,Wednesday
2023,4,26,1000,424,191,615,Wednesday
2023,4,26,900,336,169,505,Wednesday
2023,4,26,800,225,60,285,Wednesday
2023,4,26,700,110,42,152,Wednesday
2023,4,26,600,62,40,102,Wednesday
2023,4,26,500,25,24,49,Wednesday
2023,4,26,400,22,15,37,Wednesday
2023,4,26,300,19,27,46,Wednesday
2023,4,26,200,21,18,39,Wednesday
2023,4,26,100,24,18,42,Wednesday
2023,4,25,2400,42,45,87,Tuesday
2023,4,25,2300,53,133,186,Tuesday
2023,4,25,2200,82,166,248,Tuesday
2023,4,25,2100,121,224,345,Tuesday
2023,4,25,2000,157,233,390,Tuesday
2023,4,25,1900,173,344,517,Tuesday
2023,4,25,1800,226,390,616,Tuesday
2023,4,25,1700,229,473,702,Tuesday
2023,4,25,1600,308,434,742,Tuesday
2023,4,25,1500,323,410,733,Tuesday
2023,4,25,1400,327,328,655,Tuesday
2023,4,25,1300,407,331,738,Tuesday
2023,4,25,1200,451,242,693,Tuesday
2023,4,25,1100,415,239,654,Tuesday
2023,4,25,1000,416,204,620,Tuesday
2023,4,25,900,293,203,496,Tuesday
2023,4,25,800,208,58,266,Tuesday
2023,4,25,700,105,47,152,Tuesday
2023,4,25,600,66,27,93,Tuesday
2023,4,25,500,22,27,49,Tuesday
2023,4,25,400,18,29,47,Tuesday
2023,4,25,300,17,27,44,Tuesday
2023,4,25,200,30,24,54,Tuesday
2023,4,25,100,26,9,35,Tuesday
2023,4,24,2400,37,53,90,Monday
2023,4,24,2300,42,131,173,Monday
2023,4,24,2200,73,131,204,Monday
2023,4,24,2100,129,183,312,Monday
2023,4,24,2000,186,249,435,Monday
2023,4,24,1900,177,289,466,Monday
2023,4,24,1800,209,405,614,Monday
2023,4,24,1700,287,483,770,Monday
2023,4,24,1600,308,449,757,Monday
2023,4,24,1500,350,433,783,Monday
2023,4,24,1400,402,405,807,Monday
2023,4,24,1300,432,294,726,Monday
2023,4,24,1200,452,277,729,Monday
2023,4,24,1100,509,207,716,Monday
2023,4,24,1000,459,170,629,Monday
2023,4,24,900,310,150,460,Monday
2023,4,24,800,221,46,267,Monday
2023,4,24,700,110,42,152,Monday
2023,4,24,600,61,20,81,Monday
2023,4,24,500,25,19,44,Monday
2023,4,24,400,18,11,29,Monday
2023,4,24,300,17,24,41,Monday
2023,4,24,200,19,40,59,Monday
2023,4,24,100,23,29,52,Monday
2023,4,23,2400,33,53,86,Sunday
2023,4,23,2300,48,130,178,Sunday
2023,4,23,2200,67,186,253,Sunday
2023,4,23,2100,114,305,419,Sunday
2023,4,23,2000,169,773,942,Sunday
2023,4,23,1900,176,488,664,Sunday
2023,4,23,1800,244,531,775,Sunday
2023,4,23,1700,317,788,1105,Sunday
2023,4,23,1600,389,895,1284,Sunday
2023,4,23,1500,402,858,1260,Sunday
2023,4,23,1400,508,637,1145,Sunday
2023,4,23,1300,544,575,1119,Sunday
2023,4,23,1200,654,419,1073,Sunday
2023,4,23,1100,596,255,851,Sunday
2023,4,23,1000,522,156,678,Sunday
2023,4,23,900,448,103,551,Sunday
2023,4,23,800,208,49,257,Sunday
2023,4,23,700,88,18,106,Sunday
2023,4,23,600,45,7,52,Sunday
2023,4,23,500,17,18,35,Sunday
2023,4,23,400,16,19,35,Sunday
2023,4,23,300,20,26,46,Sunday
2023,4,23,200,19,22,41,Sunday
2023,4,23,100,25,27,52,Sunday
2023,4,22,2400,32,42,74,Saturday
2023,4,22,2300,45,100,145,Saturday
2023,4,22,2200,61,169,230,Saturday
2023,4,22,2100,85,204,289,Saturday
2023,4,22,2000,136,268,404,Saturday
2023,4,22,1900,137,462,599,Saturday
2023,4,22,1800,245,743,988,Saturday
2023,4,22,1700,283,901,1184,Saturday
2023,4,22,1600,351,658,1009,Saturday
2023,4,22,1500,373,533,906,Saturday
2023,4,22,1400,505,418,923,Saturday
2023,4,22,1300,512,395,907,Saturday
2023,4,22,1200,583,278,861,Saturday
2023,4,22,1100,616,221,837,Saturday
2023,4,22,1000,762,191,953,Saturday
2023,4,22,900,639,182,821,Saturday
2023,4,22,800,259,30,289,Saturday
2023,4,22,700,91,22,113,Saturday
2023,4,22,600,39,31,70,Saturday
2023,4,22,500,15,21,36,Saturday
2023,4,22,400,18,23,41,Saturday
2023,4,22,300,18,26,44,Saturday
2023,4,22,200,16,27,43,Saturday
2023,4,22,100,35,25,60,Saturday
2023,4,21,2400,48,45,93,Friday
2023,4,21,2300,69,118,187,Friday
2023,4,21,2200,88,145,233,Friday
2023,4,21,2100,153,168,321,Friday
2023,4,21,2000,244,270,514,Friday
2023,4,21,1900,315,305,620,Friday
2023,4,21,1800,380,460,840,Friday
2023,4,21,1700,413,589,1002,Friday
2023,4,21,1600,486,526,1012,Friday
2023,4,21,1500,451,461,912,Friday
2023,4,21,1400,425,375,800,Friday
2023,4,21,1300,452,332,784,Friday
2023,4,21,1200,450,303,753,Friday
2023,4,21,1100,482,254,736,Friday
2023,4,21,1000,458,202,660,Friday
2023,4,21,900,385,173,558,Friday
2023,4,21,800,221,49,270,Friday
2023,4,21,700,134,38,172,Friday
2023,4,21,600,64,40,104,Friday
2023,4,21,500,36,33,69,Friday
2023,4,21,400,24,25,49,Friday
2023,4,21,300,34,19,53,Friday
2023,4,21,200,35,20,55,Friday
2023,4,21,100,34,10,44,Friday
2023,4,20,2400,47,42,89,Thursday
2023,4,20,2300,63,117,180,Thursday
2023,4,20,2200,66,148,214,Thursday
2023,4,20,2100,159,185,344,Thursday
2023,4,20,2000,230,229,459,Thursday
2023,4,20,1900,226,271,497,Thursday
2023,4,20,1800,252,464,716,Thursday
2023,4,20,1700,260,512,772,Thursday
2023,4,20,1600,293,485,778,Thursday
2023,4,20,1500,319,423,742,Thursday
2023,4,20,1400,336,333,669,Thursday
2023,4,20,1300,363,296,659,Thursday
2023,4,20,1200,436,259,695,Thursday
2023,4,20,1100,465,190,655,Thursday
2023,4,20,1000,459,163,622,Thursday
2023,4,20,900,348,197,545,Thursday
2023,4,20,800,215,56,271,Thursday
2023,4,20,700,131,45,176,Thursday
2023,4,20,600,50,28,78,Thursday
2023,4,20,500,28,31,59,Thursday
2023,4,20,400,17,35,52,Thursday
2023,4,20,300,15,25,40,Thursday
2023,4,20,200,24,23,47,Thursday
2023,4,20,100,30,11,41,Thursday
2023,4,19,2400,41,35,76,Wednesday
2023,4,19,2300,58,111,169,Wednesday
2023,4,19,2200,64,133,197,Wednesday
2023,4,19,2100,93,145,238,Wednesday
2023,4,19,2000,150,219,369,Wednesday
2023,4,19,1900,173,261,434,Wednesday
2023,4,19,1800,211,332,543,Wednesday
2023,4,19,1700,219,456,675,Wednesday
2023,4,19,1600,258,373,631,Wednesday
2023,4,19,1500,277,342,619,Wednesday
2023,4,19,1400,282,314,596,Wednesday
2023,4,19,1300,335,439,774,Wednesday
2023,4,19,1200,357,211,568,Wednesday
2023,4,19,1100,368,222,590,Wednesday
2023,4,19,1000,357,132,489,Wednesday
2023,4,19,900,344,81,425,Wednesday
2023,4,19,800,198,58,256,Wednesday
2023,4,19,700,121,41,162,Wednesday
2023,4,19,600,45,24,69,Wednesday
2023,4,19,500,24,23,47,Wednesday
2023,4,19,400,15,29,44,Wednesday
2023,4,19,300,22,30,52,Wednesday
2023,4,19,200,27,39,66,Wednesday
2023,4,19,100,25,15,40,Wednesday
2023,4,18,2400,42,66,108,Tuesday
2023,4,18,2300,50,99,149,Tuesday
2023,4,18,2200,57,120,177,Tuesday
2023,4,18,2100,128,152,280,Tuesday
2023,4,18,2000,131,203,334,Tuesday
2023,4,18,1900,165,271,436,Tuesday
2023,4,18,1800,191,386,577,Tuesday
2023,4,18,1700,223,524,747,Tuesday
2023,4,18,1600,263,475,738,Tuesday
2023,4,18,1500,267,448,715,Tuesday
2023,4,18,1400,328,346,674,Tuesday
2023,4,18,1300,357,316,673,Tuesday
2023,4,18,1200,418,231,649,Tuesday
2023,4,18,1100,408,209,617,Tuesday
2023,4,18,1000,426,163,589,Tuesday
2023,4,18,900,422,193,615,Tuesday
2023,4,18,800,218,55,273,Tuesday
2023,4,18,700,88,49,137,Tuesday
2023,4,18,600,47,33,80,Tuesday
2023,4,18,500,22,23,45,Tuesday
2023,4,18,400,22,18,40,Tuesday
2023,4,18,300,15,26,41,Tuesday
2023,4,18,200,22,25,47,Tuesday
2023,4,18,100,26,16,42,Tuesday
2023,4,17,2400,42,50,92,Monday
2023,4,17,2300,42,115,157,Monday
2023,4,17,2200,56,99,155,Monday
2023,4,17,2100,103,184,287,Monday
2023,4,17,2000,156,235,391,Monday
2023,4,17,1900,167,302,469,Monday
2023,4,17,1800,205,429,634,Monday
2023,4,17,1700,209,478,687,Monday
2023,4,17,1600,302,472,774,Monday
2023,4,17,1500,306,467,773,Monday
2023,4,17,1400,332,365,697,Monday
2023,4,17,1300,428,299,727,Monday
2023,4,17,1200,442,286,728,Monday
2023,4,17,1100,503,233,736,Monday
2023,4,17,1000,422,127,549,Monday
2023,4,17,900,336,129,465,Monday
2023,4,17,800,192,34,226,Monday
2023,4,17,700,105,35,140,Monday
2023,4,17,600,50,25,75,Monday
2023,4,17,500,26,16,42,Monday
2023,4,17,400,15,14,29,Monday
2023,4,17,300,14,21,35,Monday
2023,4,17,200,21,31,52,Monday
2023,4,17,100,17,16,33,Monday
2023,4,16,2400,43,36,79,Sunday
2023,4,16,2300,46,95,141,Sunday
2023,4,16,2200,57,149,206,Sunday
2023,4,16,2100,66,249,315,Sunday
2023,4,16,2000,153,322,475,Sunday
2023,4,16,1900,168,486,654,Sunday
2023,4,16,1800,219,807,1026,Sunday
2023,4,16,1700,298,1131,1429,Sunday
2023,4,16,1600,351,941,1292,Sunday
2023,4,16,1500,379,784,1163,Sunday
2023,4,16,1400,406,716,1122,Sunday
2023,4,16,1300,470,574,1044,Sunday
2023,4,16,1200,556,466,1022,Sunday
2023,4,16,1100,582,296,878,Sunday
2023,4,16,1000,613,185,798,Sunday
2023,4,16,900,555,110,665,Sunday
2023,4,16,800,278,43,321,Sunday
2023,4,16,700,88,31,119,Sunday
2023,4,16,600,40,20,60,Sunday
2023,4,16,500,18,14,32,Sunday
2023,4,16,400,17,17,34,Sunday
2023,4,16,300,13,26,39,Sunday
2023,4,16,200,8,33,41,Sunday
2023,4,16,100,26,32,58,Sunday
2023,4,15,2400,33,58,91,Saturday
2023,4,15,2300,39,103,142,Saturday
2023,4,15,2200,61,140,201,Saturday
2023,4,15,2100,71,178,249,Saturday
2023,4,15,2000,131,292,423,Saturday
2023,4,15,1900,130,441,571,Saturday
2023,4,15,1800,196,803,999,Saturday
2023,4,15,1700,260,917,1177,Saturday
2023,4,15,1600,296,640,936,Saturday
2023,4,15,1500,321,550,871,Saturday
2023,4,15,1400,360,428,788,Saturday
2023,4,15,1300,443,371,814,Saturday
2023,4,15,1200,557,301,858,Saturday
2023,4,15,1100,538,250,788,Saturday
2023,4,15,1000,671,178,849,Saturday
2023,4,15,900,666,91,757,Saturday
2023,4,15,800,371,44,415,Saturday
2023,4,15,700,120,34,154,Saturday
2023,4,15,600,38,26,64,Saturday
2023,4,15,500,18,32,50,Saturday
2023,4,15,400,20,22,42,Saturday
2023,4,15,300,19,36,55,Saturday
2023,4,15,200,16,44,60,Saturday
2023,4,15,100,23,54,77,Saturday
2023,4,14,2400,46,59,105,Friday
2023,4,14,2300,61,106,167,Friday
2023,4,14,2200,101,167,268,Friday
2023,4,14,2100,138,182,320,Friday
2023,4,14,2000,232,329,561,Friday
2023,4,14,1900,317,292,609,Friday
2023,4,14,1800,385,555,940,Friday
2023,4,14,1700,346,648,994,Friday
2023,4,14,1600,411,548,959,Friday
2023,4,14,1500,425,463,888,Friday
2023,4,14,1400,398,425,823,Friday
2023,4,14,1300,414,372,786,Friday
2023,4,14,1200,446,269,715,Friday
2023,4,14,1100,509,225,734,Friday
2023,4,14,1000,539,194,733,Friday
2023,4,14,900,448,124,572,Friday
2023,4,14,800,239,50,289,Friday
2023,4,14,700,94,38,132,Friday
2023,4,14,600,49,28,77,Friday
2023,4,14,500,38,30,68,Friday
2023,4,14,400,30,37,67,Friday
2023,4,14,300,25,38,63,Friday
2023,4,14,200,24,45,69,Friday
2023,4,14,100,31,54,85,Friday
2023,4,13,2400,38,102,140,Thursday
2023,4,13,2300,62,92,154,Thursday
2023,4,13,2200,91,166,257,Thursday
2023,4,13,2100,143,181,324,Thursday
2023,4,13,2000,183,290,473,Thursday
2023,4,13,1900,206,352,558,Thursday
2023,4,13,1800,241,541,782,Thursday
2023,4,13,1700,301,803,1104,Thursday
2023,4,13,1600,320,421,741,Thursday
2023,4,13,1500,345,409,754,Thursday
2023,4,13,1400,334,374,708,Thursday
2023,4,13,1300,373,242,615,Thursday
2023,4,13,1200,438,225,663,Thursday
2023,4,13,1100,489,213,702,Thursday
2023,4,13,1000,544,133,677,Thursday
2023,4,13,900,447,118,565,Thursday
2023,4,13,800,289,59,348,Thursday
2023,4,13,700,102,49,151,Thursday
2023,4,13,600,65,40,105,Thursday
2023,4,13,500,29,19,48,Thursday
2023,4,13,400,18,38,56,Thursday
2023,4,13,300,24,30,54,Thursday
2023,4,13,200,32,41,73,Thursday
2023,4,13,100,32,43,75,Thursday
2023,4,12,2400,58,56,114,Wednesday
2023,4,12,2300,81,112,193,Wednesday
2023,4,12,2200,96,109,205,Wednesday
2023,4,12,2100,132,180,312,Wednesday
2023,4,12,2000,164,224,388,Wednesday
2023,4,12,1900,183,263,446,Wednesday
2023,4,12,1800,199,512,711,Wednesday
2023,4,12,1700,231,642,873,Wednesday
2023,4,12,1600,311,443,754,Wednesday
2023,4,12,1500,323,495,818,Wednesday
2023,4,12,1400,318,261,579,Wednesday
2023,4,12,1300,370,295,665,Wednesday
2023,4,12,1200,457,244,701,Wednesday
2023,4,12,1100,455,185,640,Wednesday
2023,4,12,1000,480,145,625,Wednesday
2023,4,12,900,499,109,608,Wednesday
2023,4,12,800,273,62,335,Wednesday
2023,4,12,700,98,44,142,Wednesday
2023,4,12,600,43,28,71,Wednesday
2023,4,12,500,30,32,62,Wednesday
2023,4,12,400,16,33,49,Wednesday
2023,4,12,300,16,32,48,Wednesday
2023,4,12,200,23,41,64,Wednesday
2023,4,12,100,30,71,101,Wednesday
2023,4,11,2400,44,84,128,Tuesday
2023,4,11,2300,66,91,157,Tuesday
2023,4,11,2200,81,143,224,Tuesday
2023,4,11,2100,98,155,253,Tuesday
2023,4,11,2000,136,220,356,Tuesday
2023,4,11,1900,156,260,416,Tuesday
2023,4,11,1800,184,609,793,Tuesday
2023,4,11,1700,217,688,905,Tuesday
2023,4,11,1600,250,338,588,Tuesday
2023,4,11,1500,278,256,534,Tuesday
2023,4,11,1400,269,236,505,Tuesday
2023,4,11,1300,287,243,530,Tuesday
2023,4,11,1200,332,210,542,Tuesday
2023,4,11,1100,409,231,640,Tuesday
2023,4,11,1000,536,174,710,Tuesday
2023,4,11,900,504,135,639,Tuesday
2023,4,11,800,265,68,333,Tuesday
2023,4,11,700,114,43,157,Tuesday
2023,4,11,600,48,35,83,Tuesday
2023,4,11,500,27,30,57,Tuesday
2023,4,11,400,16,21,37,Tuesday
2023,4,11,300,20,36,56,Tuesday
2023,4,11,200,10,36,46,Tuesday
2023,4,11,100,32,60,92,Tuesday
2023,4,10,2400,40,64,104,Monday
2023,4,10,2300,49,114,163,Monday
2023,4,10,2200,65,153,218,Monday
2023,4,10,2100,123,214,337,Monday
2023,4,10,2000,141,394,535,Monday
2023,4,10,1900,175,588,763,Monday
2023,4,10,1800,221,958,1179,Monday
2023,4,10,1700,331,975,1306,Monday
2023,4,10,1600,426,719,1145,Monday
2023,4,10,1500,521,501,1022,Monday
2023,4,10,1400,543,547,1090,Monday
2023,4,10,1300,644,540,1184,Monday
2023,4,10,1200,604,475,1079,Monday
2023,4,10,1100,607,372,979,Monday
2023,4,10,1000,572,182,754,Monday
2023,4,10,900,386,137,523,Monday
2023,4,10,800,275,53,328,Monday
2023,4,10,700,103,35,138,Monday
2023,4,10,600,40,17,57,Monday
2023,4,10,500,19,20,39,Monday
2023,4,10,400,14,18,32,Monday
2023,4,10,300,19,30,49,Monday
2023,4,10,200,15,41,56,Monday
2023,4,10,100,29,38,67,Monday
2023,4,9,2400,28,86,114,Sunday
2023,4,9,2300,57,105,162,Sunday
2023,4,9,2200,73,170,243,Sunday
2023,4,9,2100,116,297,413,Sunday
2023,4,9,2000,137,507,644,Sunday
2023,4,9,1900,176,966,1142,Sunday
2023,4,9,1800,208,1279,1487,Sunday
2023,4,9,1700,322,1223,1545,Sunday
2023,4,9,1600,406,912,1318,Sunday
2023,4,9,1500,454,994,1448,Sunday
2023,4,9,1400,550,1019,1569,Sunday
2023,4,9,1300,567,881,1448,Sunday
2023,4,9,1200,676,564,1240,Sunday
2023,4,9,1100,629,369,998,Sunday
2023,4,9,1000,539,191,730,Sunday
2023,4,9,900,475,87,562,Sunday
2023,4,9,800,275,48,323,Sunday
2023,4,9,700,92,25,117,Sunday
2023,4,9,600,33,20,53,Sunday
2023,4,9,500,16,20,36,Sunday
2023,4,9,400,14,13,27,Sunday
2023,4,9,300,11,9,20,Sunday
2023,4,9,200,18,30,48,Sunday
2023,4,9,100,10,38,48,Sunday
2023,4,8,2400,31,42,73,Saturday
2023,4,8,2300,51,68,119,Saturday
2023,4,8,2200,80,138,218,Saturday
2023,4,8,2100,111,227,338,Saturday
2023,4,8,2000,132,345,477,Saturday
2023,4,8,1900,173,494,667,Saturday
2023,4,8,1800,221,897,1118,Saturday
2023,4,8,1700,315,1109,1424,Saturday
2023,4,8,1600,373,863,1236,Saturday
2023,4,8,1500,467,716,1183,Saturday
2023,4,8,1400,517,561,1078,Saturday
2023,4,8,1300,612,476,1088,Saturday
2023,4,8,1200,741,391,1132,Saturday
2023,4,8,1100,744,257,1001,Saturday
2023,4,8,1000,747,176,923,Saturday
2023,4,8,900,719,92,811,Saturday
2023,4,8,800,368,42,410,Saturday
2023,4,8,700,124,18,142,Saturday
2023,4,8,600,51,20,71,Saturday
2023,4,8,500,21,17,38,Saturday
2023,4,8,400,10,18,28,Saturday
2023,4,8,300,11,19,30,Saturday
2023,4,8,200,17,24,41,Saturday
2023,4,8,100,26,30,56,Saturday
2023,4,7,2400,34,50,84,Friday
2023,4,7,2300,44,108,152,Friday
2023,4,7,2200,90,142,232,Friday
2023,4,7,2100,107,224,331,Friday
2023,4,7,2000,170,332,502,Friday
2023,4,7,1900,242,524,766,Friday
2023,4,7,1800,309,938,1247,Friday
2023,4,7,1700,545,1060,1605,Friday
2023,4,7,1600,640,957,1597,Friday
2023,4,7,1500,841,844,1685,Friday
2023,4,7,1400,1066,638,1704,Friday
2023,4,7,1300,1069,550,1619,Friday
2023,4,7,1200,1189,429,1618,Friday
2023,4,7,1100,1225,315,1540,Friday
2023,4,7,1000,1167,228,1395,Friday
2023,4,7,900,1017,137,1154,Friday
2023,4,7,800,524,60,584,Friday
2023,4,7,700,224,43,267,Friday
2023,4,7,600,90,40,130,Friday
2023,4,7,500,34,35,69,Friday
2023,4,7,400,28,34,62,Friday
2023,4,7,300,22,28,50,Friday
2023,4,7,200,30,49,79,Friday
2023,4,7,100,54,51,105,Friday
2023,4,6,2400,74,91,165,Thursday
2023,4,6,2300,158,126,284,Thursday
2023,4,6,2200,238,190,428,Thursday
2023,4,6,2100,385,249,634,Thursday
2023,4,6,2000,644,282,926,Thursday
2023,4,6,1900,763,453,1216,Thursday
2023,4,6,1800,740,608,1348,Thursday
2023,4,6,1700,619,715,1334,Thursday
2023,4,6,1600,590,630,1220,Thursday
2023,4,6,1500,566,556,1122,Thursday
2023,4,6,1400,491,450,941,Thursday
2023,4,6,1300,518,386,904,Thursday
2023,4,6,1200,603,333,936,Thursday
2023,4,6,1100,640,256,896,Thursday
2023,4,6,1000,619,209,828,Thursday
2023,4,6,900,449,198,647,Thursday
2023,4,6,800,321,54,375,Thursday
2023,4,6,700,146,41,187,Thursday
2023,4,6,600,84,32,116,Thursday
2023,4,6,500,28,26,54,Thursday
2023,4,6,400,21,22,43,Thursday
2023,4,6,300,20,32,52,Thursday
2023,4,6,200,24,29,53,Thursday
2023,4,6,100,37,21,58,Thursday
2023,4,5,2400,52,44,96,Wednesday
2023,4,5,2300,68,106,174,Wednesday
2023,4,5,2200,81,130,211,Wednesday
2023,4,5,2100,156,196,352,Wednesday
2023,4,5,2000,191,258,449,Wednesday
2023,4,5,1900,239,358,597,Wednesday
2023,4,5,1800,287,515,802,Wednesday
2023,4,5,1700,286,581,867,Wednesday
2023,4,5,1600,326,459,785,Wednesday
2023,4,5,1500,363,429,792,Wednesday
2023,4,5,1400,386,332,718,Wednesday
2023,4,5,1300,404,331,735,Wednesday
2023,4,5,1200,430,269,699,Wednesday
2023,4,5,1100,506,231,737,Wednesday
2023,4,5,1000,492,179,671,Wednesday
2023,4,5,900,425,163,588,Wednesday
2023,4,5,800,250,46,296,Wednesday
2023,4,5,700,134,33,167,Wednesday
2023,4,5,600,41,22,63,Wednesday
2023,4,5,500,31,15,46,Wednesday
2023,4,5,400,28,30,58,Wednesday
2023,4,5,300,13,22,35,Wednesday
2023,4,5,200,19,16,35,Wednesday
2023,4,5,100,27,17,44,Wednesday
2023,4,4,2400,42,56,98,Tuesday
2023,4,4,2300,72,110,182,Tuesday
2023,4,4,2200,60,121,181,Tuesday
2023,4,4,2100,120,164,284,Tuesday
2023,4,4,2000,162,215,377,Tuesday
2023,4,4,1900,177,282,459,Tuesday
2023,4,4,1800,225,410,635,Tuesday
2023,4,4,1700,237,492,729,Tuesday
2023,4,4,1600,286,392,678,Tuesday
2023,4,4,1500,267,330,597,Tuesday
2023,4,4,1400,307,310,617,Tuesday
2023,4,4,1300,314,273,587,Tuesday
2023,4,4,1200,408,251,659,Tuesday
2023,4,4,1100,382,196,578,Tuesday
2023,4,4,1000,403,161,564,Tuesday
2023,4,4,900,337,163,500,Tuesday
2023,4,4,800,186,42,228,Tuesday
2023,4,4,700,100,50,150,Tuesday
2023,4,4,600,62,26,88,Tuesday
2023,4,4,500,29,21,50,Tuesday
2023,4,4,400,21,15,36,Tuesday
2023,4,4,300,21,16,37,Tuesday
2023,4,4,200,21,25,46,Tuesday
2023,4,4,100,37,12,49,Tuesday
2023,4,3,2400,50,36,86,Monday
2023,4,3,2300,53,107,160,Monday
2023,4,3,2200,60,122,182,Monday
2023,4,3,2100,104,151,255,Monday
2023,4,3,2000,132,208,340,Monday
2023,4,3,1900,185,342,527,Monday
2023,4,3,1800,186,456,642,Monday
2023,4,3,1700,236,569,805,Monday
2023,4,3,1600,272,444,716,Monday
2023,4,3,1500,321,374,695,Monday
2023,4,3,1400,322,349,671,Monday
2023,4,3,1300,326,299,625,Monday
2023,4,3,1200,393,241,634,Monday
2023,4,3,1100,426,201,627,Monday
2023,4,3,1000,409,134,543,Monday
2023,4,3,900,433,108,541,Monday
2023,4,3,800,235,46,281,Monday
2023,4,3,700,102,37,139,Monday
2023,4,3,600,46,18,64,Monday
2023,4,3,500,26,9,35,Monday
2023,4,3,400,13,22,35,Monday
2023,4,3,300,15,21,36,Monday
2023,4,3,200,18,26,44,Monday
2023,4,3,100,16,10,26,Monday
2023,4,2,2400,21,34,55,Sunday
2023,4,2,2300,52,117,169,Sunday
2023,4,2,2200,52,156,208,Sunday
2023,4,2,2100,80,284,364,Sunday
2023,4,2,2000,129,329,458,Sunday
2023,4,2,1900,134,521,655,Sunday
2023,4,2,1800,227,845,1072,Sunday
2023,4,2,1700,274,1088,1362,Sunday
2023,4,2,1600,321,988,1309,Sunday
2023,4,2,1500,369,875,1244,Sunday
2023,4,2,1400,432,749,1181,Sunday
2023,4,2,1300,431,663,1094,Sunday
2023,4,2,1200,483,513,996,Sunday
2023,4,2,1100,435,301,736,Sunday
2023,4,2,1000,532,190,722,Sunday
2023,4,2,900,599,89,688,Sunday
2023,4,2,800,280,32,312,Sunday
2023,4,2,700,85,12,97,Sunday
2023,4,2,600,29,11,40,Sunday
2023,4,2,500,13,8,21,Sunday
2023,4,2,400,4,13,17,Sunday
2023,4,2,300,4,6,10,Sunday
2023,4,2,200,13,19,32,Sunday
2023,4,2,100,21,38,59,Sunday
2023,4,1,2400,34,48,82,Saturday
2023,4,1,2300,42,85,127,Saturday
2023,4,1,2200,68,149,217,Saturday
2023,4,1,2100,96,201,297,Saturday
2023,4,1,2000,112,243,355,Saturday
2023,4,1,1900,158,353,511,Saturday
2023,4,1,1800,231,654,885,Saturday
2023,4,1,1700,228,1091,1319,Saturday
2023,4,1,1600,332,728,1060,Saturday
2023,4,1,1500,390,631,1021,Saturday
2023,4,1,1400,423,560,983,Saturday
2023,4,1,1300,451,472,923,Saturday
2023,4,1,1200,568,406,974,Saturday
2023,4,1,1100,584,301,885,Saturday
2023,4,1,1000,619,212,831,Saturday
2023,4,1,900,652,175,827,Saturday
2023,4,1,800,381,43,424,Saturday
2023,4,1,700,131,29,160,Saturday
2023,4,1,600,37,28,65,Saturday
2023,4,1,500,15,26,41,Saturday
2023,4,1,400,20,14,34,Saturday
2023,4,1,300,12,23,35,Saturday
2023,4,1,200,19,22,41,Saturday
2023,4,1,100,23,19,42,Saturday
2023,3,31,2400,45,50,95,Friday
2023,3,31,2300,56,112,168,Friday
2023,3,31,2200,101,162,263,Friday
2023,3,31,2100,223,197,420,Friday
2023,3,31,2000,288,294,582,Friday
2023,3,31,1900,365,405,770,Friday
2023,3,31,1800,432,662,1094,Friday
2023,3,31,1700,442,818,1260,Friday
2023,3,31,1600,463,666,1129,Friday
2023,3,31,1500,485,588,1073,Friday
2023,3,31,1400,481,561,1042,Friday
2023,3,31,1300,443,518,961,Friday
2023,3,31,1200,569,402,971,Friday
2023,3,31,1100,553,287,840,Friday
2023,3,31,1000,576,222,798,Friday
2023,3,31,900,524,188,712,Friday
2023,3,31,800,310,57,367,Friday
2023,3,31,700,137,53,190,Friday
2023,3,31,600,62,36,98,Friday
2023,3,31,500,37,28,65,Friday
2023,3,31,400,19,28,47,Friday
2023,3,31,300,16,27,43,Friday
2023,3,31,200,28,26,54,Friday
2023,3,31,100,38,28,66,Friday
2023,3,30,2400,44,45,89,Thursday
2023,3,30,2300,65,137,202,Thursday
2023,3,30,2200,86,170,256,Thursday
2023,3,30,2100,164,209,373,Thursday
2023,3,30,2000,296,251,547,Thursday
2023,3,30,1900,303,362,665,Thursday
2023,3,30,1800,322,680,1002,Thursday
2023,3,30,1700,352,714,1066,Thursday
2023,3,30,1600,392,599,991,Thursday
2023,3,30,1500,423,492,915,Thursday
2023,3,30,1400,426,460,886,Thursday
2023,3,30,1300,462,383,845,Thursday
2023,3,30,1200,548,316,864,Thursday
2023,3,30,1100,544,252,796,Thursday
2023,3,30,1000,530,207,737,Thursday
2023,3,30,900,504,187,691,Thursday
2023,3,30,800,234,55,289,Thursday
2023,3,30,700,146,37,183,Thursday
2023,3,30,600,72,25,97,Thursday
2023,3,30,500,27,22,49,Thursday
2023,3,30,400,23,12,35,Thursday
2023,3,30,300,15,19,34,Thursday
2023,3,30,200,34,31,65,Thursday
2023,3,30,100,34,16,50,Thursday
2023,3,29,2400,45,59,104,Wednesday
2023,3,29,2300,62,98,160,Wednesday
2023,3,29,2200,66,131,197,Wednesday
2023,3,29,2100,129,182,311,Wednesday
2023,3,29,2000,195,243,438,Wednesday
2023,3,29,1900,255,373,628,Wednesday
2023,3,29,1800,269,668,937,Wednesday
2023,3,29,1700,335,768,1103,Wednesday
2023,3,29,1600,380,568,948,Wednesday
2023,3,29,1500,423,491,914,Wednesday
2023,3,29,1400,410,538,948,Wednesday
2023,3,29,1300,444,564,1008,Wednesday
2023,3,29,1200,580,261,841,Wednesday
2023,3,29,1100,526,182,708,Wednesday
2023,3,29,1000,568,152,720,Wednesday
2023,3,29,900,475,87,562,Wednesday
2023,3,29,800,269,52,321,Wednesday
2023,3,29,700,97,34,131,Wednesday
2023,3,29,600,62,10,72,Wednesday
2023,3,29,500,29,5,34,Wednesday
2023,3,29,400,12,8,20,Wednesday
2023,3,29,300,13,20,33,Wednesday
2023,3,29,200,20,15,35,Wednesday
2023,3,29,100,25,19,44,Wednesday
2023,3,28,2400,40,55,95,Tuesday
2023,3,28,2300,61,96,157,Tuesday
2023,3,28,2200,69,140,209,Tuesday
2023,3,28,2100,129,163,292,Tuesday
2023,3,28,2000,184,256,440,Tuesday
2023,3,28,1900,172,364,536,Tuesday
2023,3,28,1800,200,753,953,Tuesday
2023,3,28,1700,254,826,1080,Tuesday
2023,3,28,1600,346,561,907,Tuesday
2023,3,28,1500,393,437,830,Tuesday
2023,3,28,1400,435,354,789,Tuesday
2023,3,28,1300,436,344,780,Tuesday
2023,3,28,1200,496,322,818,Tuesday
2023,3,28,1100,556,214,770,Tuesday
2023,3,28,1000,543,212,755,Tuesday
2023,3,28,900,580,174,754,Tuesday
2023,3,28,800,294,54,348,Tuesday
2023,3,28,700,111,39,150,Tuesday
2023,3,28,600,49,32,81,Tuesday
2023,3,28,500,17,17,34,Tuesday
2023,3,28,400,19,13,32,Tuesday
2023,3,28,300,9,22,31,Tuesday
2023,3,28,200,25,18,43,Tuesday
2023,3,28,100,22,15,37,Tuesday
2023,3,27,2400,43,56,99,Monday
2023,3,27,2300,56,107,163,Monday
2023,3,27,2200,78,116,194,Monday
2023,3,27,2100,111,141,252,Monday
2023,3,27,2000,159,200,359,Monday
2023,3,27,1900,205,349,554,Monday
2023,3,27,1800,238,627,865,Monday
2023,3,27,1700,296,644,940,Monday
2023,3,27,1600,370,515,885,Monday
2023,3,27,1500,418,472,890,Monday
2023,3,27,1400,437,434,871,Monday
2023,3,27,1300,491,387,878,Monday
2023,3,27,1200,598,292,890,Monday
2023,3,27,1100,522,224,746,Monday
2023,3,27,1000,527,160,687,Monday
2023,3,27,900,576,122,698,Monday
2023,3,27,800,282,51,333,Monday
2023,3,27,700,75,24,99,Monday
2023,3,27,600,40,15,55,Monday
2023,3,27,500,28,23,51,Monday
2023,3,27,400,17,17,34,Monday
2023,3,27,300,17,10,27,Monday
2023,3,27,200,20,31,51,Monday
2023,3,27,100,17,8,25,Monday
2023,3,26,2400,31,36,67,Sunday
2023,3,26,2300,41,106,147,Sunday
2023,3,26,2200,54,129,183,Sunday
2023,3,26,2100,101,203,304,Sunday
2023,3,26,2000,176,366,542,Sunday
2023,3,26,1900,199,521,720,Sunday
2023,3,26,1800,275,979,1254,Sunday
2023,3,26,1700,362,1232,1594,Sunday
2023,3,26,1600,465,1042,1507,Sunday
2023,3,26,1500,562,816,1378,Sunday
2023,3,26,1400,537,664,1201,Sunday
2023,3,26,1300,596,542,1138,Sunday
2023,3,26,1200,608,445,1053,Sunday
2023,3,26,1100,620,251,871,Sunday
2023,3,26,1000,649,141,790,Sunday
2023,3,26,900,700,93,793,Sunday
2023,3,26,800,399,48,447,Sunday
2023,3,26,700,103,22,125,Sunday
2023,3,26,600,26,14,40,Sunday
2023,3,26,500,19,11,30,Sunday
2023,3,26,400,12,18,30,Sunday
2023,3,26,300,10,24,34,Sunday
2023,3,26,200,21,36,57,Sunday
2023,3,26,100,23,28,51,Sunday
2023,3,25,2400,35,80,115,Saturday
2023,3,25,2300,52,119,171,Saturday
2023,3,25,2200,71,122,193,Saturday
2023,3,25,2100,85,151,236,Saturday
2023,3,25,2000,134,225,359,Saturday
2023,3,25,1900,195,348,543,Saturday
2023,3,25,1800,243,938,1181,Saturday
2023,3,25,1700,338,987,1325,Saturday
2023,3,25,1600,409,674,1083,Saturday
2023,3,25,1500,437,502,939,Saturday
2023,3,25,1400,546,446,992,Saturday
2023,3,25,1300,547,369,916,Saturday
2023,3,25,1200,607,291,898,Saturday
2023,3,25,1100,629,214,843,Saturday
2023,3,25,1000,714,176,890,Saturday
2023,3,25,900,937,176,1113,Saturday
2023,3,25,800,525,36,561,Saturday
2023,3,25,700,151,31,182,Saturday
2023,3,25,600,35,30,65,Saturday
2023,3,25,500,14,23,37,Saturday
2023,3,25,400,13,23,36,Saturday
2023,3,25,300,8,18,26,Saturday
2023,3,25,200,19,20,39,Saturday
2023,3,25,100,15,19,34,Saturday
2023,3,24,2400,48,52,100,Friday
2023,3,24,2300,84,114,198,Friday
2023,3,24,2200,126,119,245,Friday
2023,3,24,2100,217,182,399,Friday
2023,3,24,2000,422,209,631,Friday
2023,3,24,1900,534,306,840,Friday
2023,3,24,1800,614,478,1092,Friday
2023,3,24,1700,620,675,1295,Friday
2023,3,24,1600,575,607,1182,Friday
2023,3,24,1500,587,414,1001,Friday
2023,3,24,1400,459,370,829,Friday
2023,3,24,1300,432,353,785,Friday
2023,3,24,1200,490,286,776,Friday
2023,3,24,1100,530,251,781,Friday
2023,3,24,1000,549,176,725,Friday
2023,3,24,900,508,190,698,Friday
2023,3,24,800,317,60,377,Friday
2023,3,24,700,122,38,160,Friday
2023,3,24,600,65,29,94,Friday
2023,3,24,500,22,12,34,Friday
2023,3,24,400,16,25,41,Friday
2023,3,24,300,27,24,51,Friday
2023,3,24,200,42,23,65,Friday
2023,3,24,100,25,19,44,Friday
2023,3,23,2400,62,69,131,Thursday
2023,3,23,2300,92,129,221,Thursday
2023,3,23,2200,108,163,271,Thursday
2023,3,23,2100,180,158,338,Thursday
2023,3,23,2000,231,233,464,Thursday
2023,3,23,1900,307,323,630,Thursday
2023,3,23,1800,373,498,871,Thursday
2023,3,23,1700,326,604,930,Thursday
2023,3,23,1600,389,518,907,Thursday
2023,3,23,1500,387,407,794,Thursday
2023,3,23,1400,361,335,696,Thursday
2023,3,23,1300,420,372,792,Thursday
2023,3,23,1200,394,241,635,Thursday
2023,3,23,1100,495,228,723,Thursday
2023,3,23,1000,497,202,699,Thursday
2023,3,23,900,433,198,631,Thursday
2023,3,23,800,258,51,309,Thursday
2023,3,23,700,127,41,168,Thursday
2023,3,23,600,57,33,90,Thursday
2023,3,23,500,28,25,53,Thursday
2023,3,23,400,15,24,39,Thursday
2023,3,23,300,17,13,30,Thursday
2023,3,23,200,21,20,41,Thursday
2023,3,23,100,24,12,36,Thursday
2023,3,22,2400,44,56,100,Wednesday
2023,3,22,2300,67,89,156,Wednesday
2023,3,22,2200,88,148,236,Wednesday
2023,3,22,2100,151,276,427,Wednesday
2023,3,22,2000,178,173,351,Wednesday
2023,3,22,1900,196,229,425,Wednesday
2023,3,22,1800,223,453,676,Wednesday
2023,3,22,1700,254,561,815,Wednesday
2023,3,22,1600,317,484,801,Wednesday
2023,3,22,1500,324,367,691,Wednesday
2023,3,22,1400,294,359,653,Wednesday
2023,3,22,1300,345,262,607,Wednesday
2023,3,22,1200,408,232,640,Wednesday
2023,3,22,1100,447,212,659,Wednesday
2023,3,22,1000,431,197,628,Wednesday
2023,3,22,900,359,203,562,Wednesday
2023,3,22,800,216,41,257,Wednesday
2023,3,22,700,119,50,169,Wednesday
2023,3,22,600,51,25,76,Wednesday
2023,3,22,500,23,15,38,Wednesday
2023,3,22,400,18,32,50,Wednesday
2023,3,22,300,10,16,26,Wednesday
2023,3,22,200,17,28,45,Wednesday
2023,3,22,100,23,22,45,Wednesday
2023,3,21,2400,43,28,71,Tuesday
2023,3,21,2300,58,106,164,Tuesday
2023,3,21,2200,78,254,332,Tuesday
2023,3,21,2100,109,82,191,Tuesday
2023,3,21,2000,144,134,278,Tuesday
2023,3,21,1900,166,300,466,Tuesday
2023,3,21,1800,200,465,665,Tuesday
2023,3,21,1700,213,593,806,Tuesday
2023,3,21,1600,272,431,703,Tuesday
2023,3,21,1500,300,368,668,Tuesday
2023,3,21,1400,278,299,577,Tuesday
2023,3,21,1300,319,285,604,Tuesday
2023,3,21,1200,375,220,595,Tuesday
2023,3,21,1100,445,204,649,Tuesday
2023,3,21,1000,417,202,619,Tuesday
2023,3,21,900,353,191,544,Tuesday
2023,3,21,800,242,52,294,Tuesday
2023,3,21,700,110,45,155,Tuesday
2023,3,21,600,47,23,70,Tuesday
2023,3,21,500,28,21,49,Tuesday
2023,3,21,400,15,22,37,Tuesday
2023,3,21,300,12,24,36,Tuesday
2023,3,21,200,12,24,36,Tuesday
2023,3,21,100,20,15,35,Tuesday
2023,3,20,2400,38,32,70,Monday
2023,3,20,2300,54,94,148,Monday
2023,3,20,2200,83,139,222,Monday
2023,3,20,2100,115,162,277,Monday
2023,3,20,2000,133,247,380,Monday
2023,3,20,1900,168,346,514,Monday
2023,3,20,1800,208,506,714,Monday
2023,3,20,1700,269,638,907,Monday
2023,3,20,1600,295,518,813,Monday
2023,3,20,1500,326,388,714,Monday
2023,3,20,1400,323,332,655,Monday
2023,3,20,1300,377,367,744,Monday
2023,3,20,1200,464,274,738,Monday
2023,3,20,1100,449,219,668,Monday
2023,3,20,1000,461,166,627,Monday
2023,3,20,900,452,132,584,Monday
2023,3,20,800,270,47,317,Monday
2023,3,20,700,108,44,152,Monday
2023,3,20,600,56,20,76,Monday
2023,3,20,500,23,13,36,Monday
2023,3,20,400,10,11,21,Monday
2023,3,20,300,21,7,28,Monday
2023,3,20,200,21,25,46,Monday
2023,3,20,100,20,26,46,Monday
2023,3,19,2400,29,27,56,Sunday
2023,3,19,2300,44,99,143,Sunday
2023,3,19,2200,49,163,212,Sunday
2023,3,19,2100,94,245,339,Sunday
2023,3,19,2000,148,382,530,Sunday
2023,3,19,1900,156,681,837,Sunday
2023,3,19,1800,231,1124,1355,Sunday
2023,3,19,1700,297,1382,1679,Sunday
2023,3,19,1600,370,970,1340,Sunday
2023,3,19,1500,440,892,1332,Sunday
2023,3,19,1400,447,746,1193,Sunday
2023,3,19,1300,455,586,1041,Sunday
2023,3,19,1200,579,490,1069,Sunday
2023,3,19,1100,593,294,887,Sunday
2023,3,19,1000,634,176,810,Sunday
2023,3,19,900,747,103,850,Sunday
2023,3,19,800,366,51,417,Sunday
2023,3,19,700,96,26,122,Sunday
2023,3,19,600,21,15,36,Sunday
2023,3,19,500,11,11,22,Sunday
2023,3,19,400,8,12,20,Sunday
2023,3,19,300,12,11,23,Sunday
2023,3,19,200,12,23,35,Sunday
2023,3,19,100,22,36,58,Sunday
2023,3,18,2400,26,52,78,Saturday
2023,3,18,2300,37,76,113,Saturday
2023,3,18,2200,62,123,185,Saturday
2023,3,18,2100,77,208,285,Saturday
2023,3,18,2000,113,264,377,Saturday
2023,3,18,1900,149,440,589,Saturday
2023,3,18,1800,190,947,1137,Saturday
2023,3,18,1700,255,1373,1628,Saturday
2023,3,18,1600,340,531,871,Saturday
2023,3,18,1500,380,500,880,Saturday
2023,3,18,1400,368,418,786,Saturday
2023,3,18,1300,492,416,908,Saturday
2023,3,18,1200,580,308,888,Saturday
2023,3,18,1100,565,240,805,Saturday
2023,3,18,1000,708,206,914,Saturday
2023,3,18,900,898,181,1079,Saturday
2023,3,18,800,478,43,521,Saturday
2023,3,18,700,130,32,162,Saturday
2023,3,18,600,53,21,74,Saturday
2023,3,18,500,13,20,33,Saturday
2023,3,18,400,6,19,25,Saturday
2023,3,18,300,13,25,38,Saturday
2023,3,18,200,16,30,46,Saturday
2023,3,18,100,23,13,36,Saturday
2023,3,17,2400,53,52,105,Friday
2023,3,17,2300,89,89,178,Friday
2023,3,17,2200,94,143,237,Friday
2023,3,17,2100,206,190,396,Friday
2023,3,17,2000,337,258,595,Friday
2023,3,17,1900,421,452,873,Friday
2023,3,17,1800,484,767,1251,Friday
2023,3,17,1700,501,826,1327,Friday
2023,3,17,1600,488,729,1217,Friday
2023,3,17,1500,509,436,945,Friday
2023,3,17,1400,416,422,838,Friday
2023,3,17,1300,479,332,811,Friday
2023,3,17,1200,542,295,837,Friday
2023,3,17,1100,550,215,765,Friday
2023,3,17,1000,528,244,772,Friday
2023,3,17,900,684,174,858,Friday
2023,3,17,800,328,58,386,Friday
2023,3,17,700,115,39,154,Friday
2023,3,17,600,65,36,101,Friday
2023,3,17,500,24,28,52,Friday
2023,3,17,400,26,18,44,Friday
2023,3,17,300,21,23,44,Friday
2023,3,17,200,35,18,53,Friday
2023,3,17,100,26,14,40,Friday
2023,3,16,2400,47,52,99,Thursday
2023,3,16,2300,70,121,191,Thursday
2023,3,16,2200,97,143,240,Thursday
2023,3,16,2100,198,213,411,Thursday
2023,3,16,2000,264,259,523,Thursday
2023,3,16,1900,297,382,679,Thursday
2023,3,16,1800,337,692,1029,Thursday
2023,3,16,1700,321,726,1047,Thursday
2023,3,16,1600,348,549,897,Thursday
2023,3,16,1500,368,393,761,Thursday
2023,3,16,1400,380,345,725,Thursday
2023,3,16,1300,422,280,702,Thursday
2023,3,16,1200,429,256,685,Thursday
2023,3,16,1100,478,234,712,Thursday
2023,3,16,1000,554,185,739,Thursday
2023,3,16,900,565,178,743,Thursday
2023,3,16,800,295,50,345,Thursday
2023,3,16,700,138,39,177,Thursday
2023,3,16,600,63,29,92,Thursday
2023,3,16,500,28,17,45,Thursday
2023,3,16,400,22,25,47,Thursday
2023,3,16,300,23,14,37,Thursday
2023,3,16,200,35,22,57,Thursday
2023,3,16,100,33,17,50,Thursday
2023,3,15,2400,61,47,108,Wednesday
2023,3,15,2300,62,102,164,Wednesday
2023,3,15,2200,57,119,176,Wednesday
2023,3,15,2100,144,159,303,Wednesday
2023,3,15,2000,161,251,412,Wednesday
2023,3,15,1900,193,362,555,Wednesday
2023,3,15,1800,206,546,752,Wednesday
2023,3,15,1700,252,684,936,Wednesday
2023,3,15,1600,300,504,804,Wednesday
2023,3,15,1500,277,375,652,Wednesday
2023,3,15,1400,265,330,595,Wednesday
2023,3,15,1300,362,301,663,Wednesday
2023,3,15,1200,399,221,620,Wednesday
2023,3,15,1100,448,229,677,Wednesday
2023,3,15,1000,479,212,691,Wednesday
2023,3,15,900,520,154,674,Wednesday
2023,3,15,800,254,48,302,Wednesday
2023,3,15,700,110,37,147,Wednesday
2023,3,15,600,48,28,76,Wednesday
2023,3,15,500,28,21,49,Wednesday
2023,3,15,400,21,30,51,Wednesday
2023,3,15,300,12,21,33,Wednesday
2023,3,15,200,24,26,50,Wednesday
2023,3,15,100,35,22,57,Wednesday
2023,3,14,2400,38,47,85,Tuesday
2023,3,14,2300,51,111,162,Tuesday
2023,3,14,2200,70,137,207,Tuesday
2023,3,14,2100,113,227,340,Tuesday
2023,3,14,2000,163,192,355,Tuesday
2023,3,14,1900,154,304,458,Tuesday
2023,3,14,1800,180,567,747,Tuesday
2023,3,14,1700,219,672,891,Tuesday
2023,3,14,1600,271,522,793,Tuesday
2023,3,14,1500,289,368,657,Tuesday
2023,3,14,1400,302,264,566,Tuesday
2023,3,14,1300,326,241,567,Tuesday
2023,3,14,1200,380,207,587,Tuesday
2023,3,14,1100,406,215,621,Tuesday
2023,3,14,1000,468,181,649,Tuesday
2023,3,14,900,564,163,727,Tuesday
2023,3,14,800,221,47,268,Tuesday
2023,3,14,700,98,37,135,Tuesday
2023,3,14,600,43,31,74,Tuesday
2023,3,14,500,23,12,35,Tuesday
2023,3,14,400,12,9,21,Tuesday
2023,3,14,300,14,13,27,Tuesday
2023,3,14,200,18,11,29,Tuesday
2023,3,14,100,24,15,39,Tuesday
2023,3,13,2400,43,104,147,Monday
2023,3,13,2300,56,111,167,Monday
2023,3,13,2200,75,76,151,Monday
2023,3,13,2100,91,93,184,Monday
2023,3,13,2000,145,141,286,Monday
2023,3,13,1900,162,280,442,Monday
2023,3,13,1800,173,457,630,Monday
2023,3,13,1700,235,572,807,Monday
2023,3,13,1600,305,516,821,Monday
2023,3,13,1500,301,394,695,Monday
2023,3,13,1400,350,312,662,Monday
2023,3,13,1300,364,276,640,Monday
2023,3,13,1200,415,256,671,Monday
2023,3,13,1100,446,190,636,Monday
2023,3,13,1000,454,130,584,Monday
2023,3,13,900,420,100,520,Monday
2023,3,13,800,240,41,281,Monday
2023,3,13,700,106,33,139,Monday
2023,3,13,600,47,18,65,Monday
2023,3,13,500,25,11,36,Monday
2023,3,13,400,8,15,23,Monday
2023,3,13,300,11,12,23,Monday
2023,3,13,200,23,20,43,Monday
2023,3,13,100,23,5,28,Monday
2023,3,12,2400,25,39,64,Sunday
2023,3,12,2300,37,81,118,Sunday
2023,3,12,2200,52,148,200,Sunday
2023,3,12,2100,101,233,334,Sunday
2023,3,12,2000,120,363,483,Sunday
2023,3,12,1900,176,528,704,Sunday
2023,3,12,1800,234,981,1215,Sunday
2023,3,12,1700,258,1374,1632,Sunday
2023,3,12,1600,361,1050,1411,Sunday
2023,3,12,1500,430,791,1221,Sunday
2023,3,12,1400,440,746,1186,Sunday
2023,3,12,1300,451,487,938,Sunday
2023,3,12,1200,502,325,827,Sunday
2023,3,12,1100,479,214,693,Sunday
2023,3,12,1000,650,135,785,Sunday
2023,3,12,900,736,66,802,Sunday
2023,3,12,800,292,41,333,Sunday
2023,3,12,700,66,18,84,Sunday
2023,3,12,600,26,15,41,Sunday
2023,3,12,500,17,28,45,Sunday
2023,3,12,400,19,22,41,Sunday
2023,3,12,300,0,0,0,Sunday
2023,3,12,200,21,16,37,Sunday
2023,3,12,100,31,28,59,Sunday
2023,3,11,2400,31,49,80,Saturday
2023,3,11,2300,47,52,99,Saturday
2023,3,11,2200,61,72,133,Saturday
2023,3,11,2100,82,141,223,Saturday
2023,3,11,2000,113,191,304,Saturday
2023,3,11,1900,132,350,482,Saturday
2023,3,11,1800,174,728,902,Saturday
2023,3,11,1700,229,1059,1288,Saturday
2023,3,11,1600,309,622,931,Saturday
2023,3,11,1500,303,472,775,Saturday
2023,3,11,1400,333,342,675,Saturday
2023,3,11,1300,395,279,674,Saturday
2023,3,11,1200,411,292,703,Saturday
2023,3,11,1100,497,253,750,Saturday
2023,3,11,1000,564,208,772,Saturday
2023,3,11,900,862,169,1031,Saturday
2023,3,11,800,404,46,450,Saturday
2023,3,11,700,90,28,118,Saturday
2023,3,11,600,35,25,60,Saturday
2023,3,11,500,10,21,31,Saturday
2023,3,11,400,21,20,41,Saturday
2023,3,11,300,16,21,37,Saturday
2023,3,11,200,20,19,39,Saturday
2023,3,11,100,24,11,35,Saturday
2023,3,10,2400,38,42,80,Friday
2023,3,10,2300,61,84,145,Friday
2023,3,10,2200,81,100,181,Friday
2023,3,10,2100,178,136,314,Friday
2023,3,10,2000,255,168,423,Friday
2023,3,10,1900,345,290,635,Friday
2023,3,10,1800,424,507,931,Friday
2023,3,10,1700,443,668,1111,Friday
2023,3,10,1600,531,576,1107,Friday
2023,3,10,1500,427,378,805,Friday
2023,3,10,1400,423,328,751,Friday
2023,3,10,1300,413,300,713,Friday
2023,3,10,1200,408,303,711,Friday
2023,3,10,1100,467,255,722,Friday
2023,3,10,1000,581,214,795,Friday
2023,3,10,900,579,163,742,Friday
2023,3,10,800,288,65,353,Friday
2023,3,10,700,139,40,179,Friday
2023,3,10,600,67,40,107,Friday
2023,3,10,500,28,24,52,Friday
2023,3,10,400,20,20,40,Friday
2023,3,10,300,22,16,38,Friday
2023,3,10,200,32,20,52,Friday
2023,3,10,100,27,9,36,Friday
2023,3,9,2400,50,37,87,Thursday
2023,3,9,2300,67,104,171,Thursday
2023,3,9,2200,96,120,216,Thursday
2023,3,9,2100,182,162,344,Thursday
2023,3,9,2000,257,180,437,Thursday
2023,3,9,1900,272,306,578,Thursday
2023,3,9,1800,320,550,870,Thursday
2023,3,9,1700,347,741,1088,Thursday
2023,3,9,1600,356,381,737,Thursday
2023,3,9,1500,347,337,684,Thursday
2023,3,9,1400,326,314,640,Thursday
2023,3,9,1300,340,272,612,Thursday
2023,3,9,1200,425,265,690,Thursday
2023,3,9,1100,461,257,718,Thursday
2023,3,9,1000,487,196,683,Thursday
2023,3,9,900,458,163,621,Thursday
2023,3,9,800,251,64,315,Thursday
2023,3,9,700,106,40,146,Thursday
2023,3,9,600,50,27,77,Thursday
2023,3,9,500,25,22,47,Thursday
2023,3,9,400,23,14,37,Thursday
2023,3,9,300,19,24,43,Thursday
2023,3,9,200,23,17,40,Thursday
2023,3,9,100,42,14,56,Thursday
2023,3,8,2400,37,47,84,Wednesday
2023,3,8,2300,55,111,166,Wednesday
2023,3,8,2200,52,104,156,Wednesday
2023,3,8,2100,97,145,242,Wednesday
2023,3,8,2000,158,189,347,Wednesday
2023,3,8,1900,176,262,438,Wednesday
2023,3,8,1800,197,455,652,Wednesday
2023,3,8,1700,243,539,782,Wednesday
2023,3,8,1600,274,395,669,Wednesday
2023,3,8,1500,255,308,563,Wednesday
2023,3,8,1400,289,282,571,Wednesday
2023,3,8,1300,296,233,529,Wednesday
2023,3,8,1200,290,194,484,Wednesday
2023,3,8,1100,406,224,630,Wednesday
2023,3,8,1000,426,191,617,Wednesday
2023,3,8,900,421,151,572,Wednesday
2023,3,8,800,212,50,262,Wednesday
2023,3,8,700,95,34,129,Wednesday
2023,3,8,600,55,34,89,Wednesday
2023,3,8,500,18,23,41,Wednesday
2023,3,8,400,16,20,36,Wednesday
2023,3,8,300,14,22,36,Wednesday
2023,3,8,200,17,21,38,Wednesday
2023,3,8,100,38,23,61,Wednesday
2023,3,7,2400,38,32,70,Tuesday
2023,3,7,2300,56,87,143,Tuesday
2023,3,7,2200,64,89,153,Tuesday
2023,3,7,2100,107,132,239,Tuesday
2023,3,7,2000,137,199,336,Tuesday
2023,3,7,1900,139,299,438,Tuesday
2023,3,7,1800,196,498,694,Tuesday
2023,3,7,1700,197,567,764,Tuesday
2023,3,7,1600,239,438,677,Tuesday
2023,3,7,1500,241,377,618,Tuesday
2023,3,7,1400,281,234,515,Tuesday
2023,3,7,1300,313,254,567,Tuesday
2023,3,7,1200,355,208,563,Tuesday
2023,3,7,1100,396,187,583,Tuesday
2023,3,7,1000,459,196,655,Tuesday
2023,3,7,900,408,162,570,Tuesday
2023,3,7,800,231,43,274,Tuesday
2023,3,7,700,102,39,141,Tuesday
2023,3,7,600,51,29,80,Tuesday
2023,3,7,500,16,20,36,Tuesday
2023,3,7,400,10,17,27,Tuesday
2023,3,7,300,13,17,30,Tuesday
2023,3,7,200,15,19,34,Tuesday
2023,3,7,100,31,16,47,Tuesday
2023,3,6,2400,24,44,68,Monday
2023,3,6,2300,48,94,142,Monday
2023,3,6,2200,66,94,160,Monday
2023,3,6,2100,97,121,218,Monday
2023,3,6,2000,143,186,329,Monday
2023,3,6,1900,129,285,414,Monday
2023,3,6,1800,184,502,686,Monday
2023,3,6,1700,256,586,842,Monday
2023,3,6,1600,264,410,674,Monday
2023,3,6,1500,292,365,657,Monday
2023,3,6,1400,301,305,606,Monday
2023,3,6,1300,332,304,636,Monday
2023,3,6,1200,380,250,630,Monday
2023,3,6,1100,399,239,638,Monday
2023,3,6,1000,468,167,635,Monday
2023,3,6,900,466,152,618,Monday
2023,3,6,800,244,43,287,Monday
2023,3,6,700,97,34,131,Monday
2023,3,6,600,33,24,57,Monday
2023,3,6,500,26,12,38,Monday
2023,3,6,400,12,14,26,Monday
2023,3,6,300,27,9,36,Monday
2023,3,6,200,17,12,29,Monday
2023,3,6,100,27,20,47,Monday
2023,3,5,2400,21,29,50,Sunday
2023,3,5,2300,29,95,124,Sunday
2023,3,5,2200,51,148,199,Sunday
2023,3,5,2100,87,206,293,Sunday
2023,3,5,2000,125,307,432,Sunday
2023,3,5,1900,139,504,643,Sunday
2023,3,5,1800,201,888,1089,Sunday
2023,3,5,1700,263,1187,1450,Sunday
2023,3,5,1600,297,892,1189,Sunday
2023,3,5,1500,370,736,1106,Sunday
2023,3,5,1400,404,640,1044,Sunday
2023,3,5,1300,420,571,991,Sunday
2023,3,5,1200,439,456,895,Sunday
2023,3,5,1100,427,296,723,Sunday
2023,3,5,1000,604,149,753,Sunday
2023,3,5,900,781,131,912,Sunday
2023,3,5,800,356,36,392,Sunday
2023,3,5,700,89,13,102,Sunday
2023,3,5,600,22,17,39,Sunday
2023,3,5,500,14,16,30,Sunday
2023,3,5,400,7,10,17,Sunday
2023,3,5,300,11,29,40,Sunday
2023,3,5,200,18,31,49,Sunday
2023,3,5,100,29,39,68,Sunday
2023,3,4,2400,31,78,109,Saturday
2023,3,4,2300,47,61,108,Saturday
2023,3,4,2200,65,97,162,Saturday
2023,3,4,2100,85,139,224,Saturday
2023,3,4,2000,105,223,328,Saturday
2023,3,4,1900,130,396,526,Saturday
2023,3,4,1800,167,1031,1198,Saturday
2023,3,4,1700,230,1139,1369,Saturday
2023,3,4,1600,298,755,1053,Saturday
2023,3,4,1500,331,474,805,Saturday
2023,3,4,1400,371,427,798,Saturday
2023,3,4,1300,432,330,762,Saturday
2023,3,4,1200,487,322,809,Saturday
2023,3,4,1100,570,253,823,Saturday
2023,3,4,1000,713,195,908,Saturday
2023,3,4,900,1093,129,1222,Saturday
2023,3,4,800,554,42,596,Saturday
2023,3,4,700,152,14,166,Saturday
2023,3,4,600,38,21,59,Saturday
2023,3,4,500,17,15,32,Saturday
2023,3,4,400,13,14,27,Saturday
2023,3,4,300,9,11,20,Saturday
2023,3,4,200,16,25,41,Saturday
2023,3,4,100,20,10,30,Saturday
2023,3,3,2400,42,26,68,Friday
2023,3,3,2300,64,86,150,Friday
2023,3,3,2200,71,85,156,Friday
2023,3,3,2100,163,124,287,Friday
2023,3,3,2000,313,166,479,Friday
2023,3,3,1900,414,334,748,Friday
2023,3,3,1800,462,619,1081,Friday
2023,3,3,1700,461,832,1293,Friday
2023,3,3,1600,532,566,1098,Friday
2023,3,3,1500,436,476,912,Friday
2023,3,3,1400,404,368,772,Friday
2023,3,3,1300,389,393,782,Friday
2023,3,3,1200,429,346,775,Friday
2023,3,3,1100,467,258,725,Friday
2023,3,3,1000,569,238,807,Friday
2023,3,3,900,659,164,823,Friday
2023,3,3,800,358,51,409,Friday
2023,3,3,700,154,36,190,Friday
2023,3,3,600,65,33,98,Friday
2023,3,3,500,22,28,50,Friday
2023,3,3,400,13,27,40,Friday
2023,3,3,300,22,44,66,Friday
2023,3,3,200,24,11,35,Friday
2023,3,3,100,31,4,35,Friday
2023,3,2,2400,60,58,118,Thursday
2023,3,2,2300,56,176,232,Thursday
2023,3,2,2200,90,87,177,Thursday
2023,3,2,2100,175,88,263,Thursday
2023,3,2,2000,231,97,328,Thursday
2023,3,2,1900,248,212,460,Thursday
2023,3,2,1800,297,411,708,Thursday
2023,3,2,1700,304,706,1010,Thursday
2023,3,2,1600,336,453,789,Thursday
2023,3,2,1500,362,308,670,Thursday
2023,3,2,1400,324,279,603,Thursday
2023,3,2,1300,306,290,596,Thursday
2023,3,2,1200,328,210,538,Thursday
2023,3,2,1100,386,212,598,Thursday
2023,3,2,1000,490,194,684,Thursday
2023,3,2,900,497,138,635,Thursday
2023,3,2,800,316,50,366,Thursday
2023,3,2,700,116,35,151,Thursday
2023,3,2,600,64,19,83,Thursday
2023,3,2,500,21,17,38,Thursday
2023,3,2,400,18,15,33,Thursday
2023,3,2,300,13,10,23,Thursday
2023,3,2,200,18,17,35,Thursday
2023,3,2,100,28,16,44,Thursday
2023,3,1,2400,37,36,73,Wednesday
2023,3,1,2300,70,76,146,Wednesday
2023,3,1,2200,74,93,167,Wednesday
2023,3,1,2100,118,127,245,Wednesday
2023,3,1,2000,145,189,334,Wednesday
2023,3,1,1900,161,237,398,Wednesday
2023,3,1,1800,228,423,651,Wednesday
2023,3,1,1700,231,547,778,Wednesday
2023,3,1,1600,296,451,747,Wednesday
2023,3,1,1500,314,405,719,Wednesday
2023,3,1,1400,306,317,623,Wednesday
2023,3,1,1300,303,282,585,Wednesday
2023,3,1,1200,355,230,585,Wednesday
2023,3,1,1100,369,209,578,Wednesday
2023,3,1,1000,448,198,646,Wednesday
2023,3,1,900,459,170,629,Wednesday
2023,3,1,800,221,38,259,Wednesday
2023,3,1,700,105,43,148,Wednesday
2023,3,1,600,51,30,81,Wednesday
2023,3,1,500,22,19,41,Wednesday
2023,3,1,400,23,16,39,Wednesday
2023,3,1,300,17,14,31,Wednesday
2023,3,1,200,18,23,41,Wednesday
2023,3,1,100,35,24,59,Wednesday
2023,2,28,2400,34,46,80,Tuesday
2023,2,28,2300,40,86,126,Tuesday
2023,2,28,2200,62,77,139,Tuesday
2023,2,28,2100,106,120,226,Tuesday
2023,2,28,2000,134,180,314,Tuesday
2023,2,28,1900,174,250,424,Tuesday
2023,2,28,1800,172,418,590,Tuesday
2023,2,28,1700,213,566,779,Tuesday
2023,2,28,1600,232,457,689,Tuesday
2023,2,28,1500,230,313,543,Tuesday
2023,2,28,1400,250,312,562,Tuesday
2023,2,28,1300,256,258,514,Tuesday
2023,2,28,1200,319,241,560,Tuesday
2023,2,28,1100,379,187,566,Tuesday
2023,2,28,1000,416,171,587,Tuesday
2023,2,28,900,405,154,559,Tuesday
2023,2,28,800,234,56,290,Tuesday
2023,2,28,700,91,32,123,Tuesday
2023,2,28,600,55,24,79,Tuesday
2023,2,28,500,10,18,28,Tuesday
2023,2,28,400,10,10,20,Tuesday
2023,2,28,300,15,12,27,Tuesday
2023,2,28,200,17,23,40,Tuesday
2023,2,28,100,18,11,29,Tuesday
2023,2,27,2400,50,54,104,Monday
2023,2,27,2300,39,110,149,Monday
2023,2,27,2200,64,99,163,Monday
2023,2,27,2100,104,157,261,Monday
2023,2,27,2000,119,224,343,Monday
2023,2,27,1900,135,303,438,Monday
2023,2,27,1800,151,484,635,Monday
2023,2,27,1700,220,696,916,Monday
2023,2,27,1600,280,526,806,Monday
2023,2,27,1500,275,494,769,Monday
2023,2,27,1400,294,399,693,Monday
2023,2,27,1300,315,325,640,Monday
2023,2,27,1200,429,272,701,Monday
2023,2,27,1100,397,222,619,Monday
2023,2,27,1000,524,203,727,Monday
2023,2,27,900,536,157,693,Monday
2023,2,27,800,269,48,317,Monday
2023,2,27,700,109,51,160,Monday
2023,2,27,600,55,32,87,Monday
2023,2,27,500,33,20,53,Monday
2023,2,27,400,12,9,21,Monday
2023,2,27,300,15,19,34,Monday
2023,2,27,200,17,18,35,Monday
2023,2,27,100,7,12,19,Monday
2023,2,26,2400,24,68,92,Sunday
2023,2,26,2300,45,210,255,Sunday
2023,2,26,2200,49,234,283,Sunday
2023,2,26,2100,76,91,167,Sunday
2023,2,26,2000,112,162,274,Sunday
2023,2,26,1900,169,327,496,Sunday
2023,2,26,1800,219,847,1066,Sunday
2023,2,26,1700,244,1095,1339,Sunday
2023,2,26,1600,280,841,1121,Sunday
2023,2,26,1500,307,631,938,Sunday
2023,2,26,1400,333,655,988,Sunday
2023,2,26,1300,339,571,910,Sunday
2023,2,26,1200,428,444,872,Sunday
2023,2,26,1100,446,251,697,Sunday
2023,2,26,1000,603,155,758,Sunday
2023,2,26,900,852,81,933,Sunday
2023,2,26,800,398,36,434,Sunday
2023,2,26,700,72,17,89,Sunday
2023,2,26,600,27,17,44,Sunday
2023,2,26,500,9,21,30,Sunday
2023,2,26,400,12,5,17,Sunday
2023,2,26,300,12,3,15,Sunday
2023,2,26,200,11,13,24,Sunday
2023,2,26,100,15,37,52,Sunday
2023,2,25,2400,28,29,57,Saturday
2023,2,25,2300,38,68,106,Saturday
2023,2,25,2200,57,65,122,Saturday
2023,2,25,2100,72,110,182,Saturday
2023,2,25,2000,118,176,294,Saturday
2023,2,25,1900,114,364,478,Saturday
2023,2,25,1800,183,836,1019,Saturday
2023,2,25,1700,277,1070,1347,Saturday
2023,2,25,1600,289,682,971,Saturday
2023,2,25,1500,341,507,848,Saturday
2023,2,25,1400,301,416,717,Saturday
2023,2,25,1300,416,435,851,Saturday
2023,2,25,1200,437,351,788,Saturday
2023,2,25,1100,487,320,807,Saturday
2023,2,25,1000,686,226,912,Saturday
2023,2,25,900,895,169,1064,Saturday
2023,2,25,800,432,41,473,Saturday
2023,2,25,700,105,32,137,Saturday
2023,2,25,600,54,29,83,Saturday
2023,2,25,500,20,17,37,Saturday
2023,2,25,400,5,17,22,Saturday
2023,2,25,300,13,19,32,Saturday
2023,2,25,200,28,25,53,Saturday
2023,2,25,100,28,14,42,Saturday
2023,2,24,2400,42,44,86,Friday
2023,2,24,2300,69,111,180,Friday
2023,2,24,2200,111,117,228,Friday
2023,2,24,2100,250,165,415,Friday
2023,2,24,2000,246,196,442,Friday
2023,2,24,1900,357,363,720,Friday
2023,2,24,1800,487,639,1126,Friday
2023,2,24,1700,500,778,1278,Friday
2023,2,24,1600,509,459,968,Friday
2023,2,24,1500,483,442,925,Friday
2023,2,24,1400,393,385,778,Friday
2023,2,24,1300,420,429,849,Friday
2023,2,24,1200,465,408,873,Friday
2023,2,24,1100,510,280,790,Friday
2023,2,24,1000,431,216,647,Friday
2023,2,24,900,386,169,555,Friday
2023,2,24,800,203,45,248,Friday
2023,2,24,700,113,39,152,Friday
2023,2,24,600,33,19,52,Friday
2023,2,24,500,34,23,57,Friday
2023,2,24,400,19,22,41,Friday
2023,2,24,300,21,11,32,Friday
2023,2,24,200,25,18,43,Friday
2023,2,24,100,27,27,54,Friday
2023,2,23,2400,49,41,90,Thursday
2023,2,23,2300,60,93,153,Thursday
2023,2,23,2200,89,98,187,Thursday
2023,2,23,2100,156,133,289,Thursday
2023,2,23,2000,197,181,378,Thursday
2023,2,23,1900,251,274,525,Thursday
2023,2,23,1800,272,489,761,Thursday
2023,2,23,1700,334,607,941,Thursday
2023,2,23,1600,372,466,838,Thursday
2023,2,23,1500,342,385,727,Thursday
2023,2,23,1400,346,372,718,Thursday
2023,2,23,1300,357,350,707,Thursday
2023,2,23,1200,431,317,748,Thursday
2023,2,23,1100,442,226,668,Thursday
2023,2,23,1000,398,176,574,Thursday
2023,2,23,900,289,146,435,Thursday
2023,2,23,800,201,43,244,Thursday
2023,2,23,700,79,40,119,Thursday
2023,2,23,600,43,24,67,Thursday
2023,2,23,500,16,22,38,Thursday
2023,2,23,400,24,23,47,Thursday
2023,2,23,300,8,16,24,Thursday
2023,2,23,200,23,20,43,Thursday
2023,2,23,100,31,18,49,Thursday
2023,2,22,2400,41,56,97,Wednesday
2023,2,22,2300,56,92,148,Wednesday
2023,2,22,2200,58,93,151,Wednesday
2023,2,22,2100,127,131,258,Wednesday
2023,2,22,2000,157,182,339,Wednesday
2023,2,22,1900,167,278,445,Wednesday
2023,2,22,1800,204,455,659,Wednesday
2023,2,22,1700,232,639,871,Wednesday
2023,2,22,1600,259,500,759,Wednesday
2023,2,22,1500,341,400,741,Wednesday
2023,2,22,1400,329,305,634,Wednesday
2023,2,22,1300,350,369,719,Wednesday
2023,2,22,1200,415,271,686,Wednesday
2023,2,22,1100,356,264,620,Wednesday
2023,2,22,1000,355,171,526,Wednesday
2023,2,22,900,390,161,551,Wednesday
2023,2,22,800,212,42,254,Wednesday
2023,2,22,700,91,45,136,Wednesday
2023,2,22,600,48,16,64,Wednesday
2023,2,22,500,17,14,31,Wednesday
2023,2,22,400,7,12,19,Wednesday
2023,2,22,300,8,19,27,Wednesday
2023,2,22,200,21,13,34,Wednesday
2023,2,22,100,30,15,45,Wednesday
2023,2,21,2400,23,37,60,Tuesday
2023,2,21,2300,42,53,95,Tuesday
2023,2,21,2200,53,91,144,Tuesday
2023,2,21,2100,78,126,204,Tuesday
2023,2,21,2000,111,131,242,Tuesday
2023,2,21,1900,121,311,432,Tuesday
2023,2,21,1800,179,668,847,Tuesday
2023,2,21,1700,235,858,1093,Tuesday
2023,2,21,1600,239,523,762,Tuesday
2023,2,21,1500,277,508,785,Tuesday
2023,2,21,1400,284,376,660,Tuesday
2023,2,21,1300,311,264,575,Tuesday
2023,2,21,1200,330,214,544,Tuesday
2023,2,21,1100,388,197,585,Tuesday
2023,2,21,1000,601,137,738,Tuesday
2023,2,21,900,746,113,859,Tuesday
2023,2,21,800,366,65,431,Tuesday
2023,2,21,700,94,14,108,Tuesday
2023,2,21,600,59,18,77,Tuesday
2023,2,21,500,6,2,8,Tuesday
2023,2,21,400,12,22,34,Tuesday
2023,2,21,300,17,9,26,Tuesday
2023,2,21,200,15,14,29,Tuesday
2023,2,21,100,13,10,23,Tuesday
2023,2,20,2400,14,31,45,Monday
2023,2,20,2300,37,29,66,Monday
2023,2,20,2200,59,37,96,Monday
2023,2,20,2100,69,146,215,Monday
2023,2,20,2000,121,250,371,Monday
2023,2,20,1900,117,396,513,Monday
2023,2,20,1800,175,1071,1246,Monday
2023,2,20,1700,229,1314,1543,Monday
2023,2,20,1600,335,1316,1651,Monday
2023,2,20,1500,440,1263,1703,Monday
2023,2,20,1400,480,1183,1663,Monday
2023,2,20,1300,581,1207,1788,Monday
2023,2,20,1200,678,986,1664,Monday
2023,2,20,1100,633,536,1169,Monday
2023,2,20,1000,762,277,1039,Monday
2023,2,20,900,1039,90,1129,Monday
2023,2,20,800,376,42,418,Monday
2023,2,20,700,87,18,105,Monday
2023,2,20,600,35,18,53,Monday
2023,2,20,500,19,7,26,Monday
2023,2,20,400,23,1,24,Monday
2023,2,20,300,12,7,19,Monday
2023,2,20,200,18,11,29,Monday
2023,2,20,100,18,11,29,Monday
2023,2,19,2400,28,8,36,Sunday
2023,2,19,2300,43,51,94,Sunday
2023,2,19,2200,65,109,174,Sunday
2023,2,19,2100,80,134,214,Sunday
2023,2,19,2000,122,289,411,Sunday
2023,2,19,1900,149,505,654,Sunday
2023,2,19,1800,213,1105,1318,Sunday
2023,2,19,1700,324,1412,1736,Sunday
2023,2,19,1600,463,1053,1516,Sunday
2023,2,19,1500,568,825,1393,Sunday
2023,2,19,1400,650,810,1460,Sunday
2023,2,19,1300,700,576,1276,Sunday
2023,2,19,1200,706,383,1089,Sunday
2023,2,19,1100,784,195,979,Sunday
2023,2,19,1000,744,148,892,Sunday
2023,2,19,900,936,80,1016,Sunday
2023,2,19,800,428,44,472,Sunday
2023,2,19,700,105,27,132,Sunday
2023,2,19,600,36,15,51,Sunday
2023,2,19,500,17,10,27,Sunday
2023,2,19,400,13,17,30,Sunday
2023,2,19,300,12,15,27,Sunday
2023,2,19,200,17,24,41,Sunday
2023,2,19,100,27,33,60,Sunday
2023,2,18,2400,21,43,64,Saturday
2023,2,18,2300,57,67,124,Saturday
2023,2,18,2200,69,104,173,Saturday
2023,2,18,2100,111,117,228,Saturday
2023,2,18,2000,117,271,388,Saturday
2023,2,18,1900,180,449,629,Saturday
2023,2,18,1800,239,941,1180,Saturday
2023,2,18,1700,358,1147,1505,Saturday
2023,2,18,1600,525,904,1429,Saturday
2023,2,18,1500,595,737,1332,Saturday
2023,2,18,1400,673,532,1205,Saturday
2023,2,18,1300,773,374,1147,Saturday
2023,2,18,1200,771,352,1123,Saturday
2023,2,18,1100,786,222,1008,Saturday
2023,2,18,1000,864,159,1023,Saturday
2023,2,18,900,945,126,1071,Saturday
2023,2,18,800,553,51,604,Saturday
2023,2,18,700,171,30,201,Saturday
2023,2,18,600,54,30,84,Saturday
2023,2,18,500,18,25,43,Saturday
2023,2,18,400,19,31,50,Saturday
2023,2,18,300,16,20,36,Saturday
2023,2,18,200,35,37,72,Saturday
2023,2,18,100,42,48,90,Saturday
2023,2,17,2400,54,63,117,Friday
2023,2,17,2300,83,83,166,Friday
2023,2,17,2200,157,118,275,Friday
2023,2,17,2100,296,172,468,Friday
2023,2,17,2000,487,266,753,Friday
2023,2,17,1900,616,360,976,Friday
2023,2,17,1800,686,772,1458,Friday
2023,2,17,1700,748,885,1633,Friday
2023,2,17,1600,869,663,1532,Friday
2023,2,17,1500,755,582,1337,Friday
2023,2,17,1400,684,412,1096,Friday
2023,2,17,1300,639,368,1007,Friday
2023,2,17,1200,629,318,947,Friday
2023,2,17,1100,596,231,827,Friday
2023,2,17,1000,600,174,774,Friday
2023,2,17,900,673,153,826,Friday
2023,2,17,800,395,40,435,Friday
2023,2,17,700,166,28,194,Friday
2023,2,17,600,56,34,90,Friday
2023,2,17,500,24,32,56,Friday
2023,2,17,400,15,16,31,Friday
2023,2,17,300,21,11,32,Friday
2023,2,17,200,28,9,37,Friday
2023,2,17,100,31,11,42,Friday
2023,2,16,2400,57,13,70,Thursday
2023,2,16,2300,58,98,156,Thursday
2023,2,16,2200,70,134,204,Thursday
2023,2,16,2100,183,116,299,Thursday
2023,2,16,2000,285,148,433,Thursday
2023,2,16,1900,293,249,542,Thursday
2023,2,16,1800,366,428,794,Thursday
2023,2,16,1700,412,641,1053,Thursday
2023,2,16,1600,470,470,940,Thursday
2023,2,16,1500,464,411,875,Thursday
2023,2,16,1400,469,335,804,Thursday
2023,2,16,1300,474,268,742,Thursday
2023,2,16,1200,443,215,658,Thursday
2023,2,16,1100,441,179,620,Thursday
2023,2,16,1000,521,182,703,Thursday
2023,2,16,900,483,163,646,Thursday
2023,2,16,800,294,46,340,Thursday
2023,2,16,700,124,43,167,Thursday
2023,2,16,600,54,31,85,Thursday
2023,2,16,500,18,23,41,Thursday
2023,2,16,400,23,15,38,Thursday
2023,2,16,300,20,27,47,Thursday
2023,2,16,200,22,19,41,Thursday
2023,2,16,100,41,25,66,Thursday
2023,2,15,2400,41,43,84,Wednesday
2023,2,15,2300,60,99,159,Wednesday
2023,2,15,2200,63,100,163,Wednesday
2023,2,15,2100,121,131,252,Wednesday
2023,2,15,2000,186,213,399,Wednesday
2023,2,15,1900,245,251,496,Wednesday
2023,2,15,1800,259,392,651,Wednesday
2023,2,15,1700,292,501,793,Wednesday
2023,2,15,1600,268,484,752,Wednesday
2023,2,15,1500,294,365,659,Wednesday
2023,2,15,1400,293,346,639,Wednesday
2023,2,15,1300,309,272,581,Wednesday
2023,2,15,1200,381,227,608,Wednesday
2023,2,15,1100,380,202,582,Wednesday
2023,2,15,1000,423,184,607,Wednesday
2023,2,15,900,370,166,536,Wednesday
2023,2,15,800,209,44,253,Wednesday
2023,2,15,700,118,43,161,Wednesday
2023,2,15,600,41,21,62,Wednesday
2023,2,15,500,25,20,45,Wednesday
2023,2,15,400,20,17,37,Wednesday
2023,2,15,300,10,23,33,Wednesday
2023,2,15,200,12,14,26,Wednesday
2023,2,15,100,30,20,50,Wednesday
2023,2,14,2400,37,29,66,Tuesday
2023,2,14,2300,53,86,139,Tuesday
2023,2,14,2200,58,88,146,Tuesday
2023,2,14,2100,114,115,229,Tuesday
2023,2,14,2000,117,165,282,Tuesday
2023,2,14,1900,124,253,377,Tuesday
2023,2,14,1800,192,398,590,Tuesday
2023,2,14,1700,205,557,762,Tuesday
2023,2,14,1600,228,377,605,Tuesday
2023,2,14,1500,241,361,602,Tuesday
2023,2,14,1400,283,299,582,Tuesday
2023,2,14,1300,293,248,541,Tuesday
2023,2,14,1200,360,227,587,Tuesday
2023,2,14,1100,341,174,515,Tuesday
2023,2,14,1000,405,169,574,Tuesday
2023,2,14,900,388,150,538,Tuesday
2023,2,14,800,205,51,256,Tuesday
2023,2,14,700,108,38,146,Tuesday
2023,2,14,600,52,15,67,Tuesday
2023,2,14,500,7,25,32,Tuesday
2023,2,14,400,13,16,29,Tuesday
2023,2,14,300,11,15,26,Tuesday
2023,2,14,200,16,13,29,Tuesday
2023,2,14,100,15,8,23,Tuesday
2023,2,13,2400,32,105,137,Monday
2023,2,13,2300,40,49,89,Monday
2023,2,13,2200,63,79,142,Monday
2023,2,13,2100,85,143,228,Monday
2023,2,13,2000,138,128,266,Monday
2023,2,13,1900,133,248,381,Monday
2023,2,13,1800,183,423,606,Monday
2023,2,13,1700,204,529,733,Monday
2023,2,13,1600,242,467,709,Monday
2023,2,13,1500,319,349,668,Monday
2023,2,13,1400,284,249,533,Monday
2023,2,13,1300,305,317,622,Monday
2023,2,13,1200,330,237,567,Monday
2023,2,13,1100,416,147,563,Monday
2023,2,13,1000,375,142,517,Monday
2023,2,13,900,497,111,608,Monday
2023,2,13,800,249,46,295,Monday
2023,2,13,700,101,26,127,Monday
2023,2,13,600,44,13,57,Monday
2023,2,13,500,22,8,30,Monday
2023,2,13,400,10,13,23,Monday
2023,2,13,300,19,13,32,Monday
2023,2,13,200,8,18,26,Monday
2023,2,13,100,15,11,26,Monday
2023,2,12,2400,20,29,49,Sunday
2023,2,12,2300,24,79,103,Sunday
2023,2,12,2200,41,108,149,Sunday
2023,2,12,2100,68,142,210,Sunday
2023,2,12,2000,114,223,337,Sunday
2023,2,12,1900,136,373,509,Sunday
2023,2,12,1800,159,635,794,Sunday
2023,2,12,1700,237,1123,1360,Sunday
2023,2,12,1600,297,881,1178,Sunday
2023,2,12,1500,364,808,1172,Sunday
2023,2,12,1400,359,714,1073,Sunday
2023,2,12,1300,420,653,1073,Sunday
2023,2,12,1200,452,502,954,Sunday
2023,2,12,1100,428,322,750,Sunday
2023,2,12,1000,515,176,691,Sunday
2023,2,12,900,623,101,724,Sunday
2023,2,12,800,282,38,320,Sunday
2023,2,12,700,82,30,112,Sunday
2023,2,12,600,37,33,70,Sunday
2023,2,12,500,20,13,33,Sunday
2023,2,12,400,12,10,22,Sunday
2023,2,12,300,5,22,27,Sunday
2023,2,12,200,16,23,39,Sunday
2023,2,12,100,18,41,59,Sunday
2023,2,11,2400,35,45,80,Saturday
2023,2,11,2300,46,59,105,Saturday
2023,2,11,2200,58,96,154,Saturday
2023,2,11,2100,77,136,213,Saturday
2023,2,11,2000,113,212,325,Saturday
2023,2,11,1900,147,368,515,Saturday
2023,2,11,1800,165,765,930,Saturday
2023,2,11,1700,264,1153,1417,Saturday
2023,2,11,1600,315,820,1135,Saturday
2023,2,11,1500,351,626,977,Saturday
2023,2,11,1400,408,444,852,Saturday
2023,2,11,1300,512,358,870,Saturday
2023,2,11,1200,562,286,848,Saturday
2023,2,11,1100,555,210,765,Saturday
2023,2,11,1000,647,190,837,Saturday
2023,2,11,900,950,172,1122,Saturday
2023,2,11,800,464,53,517,Saturday
2023,2,11,700,112,22,134,Saturday
2023,2,11,600,46,15,61,Saturday
2023,2,11,500,13,13,26,Saturday
2023,2,11,400,13,15,28,Saturday
2023,2,11,300,15,15,30,Saturday
2023,2,11,200,22,26,48,Saturday
2023,2,11,100,25,16,41,Saturday
2023,2,10,2400,50,40,90,Friday
2023,2,10,2300,62,90,152,Friday
2023,2,10,2200,79,113,192,Friday
2023,2,10,2100,184,161,345,Friday
2023,2,10,2000,304,214,518,Friday
2023,2,10,1900,388,305,693,Friday
2023,2,10,1800,430,536,966,Friday
2023,2,10,1700,444,718,1162,Friday
2023,2,10,1600,431,602,1033,Friday
2023,2,10,1500,432,392,824,Friday
2023,2,10,1400,430,347,777,Friday
2023,2,10,1300,402,310,712,Friday
2023,2,10,1200,447,277,724,Friday
2023,2,10,1100,437,232,669,Friday
2023,2,10,1000,494,162,656,Friday
2023,2,10,900,534,152,686,Friday
2023,2,10,800,341,55,396,Friday
2023,2,10,700,114,44,158,Friday
2023,2,10,600,58,27,85,Friday
2023,2,10,500,34,25,59,Friday
2023,2,10,400,13,12,25,Friday
2023,2,10,300,16,24,40,Friday
2023,2,10,200,24,23,47,Friday
2023,2,10,100,24,14,38,Friday
2023,2,9,2400,39,79,118,Thursday
2023,2,9,2300,62,95,157,Thursday
2023,2,9,2200,56,129,185,Thursday
2023,2,9,2100,158,97,255,Thursday
2023,2,9,2000,202,157,359,Thursday
2023,2,9,1900,230,242,472,Thursday
2023,2,9,1800,293,471,764,Thursday
2023,2,9,1700,294,640,934,Thursday
2023,2,9,1600,374,457,831,Thursday
2023,2,9,1500,322,372,694,Thursday
2023,2,9,1400,301,305,606,Thursday
2023,2,9,1300,293,278,571,Thursday
2023,2,9,1200,391,216,607,Thursday
2023,2,9,1100,371,167,538,Thursday
2023,2,9,1000,463,178,641,Thursday
2023,2,9,900,487,159,646,Thursday
2023,2,9,800,274,59,333,Thursday
2023,2,9,700,122,41,163,Thursday
2023,2,9,600,63,15,78,Thursday
2023,2,9,500,19,16,35,Thursday
2023,2,9,400,16,20,36,Thursday
2023,2,9,300,13,24,37,Thursday
2023,2,9,200,21,16,37,Thursday
2023,2,9,100,25,13,38,Thursday
2023,2,8,2400,40,37,77,Wednesday
2023,2,8,2300,49,82,131,Wednesday
2023,2,8,2200,64,119,183,Wednesday
2023,2,8,2100,91,164,255,Wednesday
2023,2,8,2000,148,141,289,Wednesday
2023,2,8,1900,153,235,388,Wednesday
2023,2,8,1800,181,424,605,Wednesday
2023,2,8,1700,196,590,786,Wednesday
2023,2,8,1600,254,374,628,Wednesday
2023,2,8,1500,279,368,647,Wednesday
2023,2,8,1400,282,262,544,Wednesday
2023,2,8,1300,292,275,567,Wednesday
2023,2,8,1200,287,212,499,Wednesday
2023,2,8,1100,331,179,510,Wednesday
2023,2,8,1000,379,160,539,Wednesday
2023,2,8,900,436,145,581,Wednesday
2023,2,8,800,289,41,330,Wednesday
2023,2,8,700,111,22,133,Wednesday
2023,2,8,600,55,24,79,Wednesday
2023,2,8,500,24,13,37,Wednesday
2023,2,8,400,23,18,41,Wednesday
2023,2,8,300,17,18,35,Wednesday
2023,2,8,200,28,22,50,Wednesday
2023,2,8,100,21,12,33,Wednesday
2023,2,7,2400,48,68,116,Tuesday
2023,2,7,2300,52,344,396,Tuesday
2023,2,7,2200,47,207,254,Tuesday
2023,2,7,2100,82,50,132,Tuesday
2023,2,7,2000,108,70,178,Tuesday
2023,2,7,1900,138,122,260,Tuesday
2023,2,7,1800,158,251,409,Tuesday
2023,2,7,1700,234,364,598,Tuesday
2023,2,7,1600,251,322,573,Tuesday
2023,2,7,1500,239,211,450,Tuesday
2023,2,7,1400,209,179,388,Tuesday
2023,2,7,1300,252,201,453,Tuesday
2023,2,7,1200,233,229,462,Tuesday
2023,2,7,1100,291,189,480,Tuesday
2023,2,7,1000,338,178,516,Tuesday
2023,2,7,900,340,155,495,Tuesday
2023,2,7,800,247,53,300,Tuesday
2023,2,7,700,97,39,136,Tuesday
2023,2,7,600,58,21,79,Tuesday
2023,2,7,500,26,20,46,Tuesday
2023,2,7,400,12,17,29,Tuesday
2023,2,7,300,14,14,28,Tuesday
2023,2,7,200,24,18,42,Tuesday
2023,2,7,100,39,11,50,Tuesday
2023,2,6,2400,30,44,74,Monday
2023,2,6,2300,46,96,142,Monday
2023,2,6,2200,61,81,142,Monday
2023,2,6,2100,85,115,200,Monday
2023,2,6,2000,127,114,241,Monday
2023,2,6,1900,136,237,373,Monday
2023,2,6,1800,144,349,493,Monday
2023,2,6,1700,208,506,714,Monday
2023,2,6,1600,257,435,692,Monday
2023,2,6,1500,263,326,589,Monday
2023,2,6,1400,292,311,603,Monday
2023,2,6,1300,359,277,636,Monday
2023,2,6,1200,414,252,666,Monday
2023,2,6,1100,325,191,516,Monday
2023,2,6,1000,390,157,547,Monday
2023,2,6,900,371,120,491,Monday
2023,2,6,800,265,35,300,Monday
2023,2,6,700,101,34,135,Monday
2023,2,6,600,47,16,63,Monday
2023,2,6,500,15,10,25,Monday
2023,2,6,400,14,6,20,Monday
2023,2,6,300,13,13,26,Monday
2023,2,6,200,13,16,29,Monday
2023,2,6,100,12,15,27,Monday
2023,2,5,2400,28,29,57,Sunday
2023,2,5,2300,30,87,117,Sunday
2023,2,5,2200,37,144,181,Sunday
2023,2,5,2100,80,165,245,Sunday
2023,2,5,2000,114,229,343,Sunday
2023,2,5,1900,117,455,572,Sunday
2023,2,5,1800,153,819,972,Sunday
2023,2,5,1700,247,1241,1488,Sunday
2023,2,5,1600,288,1025,1313,Sunday
2023,2,5,1500,324,784,1108,Sunday
2023,2,5,1400,400,681,1081,Sunday
2023,2,5,1300,402,543,945,Sunday
2023,2,5,1200,467,466,933,Sunday
2023,2,5,1100,489,268,757,Sunday
2023,2,5,1000,561,175,736,Sunday
2023,2,5,900,701,74,775,Sunday
2023,2,5,800,308,31,339,Sunday
2023,2,5,700,80,27,107,Sunday
2023,2,5,600,35,12,47,Sunday
2023,2,5,500,12,13,25,Sunday
2023,2,5,400,16,13,29,Sunday
2023,2,5,300,11,9,20,Sunday
2023,2,5,200,15,22,37,Sunday
2023,2,5,100,22,37,59,Sunday
2023,2,4,2400,35,50,85,Saturday
2023,2,4,2300,38,60,98,Saturday
2023,2,4,2200,46,69,115,Saturday
2023,2,4,2100,77,142,219,Saturday
2023,2,4,2000,93,160,253,Saturday
2023,2,4,1900,122,369,491,Saturday
2023,2,4,1800,175,789,964,Saturday
2023,2,4,1700,212,1144,1356,Saturday
2023,2,4,1600,286,734,1020,Saturday
2023,2,4,1500,311,554,865,Saturday
2023,2,4,1400,391,339,730,Saturday
2023,2,4,1300,432,332,764,Saturday
2023,2,4,1200,483,236,719,Saturday
2023,2,4,1100,457,187,644,Saturday
2023,2,4,1000,636,167,803,Saturday
2023,2,4,900,916,137,1053,Saturday
2023,2,4,800,431,36,467,Saturday
2023,2,4,700,134,15,149,Saturday
2023,2,4,600,28,10,38,Saturday
2023,2,4,500,12,24,36,Saturday
2023,2,4,400,6,21,27,Saturday
2023,2,4,300,7,9,16,Saturday
2023,2,4,200,27,20,47,Saturday
2023,2,4,100,20,15,35,Saturday
2023,2,3,2400,42,41,83,Friday
2023,2,3,2300,45,76,121,Friday
2023,2,3,2200,84,72,156,Friday
2023,2,3,2100,157,118,275,Friday
2023,2,3,2000,246,174,420,Friday
2023,2,3,1900,356,290,646,Friday
2023,2,3,1800,480,435,915,Friday
2023,2,3,1700,532,606,1138,Friday
2023,2,3,1600,459,506,965,Friday
2023,2,3,1500,441,386,827,Friday
2023,2,3,1400,405,323,728,Friday
2023,2,3,1300,353,242,595,Friday
2023,2,3,1200,397,225,622,Friday
2023,2,3,1100,428,185,613,Friday
2023,2,3,1000,467,228,695,Friday
2023,2,3,900,458,138,596,Friday
2023,2,3,800,254,43,297,Friday
2023,2,3,700,106,29,135,Friday
2023,2,3,600,56,26,82,Friday
2023,2,3,500,21,11,32,Friday
2023,2,3,400,13,3,16,Friday
2023,2,3,300,10,18,28,Friday
2023,2,3,200,13,12,25,Friday
2023,2,3,100,22,6,28,Friday
2023,2,2,2400,30,62,92,Thursday
2023,2,2,2300,52,83,135,Thursday
2023,2,2,2200,81,85,166,Thursday
2023,2,2,2100,140,130,270,Thursday
2023,2,2,2000,238,169,407,Thursday
2023,2,2,1900,266,223,489,Thursday
2023,2,2,1800,268,370,638,Thursday
2023,2,2,1700,294,517,811,Thursday
2023,2,2,1600,325,361,686,Thursday
2023,2,2,1500,303,337,640,Thursday
2023,2,2,1400,314,396,710,Thursday
2023,2,2,1300,329,160,489,Thursday
2023,2,2,1200,342,122,464,Thursday
2023,2,2,1100,349,153,502,Thursday
2023,2,2,1000,366,137,503,Thursday
2023,2,2,900,325,121,446,Thursday
2023,2,2,800,217,25,242,Thursday
2023,2,2,700,97,14,111,Thursday
2023,2,2,600,47,5,52,Thursday
2023,2,2,500,17,6,23,Thursday
2023,2,2,400,15,5,20,Thursday
2023,2,2,300,20,16,36,Thursday
2023,2,2,200,14,9,23,Thursday
2023,2,2,100,19,13,32,Thursday
2023,2,1,2400,42,46,88,Wednesday
2023,2,1,2300,47,67,114,Wednesday
2023,2,1,2200,64,80,144,Wednesday
2023,2,1,2100,117,109,226,Wednesday
2023,2,1,2000,155,154,309,Wednesday
2023,2,1,1900,143,200,343,Wednesday
2023,2,1,1800,180,299,479,Wednesday
2023,2,1,1700,233,378,611,Wednesday
2023,2,1,1600,213,364,577,Wednesday
2023,2,1,1500,267,275,542,Wednesday
2023,2,1,1400,238,263,501,Wednesday
2023,2,1,1300,244,215,459,Wednesday
2023,2,1,1200,251,189,440,Wednesday
2023,2,1,1100,301,172,473,Wednesday
2023,2,1,1000,292,127,419,Wednesday
2023,2,1,900,289,120,409,Wednesday
2023,2,1,800,178,48,226,Wednesday
2023,2,1,700,85,32,117,Wednesday
2023,2,1,600,48,33,81,Wednesday
2023,2,1,500,22,21,43,Wednesday
2023,2,1,400,20,11,31,Wednesday
2023,2,1,300,8,2,10,Wednesday
2023,2,1,200,21,14,35,Wednesday
2023,2,1,100,17,10,27,Wednesday
2023,1,31,2400,46,53,99,Tuesday
2023,1,31,2300,45,71,116,Tuesday
2023,1,31,2200,49,73,122,Tuesday
2023,1,31,2100,103,134,237,Tuesday
2023,1,31,2000,100,115,215,Tuesday
2023,1,31,1900,135,196,331,Tuesday
2023,1,31,1800,146,263,409,Tuesday
2023,1,31,1700,169,337,506,Tuesday
2023,1,31,1600,228,354,582,Tuesday
2023,1,31,1500,242,292,534,Tuesday
2023,1,31,1400,234,252,486,Tuesday
2023,1,31,1300,220,210,430,Tuesday
2023,1,31,1200,302,189,491,Tuesday
2023,1,31,1100,314,188,502,Tuesday
2023,1,31,1000,290,146,436,Tuesday
2023,1,31,900,262,136,398,Tuesday
2023,1,31,800,162,39,201,Tuesday
2023,1,31,700,81,27,108,Tuesday
2023,1,31,600,43,22,65,Tuesday
2023,1,31,500,17,12,29,Tuesday
2023,1,31,400,11,15,26,Tuesday
2023,1,31,300,16,14,30,Tuesday
2023,1,31,200,13,9,22,Tuesday
2023,1,31,100,28,8,36,Tuesday
2023,1,30,2400,27,24,51,Monday
2023,1,30,2300,33,68,101,Monday
2023,1,30,2200,58,80,138,Monday
2023,1,30,2100,81,93,174,Monday
2023,1,30,2000,112,112,224,Monday
2023,1,30,1900,129,193,322,Monday
2023,1,30,1800,176,306,482,Monday
2023,1,30,1700,195,440,635,Monday
2023,1,30,1600,202,358,560,Monday
2023,1,30,1500,238,342,580,Monday
2023,1,30,1400,247,288,535,Monday
2023,1,30,1300,283,298,581,Monday
2023,1,30,1200,311,255,566,Monday
2023,1,30,1100,284,191,475,Monday
2023,1,30,1000,275,135,410,Monday
2023,1,30,900,278,105,383,Monday
2023,1,30,800,155,24,179,Monday
2023,1,30,700,71,20,91,Monday
2023,1,30,600,36,16,52,Monday
2023,1,30,500,18,15,33,Monday
2023,1,30,400,14,6,20,Monday
2023,1,30,300,8,9,17,Monday
2023,1,30,200,20,13,33,Monday
2023,1,30,100,11,7,18,Monday
2023,1,29,2400,11,33,44,Sunday
2023,1,29,2300,37,65,102,Sunday
2023,1,29,2200,39,106,145,Sunday
2023,1,29,2100,65,144,209,Sunday
2023,1,29,2000,91,212,303,Sunday
2023,1,29,1900,129,359,488,Sunday
2023,1,29,1800,148,610,758,Sunday
2023,1,29,1700,194,870,1064,Sunday
2023,1,29,1600,276,771,1047,Sunday
2023,1,29,1500,317,667,984,Sunday
2023,1,29,1400,321,744,1065,Sunday
2023,1,29,1300,346,663,1009,Sunday
2023,1,29,1200,426,446,872,Sunday
2023,1,29,1100,360,246,606,Sunday
2023,1,29,1000,349,138,487,Sunday
2023,1,29,900,437,78,515,Sunday
2023,1,29,800,208,25,233,Sunday
2023,1,29,700,55,27,82,Sunday
2023,1,29,600,13,23,36,Sunday
2023,1,29,500,17,12,29,Sunday
2023,1,29,400,9,9,18,Sunday
2023,1,29,300,13,24,37,Sunday
2023,1,29,200,16,24,40,Sunday
2023,1,29,100,20,26,46,Sunday
2023,1,28,2400,23,32,55,Saturday
2023,1,28,2300,34,59,93,Saturday
2023,1,28,2200,54,93,147,Saturday
2023,1,28,2100,64,91,155,Saturday
2023,1,28,2000,83,140,223,Saturday
2023,1,28,1900,97,259,356,Saturday
2023,1,28,1800,149,550,699,Saturday
2023,1,28,1700,228,813,1041,Saturday
2023,1,28,1600,239,584,823,Saturday
2023,1,28,1500,285,397,682,Saturday
2023,1,28,1400,318,370,688,Saturday
2023,1,28,1300,323,351,674,Saturday
2023,1,28,1200,401,311,712,Saturday
2023,1,28,1100,404,232,636,Saturday
2023,1,28,1000,489,176,665,Saturday
2023,1,28,900,666,111,777,Saturday
2023,1,28,800,316,37,353,Saturday
2023,1,28,700,85,26,111,Saturday
2023,1,28,600,32,21,53,Saturday
2023,1,28,500,14,20,34,Saturday
2023,1,28,400,7,11,18,Saturday
2023,1,28,300,10,17,27,Saturday
2023,1,28,200,19,20,39,Saturday
2023,1,28,100,25,14,39,Saturday
2023,1,27,2400,41,65,106,Friday
2023,1,27,2300,60,259,319,Friday
2023,1,27,2200,102,345,447,Friday
2023,1,27,2100,179,150,329,Friday
2023,1,27,2000,209,69,278,Friday
2023,1,27,1900,290,168,458,Friday
2023,1,27,1800,373,338,711,Friday
2023,1,27,1700,447,530,977,Friday
2023,1,27,1600,392,395,787,Friday
2023,1,27,1500,399,272,671,Friday
2023,1,27,1400,313,218,531,Friday
2023,1,27,1300,354,205,559,Friday
2023,1,27,1200,419,204,623,Friday
2023,1,27,1100,399,223,622,Friday
2023,1,27,1000,508,195,703,Friday
2023,1,27,900,449,188,637,Friday
2023,1,27,800,251,47,298,Friday
2023,1,27,700,82,34,116,Friday
2023,1,27,600,40,39,79,Friday
2023,1,27,500,32,32,64,Friday
2023,1,27,400,10,21,31,Friday
2023,1,27,300,9,8,17,Friday
2023,1,27,200,23,17,40,Friday
2023,1,27,100,25,16,41,Friday
2023,1,26,2400,51,56,107,Thursday
2023,1,26,2300,66,82,148,Thursday
2023,1,26,2200,73,65,138,Thursday
2023,1,26,2100,156,123,279,Thursday
2023,1,26,2000,230,129,359,Thursday
2023,1,26,1900,269,228,497,Thursday
2023,1,26,1800,309,370,679,Thursday
2023,1,26,1700,309,556,865,Thursday
2023,1,26,1600,358,520,878,Thursday
2023,1,26,1500,373,397,770,Thursday
2023,1,26,1400,342,287,629,Thursday
2023,1,26,1300,320,280,600,Thursday
2023,1,26,1200,365,234,599,Thursday
2023,1,26,1100,371,193,564,Thursday
2023,1,26,1000,392,182,574,Thursday
2023,1,26,900,430,148,578,Thursday
2023,1,26,800,230,50,280,Thursday
2023,1,26,700,104,34,138,Thursday
2023,1,26,600,54,19,73,Thursday
2023,1,26,500,19,24,43,Thursday
2023,1,26,400,18,14,32,Thursday
2023,1,26,300,18,11,29,Thursday
2023,1,26,200,25,17,42,Thursday
2023,1,26,100,35,15,50,Thursday
2023,1,25,2400,53,46,99,Wednesday
2023,1,25,2300,36,79,115,Wednesday
2023,1,25,2200,71,107,178,Wednesday
2023,1,25,2100,102,111,213,Wednesday
2023,1,25,2000,129,211,340,Wednesday
2023,1,25,1900,152,242,394,Wednesday
2023,1,25,1800,161,404,565,Wednesday
2023,1,25,1700,230,556,786,Wednesday
2023,1,25,1600,255,434,689,Wednesday
2023,1,25,1500,256,402,658,Wednesday
2023,1,25,1400,295,311,606,Wednesday
2023,1,25,1300,282,287,569,Wednesday
2023,1,25,1200,339,222,561,Wednesday
2023,1,25,1100,380,152,532,Wednesday
2023,1,25,1000,400,144,544,Wednesday
2023,1,25,900,369,124,493,Wednesday
2023,1,25,800,252,45,297,Wednesday
2023,1,25,700,113,40,153,Wednesday
2023,1,25,600,41,38,79,Wednesday
2023,1,25,500,19,23,42,Wednesday
2023,1,25,400,17,10,27,Wednesday
2023,1,25,300,11,17,28,Wednesday
2023,1,25,200,17,7,24,Wednesday
2023,1,25,100,20,15,35,Wednesday
2023,1,24,2400,30,26,56,Tuesday
2023,1,24,2300,59,60,119,Tuesday
2023,1,24,2200,38,96,134,Tuesday
2023,1,24,2100,88,150,238,Tuesday
2023,1,24,2000,114,167,281,Tuesday
2023,1,24,1900,133,235,368,Tuesday
2023,1,24,1800,153,355,508,Tuesday
2023,1,24,1700,191,461,652,Tuesday
2023,1,24,1600,227,402,629,Tuesday
2023,1,24,1500,237,314,551,Tuesday
2023,1,24,1400,269,287,556,Tuesday
2023,1,24,1300,300,261,561,Tuesday
2023,1,24,1200,340,195,535,Tuesday
2023,1,24,1100,325,173,498,Tuesday
2023,1,24,1000,353,174,527,Tuesday
2023,1,24,900,331,115,446,Tuesday
2023,1,24,800,192,35,227,Tuesday
2023,1,24,700,114,35,149,Tuesday
2023,1,24,600,50,26,76,Tuesday
2023,1,24,500,16,10,26,Tuesday
2023,1,24,400,13,20,33,Tuesday
2023,1,24,300,9,13,22,Tuesday
2023,1,24,200,21,20,41,Tuesday
2023,1,24,100,29,19,48,Tuesday
2023,1,23,2400,40,46,86,Monday
2023,1,23,2300,39,95,134,Monday
2023,1,23,2200,48,93,141,Monday
2023,1,23,2100,84,101,185,Monday
2023,1,23,2000,119,147,266,Monday
2023,1,23,1900,124,205,329,Monday
2023,1,23,1800,157,335,492,Monday
2023,1,23,1700,206,478,684,Monday
2023,1,23,1600,264,454,718,Monday
2023,1,23,1500,265,354,619,Monday
2023,1,23,1400,325,292,617,Monday
2023,1,23,1300,331,270,601,Monday
2023,1,23,1200,384,238,622,Monday
2023,1,23,1100,388,160,548,Monday
2023,1,23,1000,383,146,529,Monday
2023,1,23,900,338,106,444,Monday
2023,1,23,800,197,45,242,Monday
2023,1,23,700,84,31,115,Monday
2023,1,23,600,34,14,48,Monday
2023,1,23,500,20,14,34,Monday
2023,1,23,400,14,4,18,Monday
2023,1,23,300,9,15,24,Monday
2023,1,23,200,14,20,34,Monday
2023,1,23,100,13,10,23,Monday
2023,1,22,2400,21,32,53,Sunday
2023,1,22,2300,48,80,128,Sunday
2023,1,22,2200,46,123,169,Sunday
2023,1,22,2100,63,182,245,Sunday
2023,1,22,2000,127,277,404,Sunday
2023,1,22,1900,127,427,554,Sunday
2023,1,22,1800,159,890,1049,Sunday
2023,1,22,1700,222,1219,1441,Sunday
2023,1,22,1600,301,927,1228,Sunday
2023,1,22,1500,367,830,1197,Sunday
2023,1,22,1400,410,671,1081,Sunday
2023,1,22,1300,551,595,1146,Sunday
2023,1,22,1200,460,446,906,Sunday
2023,1,22,1100,450,273,723,Sunday
2023,1,22,1000,527,140,667,Sunday
2023,1,22,900,570,74,644,Sunday
2023,1,22,800,346,25,371,Sunday
2023,1,22,700,73,16,89,Sunday
2023,1,22,600,35,10,45,Sunday
2023,1,22,500,9,14,23,Sunday
2023,1,22,400,12,8,20,Sunday
2023,1,22,300,11,16,27,Sunday
2023,1,22,200,18,11,29,Sunday
2023,1,22,100,19,25,44,Sunday
2023,1,21,2400,26,27,53,Saturday
2023,1,21,2300,34,56,90,Saturday
2023,1,21,2200,59,58,117,Saturday
2023,1,21,2100,77,80,157,Saturday
2023,1,21,2000,105,154,259,Saturday
2023,1,21,1900,106,374,480,Saturday
2023,1,21,1800,135,653,788,Saturday
2023,1,21,1700,206,1092,1298,Saturday
2023,1,21,1600,324,754,1078,Saturday
2023,1,21,1500,342,576,918,Saturday
2023,1,21,1400,421,476,897,Saturday
2023,1,21,1300,481,363,844,Saturday
2023,1,21,1200,491,246,737,Saturday
2023,1,21,1100,550,233,783,Saturday
2023,1,21,1000,571,176,747,Saturday
2023,1,21,900,827,149,976,Saturday
2023,1,21,800,533,25,558,Saturday
2023,1,21,700,145,18,163,Saturday
2023,1,21,600,45,12,57,Saturday
2023,1,21,500,7,20,27,Saturday
2023,1,21,400,12,11,23,Saturday
2023,1,21,300,3,19,22,Saturday
2023,1,21,200,19,14,33,Saturday
2023,1,21,100,26,16,42,Saturday
2023,1,20,2400,37,37,74,Friday
2023,1,20,2300,56,73,129,Friday
2023,1,20,2200,97,91,188,Friday
2023,1,20,2100,140,124,264,Friday
2023,1,20,2000,320,146,466,Friday
2023,1,20,1900,407,296,703,Friday
2023,1,20,1800,430,469,899,Friday
2023,1,20,1700,505,613,1118,Friday
2023,1,20,1600,481,494,975,Friday
2023,1,20,1500,540,459,999,Friday
2023,1,20,1400,450,395,845,Friday
2023,1,20,1300,438,279,717,Friday
2023,1,20,1200,444,234,678,Friday
2023,1,20,1100,443,186,629,Friday
2023,1,20,1000,460,174,634,Friday
2023,1,20,900,398,149,547,Friday
2023,1,20,800,238,41,279,Friday
2023,1,20,700,117,43,160,Friday
2023,1,20,600,49,29,78,Friday
2023,1,20,500,18,15,33,Friday
2023,1,20,400,18,23,41,Friday
2023,1,20,300,12,19,31,Friday
2023,1,20,200,19,19,38,Friday
2023,1,20,100,22,12,34,Friday
2023,1,19,2400,41,37,78,Thursday
2023,1,19,2300,56,95,151,Thursday
2023,1,19,2200,84,119,203,Thursday
2023,1,19,2100,149,106,255,Thursday
2023,1,19,2000,201,167,368,Thursday
2023,1,19,1900,216,228,444,Thursday
2023,1,19,1800,260,342,602,Thursday
2023,1,19,1700,292,564,856,Thursday
2023,1,19,1600,304,393,697,Thursday
2023,1,19,1500,339,331,670,Thursday
2023,1,19,1400,295,304,599,Thursday
2023,1,19,1300,298,240,538,Thursday
2023,1,19,1200,370,189,559,Thursday
2023,1,19,1100,361,166,527,Thursday
2023,1,19,1000,406,190,596,Thursday
2023,1,19,900,344,111,455,Thursday
2023,1,19,800,213,40,253,Thursday
2023,1,19,700,110,34,144,Thursday
2023,1,19,600,63,10,73,Thursday
2023,1,19,500,21,16,37,Thursday
2023,1,19,400,17,9,26,Thursday
2023,1,19,300,18,28,46,Thursday
2023,1,19,200,19,13,32,Thursday
2023,1,19,100,29,6,35,Thursday
2023,1,18,2400,36,36,72,Wednesday
2023,1,18,2300,50,83,133,Wednesday
2023,1,18,2200,54,93,147,Wednesday
2023,1,18,2100,124,138,262,Wednesday
2023,1,18,2000,151,153,304,Wednesday
2023,1,18,1900,184,216,400,Wednesday
2023,1,18,1800,206,334,540,Wednesday
2023,1,18,1700,242,506,748,Wednesday
2023,1,18,1600,222,374,596,Wednesday
2023,1,18,1500,242,298,540,Wednesday
2023,1,18,1400,278,265,543,Wednesday
2023,1,18,1300,278,220,498,Wednesday
2023,1,18,1200,318,220,538,Wednesday
2023,1,18,1100,309,161,470,Wednesday
2023,1,18,1000,346,167,513,Wednesday
2023,1,18,900,297,115,412,Wednesday
2023,1,18,800,208,34,242,Wednesday
2023,1,18,700,95,43,138,Wednesday
2023,1,18,600,54,23,77,Wednesday
2023,1,18,500,26,18,44,Wednesday
2023,1,18,400,14,31,45,Wednesday
2023,1,18,300,11,18,29,Wednesday
2023,1,18,200,21,20,41,Wednesday
2023,1,18,100,11,8,19,Wednesday
2023,1,17,2400,40,42,82,Tuesday
2023,1,17,2300,48,92,140,Tuesday
2023,1,17,2200,56,101,157,Tuesday
2023,1,17,2100,92,87,179,Tuesday
2023,1,17,2000,116,154,270,Tuesday
2023,1,17,1900,133,218,351,Tuesday
2023,1,17,1800,140,331,471,Tuesday
2023,1,17,1700,207,469,676,Tuesday
2023,1,17,1600,198,392,590,Tuesday
2023,1,17,1500,224,352,576,Tuesday
2023,1,17,1400,264,296,560,Tuesday
2023,1,17,1300,256,199,455,Tuesday
2023,1,17,1200,326,206,532,Tuesday
2023,1,17,1100,315,151,466,Tuesday
2023,1,17,1000,347,177,524,Tuesday
2023,1,17,900,301,137,438,Tuesday
2023,1,17,800,211,46,257,Tuesday
2023,1,17,700,90,32,122,Tuesday
2023,1,17,600,39,39,78,Tuesday
2023,1,17,500,21,24,45,Tuesday
2023,1,17,400,16,8,24,Tuesday
2023,1,17,300,18,7,25,Tuesday
2023,1,17,200,19,12,31,Tuesday
2023,1,17,100,23,10,33,Tuesday
2023,1,16,2400,33,38,71,Monday
2023,1,16,2300,57,70,127,Monday
2023,1,16,2200,42,99,141,Monday
2023,1,16,2100,74,100,174,Monday
2023,1,16,2000,126,144,270,Monday
2023,1,16,1900,110,225,335,Monday
2023,1,16,1800,159,367,526,Monday
2023,1,16,1700,194,467,661,Monday
2023,1,16,1600,230,406,636,Monday
2023,1,16,1500,248,327,575,Monday
2023,1,16,1400,268,291,559,Monday
2023,1,16,1300,301,270,571,Monday
2023,1,16,1200,323,237,560,Monday
2023,1,16,1100,375,139,514,Monday
2023,1,16,1000,404,124,528,Monday
2023,1,16,900,305,105,410,Monday
2023,1,16,800,223,47,270,Monday
2023,1,16,700,94,33,127,Monday
2023,1,16,600,43,19,62,Monday
2023,1,16,500,21,16,37,Monday
2023,1,16,400,13,14,27,Monday
2023,1,16,300,8,11,19,Monday
2023,1,16,200,18,17,35,Monday
2023,1,16,100,12,10,22,Monday
2023,1,15,2400,36,46,82,Sunday
2023,1,15,2300,26,68,94,Sunday
2023,1,15,2200,46,101,147,Sunday
2023,1,15,2100,49,168,217,Sunday
2023,1,15,2000,96,253,349,Sunday
2023,1,15,1900,133,448,581,Sunday
2023,1,15,1800,159,742,901,Sunday
2023,1,15,1700,225,1222,1447,Sunday
2023,1,15,1600,239,780,1019,Sunday
2023,1,15,1500,349,753,1102,Sunday
2023,1,15,1400,347,702,1049,Sunday
2023,1,15,1300,415,583,998,Sunday
2023,1,15,1200,489,420,909,Sunday
2023,1,15,1100,406,209,615,Sunday
2023,1,15,1000,509,126,635,Sunday
2023,1,15,900,589,87,676,Sunday
2023,1,15,800,351,29,380,Sunday
2023,1,15,700,86,15,101,Sunday
2023,1,15,600,22,13,35,Sunday
2023,1,15,500,11,13,24,Sunday
2023,1,15,400,14,21,35,Sunday
2023,1,15,300,22,23,45,Sunday
2023,1,15,200,13,17,30,Sunday
2023,1,15,100,23,25,48,Sunday
2023,1,14,2400,26,41,67,Saturday
2023,1,14,2300,38,42,80,Saturday
2023,1,14,2200,52,80,132,Saturday
2023,1,14,2100,63,112,175,Saturday
2023,1,14,2000,99,151,250,Saturday
2023,1,14,1900,91,304,395,Saturday
2023,1,14,1800,156,676,832,Saturday
2023,1,14,1700,220,1024,1244,Saturday
2023,1,14,1600,238,689,927,Saturday
2023,1,14,1500,291,511,802,Saturday
2023,1,14,1400,382,383,765,Saturday
2023,1,14,1300,424,354,778,Saturday
2023,1,14,1200,497,422,919,Saturday
2023,1,14,1100,497,133,630,Saturday
2023,1,14,1000,624,82,706,Saturday
2023,1,14,900,750,73,823,Saturday
2023,1,14,800,429,36,465,Saturday
2023,1,14,700,112,42,154,Saturday
2023,1,14,600,52,6,58,Saturday
2023,1,14,500,16,7,23,Saturday
2023,1,14,400,19,9,28,Saturday
2023,1,14,300,9,16,25,Saturday
2023,1,14,200,14,23,37,Saturday
2023,1,14,100,33,7,40,Saturday
2023,1,13,2400,38,51,89,Friday
2023,1,13,2300,40,89,129,Friday
2023,1,13,2200,76,100,176,Friday
2023,1,13,2100,184,164,348,Friday
2023,1,13,2000,304,101,405,Friday
2023,1,13,1900,383,242,625,Friday
2023,1,13,1800,416,399,815,Friday
2023,1,13,1700,428,551,979,Friday
2023,1,13,1600,434,429,863,Friday
2023,1,13,1500,386,361,747,Friday
2023,1,13,1400,355,323,678,Friday
2023,1,13,1300,321,232,553,Friday
2023,1,13,1200,347,192,539,Friday
2023,1,13,1100,328,190,518,Friday
2023,1,13,1000,368,141,509,Friday
2023,1,13,900,373,111,484,Friday
2023,1,13,800,205,31,236,Friday
2023,1,13,700,110,36,146,Friday
2023,1,13,600,56,17,73,Friday
2023,1,13,500,23,15,38,Friday
2023,1,13,400,17,13,30,Friday
2023,1,13,300,13,12,25,Friday
2023,1,13,200,15,15,30,Friday
2023,1,13,100,39,14,53,Friday
2023,1,12,2400,32,50,82,Thursday
2023,1,12,2300,47,83,130,Thursday
2023,1,12,2200,77,129,206,Thursday
2023,1,12,2100,120,122,242,Thursday
2023,1,12,2000,193,118,311,Thursday
2023,1,12,1900,195,205,400,Thursday
2023,1,12,1800,262,284,546,Thursday
2023,1,12,1700,280,439,719,Thursday
2023,1,12,1600,290,387,677,Thursday
2023,1,12,1500,306,320,626,Thursday
2023,1,12,1400,261,281,542,Thursday
2023,1,12,1300,292,198,490,Thursday
2023,1,12,1200,286,196,482,Thursday
2023,1,12,1100,336,169,505,Thursday
2023,1,12,1000,368,140,508,Thursday
2023,1,12,900,300,136,436,Thursday
2023,1,12,800,223,32,255,Thursday
2023,1,12,700,117,37,154,Thursday
2023,1,12,600,51,14,65,Thursday
2023,1,12,500,28,16,44,Thursday
2023,1,12,400,24,18,42,Thursday
2023,1,12,300,9,13,22,Thursday
2023,1,12,200,15,21,36,Thursday
2023,1,12,100,26,16,42,Thursday
2023,1,11,2400,31,53,84,Wednesday
2023,1,11,2300,57,77,134,Wednesday
2023,1,11,2200,46,87,133,Wednesday
2023,1,11,2100,97,157,254,Wednesday
2023,1,11,2000,135,112,247,Wednesday
2023,1,11,1900,142,221,363,Wednesday
2023,1,11,1800,150,285,435,Wednesday
2023,1,11,1700,188,445,633,Wednesday
2023,1,11,1600,210,389,599,Wednesday
2023,1,11,1500,241,347,588,Wednesday
2023,1,11,1400,262,270,532,Wednesday
2023,1,11,1300,261,253,514,Wednesday
2023,1,11,1200,305,197,502,Wednesday
2023,1,11,1100,358,146,504,Wednesday
2023,1,11,1000,332,162,494,Wednesday
2023,1,11,900,292,123,415,Wednesday
2023,1,11,800,196,34,230,Wednesday
2023,1,11,700,101,28,129,Wednesday
2023,1,11,600,48,12,60,Wednesday
2023,1,11,500,28,17,45,Wednesday
2023,1,11,400,12,12,24,Wednesday
2023,1,11,300,17,18,35,Wednesday
2023,1,11,200,22,17,39,Wednesday
2023,1,11,100,24,11,35,Wednesday
2023,1,10,2400,36,54,90,Tuesday
2023,1,10,2300,44,93,137,Tuesday
2023,1,10,2200,53,94,147,Tuesday
2023,1,10,2100,94,89,183,Tuesday
2023,1,10,2000,110,126,236,Tuesday
2023,1,10,1900,109,207,316,Tuesday
2023,1,10,1800,147,300,447,Tuesday
2023,1,10,1700,183,383,566,Tuesday
2023,1,10,1600,205,366,571,Tuesday
2023,1,10,1500,222,307,529,Tuesday
2023,1,10,1400,263,307,570,Tuesday
2023,1,10,1300,268,194,462,Tuesday
2023,1,10,1200,324,236,560,Tuesday
2023,1,10,1100,306,174,480,Tuesday
2023,1,10,1000,282,267,549,Tuesday
2023,1,10,900,263,179,442,Tuesday
2023,1,10,800,168,46,214,Tuesday
2023,1,10,700,86,28,114,Tuesday
2023,1,10,600,50,23,73,Tuesday
2023,1,10,500,12,11,23,Tuesday
2023,1,10,400,13,29,42,Tuesday
2023,1,10,300,16,38,54,Tuesday
2023,1,10,200,13,39,52,Tuesday
2023,1,10,100,21,103,124,Tuesday
2023,1,9,2400,29,20,49,Monday
2023,1,9,2300,40,7,47,Monday
2023,1,9,2200,39,21,60,Monday
2023,1,9,2100,92,35,127,Monday
2023,1,9,2000,122,57,179,Monday
2023,1,9,1900,106,125,231,Monday
2023,1,9,1800,158,254,412,Monday
2023,1,9,1700,179,403,582,Monday
2023,1,9,1600,225,350,575,Monday
2023,1,9,1500,254,321,575,Monday
2023,1,9,1400,286,255,541,Monday
2023,1,9,1300,330,218,548,Monday
2023,1,9,1200,307,204,511,Monday
2023,1,9,1100,359,169,528,Monday
2023,1,9,1000,329,97,426,Monday
2023,1,9,900,281,100,381,Monday
2023,1,9,800,199,30,229,Monday
2023,1,9,700,103,31,134,Monday
2023,1,9,600,42,13,55,Monday
2023,1,9,500,20,9,29,Monday
2023,1,9,400,20,11,31,Monday
2023,1,9,300,7,12,19,Monday
2023,1,9,200,12,17,29,Monday
2023,1,9,100,20,8,28,Monday
2023,1,8,2400,16,34,50,Sunday
2023,1,8,2300,28,62,90,Sunday
2023,1,8,2200,29,111,140,Sunday
2023,1,8,2100,61,136,197,Sunday
2023,1,8,2000,82,207,289,Sunday
2023,1,8,1900,130,345,475,Sunday
2023,1,8,1800,138,723,861,Sunday
2023,1,8,1700,187,1116,1303,Sunday
2023,1,8,1600,237,871,1108,Sunday
2023,1,8,1500,342,816,1158,Sunday
2023,1,8,1400,362,681,1043,Sunday
2023,1,8,1300,385,530,915,Sunday
2023,1,8,1200,525,432,957,Sunday
2023,1,8,1100,456,232,688,Sunday
2023,1,8,1000,483,129,612,Sunday
2023,1,8,900,559,87,646,Sunday
2023,1,8,800,335,30,365,Sunday
2023,1,8,700,82,24,106,Sunday
2023,1,8,600,27,12,39,Sunday
2023,1,8,500,7,5,12,Sunday
2023,1,8,400,11,16,27,Sunday
2023,1,8,300,10,13,23,Sunday
2023,1,8,200,9,13,22,Sunday
2023,1,8,100,16,12,28,Sunday
2023,1,7,2400,27,37,64,Saturday
2023,1,7,2300,34,57,91,Saturday
2023,1,7,2200,45,87,132,Saturday
2023,1,7,2100,61,145,206,Saturday
2023,1,7,2000,112,193,305,Saturday
2023,1,7,1900,89,341,430,Saturday
2023,1,7,1800,155,727,882,Saturday
2023,1,7,1700,211,1155,1366,Saturday
2023,1,7,1600,250,789,1039,Saturday
2023,1,7,1500,355,609,964,Saturday
2023,1,7,1400,455,515,970,Saturday
2023,1,7,1300,502,399,901,Saturday
2023,1,7,1200,514,355,869,Saturday
2023,1,7,1100,501,231,732,Saturday
2023,1,7,1000,538,159,697,Saturday
2023,1,7,900,800,166,966,Saturday
2023,1,7,800,395,42,437,Saturday
2023,1,7,700,102,30,132,Saturday
2023,1,7,600,35,19,54,Saturday
2023,1,7,500,17,12,29,Saturday
2023,1,7,400,2,17,19,Saturday
2023,1,7,300,16,22,38,Saturday
2023,1,7,200,16,15,31,Saturday
2023,1,7,100,30,17,47,Saturday
2023,1,6,2400,34,41,75,Friday
2023,1,6,2300,49,87,136,Friday
2023,1,6,2200,65,85,150,Friday
2023,1,6,2100,156,115,271,Friday
2023,1,6,2000,192,190,382,Friday
2023,1,6,1900,259,303,562,Friday
2023,1,6,1800,265,550,815,Friday
2023,1,6,1700,319,823,1142,Friday
2023,1,6,1600,334,688,1022,Friday
2023,1,6,1500,409,603,1012,Friday
2023,1,6,1400,380,459,839,Friday
2023,1,6,1300,397,467,864,Friday
2023,1,6,1200,474,341,815,Friday
2023,1,6,1100,461,228,689,Friday
2023,1,6,1000,467,205,672,Friday
2023,1,6,900,483,130,613,Friday
2023,1,6,800,273,47,320,Friday
2023,1,6,700,93,34,127,Friday
2023,1,6,600,54,24,78,Friday
2023,1,6,500,18,21,39,Friday
2023,1,6,400,19,21,40,Friday
2023,1,6,300,20,21,41,Friday
2023,1,6,200,22,23,45,Friday
2023,1,6,100,20,13,33,Friday
2023,1,5,2400,33,34,67,Thursday
2023,1,5,2300,50,81,131,Thursday
2023,1,5,2200,65,112,177,Thursday
2023,1,5,2100,102,138,240,Thursday
2023,1,5,2000,153,155,308,Thursday
2023,1,5,1900,189,292,481,Thursday
2023,1,5,1800,214,532,746,Thursday
2023,1,5,1700,290,811,1101,Thursday
2023,1,5,1600,307,692,999,Thursday
2023,1,5,1500,399,581,980,Thursday
2023,1,5,1400,392,473,865,Thursday
2023,1,5,1300,414,366,780,Thursday
2023,1,5,1200,532,318,850,Thursday
2023,1,5,1100,489,221,710,Thursday
2023,1,5,1000,464,173,637,Thursday
2023,1,5,900,561,154,715,Thursday
2023,1,5,800,283,42,325,Thursday
2023,1,5,700,117,34,151,Thursday
2023,1,5,600,57,23,80,Thursday
2023,1,5,500,22,18,40,Thursday
2023,1,5,400,16,20,36,Thursday
2023,1,5,300,16,27,43,Thursday
2023,1,5,200,17,13,30,Thursday
2023,1,5,100,19,11,30,Thursday
2023,1,4,2400,42,44,86,Wednesday
2023,1,4,2300,52,122,174,Wednesday
2023,1,4,2200,73,104,177,Wednesday
2023,1,4,2100,114,132,246,Wednesday
2023,1,4,2000,142,182,324,Wednesday
2023,1,4,1900,149,270,419,Wednesday
2023,1,4,1800,196,596,792,Wednesday
2023,1,4,1700,237,1302,1539,Wednesday
2023,1,4,1600,317,599,916,Wednesday
2023,1,4,1500,364,389,753,Wednesday
2023,1,4,1400,399,333,732,Wednesday
2023,1,4,1300,451,355,806,Wednesday
2023,1,4,1200,510,326,836,Wednesday
2023,1,4,1100,492,241,733,Wednesday
2023,1,4,1000,511,173,684,Wednesday
2023,1,4,900,543,146,689,Wednesday
2023,1,4,800,247,52,299,Wednesday
2023,1,4,700,94,36,130,Wednesday
2023,1,4,600,50,34,84,Wednesday
2023,1,4,500,13,26,39,Wednesday
2023,1,4,400,17,9,26,Wednesday
2023,1,4,300,16,14,30,Wednesday
2023,1,4,200,26,10,36,Wednesday
2023,1,4,100,26,6,32,Wednesday
2023,1,3,2400,35,44,79,Tuesday
2023,1,3,2300,46,52,98,Tuesday
2023,1,3,2200,66,57,123,Tuesday
2023,1,3,2100,88,104,192,Tuesday
2023,1,3,2000,156,164,320,Tuesday
2023,1,3,1900,137,296,433,Tuesday
2023,1,3,1800,182,796,978,Tuesday
2023,1,3,1700,278,899,1177,Tuesday
2023,1,3,1600,333,788,1121,Tuesday
2023,1,3,1500,416,639,1055,Tuesday
2023,1,3,1400,466,519,985,Tuesday
2023,1,3,1300,563,437,1000,Tuesday
2023,1,3,1200,599,320,919,Tuesday
2023,1,3,1100,580,222,802,Tuesday
2023,1,3,1000,570,152,722,Tuesday
2023,1,3,900,645,101,746,Tuesday
2023,1,3,800,357,57,414,Tuesday
2023,1,3,700,95,38,133,Tuesday
2023,1,3,600,50,19,69,Tuesday
2023,1,3,500,19,20,39,Tuesday
2023,1,3,400,25,10,35,Tuesday
2023,1,3,300,12,17,29,Tuesday
2023,1,3,200,29,22,51,Tuesday
2023,1,3,100,15,41,56,Tuesday
2023,1,2,2400,26,51,77,Monday
2023,1,2,2300,44,81,125,Monday
2023,1,2,2200,44,94,138,Monday
2023,1,2,2100,87,215,302,Monday
2023,1,2,2000,113,222,335,Monday
2023,1,2,1900,154,481,635,Monday
2023,1,2,1800,200,1027,1227,Monday
2023,1,2,1700,296,1512,1808,Monday
2023,1,2,1600,487,1325,1812,Monday
2023,1,2,1500,537,1214,1751,Monday
2023,1,2,1400,704,1076,1780,Monday
2023,1,2,1300,775,924,1699,Monday
2023,1,2,1200,800,623,1423,Monday
2023,1,2,1100,857,329,1186,Monday
2023,1,2,1000,816,187,1003,Monday
2023,1,2,900,962,103,1065,Monday
2023,1,2,800,394,46,440,Monday
2023,1,2,700,94,30,124,Monday
2023,1,2,600,35,18,53,Monday
2023,1,2,500,24,12,36,Monday
2023,1,2,400,12,8,20,Monday
2023,1,2,300,10,12,22,Monday
2023,1,2,200,17,11,28,Monday
2023,1,2,100,15,23,38,Monday
2023,1,1,2400,18,35,53,Sunday
2023,1,1,2300,21,57,78,Sunday
2023,1,1,2200,46,79,125,Sunday
2023,1,1,2100,71,156,227,Sunday
2023,1,1,2000,78,203,281,Sunday
2023,1,1,1900,122,449,571,Sunday
2023,1,1,1800,154,934,1088,Sunday
2023,1,1,1700,290,1271,1561,Sunday
2023,1,1,1600,419,1080,1499,Sunday
2023,1,1,1500,558,954,1512,Sunday
2023,1,1,1400,667,849,1516,Sunday
2023,1,1,1300,696,638,1334,Sunday
2023,1,1,1200,702,409,1111,Sunday
2023,1,1,1100,586,198,784,Sunday
2023,1,1,1000,464,112,576,Sunday
2023,1,1,900,462,72,534,Sunday
2023,1,1,800,237,27,264,Sunday
2023,1,1,700,49,6,55,Sunday
2023,1,1,600,26,17,43,Sunday
2023,1,1,500,11,13,24,Sunday
2023,1,1,400,12,15,27,Sunday
2023,1,1,300,12,22,34,Sunday
2023,1,1,200,15,18,33,Sunday
2023,1,1,100,22,23,45,Sunday
2022,12,31,2400,7,30,37,Saturday
2022,12,31,2300,27,48,75,Saturday
2022,12,31,2200,40,71,111,Saturday
2022,12,31,2100,54,128,182,Saturday
2022,12,31,2000,68,156,224,Saturday
2022,12,31,1900,88,321,409,Saturday
2022,12,31,1800,146,640,786,Saturday
2022,12,31,1700,192,1115,1307,Saturday
2022,12,31,1600,346,821,1167,Saturday
2022,12,31,1500,433,538,971,Saturday
2022,12,31,1400,572,457,1029,Saturday
2022,12,31,1300,598,438,1036,Saturday
2022,12,31,1200,596,368,964,Saturday
2022,12,31,1100,572,243,815,Saturday
2022,12,31,1000,558,134,692,Saturday
2022,12,31,900,700,100,800,Saturday
2022,12,31,800,359,41,400,Saturday
2022,12,31,700,79,33,112,Saturday
2022,12,31,600,21,18,39,Saturday
2022,12,31,500,19,23,42,Saturday
2022,12,31,400,18,21,39,Saturday
2022,12,31,300,22,21,43,Saturday
2022,12,31,200,17,40,57,Saturday
2022,12,31,100,29,51,80,Saturday
2022,12,30,2400,39,71,110,Friday
2022,12,30,2300,63,70,133,Friday
2022,12,30,2200,79,88,167,Friday
2022,12,30,2100,125,125,250,Friday
2022,12,30,2000,149,245,394,Friday
2022,12,30,1900,222,435,657,Friday
2022,12,30,1800,309,996,1305,Friday
2022,12,30,1700,456,1315,1771,Friday
2022,12,30,1600,619,1074,1693,Friday
2022,12,30,1500,721,885,1606,Friday
2022,12,30,1400,842,902,1744,Friday
2022,12,30,1300,767,481,1248,Friday
2022,12,30,1200,755,423,1178,Friday
2022,12,30,1100,706,303,1009,Friday
2022,12,30,1000,860,192,1052,Friday
2022,12,30,900,1134,101,1235,Friday
2022,12,30,800,528,49,577,Friday
2022,12,30,700,144,59,203,Friday
2022,12,30,600,37,39,76,Friday
2022,12,30,500,21,25,46,Friday
2022,12,30,400,27,19,46,Friday
2022,12,30,300,20,29,49,Friday
2022,12,30,200,25,33,58,Friday
2022,12,30,100,33,31,64,Friday
2022,12,29,2400,38,58,96,Thursday
2022,12,29,2300,48,73,121,Thursday
2022,12,29,2200,84,102,186,Thursday
2022,12,29,2100,142,165,307,Thursday
2022,12,29,2000,165,220,385,Thursday
2022,12,29,1900,175,412,587,Thursday
2022,12,29,1800,272,1163,1435,Thursday
2022,12,29,1700,411,1452,1863,Thursday
2022,12,29,1600,579,1089,1668,Thursday
2022,12,29,1500,707,871,1578,Thursday
2022,12,29,1400,732,505,1237,Thursday
2022,12,29,1300,815,633,1448,Thursday
2022,12,29,1200,842,309,1151,Thursday
2022,12,29,1100,881,266,1147,Thursday
2022,12,29,1000,1029,163,1192,Thursday
2022,12,29,900,1026,113,1139,Thursday
2022,12,29,800,445,48,493,Thursday
2022,12,29,700,104,40,144,Thursday
2022,12,29,600,56,39,95,Thursday
2022,12,29,500,32,23,55,Thursday
2022,12,29,400,20,23,43,Thursday
2022,12,29,300,21,29,50,Thursday
2022,12,29,200,23,27,50,Thursday
2022,12,29,100,34,42,76,Thursday
2022,12,28,2400,41,59,100,Wednesday
2022,12,28,2300,56,88,144,Wednesday
2022,12,28,2200,68,93,161,Wednesday
2022,12,28,2100,111,151,262,Wednesday
2022,12,28,2000,173,188,361,Wednesday
2022,12,28,1900,175,360,535,Wednesday
2022,12,28,1800,286,1006,1292,Wednesday
2022,12,28,1700,383,1158,1541,Wednesday
2022,12,28,1600,537,892,1429,Wednesday
2022,12,28,1500,625,782,1407,Wednesday
2022,12,28,1400,664,589,1253,Wednesday
2022,12,28,1300,711,463,1174,Wednesday
2022,12,28,1200,894,341,1235,Wednesday
2022,12,28,1100,982,201,1183,Wednesday
2022,12,28,1000,1382,118,1500,Wednesday
2022,12,28,900,476,75,551,Wednesday
2022,12,28,800,375,48,423,Wednesday
2022,12,28,700,83,27,110,Wednesday
2022,12,28,600,46,23,69,Wednesday
2022,12,28,500,22,14,36,Wednesday
2022,12,28,400,11,18,29,Wednesday
2022,12,28,300,14,30,44,Wednesday
2022,12,28,200,21,29,50,Wednesday
2022,12,28,100,24,48,72,Wednesday
2022,12,27,2400,45,47,92,Tuesday
2022,12,27,2300,46,72,118,Tuesday
2022,12,27,2200,72,90,162,Tuesday
2022,12,27,2100,108,173,281,Tuesday
2022,12,27,2000,137,158,295,Tuesday
2022,12,27,1900,189,372,561,Tuesday
2022,12,27,1800,309,937,1246,Tuesday
2022,12,27,1700,496,1230,1726,Tuesday
2022,12,27,1600,607,961,1568,Tuesday
2022,12,27,1500,802,727,1529,Tuesday
2022,12,27,1400,961,601,1562,Tuesday
2022,12,27,1300,899,493,1392,Tuesday
2022,12,27,1200,898,337,1235,Tuesday
2022,12,27,1100,849,189,1038,Tuesday
2022,12,27,1000,968,141,1109,Tuesday
2022,12,27,900,864,51,915,Tuesday
2022,12,27,800,439,30,469,Tuesday
2022,12,27,700,120,19,139,Tuesday
2022,12,27,600,57,16,73,Tuesday
2022,12,27,500,19,22,41,Tuesday
2022,12,27,400,10,19,29,Tuesday
2022,12,27,300,20,19,39,Tuesday
2022,12,27,200,26,11,37,Tuesday
2022,12,27,100,36,22,58,Tuesday
2022,12,26,2400,32,52,84,Monday
2022,12,26,2300,43,125,168,Monday
2022,12,26,2200,61,278,339,Monday
2022,12,26,2100,92,118,210,Monday
2022,12,26,2000,142,64,206,Monday
2022,12,26,1900,165,186,351,Monday
2022,12,26,1800,280,561,841,Monday
2022,12,26,1700,396,750,1146,Monday
2022,12,26,1600,618,592,1210,Monday
2022,12,26,1500,800,543,1343,Monday
2022,12,26,1400,759,523,1282,Monday
2022,12,26,1300,760,501,1261,Monday
2022,12,26,1200,767,340,1107,Monday
2022,12,26,1100,653,219,872,Monday
2022,12,26,1000,595,96,691,Monday
2022,12,26,900,582,66,648,Monday
2022,12,26,800,257,31,288,Monday
2022,12,26,700,98,23,121,Monday
2022,12,26,600,47,15,62,Monday
2022,12,26,500,20,16,36,Monday
2022,12,26,400,18,10,28,Monday
2022,12,26,300,8,9,17,Monday
2022,12,26,200,10,26,36,Monday
2022,12,26,100,19,115,134,Monday
2022,12,25,2400,24,207,231,Sunday
2022,12,25,2300,25,141,166,Sunday
2022,12,25,2200,35,39,74,Sunday
2022,12,25,2100,46,49,95,Sunday
2022,12,25,2000,44,84,128,Sunday
2022,12,25,1900,55,192,247,Sunday
2022,12,25,1800,79,482,561,Sunday
2022,12,25,1700,155,598,753,Sunday
2022,12,25,1600,262,440,702,Sunday
2022,12,25,1500,391,288,679,Sunday
2022,12,25,1400,439,215,654,Sunday
2022,12,25,1300,406,138,544,Sunday
2022,12,25,1200,423,96,519,Sunday
2022,12,25,1100,355,76,431,Sunday
2022,12,25,1000,310,35,345,Sunday
2022,12,25,900,294,24,318,Sunday
2022,12,25,800,110,16,126,Sunday
2022,12,25,700,26,4,30,Sunday
2022,12,25,600,8,5,13,Sunday
2022,12,25,500,6,8,14,Sunday
2022,12,25,400,12,7,19,Sunday
2022,12,25,300,5,11,16,Sunday
2022,12,25,200,8,8,16,Sunday
2022,12,25,100,11,6,17,Sunday
2022,12,24,2400,13,17,30,Saturday
2022,12,24,2300,25,23,48,Saturday
2022,12,24,2200,36,21,57,Saturday
2022,12,24,2100,45,33,78,Saturday
2022,12,24,2000,64,55,119,Saturday
2022,12,24,1900,73,94,167,Saturday
2022,12,24,1800,89,314,403,Saturday
2022,12,24,1700,169,483,652,Saturday
2022,12,24,1600,291,377,668,Saturday
2022,12,24,1500,359,401,760,Saturday
2022,12,24,1400,406,247,653,Saturday
2022,12,24,1300,492,221,713,Saturday
2022,12,24,1200,494,215,709,Saturday
2022,12,24,1100,434,165,599,Saturday
2022,12,24,1000,399,97,496,Saturday
2022,12,24,900,385,70,455,Saturday
2022,12,24,800,170,56,226,Saturday
2022,12,24,700,83,42,125,Saturday
2022,12,24,600,29,23,52,Saturday
2022,12,24,500,17,12,29,Saturday
2022,12,24,400,19,6,25,Saturday
2022,12,24,300,14,62,76,Saturday
2022,12,24,200,16,13,29,Saturday
2022,12,24,100,21,13,34,Saturday
2022,12,23,2400,39,65,104,Friday
2022,12,23,2300,55,99,154,Friday
2022,12,23,2200,85,108,193,Friday
2022,12,23,2100,109,144,253,Friday
2022,12,23,2000,148,194,342,Friday
2022,12,23,1900,196,280,476,Friday
2022,12,23,1800,246,491,737,Friday
2022,12,23,1700,372,529,901,Friday
2022,12,23,1600,477,423,900,Friday
2022,12,23,1500,560,370,930,Friday
2022,12,23,1400,582,340,922,Friday
2022,12,23,1300,558,309,867,Friday
2022,12,23,1200,589,286,875,Friday
2022,12,23,1100,481,233,714,Friday
2022,12,23,1000,436,152,588,Friday
2022,12,23,900,342,107,449,Friday
2022,12,23,800,199,56,255,Friday
2022,12,23,700,112,40,152,Friday
2022,12,23,600,53,35,88,Friday
2022,12,23,500,41,37,78,Friday
2022,12,23,400,18,33,51,Friday
2022,12,23,300,18,46,64,Friday
2022,12,23,200,26,39,65,Friday
2022,12,23,100,47,74,121,Friday
2022,12,22,2400,56,110,166,Thursday
2022,12,22,2300,73,136,209,Thursday
2022,12,22,2200,97,166,263,Thursday
2022,12,22,2100,137,181,318,Thursday
2022,12,22,2000,180,265,445,Thursday
2022,12,22,1900,203,295,498,Thursday
2022,12,22,1800,252,469,721,Thursday
2022,12,22,1700,313,541,854,Thursday
2022,12,22,1600,368,534,902,Thursday
2022,12,22,1500,433,462,895,Thursday
2022,12,22,1400,435,430,865,Thursday
2022,12,22,1300,464,405,869,Thursday
2022,12,22,1200,457,341,798,Thursday
2022,12,22,1100,383,207,590,Thursday
2022,12,22,1000,330,133,463,Thursday
2022,12,22,900,244,107,351,Thursday
2022,12,22,800,159,64,223,Thursday
2022,12,22,700,91,30,121,Thursday
2022,12,22,600,45,21,66,Thursday
2022,12,22,500,24,16,40,Thursday
2022,12,22,400,25,44,69,Thursday
2022,12,22,300,24,28,52,Thursday
2022,12,22,200,25,46,71,Thursday
2022,12,22,100,34,45,79,Thursday
2022,12,21,2400,58,60,118,Wednesday
2022,12,21,2300,62,118,180,Wednesday
2022,12,21,2200,67,128,195,Wednesday
2022,12,21,2100,101,136,237,Wednesday
2022,12,21,2000,126,161,287,Wednesday
2022,12,21,1900,147,198,345,Wednesday
2022,12,21,1800,175,417,592,Wednesday
2022,12,21,1700,204,442,646,Wednesday
2022,12,21,1600,252,447,699,Wednesday
2022,12,21,1500,317,399,716,Wednesday
2022,12,21,1400,328,371,699,Wednesday
2022,12,21,1300,354,290,644,Wednesday
2022,12,21,1200,434,278,712,Wednesday
2022,12,21,1100,392,177,569,Wednesday
2022,12,21,1000,253,114,367,Wednesday
2022,12,21,900,208,88,296,Wednesday
2022,12,21,800,154,47,201,Wednesday
2022,12,21,700,77,30,107,Wednesday
2022,12,21,600,43,21,64,Wednesday
2022,12,21,500,17,19,36,Wednesday
2022,12,21,400,10,24,34,Wednesday
2022,12,21,300,10,29,39,Wednesday
2022,12,21,200,21,20,41,Wednesday
2022,12,21,100,25,45,70,Wednesday
2022,12,20,2400,28,69,97,Tuesday
2022,12,20,2300,54,107,161,Tuesday
2022,12,20,2200,58,97,155,Tuesday
2022,12,20,2100,110,110,220,Tuesday
2022,12,20,2000,119,117,236,Tuesday
2022,12,20,1900,108,215,323,Tuesday
2022,12,20,1800,157,338,495,Tuesday
2022,12,20,1700,220,421,641,Tuesday
2022,12,20,1600,241,350,591,Tuesday
2022,12,20,1500,287,341,628,Tuesday
2022,12,20,1400,296,330,626,Tuesday
2022,12,20,1300,321,214,535,Tuesday
2022,12,20,1200,318,218,536,Tuesday
2022,12,20,1100,300,192,492,Tuesday
2022,12,20,1000,243,144,387,Tuesday
2022,12,20,900,181,161,342,Tuesday
2022,12,20,800,122,44,166,Tuesday
2022,12,20,700,73,31,104,Tuesday
2022,12,20,600,35,28,63,Tuesday
2022,12,20,500,15,10,25,Tuesday
2022,12,20,400,13,20,33,Tuesday
2022,12,20,300,16,19,35,Tuesday
2022,12,20,200,26,24,50,Tuesday
2022,12,20,100,23,14,37,Tuesday
2022,12,19,2400,37,43,80,Monday
2022,12,19,2300,50,106,156,Monday
2022,12,19,2200,60,114,174,Monday
2022,12,19,2100,84,129,213,Monday
2022,12,19,2000,116,187,303,Monday
2022,12,19,1900,141,219,360,Monday
2022,12,19,1800,174,364,538,Monday
2022,12,19,1700,219,426,645,Monday
2022,12,19,1600,269,376,645,Monday
2022,12,19,1500,298,361,659,Monday
2022,12,19,1400,323,336,659,Monday
2022,12,19,1300,322,313,635,Monday
2022,12,19,1200,367,194,561,Monday
2022,12,19,1100,325,212,537,Monday
2022,12,19,1000,234,147,381,Monday
2022,12,19,900,198,106,304,Monday
2022,12,19,800,164,43,207,Monday
2022,12,19,700,67,23,90,Monday
2022,12,19,600,39,15,54,Monday
2022,12,19,500,14,12,26,Monday
2022,12,19,400,12,10,22,Monday
2022,12,19,300,5,2,7,Monday
2022,12,19,200,13,10,23,Monday
2022,12,19,100,18,5,23,Monday
2022,12,18,2400,29,24,53,Sunday
2022,12,18,2300,31,44,75,Sunday
2022,12,18,2200,43,76,119,Sunday
2022,12,18,2100,66,117,183,Sunday
2022,12,18,2000,131,158,289,Sunday
2022,12,18,1900,154,216,370,Sunday
2022,12,18,1800,143,436,579,Sunday
2022,12,18,1700,193,527,720,Sunday
2022,12,18,1600,277,518,795,Sunday
2022,12,18,1500,307,571,878,Sunday
2022,12,18,1400,314,488,802,Sunday
2022,12,18,1300,333,411,744,Sunday
2022,12,18,1200,339,363,702,Sunday
2022,12,18,1100,290,184,474,Sunday
2022,12,18,1000,277,134,411,Sunday
2022,12,18,900,210,93,303,Sunday
2022,12,18,800,148,18,166,Sunday
2022,12,18,700,59,8,67,Sunday
2022,12,18,600,20,10,30,Sunday
2022,12,18,500,6,16,22,Sunday
2022,12,18,400,8,7,15,Sunday
2022,12,18,300,14,9,23,Sunday
2022,12,18,200,12,24,36,Sunday
2022,12,18,100,16,30,46,Sunday
2022,12,17,2400,21,45,66,Saturday
2022,12,17,2300,30,74,104,Saturday
2022,12,17,2200,49,99,148,Saturday
2022,12,17,2100,72,101,173,Saturday
2022,12,17,2000,100,143,243,Saturday
2022,12,17,1900,132,199,331,Saturday
2022,12,17,1800,120,413,533,Saturday
2022,12,17,1700,166,734,900,Saturday
2022,12,17,1600,260,591,851,Saturday
2022,12,17,1500,271,449,720,Saturday
2022,12,17,1400,294,389,683,Saturday
2022,12,17,1300,304,305,609,Saturday
2022,12,17,1200,329,281,610,Saturday
2022,12,17,1100,393,200,593,Saturday
2022,12,17,1000,443,173,616,Saturday
2022,12,17,900,536,144,680,Saturday
2022,12,17,800,303,50,353,Saturday
2022,12,17,700,94,35,129,Saturday
2022,12,17,600,36,38,74,Saturday
2022,12,17,500,13,10,23,Saturday
2022,12,17,400,11,11,22,Saturday
2022,12,17,300,5,19,24,Saturday
2022,12,17,200,24,27,51,Saturday
2022,12,17,100,27,13,40,Saturday
2022,12,16,2400,40,59,99,Friday
2022,12,16,2300,55,101,156,Friday
2022,12,16,2200,83,89,172,Friday
2022,12,16,2100,143,147,290,Friday
2022,12,16,2000,203,131,334,Friday
2022,12,16,1900,263,223,486,Friday
2022,12,16,1800,287,439,726,Friday
2022,12,16,1700,379,501,880,Friday
2022,12,16,1600,357,491,848,Friday
2022,12,16,1500,346,396,742,Friday
2022,12,16,1400,369,379,748,Friday
2022,12,16,1300,341,349,690,Friday
2022,12,16,1200,374,274,648,Friday
2022,12,16,1100,361,244,605,Friday
2022,12,16,1000,413,181,594,Friday
2022,12,16,900,350,188,538,Friday
2022,12,16,800,228,35,263,Friday
2022,12,16,700,99,39,138,Friday
2022,12,16,600,52,31,83,Friday
2022,12,16,500,25,33,58,Friday
2022,12,16,400,15,11,26,Friday
2022,12,16,300,19,24,43,Friday
2022,12,16,200,21,11,32,Friday
2022,12,16,100,35,12,47,Friday
2022,12,15,2400,41,46,87,Thursday
2022,12,15,2300,52,83,135,Thursday
2022,12,15,2200,59,99,158,Thursday
2022,12,15,2100,141,138,279,Thursday
2022,12,15,2000,179,146,325,Thursday
2022,12,15,1900,185,196,381,Thursday
2022,12,15,1800,195,308,503,Thursday
2022,12,15,1700,243,451,694,Thursday
2022,12,15,1600,262,433,695,Thursday
2022,12,15,1500,252,355,607,Thursday
2022,12,15,1400,287,314,601,Thursday
2022,12,15,1300,274,343,617,Thursday
2022,12,15,1200,298,282,580,Thursday
2022,12,15,1100,297,221,518,Thursday
2022,12,15,1000,337,184,521,Thursday
2022,12,15,900,303,174,477,Thursday
2022,12,15,800,229,40,269,Thursday
2022,12,15,700,90,40,130,Thursday
2022,12,15,600,54,27,81,Thursday
2022,12,15,500,17,22,39,Thursday
2022,12,15,400,24,20,44,Thursday
2022,12,15,300,16,11,27,Thursday
2022,12,15,200,26,12,38,Thursday
2022,12,15,100,23,6,29,Thursday
2022,12,14,2400,45,36,81,Wednesday
2022,12,14,2300,51,98,149,Wednesday
2022,12,14,2200,46,106,152,Wednesday
2022,12,14,2100,109,96,205,Wednesday
2022,12,14,2000,129,132,261,Wednesday
2022,12,14,1900,143,191,334,Wednesday
2022,12,14,1800,167,276,443,Wednesday
2022,12,14,1700,193,432,625,Wednesday
2022,12,14,1600,231,365,596,Wednesday
2022,12,14,1500,247,312,559,Wednesday
2022,12,14,1400,223,267,490,Wednesday
2022,12,14,1300,271,258,529,Wednesday
2022,12,14,1200,258,229,487,Wednesday
2022,12,14,1100,274,202,476,Wednesday
2022,12,14,1000,312,178,490,Wednesday
2022,12,14,900,248,156,404,Wednesday
2022,12,14,800,169,37,206,Wednesday
2022,12,14,700,70,30,100,Wednesday
2022,12,14,600,45,31,76,Wednesday
2022,12,14,500,23,23,46,Wednesday
2022,12,14,400,9,20,29,Wednesday
2022,12,14,300,16,21,37,Wednesday
2022,12,14,200,20,12,32,Wednesday
2022,12,14,100,20,11,31,Wednesday
2022,12,13,2400,29,43,72,Tuesday
2022,12,13,2300,62,80,142,Tuesday
2022,12,13,2200,51,106,157,Tuesday
2022,12,13,2100,93,110,203,Tuesday
2022,12,13,2000,138,124,262,Tuesday
2022,12,13,1900,122,191,313,Tuesday
2022,12,13,1800,139,303,442,Tuesday
2022,12,13,1700,181,438,619,Tuesday
2022,12,13,1600,246,391,637,Tuesday
2022,12,13,1500,196,323,519,Tuesday
2022,12,13,1400,262,257,519,Tuesday
2022,12,13,1300,287,233,520,Tuesday
2022,12,13,1200,297,226,523,Tuesday
2022,12,13,1100,320,166,486,Tuesday
2022,12,13,1000,275,186,461,Tuesday
2022,12,13,900,264,161,425,Tuesday
2022,12,13,800,188,31,219,Tuesday
2022,12,13,700,96,38,134,Tuesday
2022,12,13,600,46,14,60,Tuesday
2022,12,13,500,14,20,34,Tuesday
2022,12,13,400,11,19,30,Tuesday
2022,12,13,300,17,16,33,Tuesday
2022,12,13,200,22,20,42,Tuesday
2022,12,13,100,19,6,25,Tuesday
2022,12,12,2400,35,39,74,Monday
2022,12,12,2300,42,81,123,Monday
2022,12,12,2200,49,98,147,Monday
2022,12,12,2100,85,96,181,Monday
2022,12,12,2000,138,112,250,Monday
2022,12,12,1900,122,177,299,Monday
2022,12,12,1800,156,262,418,Monday
2022,12,12,1700,236,429,665,Monday
2022,12,12,1600,295,373,668,Monday
2022,12,12,1500,299,319,618,Monday
2022,12,12,1400,263,253,516,Monday
2022,12,12,1300,285,227,512,Monday
2022,12,12,1200,309,235,544,Monday
2022,12,12,1100,311,146,457,Monday
2022,12,12,1000,282,145,427,Monday
2022,12,12,900,281,121,402,Monday
2022,12,12,800,207,48,255,Monday
2022,12,12,700,90,33,123,Monday
2022,12,12,600,33,8,41,Monday
2022,12,12,500,12,15,27,Monday
2022,12,12,400,15,14,29,Monday
2022,12,12,300,10,13,23,Monday
2022,12,12,200,21,16,37,Monday
2022,12,12,100,19,9,28,Monday
2022,12,11,2400,24,41,65,Sunday
2022,12,11,2300,29,84,113,Sunday
2022,12,11,2200,37,106,143,Sunday
2022,12,11,2100,87,162,249,Sunday
2022,12,11,2000,96,190,286,Sunday
2022,12,11,1900,137,312,449,Sunday
2022,12,11,1800,160,592,752,Sunday
2022,12,11,1700,197,977,1174,Sunday
2022,12,11,1600,306,763,1069,Sunday
2022,12,11,1500,314,635,949,Sunday
2022,12,11,1400,322,548,870,Sunday
2022,12,11,1300,388,468,856,Sunday
2022,12,11,1200,382,332,714,Sunday
2022,12,11,1100,404,203,607,Sunday
2022,12,11,1000,408,132,540,Sunday
2022,12,11,900,474,103,577,Sunday
2022,12,11,800,355,23,378,Sunday
2022,12,11,700,68,15,83,Sunday
2022,12,11,600,37,17,54,Sunday
2022,12,11,500,10,4,14,Sunday
2022,12,11,400,11,12,23,Sunday
2022,12,11,300,14,12,26,Sunday
2022,12,11,200,14,13,27,Sunday
2022,12,11,100,13,8,21,Sunday
2022,12,10,2400,22,41,63,Saturday
2022,12,10,2300,27,68,95,Saturday
2022,12,10,2200,53,66,119,Saturday
2022,12,10,2100,78,67,145,Saturday
2022,12,10,2000,81,137,218,Saturday
2022,12,10,1900,111,177,288,Saturday
2022,12,10,1800,135,389,524,Saturday
2022,12,10,1700,181,756,937,Saturday
2022,12,10,1600,227,489,716,Saturday
2022,12,10,1500,288,387,675,Saturday
2022,12,10,1400,295,290,585,Saturday
2022,12,10,1300,307,262,569,Saturday
2022,12,10,1200,367,201,568,Saturday
2022,12,10,1100,351,191,542,Saturday
2022,12,10,1000,377,179,556,Saturday
2022,12,10,900,504,114,618,Saturday
2022,12,10,800,347,26,373,Saturday
2022,12,10,700,84,23,107,Saturday
2022,12,10,600,34,18,52,Saturday
2022,12,10,500,13,14,27,Saturday
2022,12,10,400,12,18,30,Saturday
2022,12,10,300,18,12,30,Saturday
2022,12,10,200,29,10,39,Saturday
2022,12,10,100,18,12,30,Saturday
2022,12,9,2400,38,53,91,Friday
2022,12,9,2300,36,75,111,Friday
2022,12,9,2200,48,105,153,Friday
2022,12,9,2100,139,118,257,Friday
2022,12,9,2000,187,131,318,Friday
2022,12,9,1900,271,181,452,Friday
2022,12,9,1800,313,317,630,Friday
2022,12,9,1700,393,412,805,Friday
2022,12,9,1600,385,422,807,Friday
2022,12,9,1500,436,354,790,Friday
2022,12,9,1400,340,258,598,Friday
2022,12,9,1300,280,261,541,Friday
2022,12,9,1200,308,175,483,Friday
2022,12,9,1100,331,209,540,Friday
2022,12,9,1000,375,212,587,Friday
2022,12,9,900,319,127,446,Friday
2022,12,9,800,202,40,242,Friday
2022,12,9,700,102,34,136,Friday
2022,12,9,600,42,14,56,Friday
2022,12,9,500,25,12,37,Friday
2022,12,9,400,27,25,52,Friday
2022,12,9,300,21,30,51,Friday
2022,12,9,200,23,16,39,Friday
2022,12,9,100,24,7,31,Friday
2022,12,8,2400,36,74,110,Thursday
2022,12,8,2300,50,71,121,Thursday
2022,12,8,2200,52,79,131,Thursday
2022,12,8,2100,117,101,218,Thursday
2022,12,8,2000,203,105,308,Thursday
2022,12,8,1900,201,129,330,Thursday
2022,12,8,1800,210,289,499,Thursday
2022,12,8,1700,227,414,641,Thursday
2022,12,8,1600,291,342,633,Thursday
2022,12,8,1500,274,292,566,Thursday
2022,12,8,1400,274,253,527,Thursday
2022,12,8,1300,304,252,556,Thursday
2022,12,8,1200,279,179,458,Thursday
2022,12,8,1100,288,149,437,Thursday
2022,12,8,1000,299,169,468,Thursday
2022,12,8,900,267,174,441,Thursday
2022,12,8,800,183,39,222,Thursday
2022,12,8,700,96,52,148,Thursday
2022,12,8,600,36,26,62,Thursday
2022,12,8,500,16,12,28,Thursday
2022,12,8,400,22,25,47,Thursday
2022,12,8,300,25,16,41,Thursday
2022,12,8,200,19,18,37,Thursday
2022,12,8,100,24,21,45,Thursday
2022,12,7,2400,41,57,98,Wednesday
2022,12,7,2300,58,87,145,Wednesday
2022,12,7,2200,65,106,171,Wednesday
2022,12,7,2100,94,99,193,Wednesday
2022,12,7,2000,144,116,260,Wednesday
2022,12,7,1900,122,198,320,Wednesday
2022,12,7,1800,179,281,460,Wednesday
2022,12,7,1700,178,362,540,Wednesday
2022,12,7,1600,236,362,598,Wednesday
2022,12,7,1500,229,338,567,Wednesday
2022,12,7,1400,233,232,465,Wednesday
2022,12,7,1300,259,218,477,Wednesday
2022,12,7,1200,293,208,501,Wednesday
2022,12,7,1100,308,199,507,Wednesday
2022,12,7,1000,292,254,546,Wednesday
2022,12,7,900,245,165,410,Wednesday
2022,12,7,800,144,54,198,Wednesday
2022,12,7,700,78,21,99,Wednesday
2022,12,7,600,32,23,55,Wednesday
2022,12,7,500,18,20,38,Wednesday
2022,12,7,400,18,18,36,Wednesday
2022,12,7,300,10,34,44,Wednesday
2022,12,7,200,25,43,68,Wednesday
2022,12,7,100,23,13,36,Wednesday
2022,12,6,2400,31,77,108,Tuesday
2022,12,6,2300,47,89,136,Tuesday
2022,12,6,2200,69,28,97,Tuesday
2022,12,6,2100,90,55,145,Tuesday
2022,12,6,2000,114,42,156,Tuesday
2022,12,6,1900,88,62,150,Tuesday
2022,12,6,1800,121,127,248,Tuesday
2022,12,6,1700,169,265,434,Tuesday
2022,12,6,1600,190,237,427,Tuesday
2022,12,6,1500,196,286,482,Tuesday
2022,12,6,1400,213,291,504,Tuesday
2022,12,6,1300,190,144,334,Tuesday
2022,12,6,1200,226,183,409,Tuesday
2022,12,6,1100,216,150,366,Tuesday
2022,12,6,1000,219,140,359,Tuesday
2022,12,6,900,213,95,308,Tuesday
2022,12,6,800,102,61,163,Tuesday
2022,12,6,700,57,46,103,Tuesday
2022,12,6,600,38,26,64,Tuesday
2022,12,6,500,16,28,44,Tuesday
2022,12,6,400,15,17,32,Tuesday
2022,12,6,300,13,9,22,Tuesday
2022,12,6,200,28,19,47,Tuesday
2022,12,6,100,27,15,42,Tuesday
2022,12,5,2400,56,59,115,Monday
2022,12,5,2300,38,88,126,Monday
2022,12,5,2200,44,94,138,Monday
2022,12,5,2100,97,121,218,Monday
2022,12,5,2000,131,85,216,Monday
2022,12,5,1900,134,178,312,Monday
2022,12,5,1800,143,234,377,Monday
2022,12,5,1700,176,344,520,Monday
2022,12,5,1600,215,311,526,Monday
2022,12,5,1500,243,286,529,Monday
2022,12,5,1400,249,259,508,Monday
2022,12,5,1300,282,215,497,Monday
2022,12,5,1200,284,199,483,Monday
2022,12,5,1100,273,152,425,Monday
2022,12,5,1000,270,136,406,Monday
2022,12,5,900,248,99,347,Monday
2022,12,5,800,134,35,169,Monday
2022,12,5,700,76,29,105,Monday
2022,12,5,600,22,18,40,Monday
2022,12,5,500,20,10,30,Monday
2022,12,5,400,13,6,19,Monday
2022,12,5,300,11,5,16,Monday
2022,12,5,200,13,14,27,Monday
2022,12,5,100,20,16,36,Monday
2022,12,4,2400,16,34,50,Sunday
2022,12,4,2300,41,81,122,Sunday
2022,12,4,2200,36,103,139,Sunday
2022,12,4,2100,63,174,237,Sunday
2022,12,4,2000,110,192,302,Sunday
2022,12,4,1900,135,281,416,Sunday
2022,12,4,1800,151,443,594,Sunday
2022,12,4,1700,208,862,1070,Sunday
2022,12,4,1600,256,733,989,Sunday
2022,12,4,1500,265,665,930,Sunday
2022,12,4,1400,307,536,843,Sunday
2022,12,4,1300,397,377,774,Sunday
2022,12,4,1200,386,242,628,Sunday
2022,12,4,1100,444,173,617,Sunday
2022,12,4,1000,451,126,577,Sunday
2022,12,4,900,450,98,548,Sunday
2022,12,4,800,291,27,318,Sunday
2022,12,4,700,81,19,100,Sunday
2022,12,4,600,26,17,43,Sunday
2022,12,4,500,9,13,22,Sunday
2022,12,4,400,6,10,16,Sunday
2022,12,4,300,10,16,26,Sunday
2022,12,4,200,13,13,26,Sunday
2022,12,4,100,18,11,29,Sunday
2022,12,3,2400,22,26,48,Saturday
2022,12,3,2300,24,72,96,Saturday
2022,12,3,2200,35,55,90,Saturday
2022,12,3,2100,48,105,153,Saturday
2022,12,3,2000,88,133,221,Saturday
2022,12,3,1900,104,168,272,Saturday
2022,12,3,1800,133,390,523,Saturday
2022,12,3,1700,170,636,806,Saturday
2022,12,3,1600,193,521,714,Saturday
2022,12,3,1500,240,352,592,Saturday
2022,12,3,1400,266,303,569,Saturday
2022,12,3,1300,310,245,555,Saturday
2022,12,3,1200,369,208,577,Saturday
2022,12,3,1100,398,151,549,Saturday
2022,12,3,1000,368,158,526,Saturday
2022,12,3,900,468,144,612,Saturday
2022,12,3,800,283,38,321,Saturday
2022,12,3,700,86,16,102,Saturday
2022,12,3,600,28,18,46,Saturday
2022,12,3,500,9,8,17,Saturday
2022,12,3,400,11,12,23,Saturday
2022,12,3,300,18,24,42,Saturday
2022,12,3,200,26,7,33,Saturday
2022,12,3,100,22,8,30,Saturday
2022,12,2,2400,27,42,69,Friday
2022,12,2,2300,49,67,116,Friday
2022,12,2,2200,73,63,136,Friday
2022,12,2,2100,92,106,198,Friday
2022,12,2,2000,163,119,282,Friday
2022,12,2,1900,199,159,358,Friday
2022,12,2,1800,289,262,551,Friday
2022,12,2,1700,302,416,718,Friday
2022,12,2,1600,339,327,666,Friday
2022,12,2,1500,325,324,649,Friday
2022,12,2,1400,337,330,667,Friday
2022,12,2,1300,276,300,576,Friday
2022,12,2,1200,338,221,559,Friday
2022,12,2,1100,291,189,480,Friday
2022,12,2,1000,301,175,476,Friday
2022,12,2,900,203,141,344,Friday
2022,12,2,800,184,39,223,Friday
2022,12,2,700,100,30,130,Friday
2022,12,2,600,41,26,67,Friday
2022,12,2,500,11,15,26,Friday
2022,12,2,400,19,17,36,Friday
2022,12,2,300,8,16,24,Friday
2022,12,2,200,23,23,46,Friday
2022,12,2,100,21,7,28,Friday
2022,12,1,2400,35,54,89,Thursday
2022,12,1,2300,47,75,122,Thursday
2022,12,1,2200,52,86,138,Thursday
2022,12,1,2100,95,130,225,Thursday
2022,12,1,2000,156,129,285,Thursday
2022,12,1,1900,147,163,310,Thursday
2022,12,1,1800,147,224,371,Thursday
2022,12,1,1700,177,325,502,Thursday
2022,12,1,1600,216,268,484,Thursday
2022,12,1,1500,216,282,498,Thursday
2022,12,1,1400,219,231,450,Thursday
2022,12,1,1300,235,219,454,Thursday
2022,12,1,1200,261,170,431,Thursday
2022,12,1,1100,254,131,385,Thursday
2022,12,1,1000,259,166,425,Thursday
2022,12,1,900,161,149,310,Thursday
2022,12,1,800,157,30,187,Thursday
2022,12,1,700,76,30,106,Thursday
2022,12,1,600,40,16,56,Thursday
2022,12,1,500,14,16,30,Thursday
2022,12,1,400,15,20,35,Thursday
2022,12,1,300,18,18,36,Thursday
2022,12,1,200,20,20,40,Thursday
2022,12,1,100,24,14,38,Thursday
2022,11,30,2400,35,67,102,Wednesday
2022,11,30,2300,34,122,156,Wednesday
2022,11,30,2200,51,111,162,Wednesday
2022,11,30,2100,75,208,283,Wednesday
2022,11,30,2000,104,81,185,Wednesday
2022,11,30,1900,98,69,167,Wednesday
2022,11,30,1800,139,148,287,Wednesday
2022,11,30,1700,192,216,408,Wednesday
2022,11,30,1600,193,212,405,Wednesday
2022,11,30,1500,198,176,374,Wednesday
2022,11,30,1400,231,185,416,Wednesday
2022,11,30,1300,201,118,319,Wednesday
2022,11,30,1200,218,133,351,Wednesday
2022,11,30,1100,171,132,303,Wednesday
2022,11,30,1000,170,122,292,Wednesday
2022,11,30,900,148,84,232,Wednesday
2022,11,30,800,119,30,149,Wednesday
2022,11,30,700,57,35,92,Wednesday
2022,11,30,600,42,14,56,Wednesday
2022,11,30,500,29,25,54,Wednesday
2022,11,30,400,14,13,27,Wednesday
2022,11,30,300,16,18,34,Wednesday
2022,11,30,200,12,17,29,Wednesday
2022,11,30,100,23,13,36,Wednesday
2022,11,29,2400,51,34,85,Tuesday
2022,11,29,2300,55,85,140,Tuesday
2022,11,29,2200,50,92,142,Tuesday
2022,11,29,2100,81,127,208,Tuesday
2022,11,29,2000,111,106,217,Tuesday
2022,11,29,1900,144,141,285,Tuesday
2022,11,29,1800,130,205,335,Tuesday
2022,11,29,1700,159,262,421,Tuesday
2022,11,29,1600,190,251,441,Tuesday
2022,11,29,1500,197,253,450,Tuesday
2022,11,29,1400,236,228,464,Tuesday
2022,11,29,1300,214,210,424,Tuesday
2022,11,29,1200,242,196,438,Tuesday
2022,11,29,1100,198,153,351,Tuesday
2022,11,29,1000,198,150,348,Tuesday
2022,11,29,900,151,170,321,Tuesday
2022,11,29,800,132,50,182,Tuesday
2022,11,29,700,75,43,118,Tuesday
2022,11,29,600,32,16,48,Tuesday
2022,11,29,500,15,21,36,Tuesday
2022,11,29,400,22,14,36,Tuesday
2022,11,29,300,22,20,42,Tuesday
2022,11,29,200,15,15,30,Tuesday
2022,11,29,100,22,7,29,Tuesday
2022,11,28,2400,42,39,81,Monday
2022,11,28,2300,43,77,120,Monday
2022,11,28,2200,41,71,112,Monday
2022,11,28,2100,97,90,187,Monday
2022,11,28,2000,128,106,234,Monday
2022,11,28,1900,125,152,277,Monday
2022,11,28,1800,148,219,367,Monday
2022,11,28,1700,162,316,478,Monday
2022,11,28,1600,232,318,550,Monday
2022,11,28,1500,234,257,491,Monday
2022,11,28,1400,258,232,490,Monday
2022,11,28,1300,246,233,479,Monday
2022,11,28,1200,279,201,480,Monday
2022,11,28,1100,283,150,433,Monday
2022,11,28,1000,284,141,425,Monday
2022,11,28,900,242,105,347,Monday
2022,11,28,800,153,45,198,Monday
2022,11,28,700,64,33,97,Monday
2022,11,28,600,36,14,50,Monday
2022,11,28,500,20,19,39,Monday
2022,11,28,400,17,12,29,Monday
2022,11,28,300,13,14,27,Monday
2022,11,28,200,16,19,35,Monday
2022,11,28,100,13,4,17,Monday
2022,11,27,2400,26,38,64,Sunday
2022,11,27,2300,31,94,125,Sunday
2022,11,27,2200,51,72,123,Sunday
2022,11,27,2100,71,114,185,Sunday
2022,11,27,2000,76,129,205,Sunday
2022,11,27,1900,110,210,320,Sunday
2022,11,27,1800,176,398,574,Sunday
2022,11,27,1700,189,782,971,Sunday
2022,11,27,1600,266,596,862,Sunday
2022,11,27,1500,245,452,697,Sunday
2022,11,27,1400,157,424,581,Sunday
2022,11,27,1300,260,414,674,Sunday
2022,11,27,1200,253,220,473,Sunday
2022,11,27,1100,361,166,527,Sunday
2022,11,27,1000,364,114,478,Sunday
2022,11,27,900,419,77,496,Sunday
2022,11,27,800,236,33,269,Sunday
2022,11,27,700,65,13,78,Sunday
2022,11,27,600,23,12,35,Sunday
2022,11,27,500,11,15,26,Sunday
2022,11,27,400,9,15,24,Sunday
2022,11,27,300,7,13,20,Sunday
2022,11,27,200,13,11,24,Sunday
2022,11,27,100,19,15,34,Sunday
2022,11,26,2400,25,24,49,Saturday
2022,11,26,2300,22,52,74,Saturday
2022,11,26,2200,54,80,134,Saturday
2022,11,26,2100,50,81,131,Saturday
2022,11,26,2000,90,112,202,Saturday
2022,11,26,1900,98,171,269,Saturday
2022,11,26,1800,130,441,571,Saturday
2022,11,26,1700,160,849,1009,Saturday
2022,11,26,1600,221,688,909,Saturday
2022,11,26,1500,296,516,812,Saturday
2022,11,26,1400,289,335,624,Saturday
2022,11,26,1300,359,554,913,Saturday
2022,11,26,1200,475,88,563,Saturday
2022,11,26,1100,505,196,701,Saturday
2022,11,26,1000,509,184,693,Saturday
2022,11,26,900,605,126,731,Saturday
2022,11,26,800,390,39,429,Saturday
2022,11,26,700,70,31,101,Saturday
2022,11,26,600,35,24,59,Saturday
2022,11,26,500,9,21,30,Saturday
2022,11,26,400,14,15,29,Saturday
2022,11,26,300,6,17,23,Saturday
2022,11,26,200,18,30,48,Saturday
2022,11,26,100,25,11,36,Saturday
2022,11,25,2400,27,25,52,Friday
2022,11,25,2300,37,70,107,Friday
2022,11,25,2200,72,85,157,Friday
2022,11,25,2100,77,96,173,Friday
2022,11,25,2000,135,140,275,Friday
2022,11,25,1900,174,193,367,Friday
2022,11,25,1800,197,289,486,Friday
2022,11,25,1700,279,402,681,Friday
2022,11,25,1600,317,382,699,Friday
2022,11,25,1500,325,352,677,Friday
2022,11,25,1400,305,328,633,Friday
2022,11,25,1300,331,282,613,Friday
2022,11,25,1200,377,181,558,Friday
2022,11,25,1100,355,216,571,Friday
2022,11,25,1000,340,157,497,Friday
2022,11,25,900,319,160,479,Friday
2022,11,25,800,176,116,292,Friday
2022,11,25,700,93,40,133,Friday
2022,11,25,600,38,26,64,Friday
2022,11,25,500,18,38,56,Friday
2022,11,25,400,22,29,51,Friday
2022,11,25,300,20,24,44,Friday
2022,11,25,200,28,33,61,Friday
2022,11,25,100,24,40,64,Friday
2022,11,24,2400,50,87,137,Thursday
2022,11,24,2300,77,85,162,Thursday
2022,11,24,2200,80,153,233,Thursday
2022,11,24,2100,87,112,199,Thursday
2022,11,24,2000,151,112,263,Thursday
2022,11,24,1900,178,208,386,Thursday
2022,11,24,1800,208,383,591,Thursday
2022,11,24,1700,226,404,630,Thursday
2022,11,24,1600,280,389,669,Thursday
2022,11,24,1500,266,351,617,Thursday
2022,11,24,1400,300,300,600,Thursday
2022,11,24,1300,291,294,585,Thursday
2022,11,24,1200,309,156,465,Thursday
2022,11,24,1100,306,153,459,Thursday
2022,11,24,1000,342,133,475,Thursday
2022,11,24,900,263,82,345,Thursday
2022,11,24,800,160,62,222,Thursday
2022,11,24,700,94,43,137,Thursday
2022,11,24,600,40,29,69,Thursday
2022,11,24,500,32,26,58,Thursday
2022,11,24,400,32,12,44,Thursday
2022,11,24,300,20,9,29,Thursday
2022,11,24,200,27,17,44,Thursday
2022,11,24,100,38,33,71,Thursday
2022,11,23,2400,35,59,94,Wednesday
2022,11,23,2300,60,70,130,Wednesday
2022,11,23,2200,67,95,162,Wednesday
2022,11,23,2100,90,136,226,Wednesday
2022,11,23,2000,121,276,397,Wednesday
2022,11,23,1900,129,295,424,Wednesday
2022,11,23,1800,120,204,324,Wednesday
2022,11,23,1700,173,403,576,Wednesday
2022,11,23,1600,220,347,567,Wednesday
2022,11,23,1500,265,371,636,Wednesday
2022,11,23,1400,226,304,530,Wednesday
2022,11,23,1300,268,124,392,Wednesday
2022,11,23,1200,262,126,388,Wednesday
2022,11,23,1100,256,109,365,Wednesday
2022,11,23,1000,278,83,361,Wednesday
2022,11,23,900,223,69,292,Wednesday
2022,11,23,800,110,39,149,Wednesday
2022,11,23,700,79,22,101,Wednesday
2022,11,23,600,34,18,52,Wednesday
2022,11,23,500,17,12,29,Wednesday
2022,11,23,400,22,16,38,Wednesday
2022,11,23,300,15,8,23,Wednesday
2022,11,23,200,23,5,28,Wednesday
2022,11,23,100,20,11,31,Wednesday
2022,11,22,2400,37,53,90,Tuesday
2022,11,22,2300,56,75,131,Tuesday
2022,11,22,2200,59,66,125,Tuesday
2022,11,22,2100,81,45,126,Tuesday
2022,11,22,2000,89,91,180,Tuesday
2022,11,22,1900,106,131,237,Tuesday
2022,11,22,1800,128,212,340,Tuesday
2022,11,22,1700,167,290,457,Tuesday
2022,11,22,1600,189,261,450,Tuesday
2022,11,22,1500,201,223,424,Tuesday
2022,11,22,1400,232,219,451,Tuesday
2022,11,22,1300,261,201,462,Tuesday
2022,11,22,1200,299,163,462,Tuesday
2022,11,22,1100,238,157,395,Tuesday
2022,11,22,1000,242,137,379,Tuesday
2022,11,22,900,186,91,277,Tuesday
2022,11,22,800,126,56,182,Tuesday
2022,11,22,700,71,51,122,Tuesday
2022,11,22,600,50,33,83,Tuesday
2022,11,22,500,34,27,61,Tuesday
2022,11,22,400,14,30,44,Tuesday
2022,11,22,300,20,26,46,Tuesday
2022,11,22,200,21,43,64,Tuesday
2022,11,22,100,35,41,76,Tuesday
2022,11,21,2400,44,69,113,Monday
2022,11,21,2300,44,76,120,Monday
2022,11,21,2200,60,80,140,Monday
2022,11,21,2100,75,100,175,Monday
2022,11,21,2000,89,104,193,Monday
2022,11,21,1900,146,164,310,Monday
2022,11,21,1800,131,259,390,Monday
2022,11,21,1700,210,373,583,Monday
2022,11,21,1600,262,313,575,Monday
2022,11,21,1500,228,274,502,Monday
2022,11,21,1400,271,270,541,Monday
2022,11,21,1300,297,228,525,Monday
2022,11,21,1200,334,175,509,Monday
2022,11,21,1100,309,147,456,Monday
2022,11,21,1000,255,87,342,Monday
2022,11,21,900,222,84,306,Monday
2022,11,21,800,144,45,189,Monday
2022,11,21,700,83,26,109,Monday
2022,11,21,600,29,24,53,Monday
2022,11,21,500,22,20,42,Monday
2022,11,21,400,15,11,26,Monday
2022,11,21,300,14,18,32,Monday
2022,11,21,200,11,22,33,Monday
2022,11,21,100,24,28,52,Monday
2022,11,20,2400,23,48,71,Sunday
2022,11,20,2300,36,52,88,Sunday
2022,11,20,2200,48,94,142,Sunday
2022,11,20,2100,55,96,151,Sunday
2022,11,20,2000,84,141,225,Sunday
2022,11,20,1900,132,228,360,Sunday
2022,11,20,1800,142,377,519,Sunday
2022,11,20,1700,189,604,793,Sunday
2022,11,20,1600,245,505,750,Sunday
2022,11,20,1500,309,481,790,Sunday
2022,11,20,1400,301,443,744,Sunday
2022,11,20,1300,356,333,689,Sunday
2022,11,20,1200,368,269,637,Sunday
2022,11,20,1100,335,158,493,Sunday
2022,11,20,1000,319,84,403,Sunday
2022,11,20,900,318,66,384,Sunday
2022,11,20,800,211,24,235,Sunday
2022,11,20,700,69,13,82,Sunday
2022,11,20,600,21,21,42,Sunday
2022,11,20,500,18,10,28,Sunday
2022,11,20,400,7,22,29,Sunday
2022,11,20,300,10,25,35,Sunday
2022,11,20,200,10,14,24,Sunday
2022,11,20,100,21,33,54,Sunday
2022,11,19,2400,32,30,62,Saturday
2022,11,19,2300,23,57,80,Saturday
2022,11,19,2200,46,79,125,Saturday
2022,11,19,2100,58,98,156,Saturday
2022,11,19,2000,63,103,166,Saturday
2022,11,19,1900,81,173,254,Saturday
2022,11,19,1800,127,419,546,Saturday
2022,11,19,1700,171,569,740,Saturday
2022,11,19,1600,237,382,619,Saturday
2022,11,19,1500,270,435,705,Saturday
2022,11,19,1400,288,361,649,Saturday
2022,11,19,1300,349,285,634,Saturday
2022,11,19,1200,375,188,563,Saturday
2022,11,19,1100,373,168,541,Saturday
2022,11,19,1000,394,142,536,Saturday
2022,11,19,900,403,87,490,Saturday
2022,11,19,800,243,56,299,Saturday
2022,11,19,700,61,45,106,Saturday
2022,11,19,600,30,28,58,Saturday
2022,11,19,500,20,25,45,Saturday
2022,11,19,400,9,11,20,Saturday
2022,11,19,300,23,37,60,Saturday
2022,11,19,200,24,33,57,Saturday
2022,11,19,100,29,42,71,Saturday
2022,11,18,2400,41,62,103,Friday
2022,11,18,2300,52,59,111,Friday
2022,11,18,2200,85,85,170,Friday
2022,11,18,2100,99,85,184,Friday
2022,11,18,2000,167,133,300,Friday
2022,11,18,1900,204,209,413,Friday
2022,11,18,1800,239,291,530,Friday
2022,11,18,1700,251,371,622,Friday
2022,11,18,1600,336,367,703,Friday
2022,11,18,1500,297,336,633,Friday
2022,11,18,1400,279,249,528,Friday
2022,11,18,1300,277,267,544,Friday
2022,11,18,1200,307,209,516,Friday
2022,11,18,1100,289,202,491,Friday
2022,11,18,1000,278,152,430,Friday
2022,11,18,900,196,82,278,Friday
2022,11,18,800,164,71,235,Friday
2022,11,18,700,71,41,112,Friday
2022,11,18,600,34,35,69,Friday
2022,11,18,500,34,26,60,Friday
2022,11,18,400,26,42,68,Friday
2022,11,18,300,19,37,56,Friday
2022,11,18,200,23,28,51,Friday
2022,11,18,100,22,60,82,Friday
2022,11,17,2400,43,53,96,Thursday
2022,11,17,2300,54,92,146,Thursday
2022,11,17,2200,93,85,178,Thursday
2022,11,17,2100,90,98,188,Thursday
2022,11,17,2000,132,116,248,Thursday
2022,11,17,1900,125,148,273,Thursday
2022,11,17,1800,154,263,417,Thursday
2022,11,17,1700,195,289,484,Thursday
2022,11,17,1600,215,317,532,Thursday
2022,11,17,1500,224,322,546,Thursday
2022,11,17,1400,272,225,497,Thursday
2022,11,17,1300,283,188,471,Thursday
2022,11,17,1200,270,158,428,Thursday
2022,11,17,1100,240,143,383,Thursday
2022,11,17,1000,208,145,353,Thursday
2022,11,17,900,171,97,268,Thursday
2022,11,17,800,152,68,220,Thursday
2022,11,17,700,67,46,113,Thursday
2022,11,17,600,39,29,68,Thursday
2022,11,17,500,25,32,57,Thursday
2022,11,17,400,27,30,57,Thursday
2022,11,17,300,20,39,59,Thursday
2022,11,17,200,28,47,75,Thursday
2022,11,17,100,23,40,63,Thursday
2022,11,16,2400,37,73,110,Wednesday
2022,11,16,2300,66,60,126,Wednesday
2022,11,16,2200,63,88,151,Wednesday
2022,11,16,2100,89,101,190,Wednesday
2022,11,16,2000,97,117,214,Wednesday
2022,11,16,1900,121,155,276,Wednesday
2022,11,16,1800,136,198,334,Wednesday
2022,11,16,1700,177,236,413,Wednesday
2022,11,16,1600,206,233,439,Wednesday
2022,11,16,1500,192,226,418,Wednesday
2022,11,16,1400,214,211,425,Wednesday
2022,11,16,1300,201,186,387,Wednesday
2022,11,16,1200,214,162,376,Wednesday
2022,11,16,1100,170,156,326,Wednesday
2022,11,16,1000,219,143,362,Wednesday
2022,11,16,900,206,104,310,Wednesday
2022,11,16,800,167,74,241,Wednesday
2022,11,16,700,79,52,131,Wednesday
2022,11,16,600,39,49,88,Wednesday
2022,11,16,500,31,17,48,Wednesday
2022,11,16,400,18,39,57,Wednesday
2022,11,16,300,19,27,46,Wednesday
2022,11,16,200,17,31,48,Wednesday
2022,11,16,100,32,31,63,Wednesday
2022,11,15,2400,51,58,109,Tuesday
2022,11,15,2300,60,82,142,Tuesday
2022,11,15,2200,62,85,147,Tuesday
2022,11,15,2100,83,108,191,Tuesday
2022,11,15,2000,115,194,309,Tuesday
2022,11,15,1900,111,261,372,Tuesday
2022,11,15,1800,124,246,370,Tuesday
2022,11,15,1700,167,228,395,Tuesday
2022,11,15,1600,223,298,521,Tuesday
2022,11,15,1500,233,279,512,Tuesday
2022,11,15,1400,232,263,495,Tuesday
2022,11,15,1300,285,219,504,Tuesday
2022,11,15,1200,294,192,486,Tuesday
2022,11,15,1100,284,174,458,Tuesday
2022,11,15,1000,218,127,345,Tuesday
2022,11,15,900,194,101,295,Tuesday
2022,11,15,800,167,69,236,Tuesday
2022,11,15,700,90,57,147,Tuesday
2022,11,15,600,46,31,77,Tuesday
2022,11,15,500,28,29,57,Tuesday
2022,11,15,400,19,28,47,Tuesday
2022,11,15,300,14,17,31,Tuesday
2022,11,15,200,22,38,60,Tuesday
2022,11,15,100,20,43,63,Tuesday
2022,11,14,2400,32,53,85,Monday
2022,11,14,2300,48,46,94,Monday
2022,11,14,2200,68,71,139,Monday
2022,11,14,2100,68,103,171,Monday
2022,11,14,2000,122,135,257,Monday
2022,11,14,1900,114,187,301,Monday
2022,11,14,1800,143,263,406,Monday
2022,11,14,1700,187,370,557,Monday
2022,11,14,1600,234,334,568,Monday
2022,11,14,1500,253,346,599,Monday
2022,11,14,1400,269,291,560,Monday
2022,11,14,1300,305,221,526,Monday
2022,11,14,1200,368,213,581,Monday
2022,11,14,1100,336,143,479,Monday
2022,11,14,1000,259,131,390,Monday
2022,11,14,900,262,91,353,Monday
2022,11,14,800,191,58,249,Monday
2022,11,14,700,79,39,118,Monday
2022,11,14,600,32,11,43,Monday
2022,11,14,500,30,12,42,Monday
2022,11,14,400,11,17,28,Monday
2022,11,14,300,14,20,34,Monday
2022,11,14,200,19,24,43,Monday
2022,11,14,100,15,35,50,Monday
2022,11,13,2400,23,54,77,Sunday
2022,11,13,2300,37,81,118,Sunday
2022,11,13,2200,40,84,124,Sunday
2022,11,13,2100,69,134,203,Sunday
2022,11,13,2000,101,159,260,Sunday
2022,11,13,1900,133,296,429,Sunday
2022,11,13,1800,142,494,636,Sunday
2022,11,13,1700,220,690,910,Sunday
2022,11,13,1600,265,748,1013,Sunday
2022,11,13,1500,388,645,1033,Sunday
2022,11,13,1400,358,604,962,Sunday
2022,11,13,1300,423,547,970,Sunday
2022,11,13,1200,412,357,769,Sunday
2022,11,13,1100,442,226,668,Sunday
2022,11,13,1000,380,141,521,Sunday
2022,11,13,900,310,67,377,Sunday
2022,11,13,800,186,32,218,Sunday
2022,11,13,700,78,21,99,Sunday
2022,11,13,600,18,14,32,Sunday
2022,11,13,500,13,10,23,Sunday
2022,11,13,400,6,15,21,Sunday
2022,11,13,300,12,15,27,Sunday
2022,11,13,200,12,25,37,Sunday
2022,11,13,100,24,31,55,Sunday
2022,11,12,2400,18,46,64,Saturday
2022,11,12,2300,33,55,88,Saturday
2022,11,12,2200,43,55,98,Saturday
2022,11,12,2100,66,88,154,Saturday
2022,11,12,2000,79,136,215,Saturday
2022,11,12,1900,99,187,286,Saturday
2022,11,12,1800,134,451,585,Saturday
2022,11,12,1700,184,674,858,Saturday
2022,11,12,1600,222,575,797,Saturday
2022,11,12,1500,293,445,738,Saturday
2022,11,12,1400,353,361,714,Saturday
2022,11,12,1300,392,339,731,Saturday
2022,11,12,1200,486,268,754,Saturday
2022,11,12,1100,467,188,655,Saturday
2022,11,12,1000,400,144,544,Saturday
2022,11,12,900,377,74,451,Saturday
2022,11,12,800,213,51,264,Saturday
2022,11,12,700,65,22,87,Saturday
2022,11,12,600,16,12,28,Saturday
2022,11,12,500,14,16,30,Saturday
2022,11,12,400,13,29,42,Saturday
2022,11,12,300,13,39,52,Saturday
2022,11,12,200,13,37,50,Saturday
2022,11,12,100,18,27,45,Saturday
2022,11,11,2400,25,53,78,Friday
2022,11,11,2300,42,67,109,Friday
2022,11,11,2200,53,79,132,Friday
2022,11,11,2100,78,89,167,Friday
2022,11,11,2000,92,141,233,Friday
2022,11,11,1900,119,205,324,Friday
2022,11,11,1800,192,448,640,Friday
2022,11,11,1700,287,636,923,Friday
2022,11,11,1600,417,603,1020,Friday
2022,11,11,1500,495,550,1045,Friday
2022,11,11,1400,505,413,918,Friday
2022,11,11,1300,581,357,938,Friday
2022,11,11,1200,645,264,909,Friday
2022,11,11,1100,570,176,746,Friday
2022,11,11,1000,487,152,639,Friday
2022,11,11,900,448,114,562,Friday
2022,11,11,800,211,65,276,Friday
2022,11,11,700,100,34,134,Friday
2022,11,11,600,36,21,57,Friday
2022,11,11,500,20,25,45,Friday
2022,11,11,400,19,42,61,Friday
2022,11,11,300,17,29,46,Friday
2022,11,11,200,23,49,72,Friday
2022,11,11,100,43,48,91,Friday
2022,11,10,2400,45,72,117,Thursday
2022,11,10,2300,73,81,154,Thursday
2022,11,10,2200,107,106,213,Thursday
2022,11,10,2100,139,127,266,Thursday
2022,11,10,2000,211,134,345,Thursday
2022,11,10,1900,233,272,505,Thursday
2022,11,10,1800,284,359,643,Thursday
2022,11,10,1700,300,439,739,Thursday
2022,11,10,1600,309,369,678,Thursday
2022,11,10,1500,320,354,674,Thursday
2022,11,10,1400,344,299,643,Thursday
2022,11,10,1300,311,249,560,Thursday
2022,11,10,1200,370,241,611,Thursday
2022,11,10,1100,391,165,556,Thursday
2022,11,10,1000,309,123,432,Thursday
2022,11,10,900,255,105,360,Thursday
2022,11,10,800,158,65,223,Thursday
2022,11,10,700,66,66,132,Thursday
2022,11,10,600,30,24,54,Thursday
2022,11,10,500,24,33,57,Thursday
2022,11,10,400,23,23,46,Thursday
2022,11,10,300,23,45,68,Thursday
2022,11,10,200,26,47,73,Thursday
2022,11,10,100,34,47,81,Thursday
2022,11,9,2400,41,72,113,Wednesday
2022,11,9,2300,64,95,159,Wednesday
2022,11,9,2200,70,106,176,Wednesday
2022,11,9,2100,100,110,210,Wednesday
2022,11,9,2000,119,188,307,Wednesday
2022,11,9,1900,108,175,283,Wednesday
2022,11,9,1800,154,285,439,Wednesday
2022,11,9,1700,215,318,533,Wednesday
2022,11,9,1600,279,323,602,Wednesday
2022,11,9,1500,239,263,502,Wednesday
2022,11,9,1400,261,281,542,Wednesday
2022,11,9,1300,268,209,477,Wednesday
2022,11,9,1200,300,197,497,Wednesday
2022,11,9,1100,330,147,477,Wednesday
2022,11,9,1000,245,146,391,Wednesday
2022,11,9,900,178,103,281,Wednesday
2022,11,9,800,112,63,175,Wednesday
2022,11,9,700,70,48,118,Wednesday
2022,11,9,600,38,22,60,Wednesday
2022,11,9,500,30,23,53,Wednesday
2022,11,9,400,20,27,47,Wednesday
2022,11,9,300,18,30,48,Wednesday
2022,11,9,200,22,35,57,Wednesday
2022,11,9,100,34,49,83,Wednesday
2022,11,8,2400,42,65,107,Tuesday
2022,11,8,2300,63,94,157,Tuesday
2022,11,8,2200,62,100,162,Tuesday
2022,11,8,2100,84,104,188,Tuesday
2022,11,8,2000,97,128,225,Tuesday
2022,11,8,1900,120,156,276,Tuesday
2022,11,8,1800,119,249,368,Tuesday
2022,11,8,1700,153,284,437,Tuesday
2022,11,8,1600,209,278,487,Tuesday
2022,11,8,1500,209,251,460,Tuesday
2022,11,8,1400,241,194,435,Tuesday
2022,11,8,1300,224,187,411,Tuesday
2022,11,8,1200,271,154,425,Tuesday
2022,11,8,1100,264,135,399,Tuesday
2022,11,8,1000,217,103,320,Tuesday
2022,11,8,900,150,96,246,Tuesday
2022,11,8,800,119,61,180,Tuesday
2022,11,8,700,60,33,93,Tuesday
2022,11,8,600,28,16,44,Tuesday
2022,11,8,500,19,31,50,Tuesday
2022,11,8,400,16,34,50,Tuesday
2022,11,8,300,18,23,41,Tuesday
2022,11,8,200,23,18,41,Tuesday
2022,11,8,100,26,26,52,Tuesday
2022,11,7,2400,28,41,69,Monday
2022,11,7,2300,30,59,89,Monday
2022,11,7,2200,57,47,104,Monday
2022,11,7,2100,63,63,126,Monday
2022,11,7,2000,78,81,159,Monday
2022,11,7,1900,65,103,168,Monday
2022,11,7,1800,79,157,236,Monday
2022,11,7,1700,133,177,310,Monday
2022,11,7,1600,168,153,321,Monday
2022,11,7,1500,162,167,329,Monday
2022,11,7,1400,187,157,344,Monday
2022,11,7,1300,168,177,345,Monday
2022,11,7,1200,205,128,333,Monday
2022,11,7,1100,220,107,327,Monday
2022,11,7,1000,169,79,248,Monday
2022,11,7,900,136,65,201,Monday
2022,11,7,800,96,36,132,Monday
2022,11,7,700,45,27,72,Monday
2022,11,7,600,19,12,31,Monday
2022,11,7,500,21,18,39,Monday
2022,11,7,400,8,14,22,Monday
2022,11,7,300,14,20,34,Monday
2022,11,7,200,17,22,39,Monday
2022,11,7,100,18,29,47,Monday
2022,11,6,2400,44,66,110,Sunday
2022,11,6,2300,42,58,100,Sunday
2022,11,6,2200,48,56,104,Sunday
2022,11,6,2100,60,68,128,Sunday
2022,11,6,2000,73,94,167,Sunday
2022,11,6,1900,105,184,289,Sunday
2022,11,6,1800,130,249,379,Sunday
2022,11,6,1700,194,382,576,Sunday
2022,11,6,1600,217,388,605,Sunday
2022,11,6,1500,279,358,637,Sunday
2022,11,6,1400,271,341,612,Sunday
2022,11,6,1300,300,309,609,Sunday
2022,11,6,1200,327,303,630,Sunday
2022,11,6,1100,282,161,443,Sunday
2022,11,6,1000,259,129,388,Sunday
2022,11,6,900,235,70,305,Sunday
2022,11,6,800,114,28,142,Sunday
2022,11,6,700,37,16,53,Sunday
2022,11,6,600,9,11,20,Sunday
2022,11,6,500,4,13,17,Sunday
2022,11,6,400,6,7,13,Sunday
2022,11,6,300,5,11,16,Sunday
2022,11,6,200,6,23,29,Sunday
2022,11,6,100,14,20,34,Sunday
2022,11,5,2400,16,44,60,Saturday
2022,11,5,2300,18,59,77,Saturday
2022,11,5,2200,27,91,118,Saturday
2022,11,5,2100,53,85,138,Saturday
2022,11,5,2000,67,108,175,Saturday
2022,11,5,1900,84,170,254,Saturday
2022,11,5,1800,118,276,394,Saturday
2022,11,5,1700,148,309,457,Saturday
2022,11,5,1600,188,383,571,Saturday
2022,11,5,1500,216,369,585,Saturday
2022,11,5,1400,275,231,506,Saturday
2022,11,5,1300,273,268,541,Saturday
2022,11,5,1200,323,213,536,Saturday
2022,11,5,1100,319,119,438,Saturday
2022,11,5,1000,281,96,377,Saturday
2022,11,5,900,220,57,277,Saturday
2022,11,5,800,120,21,141,Saturday
2022,11,5,700,70,16,86,Saturday
2022,11,5,600,35,9,44,Saturday
2022,11,5,500,10,24,34,Saturday
2022,11,5,400,4,18,22,Saturday
2022,11,5,300,24,16,40,Saturday
2022,11,5,200,38,42,80,Saturday
2022,11,5,100,24,51,75,Saturday
2022,11,4,2400,37,94,131,Friday
2022,11,4,2300,55,89,144,Friday
2022,11,4,2200,73,67,140,Friday
2022,11,4,2100,103,124,227,Friday
2022,11,4,2000,153,110,263,Friday
2022,11,4,1900,155,211,366,Friday
2022,11,4,1800,220,293,513,Friday
2022,11,4,1700,283,374,657,Friday
2022,11,4,1600,309,335,644,Friday
2022,11,4,1500,277,356,633,Friday
2022,11,4,1400,279,307,586,Friday
2022,11,4,1300,312,316,628,Friday
2022,11,4,1200,316,175,491,Friday
2022,11,4,1100,285,150,435,Friday
2022,11,4,1000,280,102,382,Friday
2022,11,4,900,247,76,323,Friday
2022,11,4,800,156,55,211,Friday
2022,11,4,700,79,35,114,Friday
2022,11,4,600,36,24,60,Friday
2022,11,4,500,21,6,27,Friday
2022,11,4,400,21,16,37,Friday
2022,11,4,300,21,33,54,Friday
2022,11,4,200,33,33,66,Friday
2022,11,4,100,37,24,61,Friday
2022,11,3,2400,41,61,102,Thursday
2022,11,3,2300,61,88,149,Thursday
2022,11,3,2200,78,65,143,Thursday
2022,11,3,2100,99,96,195,Thursday
2022,11,3,2000,141,144,285,Thursday
2022,11,3,1900,155,203,358,Thursday
2022,11,3,1800,171,286,457,Thursday
2022,11,3,1700,230,305,535,Thursday
2022,11,3,1600,233,375,608,Thursday
2022,11,3,1500,292,249,541,Thursday
2022,11,3,1400,275,270,545,Thursday
2022,11,3,1300,259,256,515,Thursday
2022,11,3,1200,267,196,463,Thursday
2022,11,3,1100,251,143,394,Thursday
2022,11,3,1000,205,96,301,Thursday
2022,11,3,900,137,81,218,Thursday
2022,11,3,800,136,72,208,Thursday
2022,11,3,700,62,43,105,Thursday
2022,11,3,600,23,31,54,Thursday
2022,11,3,500,18,26,44,Thursday
2022,11,3,400,20,26,46,Thursday
2022,11,3,300,21,30,51,Thursday
2022,11,3,200,12,35,47,Thursday
2022,11,3,100,33,40,73,Thursday
2022,11,2,2400,41,60,101,Wednesday
2022,11,2,2300,52,64,116,Wednesday
2022,11,2,2200,72,91,163,Wednesday
2022,11,2,2100,62,92,154,Wednesday
2022,11,2,2000,109,110,219,Wednesday
2022,11,2,1900,82,167,249,Wednesday
2022,11,2,1800,111,211,322,Wednesday
2022,11,2,1700,127,173,300,Wednesday
2022,11,2,1600,160,216,376,Wednesday
2022,11,2,1500,165,178,343,Wednesday
2022,11,2,1400,153,183,336,Wednesday
2022,11,2,1300,173,191,364,Wednesday
2022,11,2,1200,167,154,321,Wednesday
2022,11,2,1100,171,142,313,Wednesday
2022,11,2,1000,122,105,227,Wednesday
2022,11,2,900,120,83,203,Wednesday
2022,11,2,800,87,53,140,Wednesday
2022,11,2,700,53,64,117,Wednesday
2022,11,2,600,22,60,82,Wednesday
2022,11,2,500,19,36,55,Wednesday
2022,11,2,400,10,91,101,Wednesday
2022,11,2,300,19,12,31,Wednesday
2022,11,2,200,32,47,79,Wednesday
2022,11,2,100,98,85,183,Wednesday
2022,11,1,2400,27,93,120,Tuesday
2022,11,1,2300,16,81,97,Tuesday
2022,11,1,2200,31,120,151,Tuesday
2022,11,1,2100,26,119,145,Tuesday
2022,11,1,2000,38,116,154,Tuesday
2022,11,1,1900,77,186,263,Tuesday
2022,11,1,1800,114,231,345,Tuesday
2022,11,1,1700,153,225,378,Tuesday
2022,11,1,1600,224,200,424,Tuesday
2022,11,1,1500,267,228,495,Tuesday
2022,11,1,1400,246,222,468,Tuesday
2022,11,1,1300,253,233,486,Tuesday
2022,11,1,1200,284,189,473,Tuesday
2022,11,1,1100,261,155,416,Tuesday
2022,11,1,1000,218,94,312,Tuesday
2022,11,1,900,178,83,261,Tuesday
2022,11,1,800,132,65,197,Tuesday
2022,11,1,700,86,57,143,Tuesday
2022,11,1,600,45,19,64,Tuesday
2022,11,1,500,26,36,62,Tuesday
2022,11,1,400,18,39,57,Tuesday
2022,11,1,300,22,28,50,Tuesday
2022,11,1,200,20,38,58,Tuesday
2022,11,1,100,25,56,81,Tuesday
2022,10,31,2400,44,53,97,Monday
2022,10,31,2300,57,53,110,Monday
2022,10,31,2200,59,68,127,Monday
2022,10,31,2100,83,114,197,Monday
2022,10,31,2000,96,97,193,Monday
2022,10,31,1900,104,158,262,Monday
2022,10,31,1800,128,188,316,Monday
2022,10,31,1700,168,261,429,Monday
2022,10,31,1600,214,272,486,Monday
2022,10,31,1500,213,253,466,Monday
2022,10,31,1400,243,236,479,Monday
2022,10,31,1300,270,230,500,Monday
2022,10,31,1200,287,159,446,Monday
2022,10,31,1100,227,138,365,Monday
2022,10,31,1000,214,88,302,Monday
2022,10,31,900,184,54,238,Monday
2022,10,31,800,135,31,166,Monday
2022,10,31,700,70,46,116,Monday
2022,10,31,600,37,24,61,Monday
2022,10,31,500,13,14,27,Monday
2022,10,31,400,18,16,34,Monday
2022,10,31,300,20,31,51,Monday
2022,10,31,200,20,29,49,Monday
2022,10,31,100,19,37,56,Monday
2022,10,30,2400,34,59,93,Sunday
2022,10,30,2300,35,67,102,Sunday
2022,10,30,2200,46,115,161,Sunday
2022,10,30,2100,79,133,212,Sunday
2022,10,30,2000,113,182,295,Sunday
2022,10,30,1900,103,287,390,Sunday
2022,10,30,1800,168,372,540,Sunday
2022,10,30,1700,211,437,648,Sunday
2022,10,30,1600,279,461,740,Sunday
2022,10,30,1500,328,478,806,Sunday
2022,10,30,1400,351,430,781,Sunday
2022,10,30,1300,377,388,765,Sunday
2022,10,30,1200,345,316,661,Sunday
2022,10,30,1100,334,163,497,Sunday
2022,10,30,1000,249,114,363,Sunday
2022,10,30,900,183,48,231,Sunday
2022,10,30,800,95,22,117,Sunday
2022,10,30,700,65,19,84,Sunday
2022,10,30,600,22,21,43,Sunday
2022,10,30,500,11,18,29,Sunday
2022,10,30,400,13,22,35,Sunday
2022,10,30,300,10,22,32,Sunday
2022,10,30,200,22,34,56,Sunday
2022,10,30,100,13,39,52,Sunday
2022,10,29,2400,29,48,77,Saturday
2022,10,29,2300,36,66,102,Saturday
2022,10,29,2200,34,87,121,Saturday
2022,10,29,2100,72,103,175,Saturday
2022,10,29,2000,77,218,295,Saturday
2022,10,29,1900,109,276,385,Saturday
2022,10,29,1800,148,370,518,Saturday
2022,10,29,1700,190,390,580,Saturday
2022,10,29,1600,273,471,744,Saturday
2022,10,29,1500,296,385,681,Saturday
2022,10,29,1400,365,411,776,Saturday
2022,10,29,1300,406,300,706,Saturday
2022,10,29,1200,416,239,655,Saturday
2022,10,29,1100,378,167,545,Saturday
2022,10,29,1000,310,113,423,Saturday
2022,10,29,900,209,72,281,Saturday
2022,10,29,800,168,61,229,Saturday
2022,10,29,700,77,34,111,Saturday
2022,10,29,600,28,20,48,Saturday
2022,10,29,500,12,29,41,Saturday
2022,10,29,400,19,30,49,Saturday
2022,10,29,300,21,36,57,Saturday
2022,10,29,200,20,40,60,Saturday
2022,10,29,100,21,69,90,Saturday
2022,10,28,2400,36,68,104,Friday
2022,10,28,2300,66,90,156,Friday
2022,10,28,2200,81,114,195,Friday
2022,10,28,2100,107,148,255,Friday
2022,10,28,2000,177,185,362,Friday
2022,10,28,1900,210,295,505,Friday
2022,10,28,1800,248,369,617,Friday
2022,10,28,1700,302,366,668,Friday
2022,10,28,1600,327,362,689,Friday
2022,10,28,1500,341,349,690,Friday
2022,10,28,1400,318,287,605,Friday
2022,10,28,1300,310,266,576,Friday
2022,10,28,1200,314,244,558,Friday
2022,10,28,1100,317,215,532,Friday
2022,10,28,1000,238,146,384,Friday
2022,10,28,900,206,96,302,Friday
2022,10,28,800,142,88,230,Friday
2022,10,28,700,74,47,121,Friday
2022,10,28,600,37,55,92,Friday
2022,10,28,500,34,29,63,Friday
2022,10,28,400,20,30,50,Friday
2022,10,28,300,20,48,68,Friday
2022,10,28,200,26,58,84,Friday
2022,10,28,100,38,62,100,Friday
2022,10,27,2400,44,82,126,Thursday
2022,10,27,2300,68,220,288,Thursday
2022,10,27,2200,76,192,268,Thursday
2022,10,27,2100,102,82,184,Thursday
2022,10,27,2000,156,123,279,Thursday
2022,10,27,1900,168,227,395,Thursday
2022,10,27,1800,207,396,603,Thursday
2022,10,27,1700,212,336,548,Thursday
2022,10,27,1600,238,279,517,Thursday
2022,10,27,1500,275,293,568,Thursday
2022,10,27,1400,346,329,675,Thursday
2022,10,27,1300,332,247,579,Thursday
2022,10,27,1200,374,220,594,Thursday
2022,10,27,1100,336,185,521,Thursday
2022,10,27,1000,258,137,395,Thursday
2022,10,27,900,218,92,310,Thursday
2022,10,27,800,183,71,254,Thursday
2022,10,27,700,82,48,130,Thursday
2022,10,27,600,33,40,73,Thursday
2022,10,27,500,27,34,61,Thursday
2022,10,27,400,16,38,54,Thursday
2022,10,27,300,26,36,62,Thursday
2022,10,27,200,25,45,70,Thursday
2022,10,27,100,43,68,111,Thursday
2022,10,26,2400,58,64,122,Wednesday
2022,10,26,2300,45,109,154,Wednesday
2022,10,26,2200,70,89,159,Wednesday
2022,10,26,2100,106,162,268,Wednesday
2022,10,26,2000,120,175,295,Wednesday
2022,10,26,1900,150,270,420,Wednesday
2022,10,26,1800,176,358,534,Wednesday
2022,10,26,1700,239,383,622,Wednesday
2022,10,26,1600,216,306,522,Wednesday
2022,10,26,1500,275,299,574,Wednesday
2022,10,26,1400,298,297,595,Wednesday
2022,10,26,1300,311,232,543,Wednesday
2022,10,26,1200,386,197,583,Wednesday
2022,10,26,1100,375,187,562,Wednesday
2022,10,26,1000,315,139,454,Wednesday
2022,10,26,900,185,80,265,Wednesday
2022,10,26,800,157,71,228,Wednesday
2022,10,26,700,81,55,136,Wednesday
2022,10,26,600,33,27,60,Wednesday
2022,10,26,500,29,27,56,Wednesday
2022,10,26,400,16,34,50,Wednesday
2022,10,26,300,14,40,54,Wednesday
2022,10,26,200,21,39,60,Wednesday
2022,10,26,100,27,43,70,Wednesday
2022,10,25,2400,50,55,105,Tuesday
2022,10,25,2300,66,105,171,Tuesday
2022,10,25,2200,76,115,191,Tuesday
2022,10,25,2100,102,132,234,Tuesday
2022,10,25,2000,106,196,302,Tuesday
2022,10,25,1900,131,258,389,Tuesday
2022,10,25,1800,180,350,530,Tuesday
2022,10,25,1700,188,366,554,Tuesday
2022,10,25,1600,274,352,626,Tuesday
2022,10,25,1500,271,346,617,Tuesday
2022,10,25,1400,258,268,526,Tuesday
2022,10,25,1300,326,279,605,Tuesday
2022,10,25,1200,386,215,601,Tuesday
2022,10,25,1100,384,178,562,Tuesday
2022,10,25,1000,281,114,395,Tuesday
2022,10,25,900,216,88,304,Tuesday
2022,10,25,800,139,55,194,Tuesday
2022,10,25,700,72,58,130,Tuesday
2022,10,25,600,34,32,66,Tuesday
2022,10,25,500,28,15,43,Tuesday
2022,10,25,400,19,30,49,Tuesday
2022,10,25,300,21,36,57,Tuesday
2022,10,25,200,27,51,78,Tuesday
2022,10,25,100,28,53,81,Tuesday
2022,10,24,2400,55,49,104,Monday
2022,10,24,2300,50,73,123,Monday
2022,10,24,2200,56,89,145,Monday
2022,10,24,2100,85,123,208,Monday
2022,10,24,2000,107,141,248,Monday
2022,10,24,1900,109,268,377,Monday
2022,10,24,1800,167,299,466,Monday
2022,10,24,1700,228,366,594,Monday
2022,10,24,1600,240,375,615,Monday
2022,10,24,1500,245,341,586,Monday
2022,10,24,1400,305,313,618,Monday
2022,10,24,1300,336,248,584,Monday
2022,10,24,1200,367,203,570,Monday
2022,10,24,1100,365,159,524,Monday
2022,10,24,1000,270,122,392,Monday
2022,10,24,900,197,83,280,Monday
2022,10,24,800,137,45,182,Monday
2022,10,24,700,75,31,106,Monday
2022,10,24,600,29,14,43,Monday
2022,10,24,500,28,26,54,Monday
2022,10,24,400,8,14,22,Monday
2022,10,24,300,14,31,45,Monday
2022,10,24,200,12,48,60,Monday
2022,10,24,100,13,46,59,Monday
2022,10,23,2400,15,63,78,Sunday
2022,10,23,2300,51,112,163,Sunday
2022,10,23,2200,46,127,173,Sunday
2022,10,23,2100,84,202,286,Sunday
2022,10,23,2000,91,281,372,Sunday
2022,10,23,1900,121,467,588,Sunday
2022,10,23,1800,193,578,771,Sunday
2022,10,23,1700,220,592,812,Sunday
2022,10,23,1600,324,650,974,Sunday
2022,10,23,1500,402,541,943,Sunday
2022,10,23,1400,440,503,943,Sunday
2022,10,23,1300,464,422,886,Sunday
2022,10,23,1200,487,336,823,Sunday
2022,10,23,1100,445,209,654,Sunday
2022,10,23,1000,334,111,445,Sunday
2022,10,23,900,237,72,309,Sunday
2022,10,23,800,129,33,162,Sunday
2022,10,23,700,44,17,61,Sunday
2022,10,23,600,21,11,32,Sunday
2022,10,23,500,13,19,32,Sunday
2022,10,23,400,11,21,32,Sunday
2022,10,23,300,13,16,29,Sunday
2022,10,23,200,21,36,57,Sunday
2022,10,23,100,16,32,48,Sunday
2022,10,22,2400,19,52,71,Saturday
2022,10,22,2300,28,71,99,Saturday
2022,10,22,2200,47,90,137,Saturday
2022,10,22,2100,62,129,191,Saturday
2022,10,22,2000,80,185,265,Saturday
2022,10,22,1900,101,274,375,Saturday
2022,10,22,1800,152,427,579,Saturday
2022,10,22,1700,191,465,656,Saturday
2022,10,22,1600,310,405,715,Saturday
2022,10,22,1500,313,390,703,Saturday
2022,10,22,1400,347,364,711,Saturday
2022,10,22,1300,385,326,711,Saturday
2022,10,22,1200,436,247,683,Saturday
2022,10,22,1100,369,188,557,Saturday
2022,10,22,1000,312,135,447,Saturday
2022,10,22,900,204,92,296,Saturday
2022,10,22,800,119,62,181,Saturday
2022,10,22,700,56,39,95,Saturday
2022,10,22,600,24,44,68,Saturday
2022,10,22,500,13,39,52,Saturday
2022,10,22,400,16,35,51,Saturday
2022,10,22,300,13,47,60,Saturday
2022,10,22,200,18,41,59,Saturday
2022,10,22,100,20,71,91,Saturday
2022,10,21,2400,39,90,129,Friday
2022,10,21,2300,50,95,145,Friday
2022,10,21,2200,78,118,196,Friday
2022,10,21,2100,136,138,274,Friday
2022,10,21,2000,206,228,434,Friday
2022,10,21,1900,263,336,599,Friday
2022,10,21,1800,335,461,796,Friday
2022,10,21,1700,345,507,852,Friday
2022,10,21,1600,406,491,897,Friday
2022,10,21,1500,448,443,891,Friday
2022,10,21,1400,427,379,806,Friday
2022,10,21,1300,425,354,779,Friday
2022,10,21,1200,470,329,799,Friday
2022,10,21,1100,441,196,637,Friday
2022,10,21,1000,391,180,571,Friday
2022,10,21,900,252,123,375,Friday
2022,10,21,800,170,79,249,Friday
2022,10,21,700,101,60,161,Friday
2022,10,21,600,59,44,103,Friday
2022,10,21,500,27,37,64,Friday
2022,10,21,400,25,34,59,Friday
2022,10,21,300,36,38,74,Friday
2022,10,21,200,28,56,84,Friday
2022,10,21,100,36,66,102,Friday
2022,10,20,2400,63,91,154,Thursday
2022,10,20,2300,76,87,163,Thursday
2022,10,20,2200,101,147,248,Thursday
2022,10,20,2100,123,149,272,Thursday
2022,10,20,2000,195,320,515,Thursday
2022,10,20,1900,204,373,577,Thursday
2022,10,20,1800,257,474,731,Thursday
2022,10,20,1700,285,494,779,Thursday
2022,10,20,1600,335,493,828,Thursday
2022,10,20,1500,368,394,762,Thursday
2022,10,20,1400,375,360,735,Thursday
2022,10,20,1300,405,352,757,Thursday
2022,10,20,1200,450,273,723,Thursday
2022,10,20,1100,495,206,701,Thursday
2022,10,20,1000,394,147,541,Thursday
2022,10,20,900,287,120,407,Thursday
2022,10,20,800,207,69,276,Thursday
2022,10,20,700,115,49,164,Thursday
2022,10,20,600,47,50,97,Thursday
2022,10,20,500,23,29,52,Thursday
2022,10,20,400,22,35,57,Thursday
2022,10,20,300,16,46,62,Thursday
2022,10,20,200,34,53,87,Thursday
2022,10,20,100,31,38,69,Thursday
2022,10,19,2400,43,91,134,Wednesday
2022,10,19,2300,60,101,161,Wednesday
2022,10,19,2200,96,127,223,Wednesday
2022,10,19,2100,130,172,302,Wednesday
2022,10,19,2000,147,324,471,Wednesday
2022,10,19,1900,176,389,565,Wednesday
2022,10,19,1800,193,436,629,Wednesday
2022,10,19,1700,226,490,716,Wednesday
2022,10,19,1600,317,496,813,Wednesday
2022,10,19,1500,331,374,705,Wednesday
2022,10,19,1400,354,342,696,Wednesday
2022,10,19,1300,422,312,734,Wednesday
2022,10,19,1200,447,226,673,Wednesday
2022,10,19,1100,453,203,656,Wednesday
2022,10,19,1000,432,149,581,Wednesday
2022,10,19,900,309,96,405,Wednesday
2022,10,19,800,215,62,277,Wednesday
2022,10,19,700,134,59,193,Wednesday
2022,10,19,600,44,28,72,Wednesday
2022,10,19,500,36,33,69,Wednesday
2022,10,19,400,37,25,62,Wednesday
2022,10,19,300,19,43,62,Wednesday
2022,10,19,200,12,54,66,Wednesday
2022,10,19,100,34,68,102,Wednesday
2022,10,18,2400,47,64,111,Tuesday
2022,10,18,2300,61,98,159,Tuesday
2022,10,18,2200,81,100,181,Tuesday
2022,10,18,2100,100,195,295,Tuesday
2022,10,18,2000,130,230,360,Tuesday
2022,10,18,1900,160,405,565,Tuesday
2022,10,18,1800,193,497,690,Tuesday
2022,10,18,1700,233,530,763,Tuesday
2022,10,18,1600,288,435,723,Tuesday
2022,10,18,1500,325,367,692,Tuesday
2022,10,18,1400,347,311,658,Tuesday
2022,10,18,1300,409,259,668,Tuesday
2022,10,18,1200,433,257,690,Tuesday
2022,10,18,1100,523,191,714,Tuesday
2022,10,18,1000,414,152,566,Tuesday
2022,10,18,900,295,120,415,Tuesday
2022,10,18,800,195,79,274,Tuesday
2022,10,18,700,102,57,159,Tuesday
2022,10,18,600,40,40,80,Tuesday
2022,10,18,500,32,31,63,Tuesday
2022,10,18,400,15,35,50,Tuesday
2022,10,18,300,19,44,63,Tuesday
2022,10,18,200,17,53,70,Tuesday
2022,10,18,100,30,41,71,Tuesday
2022,10,17,2400,49,76,125,Monday
2022,10,17,2300,57,113,170,Monday
2022,10,17,2200,81,152,233,Monday
2022,10,17,2100,91,167,258,Monday
2022,10,17,2000,116,307,423,Monday
2022,10,17,1900,162,394,556,Monday
2022,10,17,1800,194,508,702,Monday
2022,10,17,1700,253,547,800,Monday
2022,10,17,1600,324,486,810,Monday
2022,10,17,1500,366,442,808,Monday
2022,10,17,1400,429,351,780,Monday
2022,10,17,1300,487,340,827,Monday
2022,10,17,1200,544,238,782,Monday
2022,10,17,1100,529,202,731,Monday
2022,10,17,1000,437,146,583,Monday
2022,10,17,900,323,113,436,Monday
2022,10,17,800,204,63,267,Monday
2022,10,17,700,123,46,169,Monday
2022,10,17,600,56,25,81,Monday
2022,10,17,500,25,24,49,Monday
2022,10,17,400,15,21,36,Monday
2022,10,17,300,21,29,50,Monday
2022,10,17,200,18,33,51,Monday
2022,10,17,100,26,50,76,Monday
2022,10,16,2400,33,95,128,Sunday
2022,10,16,2300,54,123,177,Sunday
2022,10,16,2200,80,201,281,Sunday
2022,10,16,2100,104,274,378,Sunday
2022,10,16,2000,143,439,582,Sunday
2022,10,16,1900,193,668,861,Sunday
2022,10,16,1800,211,829,1040,Sunday
2022,10,16,1700,306,897,1203,Sunday
2022,10,16,1600,398,866,1264,Sunday
2022,10,16,1500,453,743,1196,Sunday
2022,10,16,1400,550,671,1221,Sunday
2022,10,16,1300,621,500,1121,Sunday
2022,10,16,1200,660,385,1045,Sunday
2022,10,16,1100,595,272,867,Sunday
2022,10,16,1000,523,155,678,Sunday
2022,10,16,900,397,72,469,Sunday
2022,10,16,800,254,41,295,Sunday
2022,10,16,700,118,35,153,Sunday
2022,10,16,600,37,14,51,Sunday
2022,10,16,500,21,13,34,Sunday
2022,10,16,400,17,19,36,Sunday
2022,10,16,300,22,27,49,Sunday
2022,10,16,200,21,42,63,Sunday
2022,10,16,100,22,34,56,Sunday
2022,10,15,2400,30,92,122,Saturday
2022,10,15,2300,48,97,145,Saturday
2022,10,15,2200,70,145,215,Saturday
2022,10,15,2100,95,226,321,Saturday
2022,10,15,2000,116,397,513,Saturday
2022,10,15,1900,160,642,802,Saturday
2022,10,15,1800,232,700,932,Saturday
2022,10,15,1700,292,798,1090,Saturday
2022,10,15,1600,368,676,1044,Saturday
2022,10,15,1500,440,566,1006,Saturday
2022,10,15,1400,554,501,1055,Saturday
2022,10,15,1300,617,435,1052,Saturday
2022,10,15,1200,673,320,993,Saturday
2022,10,15,1100,722,264,986,Saturday
2022,10,15,1000,627,167,794,Saturday
2022,10,15,900,442,118,560,Saturday
2022,10,15,800,310,57,367,Saturday
2022,10,15,700,156,39,195,Saturday
2022,10,15,600,68,36,104,Saturday
2022,10,15,500,36,19,55,Saturday
2022,10,15,400,19,19,38,Saturday
2022,10,15,300,23,23,46,Saturday
2022,10,15,200,23,35,58,Saturday
2022,10,15,100,34,73,107,Saturday
2022,10,14,2400,49,92,141,Friday
2022,10,14,2300,64,120,184,Friday
2022,10,14,2200,109,144,253,Friday
2022,10,14,2100,149,207,356,Friday
2022,10,14,2000,251,290,541,Friday
2022,10,14,1900,308,458,766,Friday
2022,10,14,1800,392,588,980,Friday
2022,10,14,1700,401,565,966,Friday
2022,10,14,1600,442,611,1053,Friday
2022,10,14,1500,477,530,1007,Friday
2022,10,14,1400,498,430,928,Friday
2022,10,14,1300,521,385,906,Friday
2022,10,14,1200,614,316,930,Friday
2022,10,14,1100,578,251,829,Friday
2022,10,14,1000,474,152,626,Friday
2022,10,14,900,364,119,483,Friday
2022,10,14,800,260,76,336,Friday
2022,10,14,700,133,60,193,Friday
2022,10,14,600,69,41,110,Friday
2022,10,14,500,42,46,88,Friday
2022,10,14,400,16,54,70,Friday
2022,10,14,300,29,55,84,Friday
2022,10,14,200,32,25,57,Friday
2022,10,14,100,40,66,106,Friday
2022,10,13,2400,49,69,118,Thursday
2022,10,13,2300,78,106,184,Thursday
2022,10,13,2200,104,139,243,Thursday
2022,10,13,2100,130,177,307,Thursday
2022,10,13,2000,222,346,568,Thursday
2022,10,13,1900,266,443,709,Thursday
2022,10,13,1800,284,527,811,Thursday
2022,10,13,1700,320,580,900,Thursday
2022,10,13,1600,342,532,874,Thursday
2022,10,13,1500,376,455,831,Thursday
2022,10,13,1400,426,388,814,Thursday
2022,10,13,1300,444,364,808,Thursday
2022,10,13,1200,550,286,836,Thursday
2022,10,13,1100,562,233,795,Thursday
2022,10,13,1000,418,164,582,Thursday
2022,10,13,900,343,124,467,Thursday
2022,10,13,800,225,89,314,Thursday
2022,10,13,700,126,60,186,Thursday
2022,10,13,600,59,42,101,Thursday
2022,10,13,500,25,48,73,Thursday
2022,10,13,400,26,38,64,Thursday
2022,10,13,300,23,51,74,Thursday
2022,10,13,200,18,60,78,Thursday
2022,10,13,100,25,62,87,Thursday
2022,10,12,2400,41,91,132,Wednesday
2022,10,12,2300,64,98,162,Wednesday
2022,10,12,2200,94,166,260,Wednesday
2022,10,12,2100,108,185,293,Wednesday
2022,10,12,2000,152,310,462,Wednesday
2022,10,12,1900,166,455,621,Wednesday
2022,10,12,1800,223,519,742,Wednesday
2022,10,12,1700,313,560,873,Wednesday
2022,10,12,1600,332,528,860,Wednesday
2022,10,12,1500,372,465,837,Wednesday
2022,10,12,1400,419,368,787,Wednesday
2022,10,12,1300,469,335,804,Wednesday
2022,10,12,1200,578,278,856,Wednesday
2022,10,12,1100,510,212,722,Wednesday
2022,10,12,1000,514,169,683,Wednesday
2022,10,12,900,342,103,445,Wednesday
2022,10,12,800,253,82,335,Wednesday
2022,10,12,700,118,61,179,Wednesday
2022,10,12,600,71,34,105,Wednesday
2022,10,12,500,26,32,58,Wednesday
2022,10,12,400,16,38,54,Wednesday
2022,10,12,300,20,31,51,Wednesday
2022,10,12,200,31,63,94,Wednesday
2022,10,12,100,47,57,104,Wednesday
2022,10,11,2400,52,93,145,Tuesday
2022,10,11,2300,64,120,184,Tuesday
2022,10,11,2200,87,138,225,Tuesday
2022,10,11,2100,83,190,273,Tuesday
2022,10,11,2000,187,319,506,Tuesday
2022,10,11,1900,180,460,640,Tuesday
2022,10,11,1800,249,561,810,Tuesday
2022,10,11,1700,280,561,841,Tuesday
2022,10,11,1600,386,497,883,Tuesday
2022,10,11,1500,397,441,838,Tuesday
2022,10,11,1400,469,437,906,Tuesday
2022,10,11,1300,474,559,1033,Tuesday
2022,10,11,1200,589,387,976,Tuesday
2022,10,11,1100,715,272,987,Tuesday
2022,10,11,1000,648,198,846,Tuesday
2022,10,11,900,493,122,615,Tuesday
2022,10,11,800,312,80,392,Tuesday
2022,10,11,700,174,54,228,Tuesday
2022,10,11,600,57,21,78,Tuesday
2022,10,11,500,47,25,72,Tuesday
2022,10,11,400,19,13,32,Tuesday
2022,10,11,300,16,15,31,Tuesday
2022,10,11,200,17,42,59,Tuesday
2022,10,11,100,28,51,79,Tuesday
2022,10,10,2400,27,102,129,Monday
2022,10,10,2300,57,134,191,Monday
2022,10,10,2200,65,224,289,Monday
2022,10,10,2100,130,448,578,Monday
2022,10,10,2000,183,751,934,Monday
2022,10,10,1900,217,1095,1312,Monday
2022,10,10,1800,295,1399,1694,Monday
2022,10,10,1700,402,1857,2259,Monday
2022,10,10,1600,508,1859,2367,Monday
2022,10,10,1500,669,1731,2400,Monday
2022,10,10,1400,790,1477,2267,Monday
2022,10,10,1300,910,1290,2200,Monday
2022,10,10,1200,1022,876,1898,Monday
2022,10,10,1100,1000,471,1471,Monday
2022,10,10,1000,835,243,1078,Monday
2022,10,10,900,608,118,726,Monday
2022,10,10,800,424,53,477,Monday
2022,10,10,700,196,27,223,Monday
2022,10,10,600,79,18,97,Monday
2022,10,10,500,60,18,78,Monday
2022,10,10,400,34,14,48,Monday
2022,10,10,300,26,14,40,Monday
2022,10,10,200,19,27,46,Monday
2022,10,10,100,28,50,78,Monday
2022,10,9,2400,33,84,117,Sunday
2022,10,9,2300,79,108,187,Sunday
2022,10,9,2200,85,203,288,Sunday
2022,10,9,2100,110,498,608,Sunday
2022,10,9,2000,147,830,977,Sunday
2022,10,9,1900,180,1100,1280,Sunday
2022,10,9,1800,275,1100,1375,Sunday
2022,10,9,1700,349,1027,1376,Sunday
2022,10,9,1600,470,989,1459,Sunday
2022,10,9,1500,620,941,1561,Sunday
2022,10,9,1400,724,700,1424,Sunday
2022,10,9,1300,838,593,1431,Sunday
2022,10,9,1200,1018,483,1501,Sunday
2022,10,9,1100,954,317,1271,Sunday
2022,10,9,1000,817,183,1000,Sunday
2022,10,9,900,620,91,711,Sunday
2022,10,9,800,430,58,488,Sunday
2022,10,9,700,202,34,236,Sunday
2022,10,9,600,97,26,123,Sunday
2022,10,9,500,57,20,77,Sunday
2022,10,9,400,31,24,55,Sunday
2022,10,9,300,19,29,48,Sunday
2022,10,9,200,29,39,68,Sunday
2022,10,9,100,36,46,82,Sunday
2022,10,8,2400,39,55,94,Saturday
2022,10,8,2300,67,112,179,Saturday
2022,10,8,2200,75,201,276,Saturday
2022,10,8,2100,138,444,582,Saturday
2022,10,8,2000,201,695,896,Saturday
2022,10,8,1900,217,1017,1234,Saturday
2022,10,8,1800,331,985,1316,Saturday
2022,10,8,1700,436,968,1404,Saturday
2022,10,8,1600,606,863,1469,Saturday
2022,10,8,1500,718,791,1509,Saturday
2022,10,8,1400,931,639,1570,Saturday
2022,10,8,1300,992,561,1553,Saturday
2022,10,8,1200,1200,492,1692,Saturday
2022,10,8,1100,1172,347,1519,Saturday
2022,10,8,1000,1048,249,1297,Saturday
2022,10,8,900,813,143,956,Saturday
2022,10,8,800,506,74,580,Saturday
2022,10,8,700,275,56,331,Saturday
2022,10,8,600,111,49,160,Saturday
2022,10,8,500,77,44,121,Saturday
2022,10,8,400,40,45,85,Saturday
2022,10,8,300,37,52,89,Saturday
2022,10,8,200,36,48,84,Saturday
2022,10,8,100,48,77,125,Saturday
2022,10,7,2400,71,120,191,Friday
2022,10,7,2300,117,155,272,Friday
2022,10,7,2200,232,202,434,Friday
2022,10,7,2100,360,344,704,Friday
2022,10,7,2000,569,593,1162,Friday
2022,10,7,1900,753,744,1497,Friday
2022,10,7,1800,921,878,1799,Friday
2022,10,7,1700,853,924,1777,Friday
2022,10,7,1600,831,893,1724,Friday
2022,10,7,1500,868,927,1795,Friday
2022,10,7,1400,940,815,1755,Friday
2022,10,7,1300,1005,413,1418,Friday
2022,10,7,1200,1181,376,1557,Friday
2022,10,7,1100,1160,314,1474,Friday
2022,10,7,1000,745,206,951,Friday
2022,10,7,900,626,158,784,Friday
2022,10,7,800,386,82,468,Friday
2022,10,7,700,214,56,270,Friday
2022,10,7,600,104,45,149,Friday
2022,10,7,500,55,40,95,Friday
2022,10,7,400,37,39,76,Friday
2022,10,7,300,26,61,87,Friday
2022,10,7,200,36,64,100,Friday
2022,10,7,100,47,93,140,Friday
2022,10,6,2400,74,132,206,Thursday
2022,10,6,2300,94,170,264,Thursday
2022,10,6,2200,157,204,361,Thursday
2022,10,6,2100,261,329,590,Thursday
2022,10,6,2000,320,403,723,Thursday
2022,10,6,1900,401,590,991,Thursday
2022,10,6,1800,404,754,1158,Thursday
2022,10,6,1700,418,881,1299,Thursday
2022,10,6,1600,465,965,1430,Thursday
2022,10,6,1500,482,559,1041,Thursday
2022,10,6,1400,532,226,758,Thursday
2022,10,6,1300,535,190,725,Thursday
2022,10,6,1200,600,181,781,Thursday
2022,10,6,1100,736,231,967,Thursday
2022,10,6,1000,596,205,801,Thursday
2022,10,6,900,498,130,628,Thursday
2022,10,6,800,350,83,433,Thursday
2022,10,6,700,198,69,267,Thursday
2022,10,6,600,94,53,147,Thursday
2022,10,6,500,42,35,77,Thursday
2022,10,6,400,33,54,87,Thursday
2022,10,6,300,34,48,82,Thursday
2022,10,6,200,37,53,90,Thursday
2022,10,6,100,33,72,105,Thursday
2022,10,5,2400,58,104,162,Wednesday
2022,10,5,2300,73,133,206,Wednesday
2022,10,5,2200,103,179,282,Wednesday
2022,10,5,2100,145,301,446,Wednesday
2022,10,5,2000,187,423,610,Wednesday
2022,10,5,1900,216,607,823,Wednesday
2022,10,5,1800,278,612,890,Wednesday
2022,10,5,1700,332,640,972,Wednesday
2022,10,5,1600,314,602,916,Wednesday
2022,10,5,1500,372,494,866,Wednesday
2022,10,5,1400,448,370,818,Wednesday
2022,10,5,1300,438,334,772,Wednesday
2022,10,5,1200,569,273,842,Wednesday
2022,10,5,1100,587,213,800,Wednesday
2022,10,5,1000,532,163,695,Wednesday
2022,10,5,900,447,144,591,Wednesday
2022,10,5,800,313,70,383,Wednesday
2022,10,5,700,177,64,241,Wednesday
2022,10,5,600,73,43,116,Wednesday
2022,10,5,500,40,34,74,Wednesday
2022,10,5,400,28,48,76,Wednesday
2022,10,5,300,23,49,72,Wednesday
2022,10,5,200,35,37,72,Wednesday
2022,10,5,100,41,61,102,Wednesday
2022,10,4,2400,46,99,145,Tuesday
2022,10,4,2300,72,133,205,Tuesday
2022,10,4,2200,111,160,271,Tuesday
2022,10,4,2100,118,277,395,Tuesday
2022,10,4,2000,145,402,547,Tuesday
2022,10,4,1900,183,540,723,Tuesday
2022,10,4,1800,215,634,849,Tuesday
2022,10,4,1700,291,718,1009,Tuesday
2022,10,4,1600,330,620,950,Tuesday
2022,10,4,1500,366,452,818,Tuesday
2022,10,4,1400,366,435,801,Tuesday
2022,10,4,1300,490,360,850,Tuesday
2022,10,4,1200,558,314,872,Tuesday
2022,10,4,1100,642,237,879,Tuesday
2022,10,4,1000,573,167,740,Tuesday
2022,10,4,900,481,151,632,Tuesday
2022,10,4,800,345,88,433,Tuesday
2022,10,4,700,176,57,233,Tuesday
2022,10,4,600,82,43,125,Tuesday
2022,10,4,500,55,47,102,Tuesday
2022,10,4,400,31,41,72,Tuesday
2022,10,4,300,31,34,65,Tuesday
2022,10,4,200,36,54,90,Tuesday
2022,10,4,100,38,71,109,Tuesday
2022,10,3,2400,42,80,122,Monday
2022,10,3,2300,65,115,180,Monday
2022,10,3,2200,83,172,255,Monday
2022,10,3,2100,121,296,417,Monday
2022,10,3,2000,159,485,644,Monday
2022,10,3,1900,198,702,900,Monday
2022,10,3,1800,226,705,931,Monday
2022,10,3,1700,328,724,1052,Monday
2022,10,3,1600,342,653,995,Monday
2022,10,3,1500,450,553,1003,Monday
2022,10,3,1400,494,434,928,Monday
2022,10,3,1300,514,422,936,Monday
2022,10,3,1200,658,321,979,Monday
2022,10,3,1100,764,230,994,Monday
2022,10,3,1000,658,229,887,Monday
2022,10,3,900,501,131,632,Monday
2022,10,3,800,372,59,431,Monday
2022,10,3,700,212,41,253,Monday
2022,10,3,600,70,17,87,Monday
2022,10,3,500,45,13,58,Monday
2022,10,3,400,25,14,39,Monday
2022,10,3,300,24,29,53,Monday
2022,10,3,200,34,43,77,Monday
2022,10,3,100,34,85,119,Monday
2022,10,2,2400,39,113,152,Sunday
2022,10,2,2300,60,166,226,Sunday
2022,10,2,2200,76,284,360,Sunday
2022,10,2,2100,138,606,744,Sunday
2022,10,2,2000,192,824,1016,Sunday
2022,10,2,1900,225,1197,1422,Sunday
2022,10,2,1800,276,1245,1521,Sunday
2022,10,2,1700,380,1276,1656,Sunday
2022,10,2,1600,540,1219,1759,Sunday
2022,10,2,1500,527,1125,1652,Sunday
2022,10,2,1400,666,932,1598,Sunday
2022,10,2,1300,804,779,1583,Sunday
2022,10,2,1200,888,637,1525,Sunday
2022,10,2,1100,847,374,1221,Sunday
2022,10,2,1000,812,213,1025,Sunday
2022,10,2,900,673,117,790,Sunday
2022,10,2,800,433,41,474,Sunday
2022,10,2,700,237,27,264,Sunday
2022,10,2,600,87,23,110,Sunday
2022,10,2,500,54,27,81,Sunday
2022,10,2,400,33,27,60,Sunday
2022,10,2,300,31,27,58,Sunday
2022,10,2,200,33,29,62,Sunday
2022,10,2,100,39,77,116,Sunday
2022,10,1,2400,48,83,131,Saturday
2022,10,1,2300,72,154,226,Saturday
2022,10,1,2200,95,212,307,Saturday
2022,10,1,2100,126,631,757,Saturday
2022,10,1,2000,161,750,911,Saturday
2022,10,1,1900,186,1125,1311,Saturday
2022,10,1,1800,301,1102,1403,Saturday
2022,10,1,1700,374,1087,1461,Saturday
2022,10,1,1600,517,1005,1522,Saturday
2022,10,1,1500,637,755,1392,Saturday
2022,10,1,1400,790,604,1394,Saturday
2022,10,1,1300,954,500,1454,Saturday
2022,10,1,1200,935,396,1331,Saturday
2022,10,1,1100,954,332,1286,Saturday
2022,10,1,1000,951,211,1162,Saturday
2022,10,1,900,772,143,915,Saturday
2022,10,1,800,523,75,598,Saturday
2022,10,1,700,255,64,319,Saturday
2022,10,1,600,121,35,156,Saturday
2022,10,1,500,73,43,116,Saturday
2022,10,1,400,35,45,80,Saturday
2022,10,1,300,52,48,100,Saturday
2022,10,1,200,55,61,116,Saturday
2022,10,1,100,50,62,112,Saturday
2022,9,30,2400,55,88,143,Friday
2022,9,30,2300,84,159,243,Friday
2022,9,30,2200,134,218,352,Friday
2022,9,30,2100,211,454,665,Friday
2022,9,30,2000,339,701,1040,Friday
2022,9,30,1900,360,975,1335,Friday
2022,9,30,1800,506,1158,1664,Friday
2022,9,30,1700,613,987,1600,Friday
2022,9,30,1600,741,968,1709,Friday
2022,9,30,1500,928,840,1768,Friday
2022,9,30,1400,984,687,1671,Friday
2022,9,30,1300,1025,604,1629,Friday
2022,9,30,1200,982,483,1465,Friday
2022,9,30,1100,1194,350,1544,Friday
2022,9,30,1000,1009,248,1257,Friday
2022,9,30,900,848,155,1003,Friday
2022,9,30,800,522,100,622,Friday
2022,9,30,700,266,59,325,Friday
2022,9,30,600,107,44,151,Friday
2022,9,30,500,73,47,120,Friday
2022,9,30,400,56,41,97,Friday
2022,9,30,300,50,40,90,Friday
2022,9,30,200,46,57,103,Friday
2022,9,30,100,46,88,134,Friday
2022,9,29,2400,68,104,172,Thursday
2022,9,29,2300,107,152,259,Thursday
2022,9,29,2200,172,191,363,Thursday
2022,9,29,2100,251,289,540,Thursday
2022,9,29,2000,410,444,854,Thursday
2022,9,29,1900,445,528,973,Thursday
2022,9,29,1800,437,725,1162,Thursday
2022,9,29,1700,468,635,1103,Thursday
2022,9,29,1600,495,587,1082,Thursday
2022,9,29,1500,559,598,1157,Thursday
2022,9,29,1400,481,549,1030,Thursday
2022,9,29,1300,556,466,1022,Thursday
2022,9,29,1200,657,370,1027,Thursday
2022,9,29,1100,707,286,993,Thursday
2022,9,29,1000,648,232,880,Thursday
2022,9,29,900,490,110,600,Thursday
2022,9,29,800,326,74,400,Thursday
2022,9,29,700,178,74,252,Thursday
2022,9,29,600,81,48,129,Thursday
2022,9,29,500,61,48,109,Thursday
2022,9,29,400,31,53,84,Thursday
2022,9,29,300,27,42,69,Thursday
2022,9,29,200,37,49,86,Thursday
2022,9,29,100,48,76,124,Thursday
2022,9,28,2400,59,92,151,Wednesday
2022,9,28,2300,84,147,231,Wednesday
2022,9,28,2200,105,205,310,Wednesday
2022,9,28,2100,149,384,533,Wednesday
2022,9,28,2000,184,553,737,Wednesday
2022,9,28,1900,216,733,949,Wednesday
2022,9,28,1800,263,894,1157,Wednesday
2022,9,28,1700,340,804,1144,Wednesday
2022,9,28,1600,393,757,1150,Wednesday
2022,9,28,1500,483,588,1071,Wednesday
2022,9,28,1400,519,509,1028,Wednesday
2022,9,28,1300,589,453,1042,Wednesday
2022,9,28,1200,759,382,1141,Wednesday
2022,9,28,1100,853,269,1122,Wednesday
2022,9,28,1000,782,206,988,Wednesday
2022,9,28,900,594,158,752,Wednesday
2022,9,28,800,442,85,527,Wednesday
2022,9,28,700,221,67,288,Wednesday
2022,9,28,600,100,53,153,Wednesday
2022,9,28,500,67,31,98,Wednesday
2022,9,28,400,40,32,72,Wednesday
2022,9,28,300,39,47,86,Wednesday
2022,9,28,200,34,70,104,Wednesday
2022,9,28,100,35,84,119,Wednesday
2022,9,27,2400,48,110,158,Tuesday
2022,9,27,2300,67,119,186,Tuesday
2022,9,27,2200,114,213,327,Tuesday
2022,9,27,2100,134,365,499,Tuesday
2022,9,27,2000,198,579,777,Tuesday
2022,9,27,1900,220,774,994,Tuesday
2022,9,27,1800,257,842,1099,Tuesday
2022,9,27,1700,327,752,1079,Tuesday
2022,9,27,1600,394,739,1133,Tuesday
2022,9,27,1500,456,556,1012,Tuesday
2022,9,27,1400,478,535,1013,Tuesday
2022,9,27,1300,580,433,1013,Tuesday
2022,9,27,1200,709,381,1090,Tuesday
2022,9,27,1100,818,313,1131,Tuesday
2022,9,27,1000,763,197,960,Tuesday
2022,9,27,900,624,145,769,Tuesday
2022,9,27,800,458,86,544,Tuesday
2022,9,27,700,231,60,291,Tuesday
2022,9,27,600,103,49,152,Tuesday
2022,9,27,500,81,42,123,Tuesday
2022,9,27,400,35,48,83,Tuesday
2022,9,27,300,37,24,61,Tuesday
2022,9,27,200,25,57,82,Tuesday
2022,9,27,100,40,81,121,Tuesday
2022,9,26,2400,53,103,156,Monday
2022,9,26,2300,85,178,263,Monday
2022,9,26,2200,113,200,313,Monday
2022,9,26,2100,169,389,558,Monday
2022,9,26,2000,151,602,753,Monday
2022,9,26,1900,242,808,1050,Monday
2022,9,26,1800,258,962,1220,Monday
2022,9,26,1700,373,871,1244,Monday
2022,9,26,1600,427,739,1166,Monday
2022,9,26,1500,536,564,1100,Monday
2022,9,26,1400,595,540,1135,Monday
2022,9,26,1300,658,613,1271,Monday
2022,9,26,1200,818,527,1345,Monday
2022,9,26,1100,872,326,1198,Monday
2022,9,26,1000,927,252,1179,Monday
2022,9,26,900,672,167,839,Monday
2022,9,26,800,506,76,582,Monday
2022,9,26,700,250,44,294,Monday
2022,9,26,600,115,26,141,Monday
2022,9,26,500,72,22,94,Monday
2022,9,26,400,41,31,72,Monday
2022,9,26,300,36,29,65,Monday
2022,9,26,200,23,35,58,Monday
2022,9,26,100,33,38,71,Monday
2022,9,25,2400,47,117,164,Sunday
2022,9,25,2300,66,161,227,Sunday
2022,9,25,2200,71,292,363,Sunday
2022,9,25,2100,138,676,814,Sunday
2022,9,25,2000,218,1029,1247,Sunday
2022,9,25,1900,255,1265,1520,Sunday
2022,9,25,1800,351,1524,1875,Sunday
2022,9,25,1700,454,1528,1982,Sunday
2022,9,25,1600,552,1460,2012,Sunday
2022,9,25,1500,679,1253,1932,Sunday
2022,9,25,1400,819,1062,1881,Sunday
2022,9,25,1300,963,916,1879,Sunday
2022,9,25,1200,1054,751,1805,Sunday
2022,9,25,1100,1007,467,1474,Sunday
2022,9,25,1000,1021,303,1324,Sunday
2022,9,25,900,783,174,957,Sunday
2022,9,25,800,487,45,532,Sunday
2022,9,25,700,278,31,309,Sunday
2022,9,25,600,131,20,151,Sunday
2022,9,25,500,64,12,76,Sunday
2022,9,25,400,42,22,64,Sunday
2022,9,25,300,34,28,62,Sunday
2022,9,25,200,21,37,58,Sunday
2022,9,25,100,42,22,64,Sunday
2022,9,24,2400,39,65,104,Saturday
2022,9,24,2300,73,119,192,Saturday
2022,9,24,2200,95,199,294,Saturday
2022,9,24,2100,163,513,676,Saturday
2022,9,24,2000,208,787,995,Saturday
2022,9,24,1900,240,1090,1330,Saturday
2022,9,24,1800,374,1159,1533,Saturday
2022,9,24,1700,431,1128,1559,Saturday
2022,9,24,1600,605,1045,1650,Saturday
2022,9,24,1500,695,837,1532,Saturday
2022,9,24,1400,799,723,1522,Saturday
2022,9,24,1300,884,660,1544,Saturday
2022,9,24,1200,1102,525,1627,Saturday
2022,9,24,1100,1145,396,1541,Saturday
2022,9,24,1000,1036,361,1397,Saturday
2022,9,24,900,843,239,1082,Saturday
2022,9,24,800,556,65,621,Saturday
2022,9,24,700,287,42,329,Saturday
2022,9,24,600,91,42,133,Saturday
2022,9,24,500,64,33,97,Saturday
2022,9,24,400,54,32,86,Saturday
2022,9,24,300,24,31,55,Saturday
2022,9,24,200,43,38,81,Saturday
2022,9,24,100,52,29,81,Saturday
2022,9,23,2400,67,58,125,Friday
2022,9,23,2300,111,159,270,Friday
2022,9,23,2200,160,194,354,Friday
2022,9,23,2100,283,341,624,Friday
2022,9,23,2000,451,511,962,Friday
2022,9,23,1900,537,706,1243,Friday
2022,9,23,1800,641,1003,1644,Friday
2022,9,23,1700,724,976,1700,Friday
2022,9,23,1600,766,958,1724,Friday
2022,9,23,1500,762,833,1595,Friday
2022,9,23,1400,804,702,1506,Friday
2022,9,23,1300,851,673,1524,Friday
2022,9,23,1200,1028,579,1607,Friday
2022,9,23,1100,1014,401,1415,Friday
2022,9,23,1000,905,315,1220,Friday
2022,9,23,900,695,232,927,Friday
2022,9,23,800,504,66,570,Friday
2022,9,23,700,274,52,326,Friday
2022,9,23,600,126,29,155,Friday
2022,9,23,500,57,35,92,Friday
2022,9,23,400,36,33,69,Friday
2022,9,23,300,27,30,57,Friday
2022,9,23,200,26,55,81,Friday
2022,9,23,100,42,31,73,Friday
2022,9,22,2400,71,68,139,Thursday
2022,9,22,2300,76,171,247,Thursday
2022,9,22,2200,158,241,399,Thursday
2022,9,22,2100,234,379,613,Thursday
2022,9,22,2000,296,625,921,Thursday
2022,9,22,1900,420,790,1210,Thursday
2022,9,22,1800,467,896,1363,Thursday
2022,9,22,1700,512,934,1446,Thursday
2022,9,22,1600,533,874,1407,Thursday
2022,9,22,1500,607,715,1322,Thursday
2022,9,22,1400,649,598,1247,Thursday
2022,9,22,1300,727,542,1269,Thursday
2022,9,22,1200,841,461,1302,Thursday
2022,9,22,1100,999,376,1375,Thursday
2022,9,22,1000,855,323,1178,Thursday
2022,9,22,900,658,252,910,Thursday
2022,9,22,800,464,48,512,Thursday
2022,9,22,700,263,52,315,Thursday
2022,9,22,600,97,35,132,Thursday
2022,9,22,500,62,33,95,Thursday
2022,9,22,400,45,26,71,Thursday
2022,9,22,300,28,24,52,Thursday
2022,9,22,200,36,33,69,Thursday
2022,9,22,100,31,30,61,Thursday
2022,9,21,2400,49,71,120,Wednesday
2022,9,21,2300,82,163,245,Wednesday
2022,9,21,2200,99,222,321,Wednesday
2022,9,21,2100,175,439,614,Wednesday
2022,9,21,2000,289,613,902,Wednesday
2022,9,21,1900,289,790,1079,Wednesday
2022,9,21,1800,381,955,1336,Wednesday
2022,9,21,1700,388,922,1310,Wednesday
2022,9,21,1600,478,793,1271,Wednesday
2022,9,21,1500,488,682,1170,Wednesday
2022,9,21,1400,605,531,1136,Wednesday
2022,9,21,1300,723,493,1216,Wednesday
2022,9,21,1200,887,447,1334,Wednesday
2022,9,21,1100,913,356,1269,Wednesday
2022,9,21,1000,839,274,1113,Wednesday
2022,9,21,900,633,217,850,Wednesday
2022,9,21,800,438,67,505,Wednesday
2022,9,21,700,268,52,320,Wednesday
2022,9,21,600,108,33,141,Wednesday
2022,9,21,500,62,28,90,Wednesday
2022,9,21,400,31,29,60,Wednesday
2022,9,21,300,27,36,63,Wednesday
2022,9,21,200,30,34,64,Wednesday
2022,9,21,100,39,25,64,Wednesday
2022,9,20,2400,54,116,170,Tuesday
2022,9,20,2300,73,123,196,Tuesday
2022,9,20,2200,100,208,308,Tuesday
2022,9,20,2100,166,387,553,Tuesday
2022,9,20,2000,239,609,848,Tuesday
2022,9,20,1900,273,804,1077,Tuesday
2022,9,20,1800,332,896,1228,Tuesday
2022,9,20,1700,396,898,1294,Tuesday
2022,9,20,1600,451,738,1189,Tuesday
2022,9,20,1500,484,656,1140,Tuesday
2022,9,20,1400,594,559,1153,Tuesday
2022,9,20,1300,685,494,1179,Tuesday
2022,9,20,1200,837,442,1279,Tuesday
2022,9,20,1100,825,363,1188,Tuesday
2022,9,20,1000,833,295,1128,Tuesday
2022,9,20,900,654,236,890,Tuesday
2022,9,20,800,471,64,535,Tuesday
2022,9,20,700,253,46,299,Tuesday
2022,9,20,600,100,42,142,Tuesday
2022,9,20,500,64,28,92,Tuesday
2022,9,20,400,37,31,68,Tuesday
2022,9,20,300,31,29,60,Tuesday
2022,9,20,200,27,38,65,Tuesday
2022,9,20,100,25,23,48,Tuesday
2022,9,19,2400,40,110,150,Monday
2022,9,19,2300,81,104,185,Monday
2022,9,19,2200,87,242,329,Monday
2022,9,19,2100,166,343,509,Monday
2022,9,19,2000,233,434,667,Monday
2022,9,19,1900,275,502,777,Monday
2022,9,19,1800,325,609,934,Monday
2022,9,19,1700,409,871,1280,Monday
2022,9,19,1600,484,908,1392,Monday
2022,9,19,1500,581,893,1474,Monday
2022,9,19,1400,591,704,1295,Monday
2022,9,19,1300,699,600,1299,Monday
2022,9,19,1200,801,519,1320,Monday
2022,9,19,1100,873,346,1219,Monday
2022,9,19,1000,786,265,1051,Monday
2022,9,19,900,561,181,742,Monday
2022,9,19,800,382,51,433,Monday
2022,9,19,700,195,30,225,Monday
2022,9,19,600,83,17,100,Monday
2022,9,19,500,39,17,56,Monday
2022,9,19,400,21,18,39,Monday
2022,9,19,300,20,31,51,Monday
2022,9,19,200,21,35,56,Monday
2022,9,19,100,33,38,71,Monday
2022,9,18,2400,34,92,126,Sunday
2022,9,18,2300,50,143,193,Sunday
2022,9,18,2200,80,354,434,Sunday
2022,9,18,2100,170,598,768,Sunday
2022,9,18,2000,242,973,1215,Sunday
2022,9,18,1900,278,1288,1566,Sunday
2022,9,18,1800,375,1495,1870,Sunday
2022,9,18,1700,500,1528,2028,Sunday
2022,9,18,1600,674,1394,2068,Sunday
2022,9,18,1500,723,1212,1935,Sunday
2022,9,18,1400,800,1196,1996,Sunday
2022,9,18,1300,908,1015,1923,Sunday
2022,9,18,1200,1055,959,2014,Sunday
2022,9,18,1100,1059,520,1579,Sunday
2022,9,18,1000,1005,302,1307,Sunday
2022,9,18,900,725,175,900,Sunday
2022,9,18,800,466,57,523,Sunday
2022,9,18,700,238,39,277,Sunday
2022,9,18,600,101,23,124,Sunday
2022,9,18,500,60,10,70,Sunday
2022,9,18,400,27,16,43,Sunday
2022,9,18,300,18,30,48,Sunday
2022,9,18,200,22,39,61,Sunday
2022,9,18,100,35,57,92,Sunday
2022,9,17,2400,31,96,127,Saturday
2022,9,17,2300,45,114,159,Saturday
2022,9,17,2200,101,273,374,Saturday
2022,9,17,2100,148,506,654,Saturday
2022,9,17,2000,187,811,998,Saturday
2022,9,17,1900,251,1089,1340,Saturday
2022,9,17,1800,320,1199,1519,Saturday
2022,9,17,1700,463,1099,1562,Saturday
2022,9,17,1600,573,1067,1640,Saturday
2022,9,17,1500,685,847,1532,Saturday
2022,9,17,1400,815,743,1558,Saturday
2022,9,17,1300,878,601,1479,Saturday
2022,9,17,1200,1068,503,1571,Saturday
2022,9,17,1100,1145,400,1545,Saturday
2022,9,17,1000,1117,305,1422,Saturday
2022,9,17,900,867,175,1042,Saturday
2022,9,17,800,611,79,690,Saturday
2022,9,17,700,275,42,317,Saturday
2022,9,17,600,125,47,172,Saturday
2022,9,17,500,56,24,80,Saturday
2022,9,17,400,32,29,61,Saturday
2022,9,17,300,31,35,66,Saturday
2022,9,17,200,24,58,82,Saturday
2022,9,17,100,52,95,147,Saturday
2022,9,16,2400,74,65,139,Friday
2022,9,16,2300,108,137,245,Friday
2022,9,16,2200,179,200,379,Friday
2022,9,16,2100,322,400,722,Friday
2022,9,16,2000,480,492,972,Friday
2022,9,16,1900,662,820,1482,Friday
2022,9,16,1800,730,1016,1746,Friday
2022,9,16,1700,748,1008,1756,Friday
2022,9,16,1600,796,883,1679,Friday
2022,9,16,1500,885,774,1659,Friday
2022,9,16,1400,782,728,1510,Friday
2022,9,16,1300,839,710,1549,Friday
2022,9,16,1200,1079,640,1719,Friday
2022,9,16,1100,1171,451,1622,Friday
2022,9,16,1000,983,337,1320,Friday
2022,9,16,900,707,246,953,Friday
2022,9,16,800,443,98,541,Friday
2022,9,16,700,233,48,281,Friday
2022,9,16,600,128,42,170,Friday
2022,9,16,500,56,27,83,Friday
2022,9,16,400,28,24,52,Friday
2022,9,16,300,25,29,54,Friday
2022,9,16,200,30,45,75,Friday
2022,9,16,100,40,62,102,Friday
2022,9,15,2400,41,161,202,Thursday
2022,9,15,2300,99,122,221,Thursday
2022,9,15,2200,134,228,362,Thursday
2022,9,15,2100,246,403,649,Thursday
2022,9,15,2000,384,613,997,Thursday
2022,9,15,1900,436,801,1237,Thursday
2022,9,15,1800,473,936,1409,Thursday
2022,9,15,1700,506,955,1461,Thursday
2022,9,15,1600,648,937,1585,Thursday
2022,9,15,1500,684,776,1460,Thursday
2022,9,15,1400,710,714,1424,Thursday
2022,9,15,1300,851,532,1383,Thursday
2022,9,15,1200,973,542,1515,Thursday
2022,9,15,1100,1145,336,1481,Thursday
2022,9,15,1000,975,311,1286,Thursday
2022,9,15,900,766,256,1022,Thursday
2022,9,15,800,518,77,595,Thursday
2022,9,15,700,271,47,318,Thursday
2022,9,15,600,100,35,135,Thursday
2022,9,15,500,62,31,93,Thursday
2022,9,15,400,41,20,61,Thursday
2022,9,15,300,22,26,48,Thursday
2022,9,15,200,20,31,51,Thursday
2022,9,15,100,22,25,47,Thursday
2022,9,14,2400,52,118,170,Wednesday
2022,9,14,2300,71,116,187,Wednesday
2022,9,14,2200,109,204,313,Wednesday
2022,9,14,2100,187,367,554,Wednesday
2022,9,14,2000,248,545,793,Wednesday
2022,9,14,1900,295,675,970,Wednesday
2022,9,14,1800,374,823,1197,Wednesday
2022,9,14,1700,475,874,1349,Wednesday
2022,9,14,1600,553,748,1301,Wednesday
2022,9,14,1500,545,639,1184,Wednesday
2022,9,14,1400,622,551,1173,Wednesday
2022,9,14,1300,669,544,1213,Wednesday
2022,9,14,1200,848,518,1366,Wednesday
2022,9,14,1100,938,408,1346,Wednesday
2022,9,14,1000,833,305,1138,Wednesday
2022,9,14,900,612,250,862,Wednesday
2022,9,14,800,394,64,458,Wednesday
2022,9,14,700,205,51,256,Wednesday
2022,9,14,600,80,40,120,Wednesday
2022,9,14,500,32,29,61,Wednesday
2022,9,14,400,29,39,68,Wednesday
2022,9,14,300,23,39,62,Wednesday
2022,9,14,200,24,83,107,Wednesday
2022,9,14,100,32,167,199,Wednesday
2022,9,13,2400,45,173,218,Tuesday
2022,9,13,2300,83,114,197,Tuesday
2022,9,13,2200,102,84,186,Tuesday
2022,9,13,2100,168,187,355,Tuesday
2022,9,13,2000,236,399,635,Tuesday
2022,9,13,1900,265,680,945,Tuesday
2022,9,13,1800,297,880,1177,Tuesday
2022,9,13,1700,400,919,1319,Tuesday
2022,9,13,1600,441,937,1378,Tuesday
2022,9,13,1500,495,771,1266,Tuesday
2022,9,13,1400,525,647,1172,Tuesday
2022,9,13,1300,607,607,1214,Tuesday
2022,9,13,1200,813,557,1370,Tuesday
2022,9,13,1100,1021,383,1404,Tuesday
2022,9,13,1000,820,332,1152,Tuesday
2022,9,13,900,635,243,878,Tuesday
2022,9,13,800,409,66,475,Tuesday
2022,9,13,700,222,50,272,Tuesday
2022,9,13,600,112,54,166,Tuesday
2022,9,13,500,53,31,84,Tuesday
2022,9,13,400,30,45,75,Tuesday
2022,9,13,300,21,44,65,Tuesday
2022,9,13,200,20,30,50,Tuesday
2022,9,13,100,23,32,55,Tuesday
2022,9,12,2400,42,108,150,Monday
2022,9,12,2300,81,99,180,Monday
2022,9,12,2200,103,216,319,Monday
2022,9,12,2100,148,440,588,Monday
2022,9,12,2000,212,712,924,Monday
2022,9,12,1900,280,876,1156,Monday
2022,9,12,1800,348,1131,1479,Monday
2022,9,12,1700,453,1154,1607,Monday
2022,9,12,1600,520,1084,1604,Monday
2022,9,12,1500,621,873,1494,Monday
2022,9,12,1400,705,807,1512,Monday
2022,9,12,1300,822,663,1485,Monday
2022,9,12,1200,1029,599,1628,Monday
2022,9,12,1100,1133,414,1547,Monday
2022,9,12,1000,976,300,1276,Monday
2022,9,12,900,750,237,987,Monday
2022,9,12,800,513,77,590,Monday
2022,9,12,700,283,42,325,Monday
2022,9,12,600,112,30,142,Monday
2022,9,12,500,66,15,81,Monday
2022,9,12,400,25,21,46,Monday
2022,9,12,300,28,30,58,Monday
2022,9,12,200,22,24,46,Monday
2022,9,12,100,29,37,66,Monday
2022,9,11,2400,27,80,107,Sunday
2022,9,11,2300,55,146,201,Sunday
2022,9,11,2200,98,350,448,Sunday
2022,9,11,2100,202,833,1035,Sunday
2022,9,11,2000,234,1173,1407,Sunday
2022,9,11,1900,297,1404,1701,Sunday
2022,9,11,1800,396,1526,1922,Sunday
2022,9,11,1700,505,1533,2038,Sunday
2022,9,11,1600,605,1537,2142,Sunday
2022,9,11,1500,784,1335,2119,Sunday
2022,9,11,1400,836,1122,1958,Sunday
2022,9,11,1300,997,993,1990,Sunday
2022,9,11,1200,1183,777,1960,Sunday
2022,9,11,1100,1121,522,1643,Sunday
2022,9,11,1000,1032,305,1337,Sunday
2022,9,11,900,710,163,873,Sunday
2022,9,11,800,476,68,544,Sunday
2022,9,11,700,254,32,286,Sunday
2022,9,11,600,125,33,158,Sunday
2022,9,11,500,65,28,93,Sunday
2022,9,11,400,28,24,52,Sunday
2022,9,11,300,35,30,65,Sunday
2022,9,11,200,31,50,81,Sunday
2022,9,11,100,29,53,82,Sunday
2022,9,10,2400,42,111,153,Saturday
2022,9,10,2300,79,166,245,Saturday
2022,9,10,2200,132,323,455,Saturday
2022,9,10,2100,139,581,720,Saturday
2022,9,10,2000,227,896,1123,Saturday
2022,9,10,1900,308,1141,1449,Saturday
2022,9,10,1800,339,1214,1553,Saturday
2022,9,10,1700,499,1271,1770,Saturday
2022,9,10,1600,565,1082,1647,Saturday
2022,9,10,1500,707,871,1578,Saturday
2022,9,10,1400,858,729,1587,Saturday
2022,9,10,1300,995,683,1678,Saturday
2022,9,10,1200,1167,550,1717,Saturday
2022,9,10,1100,1292,442,1734,Saturday
2022,9,10,1000,1118,320,1438,Saturday
2022,9,10,900,936,209,1145,Saturday
2022,9,10,800,606,76,682,Saturday
2022,9,10,700,327,63,390,Saturday
2022,9,10,600,137,50,187,Saturday
2022,9,10,500,88,31,119,Saturday
2022,9,10,400,51,42,93,Saturday
2022,9,10,300,38,36,74,Saturday
2022,9,10,200,31,54,85,Saturday
2022,9,10,100,44,84,128,Saturday
2022,9,9,2400,65,105,170,Friday
2022,9,9,2300,126,139,265,Friday
2022,9,9,2200,209,274,483,Friday
2022,9,9,2100,348,442,790,Friday
2022,9,9,2000,514,651,1165,Friday
2022,9,9,1900,653,980,1633,Friday
2022,9,9,1800,694,996,1690,Friday
2022,9,9,1700,750,1042,1792,Friday
2022,9,9,1600,799,951,1750,Friday
2022,9,9,1500,871,832,1703,Friday
2022,9,9,1400,857,682,1539,Friday
2022,9,9,1300,878,664,1542,Friday
2022,9,9,1200,1083,593,1676,Friday
2022,9,9,1100,1150,444,1594,Friday
2022,9,9,1000,984,329,1313,Friday
2022,9,9,900,779,246,1025,Friday
2022,9,9,800,493,75,568,Friday
2022,9,9,700,258,32,290,Friday
2022,9,9,600,117,52,169,Friday
2022,9,9,500,53,34,87,Friday
2022,9,9,400,37,28,65,Friday
2022,9,9,300,26,31,57,Friday
2022,9,9,200,37,32,69,Friday
2022,9,9,100,30,39,69,Friday
2022,9,8,2400,48,110,158,Thursday
2022,9,8,2300,85,139,224,Thursday
2022,9,8,2200,147,268,415,Thursday
2022,9,8,2100,268,429,697,Thursday
2022,9,8,2000,360,542,902,Thursday
2022,9,8,1900,412,807,1219,Thursday
2022,9,8,1800,464,911,1375,Thursday
2022,9,8,1700,508,905,1413,Thursday
2022,9,8,1600,609,879,1488,Thursday
2022,9,8,1500,678,704,1382,Thursday
2022,9,8,1400,698,632,1330,Thursday
2022,9,8,1300,762,638,1400,Thursday
2022,9,8,1200,955,528,1483,Thursday
2022,9,8,1100,1011,318,1329,Thursday
2022,9,8,1000,966,314,1280,Thursday
2022,9,8,900,712,270,982,Thursday
2022,9,8,800,453,73,526,Thursday
2022,9,8,700,256,47,303,Thursday
2022,9,8,600,101,44,145,Thursday
2022,9,8,500,51,22,73,Thursday
2022,9,8,400,26,39,65,Thursday
2022,9,8,300,27,24,51,Thursday
2022,9,8,200,28,40,68,Thursday
2022,9,8,100,48,42,90,Thursday
2022,9,7,2400,68,119,187,Wednesday
2022,9,7,2300,83,162,245,Wednesday
2022,9,7,2200,127,310,437,Wednesday
2022,9,7,2100,198,462,660,Wednesday
2022,9,7,2000,282,654,936,Wednesday
2022,9,7,1900,357,790,1147,Wednesday
2022,9,7,1800,411,996,1407,Wednesday
2022,9,7,1700,458,991,1449,Wednesday
2022,9,7,1600,589,930,1519,Wednesday
2022,9,7,1500,600,782,1382,Wednesday
2022,9,7,1400,683,816,1499,Wednesday
2022,9,7,1300,826,593,1419,Wednesday
2022,9,7,1200,977,514,1491,Wednesday
2022,9,7,1100,1063,387,1450,Wednesday
2022,9,7,1000,855,305,1160,Wednesday
2022,9,7,900,699,292,991,Wednesday
2022,9,7,800,475,83,558,Wednesday
2022,9,7,700,273,55,328,Wednesday
2022,9,7,600,129,30,159,Wednesday
2022,9,7,500,63,32,95,Wednesday
2022,9,7,400,42,25,67,Wednesday
2022,9,7,300,24,32,56,Wednesday
2022,9,7,200,29,38,67,Wednesday
2022,9,7,100,38,22,60,Wednesday
2022,9,6,2400,62,130,192,Tuesday
2022,9,6,2300,80,202,282,Tuesday
2022,9,6,2200,119,357,476,Tuesday
2022,9,6,2100,179,551,730,Tuesday
2022,9,6,2000,232,774,1006,Tuesday
2022,9,6,1900,328,1067,1395,Tuesday
2022,9,6,1800,388,1237,1625,Tuesday
2022,9,6,1700,451,1206,1657,Tuesday
2022,9,6,1600,595,1036,1631,Tuesday
2022,9,6,1500,672,936,1608,Tuesday
2022,9,6,1400,737,740,1477,Tuesday
2022,9,6,1300,935,699,1634,Tuesday
2022,9,6,1200,1123,588,1711,Tuesday
2022,9,6,1100,1116,404,1520,Tuesday
2022,9,6,1000,927,289,1216,Tuesday
2022,9,6,900,747,213,960,Tuesday
2022,9,6,800,532,96,628,Tuesday
2022,9,6,700,294,55,349,Tuesday
2022,9,6,600,137,28,165,Tuesday
2022,9,6,500,89,25,114,Tuesday
2022,9,6,400,47,34,81,Tuesday
2022,9,6,300,31,45,76,Tuesday
2022,9,6,200,30,63,93,Tuesday
2022,9,6,100,32,85,117,Tuesday
2022,9,5,2400,37,138,175,Monday
2022,9,5,2300,84,293,377,Monday
2022,9,5,2200,102,622,724,Monday
2022,9,5,2100,193,1001,1194,Monday
2022,9,5,2000,265,1579,1844,Monday
2022,9,5,1900,350,2044,2394,Monday
2022,9,5,1800,434,2300,2734,Monday
2022,9,5,1700,517,2371,2888,Monday
2022,9,5,1600,690,2352,3042,Monday
2022,9,5,1500,826,2393,3219,Monday
2022,9,5,1400,1027,1889,2916,Monday
2022,9,5,1300,1104,1798,2902,Monday
2022,9,5,1200,1337,1442,2779,Monday
2022,9,5,1100,1417,913,2330,Monday
2022,9,5,1000,1186,482,1668,Monday
2022,9,5,900,900,245,1145,Monday
2022,9,5,800,616,119,735,Monday
2022,9,5,700,390,43,433,Monday
2022,9,5,600,156,38,194,Monday
2022,9,5,500,83,36,119,Monday
2022,9,5,400,54,33,87,Monday
2022,9,5,300,38,40,78,Monday
2022,9,5,200,38,71,109,Monday
2022,9,5,100,34,109,143,Monday
2022,9,4,2400,48,177,225,Sunday
2022,9,4,2300,109,330,439,Sunday
2022,9,4,2200,157,681,838,Sunday
2022,9,4,2100,212,1086,1298,Sunday
2022,9,4,2000,296,1494,1790,Sunday
2022,9,4,1900,395,1746,2141,Sunday
2022,9,4,1800,535,1805,2340,Sunday
2022,9,4,1700,633,1726,2359,Sunday
2022,9,4,1600,833,1550,2383,Sunday
2022,9,4,1500,1017,1399,2416,Sunday
2022,9,4,1400,1215,1124,2339,Sunday
2022,9,4,1300,1321,943,2264,Sunday
2022,9,4,1200,1428,769,2197,Sunday
2022,9,4,1100,1356,519,1875,Sunday
2022,9,4,1000,1247,327,1574,Sunday
2022,9,4,900,959,167,1126,Sunday
2022,9,4,800,673,87,760,Sunday
2022,9,4,700,337,31,368,Sunday
2022,9,4,600,180,37,217,Sunday
2022,9,4,500,80,25,105,Sunday
2022,9,4,400,48,32,80,Sunday
2022,9,4,300,40,31,71,Sunday
2022,9,4,200,58,78,136,Sunday
2022,9,4,100,42,83,125,Sunday
2022,9,3,2400,70,135,205,Saturday
2022,9,3,2300,134,189,323,Saturday
2022,9,3,2200,174,495,669,Saturday
2022,9,3,2100,188,799,987,Saturday
2022,9,3,2000,299,1141,1440,Saturday
2022,9,3,1900,397,1353,1750,Saturday
2022,9,3,1800,540,1409,1949,Saturday
2022,9,3,1700,693,1409,2102,Saturday
2022,9,3,1600,869,1234,2103,Saturday
2022,9,3,1500,1194,1071,2265,Saturday
2022,9,3,1400,1342,914,2256,Saturday
2022,9,3,1300,1338,813,2151,Saturday
2022,9,3,1200,1701,630,2331,Saturday
2022,9,3,1100,1604,438,2042,Saturday
2022,9,3,1000,1541,350,1891,Saturday
2022,9,3,900,1312,240,1552,Saturday
2022,9,3,800,891,96,987,Saturday
2022,9,3,700,473,60,533,Saturday
2022,9,3,600,243,52,295,Saturday
2022,9,3,500,115,33,148,Saturday
2022,9,3,400,56,38,94,Saturday
2022,9,3,300,51,55,106,Saturday
2022,9,3,200,64,64,128,Saturday
2022,9,3,100,80,101,181,Saturday
2022,9,2,2400,137,131,268,Friday
2022,9,2,2300,249,260,509,Friday
2022,9,2,2200,354,408,762,Friday
2022,9,2,2100,633,601,1234,Friday
2022,9,2,2000,1043,809,1852,Friday
2022,9,2,1900,1388,1057,2445,Friday
2022,9,2,1800,1421,1117,2538,Friday
2022,9,2,1700,1427,1152,2579,Friday
2022,9,2,1600,1415,1090,2505,Friday
2022,9,2,1500,1390,884,2274,Friday
2022,9,2,1400,1298,806,2104,Friday
2022,9,2,1300,1306,714,2020,Friday
2022,9,2,1200,1429,592,2021,Friday
2022,9,2,1100,1406,493,1899,Friday
2022,9,2,1000,1352,365,1717,Friday
2022,9,2,900,1041,315,1356,Friday
2022,9,2,800,652,103,755,Friday
2022,9,2,700,410,59,469,Friday
2022,9,2,600,214,42,256,Friday
2022,9,2,500,102,49,151,Friday
2022,9,2,400,61,56,117,Friday
2022,9,2,300,43,49,92,Friday
2022,9,2,200,57,77,134,Friday
2022,9,2,100,65,48,113,Friday
2022,9,1,2400,95,156,251,Thursday
2022,9,1,2300,132,159,291,Thursday
2022,9,1,2200,269,402,671,Thursday
2022,9,1,2100,442,532,974,Thursday
2022,9,1,2000,667,773,1440,Thursday
2022,9,1,1900,808,1041,1849,Thursday
2022,9,1,1800,773,1054,1827,Thursday
2022,9,1,1700,779,1086,1865,Thursday
2022,9,1,1600,857,1012,1869,Thursday
2022,9,1,1500,880,900,1780,Thursday
2022,9,1,1400,978,744,1722,Thursday
2022,9,1,1300,1073,636,1709,Thursday
2022,9,1,1200,1268,625,1893,Thursday
2022,9,1,1100,1243,435,1678,Thursday
2022,9,1,1000,1090,314,1404,Thursday
2022,9,1,900,909,319,1228,Thursday
2022,9,1,800,568,88,656,Thursday
2022,9,1,700,323,54,377,Thursday
2022,9,1,600,162,45,207,Thursday
2022,9,1,500,74,31,105,Thursday
2022,9,1,400,51,38,89,Thursday
2022,9,1,300,47,35,82,Thursday
2022,9,1,200,47,53,100,Thursday
2022,9,1,100,54,62,116,Thursday
2022,8,31,2400,74,129,203,Wednesday
2022,8,31,2300,122,175,297,Wednesday
2022,8,31,2200,139,421,560,Wednesday
2022,8,31,2100,256,602,858,Wednesday
2022,8,31,2000,364,752,1116,Wednesday
2022,8,31,1900,381,1032,1413,Wednesday
2022,8,31,1800,431,1132,1563,Wednesday
2022,8,31,1700,494,1036,1530,Wednesday
2022,8,31,1600,599,933,1532,Wednesday
2022,8,31,1500,646,773,1419,Wednesday
2022,8,31,1400,708,732,1440,Wednesday
2022,8,31,1300,775,597,1372,Wednesday
2022,8,31,1200,972,484,1456,Wednesday
2022,8,31,1100,988,399,1387,Wednesday
2022,8,31,1000,918,295,1213,Wednesday
2022,8,31,900,801,277,1078,Wednesday
2022,8,31,800,508,88,596,Wednesday
2022,8,31,700,271,52,323,Wednesday
2022,8,31,600,142,38,180,Wednesday
2022,8,31,500,82,35,117,Wednesday
2022,8,31,400,38,28,66,Wednesday
2022,8,31,300,48,37,85,Wednesday
2022,8,31,200,39,59,98,Wednesday
2022,8,31,100,56,38,94,Wednesday
2022,8,30,2400,56,101,157,Tuesday
2022,8,30,2300,100,248,348,Tuesday
2022,8,30,2200,125,432,557,Tuesday
2022,8,30,2100,206,633,839,Tuesday
2022,8,30,2000,278,893,1171,Tuesday
2022,8,30,1900,329,1077,1406,Tuesday
2022,8,30,1800,379,1242,1621,Tuesday
2022,8,30,1700,439,1079,1518,Tuesday
2022,8,30,1600,561,1024,1585,Tuesday
2022,8,30,1500,568,824,1392,Tuesday
2022,8,30,1400,733,739,1472,Tuesday
2022,8,30,1300,843,587,1430,Tuesday
2022,8,30,1200,966,560,1526,Tuesday
2022,8,30,1100,1094,408,1502,Tuesday
2022,8,30,1000,915,299,1214,Tuesday
2022,8,30,900,725,308,1033,Tuesday
2022,8,30,800,565,73,638,Tuesday
2022,8,30,700,282,48,330,Tuesday
2022,8,30,600,143,38,181,Tuesday
2022,8,30,500,80,41,121,Tuesday
2022,8,30,400,50,31,81,Tuesday
2022,8,30,300,44,33,77,Tuesday
2022,8,30,200,44,66,110,Tuesday
2022,8,30,100,30,49,79,Tuesday
2022,8,29,2400,63,112,175,Monday
2022,8,29,2300,90,354,444,Monday
2022,8,29,2200,122,791,913,Monday
2022,8,29,2100,197,1079,1276,Monday
2022,8,29,2000,299,978,1277,Monday
2022,8,29,1900,313,1122,1435,Monday
2022,8,29,1800,445,1152,1597,Monday
2022,8,29,1700,510,1175,1685,Monday
2022,8,29,1600,618,977,1595,Monday
2022,8,29,1500,705,835,1540,Monday
2022,8,29,1400,778,778,1556,Monday
2022,8,29,1300,854,673,1527,Monday
2022,8,29,1200,1063,569,1632,Monday
2022,8,29,1100,994,422,1416,Monday
2022,8,29,1000,981,267,1248,Monday
2022,8,29,900,756,194,950,Monday
2022,8,29,800,509,117,626,Monday
2022,8,29,700,274,73,347,Monday
2022,8,29,600,161,31,192,Monday
2022,8,29,500,72,22,94,Monday
2022,8,29,400,41,26,67,Monday
2022,8,29,300,43,44,87,Monday
2022,8,29,200,39,76,115,Monday
2022,8,29,100,44,134,178,Monday
2022,8,28,2400,35,344,379,Sunday
2022,8,28,2300,78,695,773,Sunday
2022,8,28,2200,138,915,1053,Sunday
2022,8,28,2100,180,1051,1231,Sunday
2022,8,28,2000,283,1517,1800,Sunday
2022,8,28,1900,375,1830,2205,Sunday
2022,8,28,1800,426,1681,2107,Sunday
2022,8,28,1700,514,1489,2003,Sunday
2022,8,28,1600,746,1549,2295,Sunday
2022,8,28,1500,723,1306,2029,Sunday
2022,8,28,1400,805,1132,1937,Sunday
2022,8,28,1300,912,1035,1947,Sunday
2022,8,28,1200,1112,857,1969,Sunday
2022,8,28,1100,1243,450,1693,Sunday
2022,8,28,1000,1039,238,1277,Sunday
2022,8,28,900,852,120,972,Sunday
2022,8,28,800,557,68,625,Sunday
2022,8,28,700,254,38,292,Sunday
2022,8,28,600,152,22,174,Sunday
2022,8,28,500,52,24,76,Sunday
2022,8,28,400,48,23,71,Sunday
2022,8,28,300,45,32,77,Sunday
2022,8,28,200,20,51,71,Sunday
2022,8,28,100,38,90,128,Sunday
2022,8,27,2400,56,164,220,Saturday
2022,8,27,2300,91,210,301,Saturday
2022,8,27,2200,105,424,529,Saturday
2022,8,27,2100,156,1243,1399,Saturday
2022,8,27,2000,212,998,1210,Saturday
2022,8,27,1900,271,298,569,Saturday
2022,8,27,1800,384,1257,1641,Saturday
2022,8,27,1700,508,1190,1698,Saturday
2022,8,27,1600,572,1198,1770,Saturday
2022,8,27,1500,768,1078,1846,Saturday
2022,8,27,1400,871,901,1772,Saturday
2022,8,27,1300,998,948,1946,Saturday
2022,8,27,1200,1145,761,1906,Saturday
2022,8,27,1100,1117,533,1650,Saturday
2022,8,27,1000,981,332,1313,Saturday
2022,8,27,900,765,209,974,Saturday
2022,8,27,800,511,95,606,Saturday
2022,8,27,700,234,61,295,Saturday
2022,8,27,600,125,46,171,Saturday
2022,8,27,500,52,49,101,Saturday
2022,8,27,400,38,57,95,Saturday
2022,8,27,300,33,38,71,Saturday
2022,8,27,200,25,77,102,Saturday
2022,8,27,100,48,80,128,Saturday
2022,8,26,2400,74,202,276,Friday
2022,8,26,2300,121,232,353,Friday
2022,8,26,2200,192,358,550,Friday
2022,8,26,2100,318,734,1052,Friday
2022,8,26,2000,605,1012,1617,Friday
2022,8,26,1900,726,1131,1857,Friday
2022,8,26,1800,775,1226,2001,Friday
2022,8,26,1700,894,1241,2135,Friday
2022,8,26,1600,904,1481,2385,Friday
2022,8,26,1500,1081,1124,2205,Friday
2022,8,26,1400,1094,902,1996,Friday
2022,8,26,1300,1160,830,1990,Friday
2022,8,26,1200,1365,709,2074,Friday
2022,8,26,1100,1346,496,1842,Friday
2022,8,26,1000,1156,340,1496,Friday
2022,8,26,900,894,292,1186,Friday
2022,8,26,800,607,93,700,Friday
2022,8,26,700,355,50,405,Friday
2022,8,26,600,171,36,207,Friday
2022,8,26,500,83,38,121,Friday
2022,8,26,400,45,40,85,Friday
2022,8,26,300,38,58,96,Friday
2022,8,26,200,54,53,107,Friday
2022,8,26,100,45,37,82,Friday
2022,8,25,2400,72,111,183,Thursday
2022,8,25,2300,113,315,428,Thursday
2022,8,25,2200,173,470,643,Thursday
2022,8,25,2100,337,644,981,Thursday
2022,8,25,2000,503,917,1420,Thursday
2022,8,25,1900,544,1146,1690,Thursday
2022,8,25,1800,659,1266,1925,Thursday
2022,8,25,1700,674,1303,1977,Thursday
2022,8,25,1600,774,1285,2059,Thursday
2022,8,25,1500,842,962,1804,Thursday
2022,8,25,1400,888,791,1679,Thursday
2022,8,25,1300,1113,724,1837,Thursday
2022,8,25,1200,1231,606,1837,Thursday
2022,8,25,1100,1253,436,1689,Thursday
2022,8,25,1000,1106,289,1395,Thursday
2022,8,25,900,899,286,1185,Thursday
2022,8,25,800,599,86,685,Thursday
2022,8,25,700,344,63,407,Thursday
2022,8,25,600,205,39,244,Thursday
2022,8,25,500,93,46,139,Thursday
2022,8,25,400,53,29,82,Thursday
2022,8,25,300,33,41,74,Thursday
2022,8,25,200,31,42,73,Thursday
2022,8,25,100,40,31,71,Thursday
2022,8,24,2400,62,160,222,Wednesday
2022,8,24,2300,90,235,325,Wednesday
2022,8,24,2200,142,459,601,Wednesday
2022,8,24,2100,259,619,878,Wednesday
2022,8,24,2000,341,861,1202,Wednesday
2022,8,24,1900,377,1023,1400,Wednesday
2022,8,24,1800,456,1166,1622,Wednesday
2022,8,24,1700,514,1146,1660,Wednesday
2022,8,24,1600,623,1076,1699,Wednesday
2022,8,24,1500,692,977,1669,Wednesday
2022,8,24,1400,776,645,1421,Wednesday
2022,8,24,1300,979,603,1582,Wednesday
2022,8,24,1200,1080,551,1631,Wednesday
2022,8,24,1100,1132,406,1538,Wednesday
2022,8,24,1000,1031,284,1315,Wednesday
2022,8,24,900,802,273,1075,Wednesday
2022,8,24,800,545,80,625,Wednesday
2022,8,24,700,312,55,367,Wednesday
2022,8,24,600,167,36,203,Wednesday
2022,8,24,500,67,34,101,Wednesday
2022,8,24,400,47,32,79,Wednesday
2022,8,24,300,34,54,88,Wednesday
2022,8,24,200,32,45,77,Wednesday
2022,8,24,100,40,43,83,Wednesday
2022,8,23,2400,53,137,190,Tuesday
2022,8,23,2300,93,208,301,Tuesday
2022,8,23,2200,126,466,592,Tuesday
2022,8,23,2100,208,581,789,Tuesday
2022,8,23,2000,314,858,1172,Tuesday
2022,8,23,1900,343,1006,1349,Tuesday
2022,8,23,1800,418,968,1386,Tuesday
2022,8,23,1700,537,1003,1540,Tuesday
2022,8,23,1600,567,955,1522,Tuesday
2022,8,23,1500,646,835,1481,Tuesday
2022,8,23,1400,773,720,1493,Tuesday
2022,8,23,1300,854,685,1539,Tuesday
2022,8,23,1200,998,507,1505,Tuesday
2022,8,23,1100,980,420,1400,Tuesday
2022,8,23,1000,800,283,1083,Tuesday
2022,8,23,900,621,281,902,Tuesday
2022,8,23,800,460,87,547,Tuesday
2022,8,23,700,210,68,278,Tuesday
2022,8,23,600,123,45,168,Tuesday
2022,8,23,500,46,85,131,Tuesday
2022,8,23,400,38,83,121,Tuesday
2022,8,23,300,17,27,44,Tuesday
2022,8,23,200,30,17,47,Tuesday
2022,8,23,100,42,21,63,Tuesday
2022,8,22,2400,58,72,130,Monday
2022,8,22,2300,108,345,453,Monday
2022,8,22,2200,127,537,664,Monday
2022,8,22,2100,185,755,940,Monday
2022,8,22,2000,276,1130,1406,Monday
2022,8,22,1900,403,1306,1709,Monday
2022,8,22,1800,479,1400,1879,Monday
2022,8,22,1700,598,1345,1943,Monday
2022,8,22,1600,822,1302,2124,Monday
2022,8,22,1500,968,1062,2030,Monday
2022,8,22,1400,1149,929,2078,Monday
2022,8,22,1300,1265,782,2047,Monday
2022,8,22,1200,1347,640,1987,Monday
2022,8,22,1100,1313,456,1769,Monday
2022,8,22,1000,1243,302,1545,Monday
2022,8,22,900,946,258,1204,Monday
2022,8,22,800,670,107,777,Monday
2022,8,22,700,364,72,436,Monday
2022,8,22,600,206,27,233,Monday
2022,8,22,500,101,15,116,Monday
2022,8,22,400,54,30,84,Monday
2022,8,22,300,29,44,73,Monday
2022,8,22,200,38,70,108,Monday
2022,8,22,100,34,38,72,Monday
2022,8,21,2400,53,154,207,Sunday
2022,8,21,2300,73,303,376,Sunday
2022,8,21,2200,117,574,691,Sunday
2022,8,21,2100,202,940,1142,Sunday
2022,8,21,2000,334,1213,1547,Sunday
2022,8,21,1900,422,1604,2026,Sunday
2022,8,21,1800,469,1838,2307,Sunday
2022,8,21,1700,580,1718,2298,Sunday
2022,8,21,1600,801,1887,2688,Sunday
2022,8,21,1500,504,1143,1647,Sunday
2022,8,21,1400,1056,1507,2563,Sunday
2022,8,21,1300,1144,1344,2488,Sunday
2022,8,21,1200,1271,964,2235,Sunday
2022,8,21,1100,1285,542,1827,Sunday
2022,8,21,1000,1125,321,1446,Sunday
2022,8,21,900,833,168,1001,Sunday
2022,8,21,800,570,78,648,Sunday
2022,8,21,700,257,33,290,Sunday
2022,8,21,600,143,30,173,Sunday
2022,8,21,500,62,26,88,Sunday
2022,8,21,400,38,34,72,Sunday
2022,8,21,300,27,52,79,Sunday
2022,8,21,200,30,81,111,Sunday
2022,8,21,100,40,99,139,Sunday
2022,8,20,2400,65,136,201,Saturday
2022,8,20,2300,110,294,404,Saturday
2022,8,20,2200,148,562,710,Saturday
2022,8,20,2100,179,759,938,Saturday
2022,8,20,2000,284,1059,1343,Saturday
2022,8,20,1900,334,1329,1663,Saturday
2022,8,20,1800,439,1494,1933,Saturday
2022,8,20,1700,589,1378,1967,Saturday
2022,8,20,1600,698,1357,2055,Saturday
2022,8,20,1500,893,1087,1980,Saturday
2022,8,20,1400,1009,975,1984,Saturday
2022,8,20,1300,1177,759,1936,Saturday
2022,8,20,1200,1384,719,2103,Saturday
2022,8,20,1100,1357,483,1840,Saturday
2022,8,20,1000,1262,329,1591,Saturday
2022,8,20,900,1055,232,1287,Saturday
2022,8,20,800,771,112,883,Saturday
2022,8,20,700,378,69,447,Saturday
2022,8,20,600,201,51,252,Saturday
2022,8,20,500,97,46,143,Saturday
2022,8,20,400,49,44,93,Saturday
2022,8,20,300,48,62,110,Saturday
2022,8,20,200,52,64,116,Saturday
2022,8,20,100,55,111,166,Saturday
2022,8,19,2400,102,146,248,Friday
2022,8,19,2300,141,294,435,Friday
2022,8,19,2200,247,428,675,Friday
2022,8,19,2100,384,717,1101,Friday
2022,8,19,2000,671,953,1624,Friday
2022,8,19,1900,845,1270,2115,Friday
2022,8,19,1800,939,1308,2247,Friday
2022,8,19,1700,910,1667,2577,Friday
2022,8,19,1600,1042,1194,2236,Friday
2022,8,19,1500,1166,907,2073,Friday
2022,8,19,1400,1228,830,2058,Friday
2022,8,19,1300,1204,884,2088,Friday
2022,8,19,1200,1347,746,2093,Friday
2022,8,19,1100,1376,504,1880,Friday
2022,8,19,1000,1208,434,1642,Friday
2022,8,19,900,969,304,1273,Friday
2022,8,19,800,689,98,787,Friday
2022,8,19,700,412,66,478,Friday
2022,8,19,600,199,47,246,Friday
2022,8,19,500,92,51,143,Friday
2022,8,19,400,50,43,93,Friday
2022,8,19,300,48,50,98,Friday
2022,8,19,200,60,73,133,Friday
2022,8,19,100,58,47,105,Friday
2022,8,18,2400,75,194,269,Thursday
2022,8,18,2300,147,276,423,Thursday
2022,8,18,2200,195,461,656,Thursday
2022,8,18,2100,357,765,1122,Thursday
2022,8,18,2000,536,918,1454,Thursday
2022,8,18,1900,625,1158,1783,Thursday
2022,8,18,1800,664,1212,1876,Thursday
2022,8,18,1700,747,1280,2027,Thursday
2022,8,18,1600,717,1205,1922,Thursday
2022,8,18,1500,887,1001,1888,Thursday
2022,8,18,1400,980,878,1858,Thursday
2022,8,18,1300,1252,761,2013,Thursday
2022,8,18,1200,1094,638,1732,Thursday
2022,8,18,1100,1259,456,1715,Thursday
2022,8,18,1000,1077,299,1376,Thursday
2022,8,18,900,852,322,1174,Thursday
2022,8,18,800,623,85,708,Thursday
2022,8,18,700,359,64,423,Thursday
2022,8,18,600,171,52,223,Thursday
2022,8,18,500,73,42,115,Thursday
2022,8,18,400,50,41,91,Thursday
2022,8,18,300,66,43,109,Thursday
2022,8,18,200,60,68,128,Thursday
2022,8,18,100,79,59,138,Thursday
2022,8,17,2400,83,221,304,Wednesday
2022,8,17,2300,105,328,433,Wednesday
2022,8,17,2200,145,353,498,Wednesday
2022,8,17,2100,255,693,948,Wednesday
2022,8,17,2000,387,886,1273,Wednesday
2022,8,17,1900,400,1090,1490,Wednesday
2022,8,17,1800,531,1155,1686,Wednesday
2022,8,17,1700,574,1137,1711,Wednesday
2022,8,17,1600,668,1049,1717,Wednesday
2022,8,17,1500,755,936,1691,Wednesday
2022,8,17,1400,821,751,1572,Wednesday
2022,8,17,1300,948,690,1638,Wednesday
2022,8,17,1200,1196,553,1749,Wednesday
2022,8,17,1100,1270,431,1701,Wednesday
2022,8,17,1000,945,431,1376,Wednesday
2022,8,17,900,859,135,994,Wednesday
2022,8,17,800,616,91,707,Wednesday
2022,8,17,700,315,65,380,Wednesday
2022,8,17,600,204,53,257,Wednesday
2022,8,17,500,87,30,117,Wednesday
2022,8,17,400,59,21,80,Wednesday
2022,8,17,300,47,30,77,Wednesday
2022,8,17,200,31,61,92,Wednesday
2022,8,17,100,33,42,75,Wednesday
2022,8,16,2400,60,209,269,Tuesday
2022,8,16,2300,96,271,367,Tuesday
2022,8,16,2200,139,463,602,Tuesday
2022,8,16,2100,206,682,888,Tuesday
2022,8,16,2000,305,819,1124,Tuesday
2022,8,16,1900,368,1085,1453,Tuesday
2022,8,16,1800,444,1277,1721,Tuesday
2022,8,16,1700,541,1109,1650,Tuesday
2022,8,16,1600,592,1155,1747,Tuesday
2022,8,16,1500,675,950,1625,Tuesday
2022,8,16,1400,784,754,1538,Tuesday
2022,8,16,1300,986,671,1657,Tuesday
2022,8,16,1200,1105,562,1667,Tuesday
2022,8,16,1100,1181,395,1576,Tuesday
2022,8,16,1000,1052,322,1374,Tuesday
2022,8,16,900,779,285,1064,Tuesday
2022,8,16,800,613,99,712,Tuesday
2022,8,16,700,302,49,351,Tuesday
2022,8,16,600,163,39,202,Tuesday
2022,8,16,500,81,46,127,Tuesday
2022,8,16,400,58,38,96,Tuesday
2022,8,16,300,39,45,84,Tuesday
2022,8,16,200,39,58,97,Tuesday
2022,8,16,100,42,37,79,Tuesday
2022,8,15,2400,60,162,222,Monday
2022,8,15,2300,88,307,395,Monday
2022,8,15,2200,131,510,641,Monday
2022,8,15,2100,254,714,968,Monday
2022,8,15,2000,318,1029,1347,Monday
2022,8,15,1900,418,1253,1671,Monday
2022,8,15,1800,615,1386,2001,Monday
2022,8,15,1700,833,1314,2147,Monday
2022,8,15,1600,863,1250,2113,Monday
2022,8,15,1500,1004,1096,2100,Monday
2022,8,15,1400,1084,938,2022,Monday
2022,8,15,1300,1038,766,1804,Monday
2022,8,15,1200,1072,650,1722,Monday
2022,8,15,1100,986,512,1498,Monday
2022,8,15,1000,1047,309,1356,Monday
2022,8,15,900,869,266,1135,Monday
2022,8,15,800,573,115,688,Monday
2022,8,15,700,339,70,409,Monday
2022,8,15,600,181,24,205,Monday
2022,8,15,500,82,27,109,Monday
2022,8,15,400,70,27,97,Monday
2022,8,15,300,40,26,66,Monday
2022,8,15,200,35,50,85,Monday
2022,8,15,100,37,62,99,Monday
2022,8,14,2400,50,140,190,Sunday
2022,8,14,2300,91,378,469,Sunday
2022,8,14,2200,137,701,838,Sunday
2022,8,14,2100,221,1012,1233,Sunday
2022,8,14,2000,334,1829,2163,Sunday
2022,8,14,1900,408,2117,2525,Sunday
2022,8,14,1800,478,2208,2686,Sunday
2022,8,14,1700,673,1652,2325,Sunday
2022,8,14,1600,767,1630,2397,Sunday
2022,8,14,1500,1018,1671,2689,Sunday
2022,8,14,1400,1127,1281,2408,Sunday
2022,8,14,1300,1269,1080,2349,Sunday
2022,8,14,1200,1370,931,2301,Sunday
2022,8,14,1100,1339,569,1908,Sunday
2022,8,14,1000,1233,338,1571,Sunday
2022,8,14,900,888,208,1096,Sunday
2022,8,14,800,622,91,713,Sunday
2022,8,14,700,324,30,354,Sunday
2022,8,14,600,148,29,177,Sunday
2022,8,14,500,68,18,86,Sunday
2022,8,14,400,56,28,84,Sunday
2022,8,14,300,46,43,89,Sunday
2022,8,14,200,32,60,92,Sunday
2022,8,14,100,45,106,151,Sunday
2022,8,13,2400,43,171,214,Saturday
2022,8,13,2300,103,314,417,Saturday
2022,8,13,2200,138,559,697,Saturday
2022,8,13,2100,210,830,1040,Saturday
2022,8,13,2000,248,1037,1285,Saturday
2022,8,13,1900,364,1320,1684,Saturday
2022,8,13,1800,455,1603,2058,Saturday
2022,8,13,1700,632,1399,2031,Saturday
2022,8,13,1600,733,1587,2320,Saturday
2022,8,13,1500,981,1166,2147,Saturday
2022,8,13,1400,1067,998,2065,Saturday
2022,8,13,1300,1398,808,2206,Saturday
2022,8,13,1200,1588,675,2263,Saturday
2022,8,13,1100,1348,480,1828,Saturday
2022,8,13,1000,1364,306,1670,Saturday
2022,8,13,900,1100,234,1334,Saturday
2022,8,13,800,692,115,807,Saturday
2022,8,13,700,385,72,457,Saturday
2022,8,13,600,198,46,244,Saturday
2022,8,13,500,104,48,152,Saturday
2022,8,13,400,50,35,85,Saturday
2022,8,13,300,68,56,124,Saturday
2022,8,13,200,56,64,120,Saturday
2022,8,13,100,48,121,169,Saturday
2022,8,12,2400,86,190,276,Friday
2022,8,12,2300,143,286,429,Friday
2022,8,12,2200,269,454,723,Friday
2022,8,12,2100,442,725,1167,Friday
2022,8,12,2000,702,964,1666,Friday
2022,8,12,1900,851,1296,2147,Friday
2022,8,12,1800,919,1303,2222,Friday
2022,8,12,1700,928,1282,2210,Friday
2022,8,12,1600,1034,1221,2255,Friday
2022,8,12,1500,1174,1096,2270,Friday
2022,8,12,1400,1107,948,2055,Friday
2022,8,12,1300,1197,862,2059,Friday
2022,8,12,1200,1447,667,2114,Friday
2022,8,12,1100,1382,530,1912,Friday
2022,8,12,1000,1168,348,1516,Friday
2022,8,12,900,954,278,1232,Friday
2022,8,12,800,683,93,776,Friday
2022,8,12,700,365,68,433,Friday
2022,8,12,600,203,41,244,Friday
2022,8,12,500,109,54,163,Friday
2022,8,12,400,65,40,105,Friday
2022,8,12,300,44,61,105,Friday
2022,8,12,200,39,55,94,Friday
2022,8,12,100,52,44,96,Friday
2022,8,11,2400,77,162,239,Thursday
2022,8,11,2300,136,258,394,Thursday
2022,8,11,2200,185,444,629,Thursday
2022,8,11,2100,332,615,947,Thursday
2022,8,11,2000,541,887,1428,Thursday
2022,8,11,1900,561,1146,1707,Thursday
2022,8,11,1800,616,1211,1827,Thursday
2022,8,11,1700,690,1141,1831,Thursday
2022,8,11,1600,669,1057,1726,Thursday
2022,8,11,1500,861,941,1802,Thursday
2022,8,11,1400,917,793,1710,Thursday
2022,8,11,1300,999,746,1745,Thursday
2022,8,11,1200,1154,613,1767,Thursday
2022,8,11,1100,1267,448,1715,Thursday
2022,8,11,1000,1099,327,1426,Thursday
2022,8,11,900,904,280,1184,Thursday
2022,8,11,800,599,99,698,Thursday
2022,8,11,700,311,72,383,Thursday
2022,8,11,600,199,43,242,Thursday
2022,8,11,500,90,41,131,Thursday
2022,8,11,400,69,19,88,Thursday
2022,8,11,300,34,28,62,Thursday
2022,8,11,200,44,53,97,Thursday
2022,8,11,100,43,44,87,Thursday
2022,8,10,2400,65,198,263,Wednesday
2022,8,10,2300,111,292,403,Wednesday
2022,8,10,2200,167,434,601,Wednesday
2022,8,10,2100,237,636,873,Wednesday
2022,8,10,2000,361,930,1291,Wednesday
2022,8,10,1900,382,1056,1438,Wednesday
2022,8,10,1800,460,1124,1584,Wednesday
2022,8,10,1700,614,1145,1759,Wednesday
2022,8,10,1600,625,1117,1742,Wednesday
2022,8,10,1500,706,879,1585,Wednesday
2022,8,10,1400,855,718,1573,Wednesday
2022,8,10,1300,887,677,1564,Wednesday
2022,8,10,1200,1158,545,1703,Wednesday
2022,8,10,1100,1134,418,1552,Wednesday
2022,8,10,1000,980,336,1316,Wednesday
2022,8,10,900,773,282,1055,Wednesday
2022,8,10,800,574,110,684,Wednesday
2022,8,10,700,329,64,393,Wednesday
2022,8,10,600,188,46,234,Wednesday
2022,8,10,500,93,31,124,Wednesday
2022,8,10,400,49,25,74,Wednesday
2022,8,10,300,31,51,82,Wednesday
2022,8,10,200,35,53,88,Wednesday
2022,8,10,100,40,40,80,Wednesday
2022,8,9,2400,62,158,220,Tuesday
2022,8,9,2300,109,299,408,Tuesday
2022,8,9,2200,126,473,599,Tuesday
2022,8,9,2100,213,674,887,Tuesday
2022,8,9,2000,351,900,1251,Tuesday
2022,8,9,1900,400,1125,1525,Tuesday
2022,8,9,1800,476,1148,1624,Tuesday
2022,8,9,1700,546,1200,1746,Tuesday
2022,8,9,1600,769,1067,1836,Tuesday
2022,8,9,1500,541,834,1375,Tuesday
2022,8,9,1400,787,807,1594,Tuesday
2022,8,9,1300,908,695,1603,Tuesday
2022,8,9,1200,1139,547,1686,Tuesday
2022,8,9,1100,1197,358,1555,Tuesday
2022,8,9,1000,1007,296,1303,Tuesday
2022,8,9,900,801,311,1112,Tuesday
2022,8,9,800,574,88,662,Tuesday
2022,8,9,700,335,63,398,Tuesday
2022,8,9,600,160,52,212,Tuesday
2022,8,9,500,94,39,133,Tuesday
2022,8,9,400,54,33,87,Tuesday
2022,8,9,300,43,44,87,Tuesday
2022,8,9,200,41,74,115,Tuesday
2022,8,9,100,39,59,98,Tuesday
2022,8,8,2400,55,128,183,Monday
2022,8,8,2300,107,337,444,Monday
2022,8,8,2200,144,516,660,Monday
2022,8,8,2100,244,752,996,Monday
2022,8,8,2000,320,1033,1353,Monday
2022,8,8,1900,383,1192,1575,Monday
2022,8,8,1800,461,1300,1761,Monday
2022,8,8,1700,576,1304,1880,Monday
2022,8,8,1600,769,1203,1972,Monday
2022,8,8,1500,929,1070,1999,Monday
2022,8,8,1400,1080,871,1951,Monday
2022,8,8,1300,1173,810,1983,Monday
2022,8,8,1200,1343,637,1980,Monday
2022,8,8,1100,1236,417,1653,Monday
2022,8,8,1000,1155,290,1445,Monday
2022,8,8,900,886,240,1126,Monday
2022,8,8,800,672,114,786,Monday
2022,8,8,700,345,50,395,Monday
2022,8,8,600,172,43,215,Monday
2022,8,8,500,104,19,123,Monday
2022,8,8,400,45,25,70,Monday
2022,8,8,300,47,40,87,Monday
2022,8,8,200,38,77,115,Monday
2022,8,8,100,27,57,84,Monday
2022,8,7,2400,38,166,204,Sunday
2022,8,7,2300,92,443,535,Sunday
2022,8,7,2200,130,736,866,Sunday
2022,8,7,2100,229,1060,1289,Sunday
2022,8,7,2000,320,1468,1788,Sunday
2022,8,7,1900,411,1883,2294,Sunday
2022,8,7,1800,548,1987,2535,Sunday
2022,8,7,1700,619,1973,2592,Sunday
2022,8,7,1600,829,1821,2650,Sunday
2022,8,7,1500,1080,1601,2681,Sunday
2022,8,7,1400,1213,1352,2565,Sunday
2022,8,7,1300,1234,1207,2441,Sunday
2022,8,7,1200,1389,910,2299,Sunday
2022,8,7,1100,1273,618,1891,Sunday
2022,8,7,1000,1209,329,1538,Sunday
2022,8,7,900,915,176,1091,Sunday
2022,8,7,800,596,82,678,Sunday
2022,8,7,700,343,50,393,Sunday
2022,8,7,600,145,22,167,Sunday
2022,8,7,500,89,35,124,Sunday
2022,8,7,400,52,31,83,Sunday
2022,8,7,300,44,51,95,Sunday
2022,8,7,200,50,81,131,Sunday
2022,8,7,100,47,74,121,Sunday
2022,8,6,2400,68,205,273,Saturday
2022,8,6,2300,97,317,414,Saturday
2022,8,6,2200,135,617,752,Saturday
2022,8,6,2100,205,899,1104,Saturday
2022,8,6,2000,288,1278,1566,Saturday
2022,8,6,1900,349,1474,1823,Saturday
2022,8,6,1800,488,1540,2028,Saturday
2022,8,6,1700,564,1643,2207,Saturday
2022,8,6,1600,765,1436,2201,Saturday
2022,8,6,1500,965,1150,2115,Saturday
2022,8,6,1400,1065,973,2038,Saturday
2022,8,6,1300,1234,846,2080,Saturday
2022,8,6,1200,1511,627,2138,Saturday
2022,8,6,1100,1483,458,1941,Saturday
2022,8,6,1000,1339,363,1702,Saturday
2022,8,6,900,1170,224,1394,Saturday
2022,8,6,800,786,125,911,Saturday
2022,8,6,700,422,69,491,Saturday
2022,8,6,600,218,50,268,Saturday
2022,8,6,500,129,59,188,Saturday
2022,8,6,400,68,37,105,Saturday
2022,8,6,300,53,64,117,Saturday
2022,8,6,200,47,62,109,Saturday
2022,8,6,100,70,116,186,Saturday
2022,8,5,2400,93,169,262,Friday
2022,8,5,2300,137,345,482,Friday
2022,8,5,2200,256,474,730,Friday
2022,8,5,2100,419,669,1088,Friday
2022,8,5,2000,627,880,1507,Friday
2022,8,5,1900,732,1157,1889,Friday
2022,8,5,1800,840,1232,2072,Friday
2022,8,5,1700,944,1207,2151,Friday
2022,8,5,1600,943,1120,2063,Friday
2022,8,5,1500,1168,1067,2235,Friday
2022,8,5,1400,1084,921,2005,Friday
2022,8,5,1300,1084,790,1874,Friday
2022,8,5,1200,1378,693,2071,Friday
2022,8,5,1100,1428,526,1954,Friday
2022,8,5,1000,1241,298,1539,Friday
2022,8,5,900,947,266,1213,Friday
2022,8,5,800,556,87,643,Friday
2022,8,5,700,356,50,406,Friday
2022,8,5,600,157,50,207,Friday
2022,8,5,500,56,45,101,Friday
2022,8,5,400,46,33,79,Friday
2022,8,5,300,38,62,100,Friday
2022,8,5,200,34,36,70,Friday
2022,8,5,100,56,39,95,Friday
2022,8,4,2400,80,184,264,Thursday
2022,8,4,2300,137,244,381,Thursday
2022,8,4,2200,199,411,610,Thursday
2022,8,4,2100,327,532,859,Thursday
2022,8,4,2000,450,733,1183,Thursday
2022,8,4,1900,529,986,1515,Thursday
2022,8,4,1800,604,1120,1724,Thursday
2022,8,4,1700,670,1210,1880,Thursday
2022,8,4,1600,771,1126,1897,Thursday
2022,8,4,1500,834,930,1764,Thursday
2022,8,4,1400,876,850,1726,Thursday
2022,8,4,1300,1027,702,1729,Thursday
2022,8,4,1200,1174,678,1852,Thursday
2022,8,4,1100,1125,482,1607,Thursday
2022,8,4,1000,1017,375,1392,Thursday
2022,8,4,900,760,284,1044,Thursday
2022,8,4,800,584,106,690,Thursday
2022,8,4,700,323,54,377,Thursday
2022,8,4,600,144,44,188,Thursday
2022,8,4,500,67,36,103,Thursday
2022,8,4,400,45,39,84,Thursday
2022,8,4,300,42,35,77,Thursday
2022,8,4,200,27,56,83,Thursday
2022,8,4,100,40,37,77,Thursday
2022,8,3,2400,74,111,185,Wednesday
2022,8,3,2300,109,311,420,Wednesday
2022,8,3,2200,137,397,534,Wednesday
2022,8,3,2100,250,646,896,Wednesday
2022,8,3,2000,344,1015,1359,Wednesday
2022,8,3,1900,413,1146,1559,Wednesday
2022,8,3,1800,495,1303,1798,Wednesday
2022,8,3,1700,506,1277,1783,Wednesday
2022,8,3,1600,674,1213,1887,Wednesday
2022,8,3,1500,814,1003,1817,Wednesday
2022,8,3,1400,858,800,1658,Wednesday
2022,8,3,1300,1096,719,1815,Wednesday
2022,8,3,1200,1191,600,1791,Wednesday
2022,8,3,1100,1231,378,1609,Wednesday
2022,8,3,1000,1083,340,1423,Wednesday
2022,8,3,900,832,265,1097,Wednesday
2022,8,3,800,643,107,750,Wednesday
2022,8,3,700,391,61,452,Wednesday
2022,8,3,600,174,46,220,Wednesday
2022,8,3,500,113,28,141,Wednesday
2022,8,3,400,66,40,106,Wednesday
2022,8,3,300,48,41,89,Wednesday
2022,8,3,200,36,66,102,Wednesday
2022,8,3,100,42,60,102,Wednesday
2022,8,2,2400,75,191,266,Tuesday
2022,8,2,2300,102,314,416,Tuesday
2022,8,2,2200,163,537,700,Tuesday
2022,8,2,2100,195,720,915,Tuesday
2022,8,2,2000,321,1111,1432,Tuesday
2022,8,2,1900,341,1286,1627,Tuesday
2022,8,2,1800,480,1361,1841,Tuesday
2022,8,2,1700,584,1319,1903,Tuesday
2022,8,2,1600,747,1228,1975,Tuesday
2022,8,2,1500,825,1158,1983,Tuesday
2022,8,2,1400,928,964,1892,Tuesday
2022,8,2,1300,1107,823,1930,Tuesday
2022,8,2,1200,1329,649,1978,Tuesday
2022,8,2,1100,1284,487,1771,Tuesday
2022,8,2,1000,1161,320,1481,Tuesday
2022,8,2,900,898,232,1130,Tuesday
2022,8,2,800,634,138,772,Tuesday
2022,8,2,700,347,78,425,Tuesday
2022,8,2,600,172,45,217,Tuesday
2022,8,2,500,94,28,122,Tuesday
2022,8,2,400,74,27,101,Tuesday
2022,8,2,300,38,33,71,Tuesday
2022,8,2,200,31,51,82,Tuesday
2022,8,2,100,37,110,147,Tuesday
2022,8,1,2400,54,245,299,Monday
2022,8,1,2300,104,473,577,Monday
2022,8,1,2200,141,951,1092,Monday
2022,8,1,2100,231,1227,1458,Monday
2022,8,1,2000,285,1761,2046,Monday
2022,8,1,1900,374,1848,2222,Monday
2022,8,1,1800,537,1972,2509,Monday
2022,8,1,1700,676,2012,2688,Monday
2022,8,1,1600,878,1940,2818,Monday
2022,8,1,1500,1075,1851,2926,Monday
2022,8,1,1400,1357,1678,3035,Monday
2022,8,1,1300,1181,1445,2626,Monday
2022,8,1,1200,1422,1125,2547,Monday
2022,8,1,1100,1472,723,2195,Monday
2022,8,1,1000,1314,376,1690,Monday
2022,8,1,900,1060,258,1318,Monday
2022,8,1,800,708,146,854,Monday
2022,8,1,700,393,56,449,Monday
2022,8,1,600,218,41,259,Monday
2022,8,1,500,110,36,146,Monday
2022,8,1,400,71,44,115,Monday
2022,8,1,300,48,56,104,Monday
2022,8,1,200,34,61,95,Monday
2022,8,1,100,41,148,189,Monday
2022,7,31,2400,75,240,315,Sunday
2022,7,31,2300,94,511,605,Sunday
2022,7,31,2200,162,730,892,Sunday
2022,7,31,2100,225,1091,1316,Sunday
2022,7,31,2000,348,1471,1819,Sunday
2022,7,31,1900,432,1690,2122,Sunday
2022,7,31,1800,532,1741,2273,Sunday
2022,7,31,1700,615,1784,2399,Sunday
2022,7,31,1600,891,1614,2505,Sunday
2022,7,31,1500,1120,1353,2473,Sunday
2022,7,31,1400,1191,1190,2381,Sunday
2022,7,31,1300,1437,951,2388,Sunday
2022,7,31,1200,1516,726,2242,Sunday
2022,7,31,1100,1537,519,2056,Sunday
2022,7,31,1000,1292,302,1594,Sunday
2022,7,31,900,1074,184,1258,Sunday
2022,7,31,800,742,128,870,Sunday
2022,7,31,700,398,64,462,Sunday
2022,7,31,600,210,29,239,Sunday
2022,7,31,500,103,30,133,Sunday
2022,7,31,400,57,26,83,Sunday
2022,7,31,300,48,45,93,Sunday
2022,7,31,200,58,55,113,Sunday
2022,7,31,100,58,103,161,Sunday
2022,7,30,2400,81,219,300,Saturday
2022,7,30,2300,134,358,492,Saturday
2022,7,30,2200,163,593,756,Saturday
2022,7,30,2100,235,800,1035,Saturday
2022,7,30,2000,309,1129,1438,Saturday
2022,7,30,1900,410,1388,1798,Saturday
2022,7,30,1800,521,1429,1950,Saturday
2022,7,30,1700,661,1456,2117,Saturday
2022,7,30,1600,913,1220,2133,Saturday
2022,7,30,1500,968,1067,2035,Saturday
2022,7,30,1400,1264,848,2112,Saturday
2022,7,30,1300,1490,771,2261,Saturday
2022,7,30,1200,1665,697,2362,Saturday
2022,7,30,1100,1816,466,2282,Saturday
2022,7,30,1000,1750,340,2090,Saturday
2022,7,30,900,1373,213,1586,Saturday
2022,7,30,800,983,147,1130,Saturday
2022,7,30,700,529,77,606,Saturday
2022,7,30,600,275,58,333,Saturday
2022,7,30,500,150,51,201,Saturday
2022,7,30,400,76,52,128,Saturday
2022,7,30,300,68,46,114,Saturday
2022,7,30,200,59,97,156,Saturday
2022,7,30,100,77,134,211,Saturday
2022,7,29,2400,115,185,300,Friday
2022,7,29,2300,212,325,537,Friday
2022,7,29,2200,398,486,884,Friday
2022,7,29,2100,673,604,1277,Friday
2022,7,29,2000,886,872,1758,Friday
2022,7,29,1900,1012,1050,2062,Friday
2022,7,29,1800,1176,1118,2294,Friday
2022,7,29,1700,1173,1290,2463,Friday
2022,7,29,1600,1328,1351,2679,Friday
2022,7,29,1500,1411,1203,2614,Friday
2022,7,29,1400,1384,967,2351,Friday
2022,7,29,1300,1548,934,2482,Friday
2022,7,29,1200,1603,785,2388,Friday
2022,7,29,1100,1572,579,2151,Friday
2022,7,29,1000,1431,402,1833,Friday
2022,7,29,900,1121,342,1463,Friday
2022,7,29,800,910,110,1020,Friday
2022,7,29,700,431,88,519,Friday
2022,7,29,600,223,56,279,Friday
2022,7,29,500,131,37,168,Friday
2022,7,29,400,69,44,113,Friday
2022,7,29,300,52,55,107,Friday
2022,7,29,200,58,63,121,Friday
2022,7,29,100,56,51,107,Friday
2022,7,28,2400,101,173,274,Thursday
2022,7,28,2300,180,320,500,Thursday
2022,7,28,2200,245,508,753,Thursday
2022,7,28,2100,457,700,1157,Thursday
2022,7,28,2000,770,932,1702,Thursday
2022,7,28,1900,863,1189,2052,Thursday
2022,7,28,1800,865,1316,2181,Thursday
2022,7,28,1700,871,1188,2059,Thursday
2022,7,28,1600,948,1107,2055,Thursday
2022,7,28,1500,1044,991,2035,Thursday
2022,7,28,1400,1091,840,1931,Thursday
2022,7,28,1300,0,0,0,Thursday
2022,7,28,1200,1331,638,1969,Thursday
2022,7,28,1100,1363,432,1795,Thursday
2022,7,28,1000,1264,375,1639,Thursday
2022,7,28,900,1009,298,1307,Thursday
2022,7,28,800,727,103,830,Thursday
2022,7,28,700,396,72,468,Thursday
2022,7,28,600,225,54,279,Thursday
2022,7,28,500,141,31,172,Thursday
2022,7,28,400,87,38,125,Thursday
2022,7,28,300,50,44,94,Thursday
2022,7,28,200,40,69,109,Thursday
2022,7,28,100,41,54,95,Thursday
2022,7,27,2400,88,171,259,Wednesday
2022,7,27,2300,97,303,400,Wednesday
2022,7,27,2200,162,483,645,Wednesday
2022,7,27,2100,286,652,938,Wednesday
2022,7,27,2000,392,871,1263,Wednesday
2022,7,27,1900,448,1081,1529,Wednesday
2022,7,27,1800,516,1165,1681,Wednesday
2022,7,27,1700,569,1129,1698,Wednesday
2022,7,27,1600,681,1094,1775,Wednesday
2022,7,27,1500,848,960,1808,Wednesday
2022,7,27,1400,880,824,1704,Wednesday
2022,7,27,1300,950,694,1644,Wednesday
2022,7,27,1200,1170,553,1723,Wednesday
2022,7,27,1100,1223,408,1631,Wednesday
2022,7,27,1000,1056,338,1394,Wednesday
2022,7,27,900,843,285,1128,Wednesday
2022,7,27,800,572,114,686,Wednesday
2022,7,27,700,363,65,428,Wednesday
2022,7,27,600,174,40,214,Wednesday
2022,7,27,500,95,36,131,Wednesday
2022,7,27,400,71,42,113,Wednesday
2022,7,27,300,50,53,103,Wednesday
2022,7,27,200,39,61,100,Wednesday
2022,7,27,100,35,35,70,Wednesday
2022,7,26,2400,74,111,185,Tuesday
2022,7,26,2300,111,357,468,Tuesday
2022,7,26,2200,142,510,652,Tuesday
2022,7,26,2100,229,659,888,Tuesday
2022,7,26,2000,323,890,1213,Tuesday
2022,7,26,1900,397,1045,1442,Tuesday
2022,7,26,1800,409,1087,1496,Tuesday
2022,7,26,1700,489,1170,1659,Tuesday
2022,7,26,1600,637,958,1595,Tuesday
2022,7,26,1500,694,898,1592,Tuesday
2022,7,26,1400,825,777,1602,Tuesday
2022,7,26,1300,938,665,1603,Tuesday
2022,7,26,1200,1081,556,1637,Tuesday
2022,7,26,1100,1165,382,1547,Tuesday
2022,7,26,1000,1021,319,1340,Tuesday
2022,7,26,900,814,299,1113,Tuesday
2022,7,26,800,543,104,647,Tuesday
2022,7,26,700,324,63,387,Tuesday
2022,7,26,600,162,47,209,Tuesday
2022,7,26,500,112,35,147,Tuesday
2022,7,26,400,50,45,95,Tuesday
2022,7,26,300,44,55,99,Tuesday
2022,7,26,200,33,71,104,Tuesday
2022,7,26,100,46,36,82,Tuesday
2022,7,25,2400,56,196,252,Monday
2022,7,25,2300,79,278,357,Monday
2022,7,25,2200,125,448,573,Monday
2022,7,25,2100,215,657,872,Monday
2022,7,25,2000,301,851,1152,Monday
2022,7,25,1900,386,1102,1488,Monday
2022,7,25,1800,411,1187,1598,Monday
2022,7,25,1700,540,1211,1751,Monday
2022,7,25,1600,697,1126,1823,Monday
2022,7,25,1500,844,946,1790,Monday
2022,7,25,1400,941,795,1736,Monday
2022,7,25,1300,1184,776,1960,Monday
2022,7,25,1200,1270,577,1847,Monday
2022,7,25,1100,1271,390,1661,Monday
2022,7,25,1000,1045,292,1337,Monday
2022,7,25,900,800,219,1019,Monday
2022,7,25,800,533,93,626,Monday
2022,7,25,700,341,68,409,Monday
2022,7,25,600,176,30,206,Monday
2022,7,25,500,60,25,85,Monday
2022,7,25,400,53,26,79,Monday
2022,7,25,300,32,36,68,Monday
2022,7,25,200,24,64,88,Monday
2022,7,25,100,40,50,90,Monday
2022,7,24,2400,55,162,217,Sunday
2022,7,24,2300,87,316,403,Sunday
2022,7,24,2200,133,627,760,Sunday
2022,7,24,2100,216,1003,1219,Sunday
2022,7,24,2000,329,1404,1733,Sunday
2022,7,24,1900,385,2018,2403,Sunday
2022,7,24,1800,559,2101,2660,Sunday
2022,7,24,1700,612,1813,2425,Sunday
2022,7,24,1600,848,1474,2322,Sunday
2022,7,24,1500,1029,1125,2154,Sunday
2022,7,24,1400,1113,969,2082,Sunday
2022,7,24,1300,1222,1104,2326,Sunday
2022,7,24,1200,1322,812,2134,Sunday
2022,7,24,1100,1307,485,1792,Sunday
2022,7,24,1000,1192,302,1494,Sunday
2022,7,24,900,913,207,1120,Sunday
2022,7,24,800,571,97,668,Sunday
2022,7,24,700,304,41,345,Sunday
2022,7,24,600,133,28,161,Sunday
2022,7,24,500,100,25,125,Sunday
2022,7,24,400,63,28,91,Sunday
2022,7,24,300,37,35,72,Sunday
2022,7,24,200,35,67,102,Sunday
2022,7,24,100,42,101,143,Sunday
2022,7,23,2400,69,208,277,Saturday
2022,7,23,2300,90,300,390,Saturday
2022,7,23,2200,139,516,655,Saturday
2022,7,23,2100,190,730,920,Saturday
2022,7,23,2000,278,1035,1313,Saturday
2022,7,23,1900,323,1309,1632,Saturday
2022,7,23,1800,448,1258,1706,Saturday
2022,7,23,1700,581,1285,1866,Saturday
2022,7,23,1600,745,1154,1899,Saturday
2022,7,23,1500,905,985,1890,Saturday
2022,7,23,1400,1091,879,1970,Saturday
2022,7,23,1300,1234,722,1956,Saturday
2022,7,23,1200,1431,553,1984,Saturday
2022,7,23,1100,1461,459,1920,Saturday
2022,7,23,1000,1344,288,1632,Saturday
2022,7,23,900,1098,176,1274,Saturday
2022,7,23,800,700,117,817,Saturday
2022,7,23,700,395,70,465,Saturday
2022,7,23,600,161,38,199,Saturday
2022,7,23,500,126,34,160,Saturday
2022,7,23,400,53,40,93,Saturday
2022,7,23,300,50,46,96,Saturday
2022,7,23,200,33,68,101,Saturday
2022,7,23,100,56,103,159,Saturday
2022,7,22,2400,70,154,224,Friday
2022,7,22,2300,135,238,373,Friday
2022,7,22,2200,233,415,648,Friday
2022,7,22,2100,397,581,978,Friday
2022,7,22,2000,621,806,1427,Friday
2022,7,22,1900,711,922,1633,Friday
2022,7,22,1800,929,1116,2045,Friday
2022,7,22,1700,938,1160,2098,Friday
2022,7,22,1600,966,1149,2115,Friday
2022,7,22,1500,1082,1002,2084,Friday
2022,7,22,1400,1097,915,2012,Friday
2022,7,22,1300,1194,883,2077,Friday
2022,7,22,1200,1345,639,1984,Friday
2022,7,22,1100,1317,447,1764,Friday
2022,7,22,1000,1197,347,1544,Friday
2022,7,22,900,950,267,1217,Friday
2022,7,22,800,662,105,767,Friday
2022,7,22,700,351,56,407,Friday
2022,7,22,600,169,30,199,Friday
2022,7,22,500,102,27,129,Friday
2022,7,22,400,69,31,100,Friday
2022,7,22,300,39,50,89,Friday
2022,7,22,200,35,49,84,Friday
2022,7,22,100,53,50,103,Friday
2022,7,21,2400,84,186,270,Thursday
2022,7,21,2300,121,246,367,Thursday
2022,7,21,2200,194,472,666,Thursday
2022,7,21,2100,344,673,1017,Thursday
2022,7,21,2000,533,808,1341,Thursday
2022,7,21,1900,607,1050,1657,Thursday
2022,7,21,1800,666,1119,1785,Thursday
2022,7,21,1700,775,1085,1860,Thursday
2022,7,21,1600,759,1021,1780,Thursday
2022,7,21,1500,898,897,1795,Thursday
2022,7,21,1400,963,792,1755,Thursday
2022,7,21,1300,1386,760,2146,Thursday
2022,7,21,1200,1162,558,1720,Thursday
2022,7,21,1100,1017,442,1459,Thursday
2022,7,21,1000,998,325,1323,Thursday
2022,7,21,900,848,268,1116,Thursday
2022,7,21,800,600,125,725,Thursday
2022,7,21,700,372,63,435,Thursday
2022,7,21,600,182,41,223,Thursday
2022,7,21,500,122,23,145,Thursday
2022,7,21,400,77,22,99,Thursday
2022,7,21,300,39,41,80,Thursday
2022,7,21,200,32,52,84,Thursday
2022,7,21,100,55,43,98,Thursday
2022,7,20,2400,65,162,227,Wednesday
2022,7,20,2300,113,246,359,Wednesday
2022,7,20,2200,168,414,582,Wednesday
2022,7,20,2100,246,625,871,Wednesday
2022,7,20,2000,380,826,1206,Wednesday
2022,7,20,1900,441,1032,1473,Wednesday
2022,7,20,1800,485,1113,1598,Wednesday
2022,7,20,1700,545,1153,1698,Wednesday
2022,7,20,1600,653,1037,1690,Wednesday
2022,7,20,1500,695,802,1497,Wednesday
2022,7,20,1400,806,752,1558,Wednesday
2022,7,20,1300,1054,612,1666,Wednesday
2022,7,20,1200,1111,534,1645,Wednesday
2022,7,20,1100,1167,412,1579,Wednesday
2022,7,20,1000,1038,316,1354,Wednesday
2022,7,20,900,799,245,1044,Wednesday
2022,7,20,800,576,98,674,Wednesday
2022,7,20,700,364,62,426,Wednesday
2022,7,20,600,153,37,190,Wednesday
2022,7,20,500,104,33,137,Wednesday
2022,7,20,400,58,28,86,Wednesday
2022,7,20,300,38,36,74,Wednesday
2022,7,20,200,40,49,89,Wednesday
2022,7,20,100,48,30,78,Wednesday
2022,7,19,2400,61,147,208,Tuesday
2022,7,19,2300,105,291,396,Tuesday
2022,7,19,2200,131,416,547,Tuesday
2022,7,19,2100,199,600,799,Tuesday
2022,7,19,2000,326,821,1147,Tuesday
2022,7,19,1900,429,983,1412,Tuesday
2022,7,19,1800,436,1216,1652,Tuesday
2022,7,19,1700,535,1027,1562,Tuesday
2022,7,19,1600,628,999,1627,Tuesday
2022,7,19,1500,720,840,1560,Tuesday
2022,7,19,1400,787,741,1528,Tuesday
2022,7,19,1300,937,640,1577,Tuesday
2022,7,19,1200,1158,551,1709,Tuesday
2022,7,19,1100,1186,407,1593,Tuesday
2022,7,19,1000,1038,328,1366,Tuesday
2022,7,19,900,807,291,1098,Tuesday
2022,7,19,800,565,92,657,Tuesday
2022,7,19,700,335,66,401,Tuesday
2022,7,19,600,172,34,206,Tuesday
2022,7,19,500,134,24,158,Tuesday
2022,7,19,400,64,26,90,Tuesday
2022,7,19,300,46,40,86,Tuesday
2022,7,19,200,38,60,98,Tuesday
2022,7,19,100,43,35,78,Tuesday
2022,7,18,2400,61,144,205,Monday
2022,7,18,2300,89,274,363,Monday
2022,7,18,2200,126,389,515,Monday
2022,7,18,2100,221,582,803,Monday
2022,7,18,2000,323,806,1129,Monday
2022,7,18,1900,351,1044,1395,Monday
2022,7,18,1800,468,1041,1509,Monday
2022,7,18,1700,613,1080,1693,Monday
2022,7,18,1600,801,1028,1829,Monday
2022,7,18,1500,929,962,1891,Monday
2022,7,18,1400,1033,789,1822,Monday
2022,7,18,1300,1220,710,1930,Monday
2022,7,18,1200,1305,562,1867,Monday
2022,7,18,1100,1320,400,1720,Monday
2022,7,18,1000,1108,277,1385,Monday
2022,7,18,900,797,202,999,Monday
2022,7,18,800,550,101,651,Monday
2022,7,18,700,342,57,399,Monday
2022,7,18,600,122,23,145,Monday
2022,7,18,500,80,16,96,Monday
2022,7,18,400,39,20,59,Monday
2022,7,18,300,25,28,53,Monday
2022,7,18,200,20,51,71,Monday
2022,7,18,100,34,40,74,Monday
2022,7,17,2400,39,162,201,Sunday
2022,7,17,2300,106,295,401,Sunday
2022,7,17,2200,141,515,656,Sunday
2022,7,17,2100,244,800,1044,Sunday
2022,7,17,2000,315,1241,1556,Sunday
2022,7,17,1900,434,1408,1842,Sunday
2022,7,17,1800,577,1611,2188,Sunday
2022,7,17,1700,644,1491,2135,Sunday
2022,7,17,1600,846,1508,2354,Sunday
2022,7,17,1500,1029,1347,2376,Sunday
2022,7,17,1400,1157,1140,2297,Sunday
2022,7,17,1300,1282,1097,2379,Sunday
2022,7,17,1200,1326,763,2089,Sunday
2022,7,17,1100,1298,552,1850,Sunday
2022,7,17,1000,1017,328,1345,Sunday
2022,7,17,900,813,179,992,Sunday
2022,7,17,800,526,80,606,Sunday
2022,7,17,700,269,41,310,Sunday
2022,7,17,600,123,14,137,Sunday
2022,7,17,500,75,14,89,Sunday
2022,7,17,400,51,21,72,Sunday
2022,7,17,300,33,33,66,Sunday
2022,7,17,200,31,56,87,Sunday
2022,7,17,100,45,81,126,Sunday
2022,7,16,2400,62,150,212,Saturday
2022,7,16,2300,94,278,372,Saturday
2022,7,16,2200,157,422,579,Saturday
2022,7,16,2100,205,711,916,Saturday
2022,7,16,2000,276,1034,1310,Saturday
2022,7,16,1900,334,1228,1562,Saturday
2022,7,16,1800,468,1316,1784,Saturday
2022,7,16,1700,563,1339,1902,Saturday
2022,7,16,1600,701,1249,1950,Saturday
2022,7,16,1500,902,1009,1911,Saturday
2022,7,16,1400,1072,916,1988,Saturday
2022,7,16,1300,1107,724,1831,Saturday
2022,7,16,1200,1473,642,2115,Saturday
2022,7,16,1100,1478,460,1938,Saturday
2022,7,16,1000,1320,300,1620,Saturday
2022,7,16,900,1045,235,1280,Saturday
2022,7,16,800,688,137,825,Saturday
2022,7,16,700,395,66,461,Saturday
2022,7,16,600,168,43,211,Saturday
2022,7,16,500,129,38,167,Saturday
2022,7,16,400,63,45,108,Saturday
2022,7,16,300,65,63,128,Saturday
2022,7,16,200,56,60,116,Saturday
2022,7,16,100,52,72,124,Saturday
2022,7,15,2400,89,241,330,Friday
2022,7,15,2300,156,290,446,Friday
2022,7,15,2200,237,457,694,Friday
2022,7,15,2100,399,616,1015,Friday
2022,7,15,2000,612,845,1457,Friday
2022,7,15,1900,752,1049,1801,Friday
2022,7,15,1800,766,1214,1980,Friday
2022,7,15,1700,932,1284,2216,Friday
2022,7,15,1600,1043,1154,2197,Friday
2022,7,15,1500,1056,946,2002,Friday
2022,7,15,1400,1174,862,2036,Friday
2022,7,15,1300,1284,826,2110,Friday
2022,7,15,1200,1299,696,1995,Friday
2022,7,15,1100,1336,515,1851,Friday
2022,7,15,1000,1169,351,1520,Friday
2022,7,15,900,921,285,1206,Friday
2022,7,15,800,599,107,706,Friday
2022,7,15,700,371,69,440,Friday
2022,7,15,600,171,32,203,Friday
2022,7,15,500,114,32,146,Friday
2022,7,15,400,73,33,106,Friday
2022,7,15,300,39,50,89,Friday
2022,7,15,200,41,66,107,Friday
2022,7,15,100,54,63,117,Friday
2022,7,14,2400,72,164,236,Thursday
2022,7,14,2300,154,276,430,Thursday
2022,7,14,2200,211,438,649,Thursday
2022,7,14,2100,332,601,933,Thursday
2022,7,14,2000,502,766,1268,Thursday
2022,7,14,1900,570,1058,1628,Thursday
2022,7,14,1800,585,1215,1800,Thursday
2022,7,14,1700,639,938,1577,Thursday
2022,7,14,1600,716,1003,1719,Thursday
2022,7,14,1500,854,966,1820,Thursday
2022,7,14,1400,941,829,1770,Thursday
2022,7,14,1300,1068,686,1754,Thursday
2022,7,14,1200,1267,589,1856,Thursday
2022,7,14,1100,1213,471,1684,Thursday
2022,7,14,1000,1076,328,1404,Thursday
2022,7,14,900,831,292,1123,Thursday
2022,7,14,800,557,89,646,Thursday
2022,7,14,700,303,74,377,Thursday
2022,7,14,600,175,32,207,Thursday
2022,7,14,500,105,48,153,Thursday
2022,7,14,400,60,33,93,Thursday
2022,7,14,300,36,51,87,Thursday
2022,7,14,200,35,52,87,Thursday
2022,7,14,100,49,36,85,Thursday
2022,7,13,2400,85,93,178,Wednesday
2022,7,13,2300,134,303,437,Wednesday
2022,7,13,2200,149,432,581,Wednesday
2022,7,13,2100,234,594,828,Wednesday
2022,7,13,2000,344,774,1118,Wednesday
2022,7,13,1900,428,914,1342,Wednesday
2022,7,13,1800,437,997,1434,Wednesday
2022,7,13,1700,534,1040,1574,Wednesday
2022,7,13,1600,651,1014,1665,Wednesday
2022,7,13,1500,713,875,1588,Wednesday
2022,7,13,1400,796,805,1601,Wednesday
2022,7,13,1300,979,688,1667,Wednesday
2022,7,13,1200,1140,500,1640,Wednesday
2022,7,13,1100,1086,422,1508,Wednesday
2022,7,13,1000,959,313,1272,Wednesday
2022,7,13,900,786,234,1020,Wednesday
2022,7,13,800,541,83,624,Wednesday
2022,7,13,700,320,67,387,Wednesday
2022,7,13,600,170,44,214,Wednesday
2022,7,13,500,105,33,138,Wednesday
2022,7,13,400,62,33,95,Wednesday
2022,7,13,300,45,43,88,Wednesday
2022,7,13,200,35,49,84,Wednesday
2022,7,13,100,43,33,76,Wednesday
2022,7,12,2400,73,136,209,Tuesday
2022,7,12,2300,108,315,423,Tuesday
2022,7,12,2200,140,441,581,Tuesday
2022,7,12,2100,196,655,851,Tuesday
2022,7,12,2000,353,848,1201,Tuesday
2022,7,12,1900,382,1004,1386,Tuesday
2022,7,12,1800,399,1076,1475,Tuesday
2022,7,12,1700,490,1102,1592,Tuesday
2022,7,12,1600,594,884,1478,Tuesday
2022,7,12,1500,677,844,1521,Tuesday
2022,7,12,1400,791,706,1497,Tuesday
2022,7,12,1300,899,572,1471,Tuesday
2022,7,12,1200,1089,487,1576,Tuesday
2022,7,12,1100,1100,437,1537,Tuesday
2022,7,12,1000,994,340,1334,Tuesday
2022,7,12,900,749,295,1044,Tuesday
2022,7,12,800,529,105,634,Tuesday
2022,7,12,700,331,76,407,Tuesday
2022,7,12,600,150,55,205,Tuesday
2022,7,12,500,110,42,152,Tuesday
2022,7,12,400,53,44,97,Tuesday
2022,7,12,300,36,47,83,Tuesday
2022,7,12,200,29,47,76,Tuesday
2022,7,12,100,40,52,92,Tuesday
2022,7,11,2400,62,119,181,Monday
2022,7,11,2300,106,293,399,Monday
2022,7,11,2200,134,452,586,Monday
2022,7,11,2100,187,698,885,Monday
2022,7,11,2000,319,935,1254,Monday
2022,7,11,1900,354,1105,1459,Monday
2022,7,11,1800,455,1311,1766,Monday
2022,7,11,1700,622,1089,1711,Monday
2022,7,11,1600,723,1033,1756,Monday
2022,7,11,1500,875,919,1794,Monday
2022,7,11,1400,1091,800,1891,Monday
2022,7,11,1300,1114,660,1774,Monday
2022,7,11,1200,1166,595,1761,Monday
2022,7,11,1100,1233,458,1691,Monday
2022,7,11,1000,1109,305,1414,Monday
2022,7,11,900,809,203,1012,Monday
2022,7,11,800,580,115,695,Monday
2022,7,11,700,326,50,376,Monday
2022,7,11,600,142,33,175,Monday
2022,7,11,500,118,21,139,Monday
2022,7,11,400,66,27,93,Monday
2022,7,11,300,39,36,75,Monday
2022,7,11,200,27,49,76,Monday
2022,7,11,100,34,46,80,Monday
2022,7,10,2400,50,170,220,Sunday
2022,7,10,2300,78,280,358,Sunday
2022,7,10,2200,115,459,574,Sunday
2022,7,10,2100,219,796,1015,Sunday
2022,7,10,2000,301,1129,1430,Sunday
2022,7,10,1900,397,1448,1845,Sunday
2022,7,10,1800,451,1558,2009,Sunday
2022,7,10,1700,608,1550,2158,Sunday
2022,7,10,1600,809,1649,2458,Sunday
2022,7,10,1500,986,1393,2379,Sunday
2022,7,10,1400,994,1297,2291,Sunday
2022,7,10,1300,1159,1086,2245,Sunday
2022,7,10,1200,1253,789,2042,Sunday
2022,7,10,1100,1202,528,1730,Sunday
2022,7,10,1000,1030,316,1346,Sunday
2022,7,10,900,753,142,895,Sunday
2022,7,10,800,488,89,577,Sunday
2022,7,10,700,244,49,293,Sunday
2022,7,10,600,125,23,148,Sunday
2022,7,10,500,84,20,104,Sunday
2022,7,10,400,43,15,58,Sunday
2022,7,10,300,25,19,44,Sunday
2022,7,10,200,31,51,82,Sunday
2022,7,10,100,33,75,108,Sunday
2022,7,9,2400,65,137,202,Saturday
2022,7,9,2300,110,292,402,Saturday
2022,7,9,2200,126,394,520,Saturday
2022,7,9,2100,167,673,840,Saturday
2022,7,9,2000,222,917,1139,Saturday
2022,7,9,1900,304,1139,1443,Saturday
2022,7,9,1800,386,1186,1572,Saturday
2022,7,9,1700,536,1266,1802,Saturday
2022,7,9,1600,682,1131,1813,Saturday
2022,7,9,1500,832,962,1794,Saturday
2022,7,9,1400,966,799,1765,Saturday
2022,7,9,1300,1177,725,1902,Saturday
2022,7,9,1200,1253,654,1907,Saturday
2022,7,9,1100,1346,399,1745,Saturday
2022,7,9,1000,1192,314,1506,Saturday
2022,7,9,900,857,212,1069,Saturday
2022,7,9,800,600,108,708,Saturday
2022,7,9,700,321,66,387,Saturday
2022,7,9,600,155,37,192,Saturday
2022,7,9,500,102,46,148,Saturday
2022,7,9,400,57,33,90,Saturday
2022,7,9,300,27,46,73,Saturday
2022,7,9,200,45,69,114,Saturday
2022,7,9,100,51,99,150,Saturday
2022,7,8,2400,91,196,287,Friday
2022,7,8,2300,131,264,395,Friday
2022,7,8,2200,186,368,554,Friday
2022,7,8,2100,340,607,947,Friday
2022,7,8,2000,573,772,1345,Friday
2022,7,8,1900,628,970,1598,Friday
2022,7,8,1800,709,1188,1897,Friday
2022,7,8,1700,746,1199,1945,Friday
2022,7,8,1600,924,1121,2045,Friday
2022,7,8,1500,1025,986,2011,Friday
2022,7,8,1400,999,891,1890,Friday
2022,7,8,1300,1069,821,1890,Friday
2022,7,8,1200,1316,691,2007,Friday
2022,7,8,1100,1140,488,1628,Friday
2022,7,8,1000,1020,367,1387,Friday
2022,7,8,900,815,321,1136,Friday
2022,7,8,800,561,89,650,Friday
2022,7,8,700,327,70,397,Friday
2022,7,8,600,149,42,191,Friday
2022,7,8,500,128,36,164,Friday
2022,7,8,400,64,30,94,Friday
2022,7,8,300,31,33,64,Friday
2022,7,8,200,36,76,112,Friday
2022,7,8,100,53,47,100,Friday
2022,7,7,2400,84,234,318,Thursday
2022,7,7,2300,117,300,417,Thursday
2022,7,7,2200,175,452,627,Thursday
2022,7,7,2100,286,652,938,Thursday
2022,7,7,2000,435,845,1280,Thursday
2022,7,7,1900,482,1131,1613,Thursday
2022,7,7,1800,518,1106,1624,Thursday
2022,7,7,1700,624,1077,1701,Thursday
2022,7,7,1600,727,1089,1816,Thursday
2022,7,7,1500,815,872,1687,Thursday
2022,7,7,1400,947,902,1849,Thursday
2022,7,7,1300,1060,830,1890,Thursday
2022,7,7,1200,1048,592,1640,Thursday
2022,7,7,1100,1177,497,1674,Thursday
2022,7,7,1000,1048,395,1443,Thursday
2022,7,7,900,732,285,1017,Thursday
2022,7,7,800,578,90,668,Thursday
2022,7,7,700,293,60,353,Thursday
2022,7,7,600,179,36,215,Thursday
2022,7,7,500,119,35,154,Thursday
2022,7,7,400,70,30,100,Thursday
2022,7,7,300,31,39,70,Thursday
2022,7,7,200,42,70,112,Thursday
2022,7,7,100,50,66,116,Thursday
2022,7,6,2400,62,357,419,Wednesday
2022,7,6,2300,107,288,395,Wednesday
2022,7,6,2200,158,310,468,Wednesday
2022,7,6,2100,231,687,918,Wednesday
2022,7,6,2000,324,832,1156,Wednesday
2022,7,6,1900,379,1142,1521,Wednesday
2022,7,6,1800,417,1146,1563,Wednesday
2022,7,6,1700,519,1148,1667,Wednesday
2022,7,6,1600,656,1057,1713,Wednesday
2022,7,6,1500,767,915,1682,Wednesday
2022,7,6,1400,1048,761,1809,Wednesday
2022,7,6,1300,846,645,1491,Wednesday
2022,7,6,1200,1025,520,1545,Wednesday
2022,7,6,1100,1094,409,1503,Wednesday
2022,7,6,1000,1077,330,1407,Wednesday
2022,7,6,900,813,254,1067,Wednesday
2022,7,6,800,610,110,720,Wednesday
2022,7,6,700,365,70,435,Wednesday
2022,7,6,600,157,30,187,Wednesday
2022,7,6,500,144,38,182,Wednesday
2022,7,6,400,92,30,122,Wednesday
2022,7,6,300,23,36,59,Wednesday
2022,7,6,200,29,60,89,Wednesday
2022,7,6,100,53,42,95,Wednesday
2022,7,5,2400,76,232,308,Tuesday
2022,7,5,2300,102,239,341,Tuesday
2022,7,5,2200,123,461,584,Tuesday
2022,7,5,2100,247,634,881,Tuesday
2022,7,5,2000,317,830,1147,Tuesday
2022,7,5,1900,351,1037,1388,Tuesday
2022,7,5,1800,435,1181,1616,Tuesday
2022,7,5,1700,537,1117,1654,Tuesday
2022,7,5,1600,591,1033,1624,Tuesday
2022,7,5,1500,714,831,1545,Tuesday
2022,7,5,1400,814,749,1563,Tuesday
2022,7,5,1300,943,655,1598,Tuesday
2022,7,5,1200,1066,526,1592,Tuesday
2022,7,5,1100,1134,402,1536,Tuesday
2022,7,5,1000,952,331,1283,Tuesday
2022,7,5,900,795,275,1070,Tuesday
2022,7,5,800,531,82,613,Tuesday
2022,7,5,700,279,70,349,Tuesday
2022,7,5,600,107,32,139,Tuesday
2022,7,5,500,83,31,114,Tuesday
2022,7,5,400,28,22,50,Tuesday
2022,7,5,300,26,37,63,Tuesday
2022,7,5,200,24,49,73,Tuesday
2022,7,5,100,21,29,50,Tuesday
2022,7,4,2400,39,159,198,Monday
2022,7,4,2300,86,529,615,Monday
2022,7,4,2200,114,742,856,Monday
2022,7,4,2100,223,245,468,Monday
2022,7,4,2000,266,567,833,Monday
2022,7,4,1900,330,1364,1694,Monday
2022,7,4,1800,429,1527,1956,Monday
2022,7,4,1700,539,1344,1883,Monday
2022,7,4,1600,661,1314,1975,Monday
2022,7,4,1500,842,1058,1900,Monday
2022,7,4,1400,1012,1131,2143,Monday
2022,7,4,1300,1035,960,1995,Monday
2022,7,4,1200,1048,689,1737,Monday
2022,7,4,1100,1151,481,1632,Monday
2022,7,4,1000,1089,345,1434,Monday
2022,7,4,900,726,204,930,Monday
2022,7,4,800,458,132,590,Monday
2022,7,4,700,270,81,351,Monday
2022,7,4,600,139,27,166,Monday
2022,7,4,500,65,16,81,Monday
2022,7,4,400,31,28,59,Monday
2022,7,4,300,19,38,57,Monday
2022,7,4,200,13,134,147,Monday
2022,7,4,100,23,402,425,Monday
2022,7,3,2400,41,508,549,Sunday
2022,7,3,2300,88,489,577,Sunday
2022,7,3,2200,125,356,481,Sunday
2022,7,3,2100,193,636,829,Sunday
2022,7,3,2000,269,1246,1515,Sunday
2022,7,3,1900,325,1766,2091,Sunday
2022,7,3,1800,407,2058,2465,Sunday
2022,7,3,1700,580,2104,2684,Sunday
2022,7,3,1600,764,1914,2678,Sunday
2022,7,3,1500,929,1921,2850,Sunday
2022,7,3,1400,1006,1699,2705,Sunday
2022,7,3,1300,1150,1510,2660,Sunday
2022,7,3,1200,1276,1075,2351,Sunday
2022,7,3,1100,1225,645,1870,Sunday
2022,7,3,1000,1024,363,1387,Sunday
2022,7,3,900,776,197,973,Sunday
2022,7,3,800,529,107,636,Sunday
2022,7,3,700,293,42,335,Sunday
2022,7,3,600,146,19,165,Sunday
2022,7,3,500,88,16,104,Sunday
2022,7,3,400,45,20,65,Sunday
2022,7,3,300,23,27,50,Sunday
2022,7,3,200,35,50,85,Sunday
2022,7,3,100,19,93,112,Sunday
2022,7,2,2400,61,205,266,Saturday
2022,7,2,2300,96,337,433,Saturday
2022,7,2,2200,145,537,682,Saturday
2022,7,2,2100,175,1116,1291,Saturday
2022,7,2,2000,226,1292,1518,Saturday
2022,7,2,1900,321,1275,1596,Saturday
2022,7,2,1800,454,1131,1585,Saturday
2022,7,2,1700,563,936,1499,Saturday
2022,7,2,1600,684,895,1579,Saturday
2022,7,2,1500,870,681,1551,Saturday
2022,7,2,1400,1006,726,1732,Saturday
2022,7,2,1300,1180,636,1816,Saturday
2022,7,2,1200,1410,481,1891,Saturday
2022,7,2,1100,1342,330,1672,Saturday
2022,7,2,1000,1079,229,1308,Saturday
2022,7,2,900,793,153,946,Saturday
2022,7,2,800,581,99,680,Saturday
2022,7,2,700,319,41,360,Saturday
2022,7,2,600,143,27,170,Saturday
2022,7,2,500,95,28,123,Saturday
2022,7,2,400,63,21,84,Saturday
2022,7,2,300,18,31,49,Saturday
2022,7,2,200,28,52,80,Saturday
2022,7,2,100,38,60,98,Saturday
2022,7,1,2400,96,150,246,Friday
2022,7,1,2300,81,251,332,Friday
2022,7,1,2200,140,464,604,Friday
2022,7,1,2100,205,547,752,Friday
2022,7,1,2000,293,844,1137,Friday
2022,7,1,1900,349,1037,1386,Friday
2022,7,1,1800,523,1048,1571,Friday
2022,7,1,1700,698,998,1696,Friday
2022,7,1,1600,951,961,1912,Friday
2022,7,1,1500,1638,876,2514,Friday
2022,7,1,1400,1470,762,2232,Friday
2022,7,1,1300,1521,696,2217,Friday
2022,7,1,1200,1765,583,2348,Friday
2022,7,1,1100,1438,390,1828,Friday
2022,7,1,1000,1576,321,1897,Friday
2022,7,1,900,1441,248,1689,Friday
2022,7,1,800,943,146,1089,Friday
2022,7,1,700,554,89,643,Friday
2022,7,1,600,260,41,301,Friday
2022,7,1,500,165,43,208,Friday
2022,7,1,400,92,44,136,Friday
2022,7,1,300,49,61,110,Friday
2022,7,1,200,78,59,137,Friday
2022,7,1,100,86,92,178,Friday
2022,6,30,2400,116,202,318,Thursday
2022,6,30,2300,278,329,607,Thursday
2022,6,30,2200,483,472,955,Thursday
2022,6,30,2100,787,560,1347,Thursday
2022,6,30,2000,1086,797,1883,Thursday
2022,6,30,1900,1348,908,2256,Thursday
2022,6,30,1800,1342,1078,2420,Thursday
2022,6,30,1700,1383,997,2380,Thursday
2022,6,30,1600,1386,880,2266,Thursday
2022,6,30,1500,1405,789,2194,Thursday
2022,6,30,1400,1385,652,2037,Thursday
2022,6,30,1300,1444,577,2021,Thursday
2022,6,30,1200,1511,536,2047,Thursday
2022,6,30,1100,1631,428,2059,Thursday
2022,6,30,1000,1366,354,1720,Thursday
2022,6,30,900,953,296,1249,Thursday
2022,6,30,800,702,112,814,Thursday
2022,6,30,700,411,62,473,Thursday
2022,6,30,600,182,41,223,Thursday
2022,6,30,500,118,32,150,Thursday
2022,6,30,400,68,31,99,Thursday
2022,6,30,300,33,58,91,Thursday
2022,6,30,200,53,41,94,Thursday
2022,6,30,100,56,37,93,Thursday
2022,6,29,2400,76,154,230,Wednesday
2022,6,29,2300,138,200,338,Wednesday
2022,6,29,2200,219,329,548,Wednesday
2022,6,29,2100,334,455,789,Wednesday
2022,6,29,2000,515,652,1167,Wednesday
2022,6,29,1900,603,762,1365,Wednesday
2022,6,29,1800,650,820,1470,Wednesday
2022,6,29,1700,650,816,1466,Wednesday
2022,6,29,1600,747,767,1514,Wednesday
2022,6,29,1500,811,718,1529,Wednesday
2022,6,29,1400,834,611,1445,Wednesday
2022,6,29,1300,917,557,1474,Wednesday
2022,6,29,1200,1183,475,1658,Wednesday
2022,6,29,1100,1091,389,1480,Wednesday
2022,6,29,1000,923,292,1215,Wednesday
2022,6,29,900,752,291,1043,Wednesday
2022,6,29,800,486,91,577,Wednesday
2022,6,29,700,274,43,317,Wednesday
2022,6,29,600,135,24,159,Wednesday
2022,6,29,500,67,26,93,Wednesday
2022,6,29,400,33,27,60,Wednesday
2022,6,29,300,26,36,62,Wednesday
2022,6,29,200,25,46,71,Wednesday
2022,6,29,100,37,38,75,Wednesday
2022,6,28,2400,70,95,165,Tuesday
2022,6,28,2300,72,264,336,Tuesday
2022,6,28,2200,121,296,417,Tuesday
2022,6,28,2100,251,382,633,Tuesday
2022,6,28,2000,309,694,1003,Tuesday
2022,6,28,1900,397,823,1220,Tuesday
2022,6,28,1800,462,805,1267,Tuesday
2022,6,28,1700,511,871,1382,Tuesday
2022,6,28,1600,520,802,1322,Tuesday
2022,6,28,1500,547,707,1254,Tuesday
2022,6,28,1400,668,636,1304,Tuesday
2022,6,28,1300,715,562,1277,Tuesday
2022,6,28,1200,774,472,1246,Tuesday
2022,6,28,1100,866,385,1251,Tuesday
2022,6,28,1000,786,281,1067,Tuesday
2022,6,28,900,653,276,929,Tuesday
2022,6,28,800,462,87,549,Tuesday
2022,6,28,700,266,52,318,Tuesday
2022,6,28,600,131,31,162,Tuesday
2022,6,28,500,82,19,101,Tuesday
2022,6,28,400,36,26,62,Tuesday
2022,6,28,300,17,44,61,Tuesday
2022,6,28,200,25,55,80,Tuesday
2022,6,28,100,27,46,73,Tuesday
2022,6,27,2400,45,154,199,Monday
2022,6,27,2300,100,259,359,Monday
2022,6,27,2200,149,350,499,Monday
2022,6,27,2100,220,579,799,Monday
2022,6,27,2000,325,786,1111,Monday
2022,6,27,1900,342,996,1338,Monday
2022,6,27,1800,383,979,1362,Monday
2022,6,27,1700,479,952,1431,Monday
2022,6,27,1600,573,872,1445,Monday
2022,6,27,1500,675,764,1439,Monday
2022,6,27,1400,726,671,1397,Monday
2022,6,27,1300,889,627,1516,Monday
2022,6,27,1200,1032,536,1568,Monday
2022,6,27,1100,1062,351,1413,Monday
2022,6,27,1000,911,259,1170,Monday
2022,6,27,900,757,248,1005,Monday
2022,6,27,800,507,104,611,Monday
2022,6,27,700,299,54,353,Monday
2022,6,27,600,136,19,155,Monday
2022,6,27,500,99,19,118,Monday
2022,6,27,400,59,25,84,Monday
2022,6,27,300,34,32,66,Monday
2022,6,27,200,23,48,71,Monday
2022,6,27,100,31,59,90,Monday
2022,6,26,2400,52,157,209,Sunday
2022,6,26,2300,78,297,375,Sunday
2022,6,26,2200,128,550,678,Sunday
2022,6,26,2100,202,828,1030,Sunday
2022,6,26,2000,288,1144,1432,Sunday
2022,6,26,1900,350,1420,1770,Sunday
2022,6,26,1800,428,1595,2023,Sunday
2022,6,26,1700,582,1347,1929,Sunday
2022,6,26,1600,686,1184,1870,Sunday
2022,6,26,1500,894,1114,2008,Sunday
2022,6,26,1400,955,1028,1983,Sunday
2022,6,26,1300,988,945,1933,Sunday
2022,6,26,1200,1153,727,1880,Sunday
2022,6,26,1100,1057,478,1535,Sunday
2022,6,26,1000,977,275,1252,Sunday
2022,6,26,900,767,191,958,Sunday
2022,6,26,800,513,115,628,Sunday
2022,6,26,700,270,39,309,Sunday
2022,6,26,600,122,28,150,Sunday
2022,6,26,500,109,20,129,Sunday
2022,6,26,400,75,17,92,Sunday
2022,6,26,300,24,32,56,Sunday
2022,6,26,200,41,44,85,Sunday
2022,6,26,100,31,89,120,Sunday
2022,6,25,2400,50,136,186,Saturday
2022,6,25,2300,98,248,346,Saturday
2022,6,25,2200,149,392,541,Saturday
2022,6,25,2100,179,562,741,Saturday
2022,6,25,2000,245,904,1149,Saturday
2022,6,25,1900,353,1043,1396,Saturday
2022,6,25,1800,404,1118,1522,Saturday
2022,6,25,1700,488,1087,1575,Saturday
2022,6,25,1600,675,917,1592,Saturday
2022,6,25,1500,812,823,1635,Saturday
2022,6,25,1400,1010,700,1710,Saturday
2022,6,25,1300,1217,602,1819,Saturday
2022,6,25,1200,1145,526,1671,Saturday
2022,6,25,1100,1202,390,1592,Saturday
2022,6,25,1000,1152,261,1413,Saturday
2022,6,25,900,866,187,1053,Saturday
2022,6,25,800,603,104,707,Saturday
2022,6,25,700,307,88,395,Saturday
2022,6,25,600,146,25,171,Saturday
2022,6,25,500,98,37,135,Saturday
2022,6,25,400,62,43,105,Saturday
2022,6,25,300,31,46,77,Saturday
2022,6,25,200,31,46,77,Saturday
2022,6,25,100,44,100,144,Saturday
2022,6,24,2400,66,143,209,Friday
2022,6,24,2300,135,189,324,Friday
2022,6,24,2200,208,305,513,Friday
2022,6,24,2100,370,402,772,Friday
2022,6,24,2000,607,581,1188,Friday
2022,6,24,1900,744,747,1491,Friday
2022,6,24,1800,795,978,1773,Friday
2022,6,24,1700,833,891,1724,Friday
2022,6,24,1600,925,835,1760,Friday
2022,6,24,1500,994,715,1709,Friday
2022,6,24,1400,940,652,1592,Friday
2022,6,24,1300,1044,540,1584,Friday
2022,6,24,1200,1183,549,1732,Friday
2022,6,24,1100,1051,419,1470,Friday
2022,6,24,1000,922,299,1221,Friday
2022,6,24,900,669,195,864,Friday
2022,6,24,800,407,89,496,Friday
2022,6,24,700,213,36,249,Friday
2022,6,24,600,99,38,137,Friday
2022,6,24,500,50,34,84,Friday
2022,6,24,400,28,33,61,Friday
2022,6,24,300,27,41,68,Friday
2022,6,24,200,30,49,79,Friday
2022,6,24,100,43,34,77,Friday
2022,6,23,2400,59,118,177,Thursday
2022,6,23,2300,115,167,282,Thursday
2022,6,23,2200,169,279,448,Thursday
2022,6,23,2100,322,371,693,Thursday
2022,6,23,2000,454,582,1036,Thursday
2022,6,23,1900,451,646,1097,Thursday
2022,6,23,1800,481,850,1331,Thursday
2022,6,23,1700,559,911,1470,Thursday
2022,6,23,1600,617,721,1338,Thursday
2022,6,23,1500,657,721,1378,Thursday
2022,6,23,1400,649,616,1265,Thursday
2022,6,23,1300,750,644,1394,Thursday
2022,6,23,1200,872,428,1300,Thursday
2022,6,23,1100,1013,313,1326,Thursday
2022,6,23,1000,865,275,1140,Thursday
2022,6,23,900,635,247,882,Thursday
2022,6,23,800,397,69,466,Thursday
2022,6,23,700,225,55,280,Thursday
2022,6,23,600,94,31,125,Thursday
2022,6,23,500,63,30,93,Thursday
2022,6,23,400,30,25,55,Thursday
2022,6,23,300,18,32,50,Thursday
2022,6,23,200,36,37,73,Thursday
2022,6,23,100,29,34,63,Thursday
2022,6,22,2400,69,174,243,Wednesday
2022,6,22,2300,96,193,289,Wednesday
2022,6,22,2200,130,338,468,Wednesday
2022,6,22,2100,212,407,619,Wednesday
2022,6,22,2000,328,536,864,Wednesday
2022,6,22,1900,318,746,1064,Wednesday
2022,6,22,1800,435,873,1308,Wednesday
2022,6,22,1700,426,802,1228,Wednesday
2022,6,22,1600,479,835,1314,Wednesday
2022,6,22,1500,560,670,1230,Wednesday
2022,6,22,1400,602,612,1214,Wednesday
2022,6,22,1300,689,559,1248,Wednesday
2022,6,22,1200,870,498,1368,Wednesday
2022,6,22,1100,957,393,1350,Wednesday
2022,6,22,1000,840,239,1079,Wednesday
2022,6,22,900,611,245,856,Wednesday
2022,6,22,800,429,73,502,Wednesday
2022,6,22,700,171,51,222,Wednesday
2022,6,22,600,96,25,121,Wednesday
2022,6,22,500,59,32,91,Wednesday
2022,6,22,400,29,29,58,Wednesday
2022,6,22,300,20,38,58,Wednesday
2022,6,22,200,39,35,74,Wednesday
2022,6,22,100,38,41,79,Wednesday
2022,6,21,2400,56,125,181,Tuesday
2022,6,21,2300,101,139,240,Tuesday
2022,6,21,2200,110,307,417,Tuesday
2022,6,21,2100,181,434,615,Tuesday
2022,6,21,2000,256,604,860,Tuesday
2022,6,21,1900,276,780,1056,Tuesday
2022,6,21,1800,339,855,1194,Tuesday
2022,6,21,1700,431,885,1316,Tuesday
2022,6,21,1600,489,839,1328,Tuesday
2022,6,21,1500,577,782,1359,Tuesday
2022,6,21,1400,623,598,1221,Tuesday
2022,6,21,1300,717,589,1306,Tuesday
2022,6,21,1200,841,494,1335,Tuesday
2022,6,21,1100,972,326,1298,Tuesday
2022,6,21,1000,884,282,1166,Tuesday
2022,6,21,900,683,278,961,Tuesday
2022,6,21,800,483,80,563,Tuesday
2022,6,21,700,256,54,310,Tuesday
2022,6,21,600,100,33,133,Tuesday
2022,6,21,500,81,27,108,Tuesday
2022,6,21,400,43,31,74,Tuesday
2022,6,21,300,18,28,46,Tuesday
2022,6,21,200,32,43,75,Tuesday
2022,6,21,100,26,37,63,Tuesday
2022,6,20,2400,44,126,170,Monday
2022,6,20,2300,80,184,264,Monday
2022,6,20,2200,139,321,460,Monday
2022,6,20,2100,185,455,640,Monday
2022,6,20,2000,228,652,880,Monday
2022,6,20,1900,283,794,1077,Monday
2022,6,20,1800,402,908,1310,Monday
2022,6,20,1700,455,960,1415,Monday
2022,6,20,1600,499,845,1344,Monday
2022,6,20,1500,654,813,1467,Monday
2022,6,20,1400,731,586,1317,Monday
2022,6,20,1300,817,591,1408,Monday
2022,6,20,1200,948,482,1430,Monday
2022,6,20,1100,1026,372,1398,Monday
2022,6,20,1000,862,245,1107,Monday
2022,6,20,900,685,188,873,Monday
2022,6,20,800,473,106,579,Monday
2022,6,20,700,269,40,309,Monday
2022,6,20,600,124,23,147,Monday
2022,6,20,500,62,13,75,Monday
2022,6,20,400,32,12,44,Monday
2022,6,20,300,20,29,49,Monday
2022,6,20,200,20,35,55,Monday
2022,6,20,100,27,31,58,Monday
2022,6,19,2400,39,121,160,Sunday
2022,6,19,2300,73,211,284,Sunday
2022,6,19,2200,126,370,496,Sunday
2022,6,19,2100,200,552,752,Sunday
2022,6,19,2000,247,695,942,Sunday
2022,6,19,1900,304,899,1203,Sunday
2022,6,19,1800,371,1107,1478,Sunday
2022,6,19,1700,452,1234,1686,Sunday
2022,6,19,1600,598,1238,1836,Sunday
2022,6,19,1500,745,1202,1947,Sunday
2022,6,19,1400,740,1120,1860,Sunday
2022,6,19,1300,897,873,1770,Sunday
2022,6,19,1200,886,735,1621,Sunday
2022,6,19,1100,875,392,1267,Sunday
2022,6,19,1000,730,240,970,Sunday
2022,6,19,900,560,154,714,Sunday
2022,6,19,800,311,77,388,Sunday
2022,6,19,700,146,36,182,Sunday
2022,6,19,600,74,17,91,Sunday
2022,6,19,500,50,15,65,Sunday
2022,6,19,400,32,17,49,Sunday
2022,6,19,300,18,23,41,Sunday
2022,6,19,200,29,36,65,Sunday
2022,6,19,100,25,70,95,Sunday
2022,6,18,2400,39,102,141,Saturday
2022,6,18,2300,78,225,303,Saturday
2022,6,18,2200,121,296,417,Saturday
2022,6,18,2100,175,437,612,Saturday
2022,6,18,2000,211,598,809,Saturday
2022,6,18,1900,290,771,1061,Saturday
2022,6,18,1800,371,861,1232,Saturday
2022,6,18,1700,433,854,1287,Saturday
2022,6,18,1600,539,807,1346,Saturday
2022,6,18,1500,634,669,1303,Saturday
2022,6,18,1400,688,573,1261,Saturday
2022,6,18,1300,774,549,1323,Saturday
2022,6,18,1200,899,415,1314,Saturday
2022,6,18,1100,924,303,1227,Saturday
2022,6,18,1000,820,236,1056,Saturday
2022,6,18,900,620,152,772,Saturday
2022,6,18,800,356,70,426,Saturday
2022,6,18,700,172,38,210,Saturday
2022,6,18,600,80,37,117,Saturday
2022,6,18,500,39,30,69,Saturday
2022,6,18,400,18,23,41,Saturday
2022,6,18,300,23,45,68,Saturday
2022,6,18,200,20,41,61,Saturday
2022,6,18,100,42,83,125,Saturday
2022,6,17,2400,54,122,176,Friday
2022,6,17,2300,101,116,217,Friday
2022,6,17,2200,161,238,399,Friday
2022,6,17,2100,308,405,713,Friday
2022,6,17,2000,465,661,1126,Friday
2022,6,17,1900,575,784,1359,Friday
2022,6,17,1800,687,903,1590,Friday
2022,6,17,1700,682,909,1591,Friday
2022,6,17,1600,743,850,1593,Friday
2022,6,17,1500,861,772,1633,Friday
2022,6,17,1400,837,634,1471,Friday
2022,6,17,1300,881,616,1497,Friday
2022,6,17,1200,1029,526,1555,Friday
2022,6,17,1100,1092,398,1490,Friday
2022,6,17,1000,942,304,1246,Friday
2022,6,17,900,675,224,899,Friday
2022,6,17,800,458,89,547,Friday
2022,6,17,700,269,46,315,Friday
2022,6,17,600,114,30,144,Friday
2022,6,17,500,80,33,113,Friday
2022,6,17,400,41,28,69,Friday
2022,6,17,300,32,33,65,Friday
2022,6,17,200,25,33,58,Friday
2022,6,17,100,38,27,65,Friday
2022,6,16,2400,52,135,187,Thursday
2022,6,16,2300,119,126,245,Thursday
2022,6,16,2200,149,264,413,Thursday
2022,6,16,2100,251,478,729,Thursday
2022,6,16,2000,374,377,751,Thursday
2022,6,16,1900,433,806,1239,Thursday
2022,6,16,1800,445,837,1282,Thursday
2022,6,16,1700,477,778,1255,Thursday
2022,6,16,1600,568,754,1322,Thursday
2022,6,16,1500,616,709,1325,Thursday
2022,6,16,1400,667,557,1224,Thursday
2022,6,16,1300,715,531,1246,Thursday
2022,6,16,1200,855,446,1301,Thursday
2022,6,16,1100,949,361,1310,Thursday
2022,6,16,1000,784,297,1081,Thursday
2022,6,16,900,635,217,852,Thursday
2022,6,16,800,404,82,486,Thursday
2022,6,16,700,218,48,266,Thursday
2022,6,16,600,91,32,123,Thursday
2022,6,16,500,57,33,90,Thursday
2022,6,16,400,29,16,45,Thursday
2022,6,16,300,23,40,63,Thursday
2022,6,16,200,32,52,84,Thursday
2022,6,16,100,44,30,74,Thursday
2022,6,15,2400,56,140,196,Wednesday
2022,6,15,2300,118,150,268,Wednesday
2022,6,15,2200,119,223,342,Wednesday
2022,6,15,2100,209,406,615,Wednesday
2022,6,15,2000,253,559,812,Wednesday
2022,6,15,1900,278,759,1037,Wednesday
2022,6,15,1800,356,748,1104,Wednesday
2022,6,15,1700,393,978,1371,Wednesday
2022,6,15,1600,444,710,1154,Wednesday
2022,6,15,1500,552,634,1186,Wednesday
2022,6,15,1400,606,668,1274,Wednesday
2022,6,15,1300,665,460,1125,Wednesday
2022,6,15,1200,794,305,1099,Wednesday
2022,6,15,1100,933,180,1113,Wednesday
2022,6,15,1000,817,133,950,Wednesday
2022,6,15,900,661,154,815,Wednesday
2022,6,15,800,416,70,486,Wednesday
2022,6,15,700,206,43,249,Wednesday
2022,6,15,600,86,36,122,Wednesday
2022,6,15,500,50,25,75,Wednesday
2022,6,15,400,23,29,52,Wednesday
2022,6,15,300,18,32,50,Wednesday
2022,6,15,200,21,22,43,Wednesday
2022,6,15,100,35,33,68,Wednesday
2022,6,14,2400,42,86,128,Tuesday
2022,6,14,2300,73,120,193,Tuesday
2022,6,14,2200,106,212,318,Tuesday
2022,6,14,2100,156,303,459,Tuesday
2022,6,14,2000,215,424,639,Tuesday
2022,6,14,1900,240,533,773,Tuesday
2022,6,14,1800,323,645,968,Tuesday
2022,6,14,1700,372,638,1010,Tuesday
2022,6,14,1600,428,559,987,Tuesday
2022,6,14,1500,468,602,1070,Tuesday
2022,6,14,1400,481,525,1006,Tuesday
2022,6,14,1300,567,435,1002,Tuesday
2022,6,14,1200,670,410,1080,Tuesday
2022,6,14,1100,698,333,1031,Tuesday
2022,6,14,1000,643,225,868,Tuesday
2022,6,14,900,433,212,645,Tuesday
2022,6,14,800,246,64,310,Tuesday
2022,6,14,700,129,34,163,Tuesday
2022,6,14,600,63,23,86,Tuesday
2022,6,14,500,30,26,56,Tuesday
2022,6,14,400,19,29,48,Tuesday
2022,6,14,300,20,30,50,Tuesday
2022,6,14,200,23,29,52,Tuesday
2022,6,14,100,25,27,52,Tuesday
2022,6,13,2400,50,96,146,Monday
2022,6,13,2300,61,125,186,Monday
2022,6,13,2200,89,232,321,Monday
2022,6,13,2100,150,317,467,Monday
2022,6,13,2000,221,475,696,Monday
2022,6,13,1900,240,628,868,Monday
2022,6,13,1800,334,785,1119,Monday
2022,6,13,1700,386,756,1142,Monday
2022,6,13,1600,498,766,1264,Monday
2022,6,13,1500,554,620,1174,Monday
2022,6,13,1400,576,567,1143,Monday
2022,6,13,1300,705,559,1264,Monday
2022,6,13,1200,805,489,1294,Monday
2022,6,13,1100,824,335,1159,Monday
2022,6,13,1000,663,197,860,Monday
2022,6,13,900,480,193,673,Monday
2022,6,13,800,305,67,372,Monday
2022,6,13,700,142,34,176,Monday
2022,6,13,600,72,18,90,Monday
2022,6,13,500,48,12,60,Monday
2022,6,13,400,23,15,38,Monday
2022,6,13,300,19,24,43,Monday
2022,6,13,200,7,28,35,Monday
2022,6,13,100,22,42,64,Monday
2022,6,12,2400,36,100,136,Sunday
2022,6,12,2300,68,216,284,Sunday
2022,6,12,2200,92,330,422,Sunday
2022,6,12,2100,155,612,767,Sunday
2022,6,12,2000,264,811,1075,Sunday
2022,6,12,1900,298,963,1261,Sunday
2022,6,12,1800,395,1209,1604,Sunday
2022,6,12,1700,473,1236,1709,Sunday
2022,6,12,1600,540,1176,1716,Sunday
2022,6,12,1500,678,1093,1771,Sunday
2022,6,12,1400,734,917,1651,Sunday
2022,6,12,1300,790,870,1660,Sunday
2022,6,12,1200,931,756,1687,Sunday
2022,6,12,1100,807,494,1301,Sunday
2022,6,12,1000,730,285,1015,Sunday
2022,6,12,900,530,118,648,Sunday
2022,6,12,800,348,72,420,Sunday
2022,6,12,700,144,34,178,Sunday
2022,6,12,600,73,30,103,Sunday
2022,6,12,500,50,19,69,Sunday
2022,6,12,400,27,24,51,Sunday
2022,6,12,300,26,19,45,Sunday
2022,6,12,200,18,15,33,Sunday
2022,6,12,100,36,57,93,Sunday
2022,6,11,2400,44,103,147,Saturday
2022,6,11,2300,80,204,284,Saturday
2022,6,11,2200,100,286,386,Saturday
2022,6,11,2100,175,436,611,Saturday
2022,6,11,2000,235,617,852,Saturday
2022,6,11,1900,274,796,1070,Saturday
2022,6,11,1800,356,863,1219,Saturday
2022,6,11,1700,447,850,1297,Saturday
2022,6,11,1600,507,822,1329,Saturday
2022,6,11,1500,628,672,1300,Saturday
2022,6,11,1400,791,589,1380,Saturday
2022,6,11,1300,891,558,1449,Saturday
2022,6,11,1200,956,436,1392,Saturday
2022,6,11,1100,948,342,1290,Saturday
2022,6,11,1000,827,260,1087,Saturday
2022,6,11,900,593,160,753,Saturday
2022,6,11,800,360,75,435,Saturday
2022,6,11,700,167,42,209,Saturday
2022,6,11,600,76,43,119,Saturday
2022,6,11,500,51,36,87,Saturday
2022,6,11,400,19,25,44,Saturday
2022,6,11,300,22,34,56,Saturday
2022,6,11,200,20,45,65,Saturday
2022,6,11,100,42,88,130,Saturday
2022,6,10,2400,70,121,191,Friday
2022,6,10,2300,107,152,259,Friday
2022,6,10,2200,164,308,472,Friday
2022,6,10,2100,319,427,746,Friday
2022,6,10,2000,502,556,1058,Friday
2022,6,10,1900,640,703,1343,Friday
2022,6,10,1800,645,821,1466,Friday
2022,6,10,1700,707,938,1645,Friday
2022,6,10,1600,777,848,1625,Friday
2022,6,10,1500,854,720,1574,Friday
2022,6,10,1400,790,610,1400,Friday
2022,6,10,1300,797,530,1327,Friday
2022,6,10,1200,962,503,1465,Friday
2022,6,10,1100,1008,339,1347,Friday
2022,6,10,1000,924,280,1204,Friday
2022,6,10,900,686,260,946,Friday
2022,6,10,800,433,66,499,Friday
2022,6,10,700,237,45,282,Friday
2022,6,10,600,117,28,145,Friday
2022,6,10,500,59,28,87,Friday
2022,6,10,400,34,28,62,Friday
2022,6,10,300,23,29,52,Friday
2022,6,10,200,24,34,58,Friday
2022,6,10,100,31,31,62,Friday
2022,6,9,2400,67,133,200,Thursday
2022,6,9,2300,88,146,234,Thursday
2022,6,9,2200,132,242,374,Thursday
2022,6,9,2100,255,361,616,Thursday
2022,6,9,2000,343,512,855,Thursday
2022,6,9,1900,406,711,1117,Thursday
2022,6,9,1800,437,822,1259,Thursday
2022,6,9,1700,473,814,1287,Thursday
2022,6,9,1600,584,727,1311,Thursday
2022,6,9,1500,575,700,1275,Thursday
2022,6,9,1400,582,577,1159,Thursday
2022,6,9,1300,713,511,1224,Thursday
2022,6,9,1200,908,415,1323,Thursday
2022,6,9,1100,1013,313,1326,Thursday
2022,6,9,1000,892,249,1141,Thursday
2022,6,9,900,673,231,904,Thursday
2022,6,9,800,431,73,504,Thursday
2022,6,9,700,225,44,269,Thursday
2022,6,9,600,93,30,123,Thursday
2022,6,9,500,70,27,97,Thursday
2022,6,9,400,40,23,63,Thursday
2022,6,9,300,23,24,47,Thursday
2022,6,9,200,31,31,62,Thursday
2022,6,9,100,39,35,74,Thursday
2022,6,8,2400,47,124,171,Wednesday
2022,6,8,2300,102,133,235,Wednesday
2022,6,8,2200,109,256,365,Wednesday
2022,6,8,2100,176,334,510,Wednesday
2022,6,8,2000,266,481,747,Wednesday
2022,6,8,1900,305,657,962,Wednesday
2022,6,8,1800,360,665,1025,Wednesday
2022,6,8,1700,400,659,1059,Wednesday
2022,6,8,1600,446,659,1105,Wednesday
2022,6,8,1500,504,623,1127,Wednesday
2022,6,8,1400,589,555,1144,Wednesday
2022,6,8,1300,624,520,1144,Wednesday
2022,6,8,1200,773,365,1138,Wednesday
2022,6,8,1100,844,295,1139,Wednesday
2022,6,8,1000,697,253,950,Wednesday
2022,6,8,900,593,239,832,Wednesday
2022,6,8,800,320,77,397,Wednesday
2022,6,8,700,169,47,216,Wednesday
2022,6,8,600,76,32,108,Wednesday
2022,6,8,500,37,20,57,Wednesday
2022,6,8,400,23,28,51,Wednesday
2022,6,8,300,20,30,50,Wednesday
2022,6,8,200,30,44,74,Wednesday
2022,6,8,100,28,26,54,Wednesday
2022,6,7,2400,56,100,156,Tuesday
2022,6,7,2300,94,144,238,Tuesday
2022,6,7,2200,94,252,346,Tuesday
2022,6,7,2100,151,329,480,Tuesday
2022,6,7,2000,258,439,697,Tuesday
2022,6,7,1900,264,571,835,Tuesday
2022,6,7,1800,308,672,980,Tuesday
2022,6,7,1700,324,663,987,Tuesday
2022,6,7,1600,384,541,925,Tuesday
2022,6,7,1500,480,572,1052,Tuesday
2022,6,7,1400,515,486,1001,Tuesday
2022,6,7,1300,563,455,1018,Tuesday
2022,6,7,1200,744,343,1087,Tuesday
2022,6,7,1100,724,277,1001,Tuesday
2022,6,7,1000,658,252,910,Tuesday
2022,6,7,900,477,215,692,Tuesday
2022,6,7,800,302,76,378,Tuesday
2022,6,7,700,172,52,224,Tuesday
2022,6,7,600,78,38,116,Tuesday
2022,6,7,500,29,24,53,Tuesday
2022,6,7,400,26,26,52,Tuesday
2022,6,7,300,22,37,59,Tuesday
2022,6,7,200,18,39,57,Tuesday
2022,6,7,100,26,26,52,Tuesday
2022,6,6,2400,49,88,137,Monday
2022,6,6,2300,83,143,226,Monday
2022,6,6,2200,89,244,333,Monday
2022,6,6,2100,154,330,484,Monday
2022,6,6,2000,245,501,746,Monday
2022,6,6,1900,233,737,970,Monday
2022,6,6,1800,335,675,1010,Monday
2022,6,6,1700,333,818,1151,Monday
2022,6,6,1600,434,757,1191,Monday
2022,6,6,1500,542,636,1178,Monday
2022,6,6,1400,582,514,1096,Monday
2022,6,6,1300,674,569,1243,Monday
2022,6,6,1200,801,418,1219,Monday
2022,6,6,1100,836,282,1118,Monday
2022,6,6,1000,776,213,989,Monday
2022,6,6,900,616,163,779,Monday
2022,6,6,800,374,71,445,Monday
2022,6,6,700,162,41,203,Monday
2022,6,6,600,83,17,100,Monday
2022,6,6,500,28,17,45,Monday
2022,6,6,400,19,19,38,Monday
2022,6,6,300,23,19,42,Monday
2022,6,6,200,15,27,42,Monday
2022,6,6,100,31,30,61,Monday
2022,6,5,2400,28,77,105,Sunday
2022,6,5,2300,65,152,217,Sunday
2022,6,5,2200,86,254,340,Sunday
2022,6,5,2100,124,340,464,Sunday
2022,6,5,2000,205,543,748,Sunday
2022,6,5,1900,284,734,1018,Sunday
2022,6,5,1800,305,1065,1370,Sunday
2022,6,5,1700,398,1048,1446,Sunday
2022,6,5,1600,460,1115,1575,Sunday
2022,6,5,1500,611,1011,1622,Sunday
2022,6,5,1400,640,823,1463,Sunday
2022,6,5,1300,712,830,1542,Sunday
2022,6,5,1200,817,693,1510,Sunday
2022,6,5,1100,814,401,1215,Sunday
2022,6,5,1000,592,239,831,Sunday
2022,6,5,900,421,121,542,Sunday
2022,6,5,800,213,62,275,Sunday
2022,6,5,700,115,33,148,Sunday
2022,6,5,600,42,19,61,Sunday
2022,6,5,500,28,23,51,Sunday
2022,6,5,400,14,8,22,Sunday
2022,6,5,300,17,25,42,Sunday
2022,6,5,200,22,36,58,Sunday
2022,6,5,100,25,51,76,Sunday
2022,6,4,2400,35,80,115,Saturday
2022,6,4,2300,73,173,246,Saturday
2022,6,4,2200,125,247,372,Saturday
2022,6,4,2100,134,357,491,Saturday
2022,6,4,2000,199,491,690,Saturday
2022,6,4,1900,236,671,907,Saturday
2022,6,4,1800,325,749,1074,Saturday
2022,6,4,1700,363,752,1115,Saturday
2022,6,4,1600,465,846,1311,Saturday
2022,6,4,1500,536,734,1270,Saturday
2022,6,4,1400,625,539,1164,Saturday
2022,6,4,1300,753,510,1263,Saturday
2022,6,4,1200,823,448,1271,Saturday
2022,6,4,1100,874,306,1180,Saturday
2022,6,4,1000,763,190,953,Saturday
2022,6,4,900,562,182,744,Saturday
2022,6,4,800,342,78,420,Saturday
2022,6,4,700,164,55,219,Saturday
2022,6,4,600,67,44,111,Saturday
2022,6,4,500,44,18,62,Saturday
2022,6,4,400,17,13,30,Saturday
2022,6,4,300,17,13,30,Saturday
2022,6,4,200,20,20,40,Saturday
2022,6,4,100,38,44,82,Saturday
2022,6,3,2400,46,101,147,Friday
2022,6,3,2300,77,173,250,Friday
2022,6,3,2200,154,189,343,Friday
2022,6,3,2100,277,303,580,Friday
2022,6,3,2000,440,405,845,Friday
2022,6,3,1900,584,567,1151,Friday
2022,6,3,1800,641,631,1272,Friday
2022,6,3,1700,657,791,1448,Friday
2022,6,3,1600,698,815,1513,Friday
2022,6,3,1500,742,720,1462,Friday
2022,6,3,1400,701,616,1317,Friday
2022,6,3,1300,715,479,1194,Friday
2022,6,3,1200,897,460,1357,Friday
2022,6,3,1100,859,327,1186,Friday
2022,6,3,1000,746,283,1029,Friday
2022,6,3,900,573,232,805,Friday
2022,6,3,800,368,80,448,Friday
2022,6,3,700,208,47,255,Friday
2022,6,3,600,76,42,118,Friday
2022,6,3,500,47,27,74,Friday
2022,6,3,400,29,30,59,Friday
2022,6,3,300,27,35,62,Friday
2022,6,3,200,30,34,64,Friday
2022,6,3,100,43,30,73,Friday
2022,6,2,2400,67,108,175,Thursday
2022,6,2,2300,86,119,205,Thursday
2022,6,2,2200,119,272,391,Thursday
2022,6,2,2100,220,453,673,Thursday
2022,6,2,2000,333,431,764,Thursday
2022,6,2,1900,357,406,763,Thursday
2022,6,2,1800,393,625,1018,Thursday
2022,6,2,1700,459,769,1228,Thursday
2022,6,2,1600,482,595,1077,Thursday
2022,6,2,1500,532,580,1112,Thursday
2022,6,2,1400,535,562,1097,Thursday
2022,6,2,1300,589,388,977,Thursday
2022,6,2,1200,764,401,1165,Thursday
2022,6,2,1100,761,325,1086,Thursday
2022,6,2,1000,727,244,971,Thursday
2022,6,2,900,495,224,719,Thursday
2022,6,2,800,346,73,419,Thursday
2022,6,2,700,175,51,226,Thursday
2022,6,2,600,68,32,100,Thursday
2022,6,2,500,45,34,79,Thursday
2022,6,2,400,27,26,53,Thursday
2022,6,2,300,26,32,58,Thursday
2022,6,2,200,33,33,66,Thursday
2022,6,2,100,35,32,67,Thursday
2022,6,1,2400,78,98,176,Wednesday
2022,6,1,2300,81,146,227,Wednesday
2022,6,1,2200,121,307,428,Wednesday
2022,6,1,2100,180,522,702,Wednesday
2022,6,1,2000,208,559,767,Wednesday
2022,6,1,1900,279,401,680,Wednesday
2022,6,1,1800,318,460,778,Wednesday
2022,6,1,1700,330,477,807,Wednesday
2022,6,1,1600,411,641,1052,Wednesday
2022,6,1,1500,457,612,1069,Wednesday
2022,6,1,1400,479,485,964,Wednesday
2022,6,1,1300,591,439,1030,Wednesday
2022,6,1,1200,707,368,1075,Wednesday
2022,6,1,1100,672,280,952,Wednesday
2022,6,1,1000,638,227,865,Wednesday
2022,6,1,900,450,240,690,Wednesday
2022,6,1,800,287,60,347,Wednesday
2022,6,1,700,158,63,221,Wednesday
2022,6,1,600,70,40,110,Wednesday
2022,6,1,500,31,30,61,Wednesday
2022,6,1,400,25,22,47,Wednesday
2022,6,1,300,26,28,54,Wednesday
2022,6,1,200,24,55,79,Wednesday
2022,6,1,100,34,45,79,Wednesday
2022,5,31,2400,60,106,166,Tuesday
2022,5,31,2300,73,101,174,Tuesday
2022,5,31,2200,93,205,298,Tuesday
2022,5,31,2100,164,290,454,Tuesday
2022,5,31,2000,200,377,577,Tuesday
2022,5,31,1900,222,468,690,Tuesday
2022,5,31,1800,266,559,825,Tuesday
2022,5,31,1700,338,685,1023,Tuesday
2022,5,31,1600,387,657,1044,Tuesday
2022,5,31,1500,462,504,966,Tuesday
2022,5,31,1400,459,528,987,Tuesday
2022,5,31,1300,566,394,960,Tuesday
2022,5,31,1200,638,340,978,Tuesday
2022,5,31,1100,743,283,1026,Tuesday
2022,5,31,1000,642,223,865,Tuesday
2022,5,31,900,461,250,711,Tuesday
2022,5,31,800,283,80,363,Tuesday
2022,5,31,700,138,50,188,Tuesday
2022,5,31,600,75,30,105,Tuesday
2022,5,31,500,32,22,54,Tuesday
2022,5,31,400,24,22,46,Tuesday
2022,5,31,300,23,30,53,Tuesday
2022,5,31,200,29,36,65,Tuesday
2022,5,31,100,30,18,48,Tuesday
2022,5,30,2400,43,176,219,Monday
2022,5,30,2300,80,130,210,Monday
2022,5,30,2200,111,183,294,Monday
2022,5,30,2100,153,305,458,Monday
2022,5,30,2000,190,402,592,Monday
2022,5,30,1900,246,547,793,Monday
2022,5,30,1800,303,661,964,Monday
2022,5,30,1700,342,737,1079,Monday
2022,5,30,1600,434,685,1119,Monday
2022,5,30,1500,462,576,1038,Monday
2022,5,30,1400,600,584,1184,Monday
2022,5,30,1300,542,537,1079,Monday
2022,5,30,1200,718,392,1110,Monday
2022,5,30,1100,790,263,1053,Monday
2022,5,30,1000,660,203,863,Monday
2022,5,30,900,451,170,621,Monday
2022,5,30,800,277,64,341,Monday
2022,5,30,700,151,40,191,Monday
2022,5,30,600,74,26,100,Monday
2022,5,30,500,24,13,37,Monday
2022,5,30,400,21,22,43,Monday
2022,5,30,300,16,36,52,Monday
2022,5,30,200,24,39,63,Monday
2022,5,30,100,18,32,50,Monday
2022,5,29,2400,27,121,148,Sunday
2022,5,29,2300,47,207,254,Sunday
2022,5,29,2200,91,339,430,Sunday
2022,5,29,2100,136,377,513,Sunday
2022,5,29,2000,159,588,747,Sunday
2022,5,29,1900,274,774,1048,Sunday
2022,5,29,1800,304,877,1181,Sunday
2022,5,29,1700,390,1163,1553,Sunday
2022,5,29,1600,459,997,1456,Sunday
2022,5,29,1500,554,942,1496,Sunday
2022,5,29,1400,686,831,1517,Sunday
2022,5,29,1300,659,699,1358,Sunday
2022,5,29,1200,725,634,1359,Sunday
2022,5,29,1100,740,376,1116,Sunday
2022,5,29,1000,584,209,793,Sunday
2022,5,29,900,417,109,526,Sunday
2022,5,29,800,259,50,309,Sunday
2022,5,29,700,126,33,159,Sunday
2022,5,29,600,42,19,61,Sunday
2022,5,29,500,15,18,33,Sunday
2022,5,29,400,15,11,26,Sunday
2022,5,29,300,16,22,38,Sunday
2022,5,29,200,25,42,67,Sunday
2022,5,29,100,30,53,83,Sunday
2022,5,28,2400,41,68,109,Saturday
2022,5,28,2300,67,158,225,Saturday
2022,5,28,2200,100,248,348,Saturday
2022,5,28,2100,136,317,453,Saturday
2022,5,28,2000,169,521,690,Saturday
2022,5,28,1900,247,663,910,Saturday
2022,5,28,1800,332,765,1097,Saturday
2022,5,28,1700,380,798,1178,Saturday
2022,5,28,1600,471,840,1311,Saturday
2022,5,28,1500,621,607,1228,Saturday
2022,5,28,1400,651,585,1236,Saturday
2022,5,28,1300,754,492,1246,Saturday
2022,5,28,1200,860,428,1288,Saturday
2022,5,28,1100,792,276,1068,Saturday
2022,5,28,1000,639,245,884,Saturday
2022,5,28,900,531,215,746,Saturday
2022,5,28,800,319,53,372,Saturday
2022,5,28,700,159,42,201,Saturday
2022,5,28,600,53,27,80,Saturday
2022,5,28,500,33,23,56,Saturday
2022,5,28,400,23,29,52,Saturday
2022,5,28,300,18,31,49,Saturday
2022,5,28,200,23,38,61,Saturday
2022,5,28,100,39,30,69,Saturday
2022,5,27,2400,43,87,130,Friday
2022,5,27,2300,84,131,215,Friday
2022,5,27,2200,125,218,343,Friday
2022,5,27,2100,248,261,509,Friday
2022,5,27,2000,459,363,822,Friday
2022,5,27,1900,512,470,982,Friday
2022,5,27,1800,563,649,1212,Friday
2022,5,27,1700,603,631,1234,Friday
2022,5,27,1600,641,658,1299,Friday
2022,5,27,1500,651,632,1283,Friday
2022,5,27,1400,660,505,1165,Friday
2022,5,27,1300,648,456,1104,Friday
2022,5,27,1200,745,382,1127,Friday
2022,5,27,1100,739,329,1068,Friday
2022,5,27,1000,590,242,832,Friday
2022,5,27,900,450,229,679,Friday
2022,5,27,800,258,63,321,Friday
2022,5,27,700,169,42,211,Friday
2022,5,27,600,86,33,119,Friday
2022,5,27,500,28,28,56,Friday
2022,5,27,400,31,27,58,Friday
2022,5,27,300,24,47,71,Friday
2022,5,27,200,32,41,73,Friday
2022,5,27,100,44,33,77,Friday
2022,5,26,2400,55,103,158,Thursday
2022,5,26,2300,100,134,234,Thursday
2022,5,26,2200,105,213,318,Thursday
2022,5,26,2100,215,325,540,Thursday
2022,5,26,2000,311,417,728,Thursday
2022,5,26,1900,296,451,747,Thursday
2022,5,26,1800,382,590,972,Thursday
2022,5,26,1700,429,661,1090,Thursday
2022,5,26,1600,486,661,1147,Thursday
2022,5,26,1500,511,651,1162,Thursday
2022,5,26,1400,596,520,1116,Thursday
2022,5,26,1300,626,409,1035,Thursday
2022,5,26,1200,687,385,1072,Thursday
2022,5,26,1100,759,246,1005,Thursday
2022,5,26,1000,590,242,832,Thursday
2022,5,26,900,429,195,624,Thursday
2022,5,26,800,319,62,381,Thursday
2022,5,26,700,159,50,209,Thursday
2022,5,26,600,65,37,102,Thursday
2022,5,26,500,35,22,57,Thursday
2022,5,26,400,25,36,61,Thursday
2022,5,26,300,24,29,53,Thursday
2022,5,26,200,26,31,57,Thursday
2022,5,26,100,30,20,50,Thursday
2022,5,25,2400,67,99,166,Wednesday
2022,5,25,2300,86,112,198,Wednesday
2022,5,25,2200,106,200,306,Wednesday
2022,5,25,2100,160,266,426,Wednesday
2022,5,25,2000,216,389,605,Wednesday
2022,5,25,1900,267,432,699,Wednesday
2022,5,25,1800,282,609,891,Wednesday
2022,5,25,1700,382,662,1044,Wednesday
2022,5,25,1600,426,602,1028,Wednesday
2022,5,25,1500,492,573,1065,Wednesday
2022,5,25,1400,512,519,1031,Wednesday
2022,5,25,1300,533,437,970,Wednesday
2022,5,25,1200,647,361,1008,Wednesday
2022,5,25,1100,634,242,876,Wednesday
2022,5,25,1000,509,242,751,Wednesday
2022,5,25,900,386,212,598,Wednesday
2022,5,25,800,246,65,311,Wednesday
2022,5,25,700,144,46,190,Wednesday
2022,5,25,600,52,39,91,Wednesday
2022,5,25,500,37,30,67,Wednesday
2022,5,25,400,18,25,43,Wednesday
2022,5,25,300,27,16,43,Wednesday
2022,5,25,200,25,14,39,Wednesday
2022,5,25,100,38,36,74,Wednesday
2022,5,24,2400,58,103,161,Tuesday
2022,5,24,2300,65,165,230,Tuesday
2022,5,24,2200,100,203,303,Tuesday
2022,5,24,2100,155,301,456,Tuesday
2022,5,24,2000,179,416,595,Tuesday
2022,5,24,1900,212,499,711,Tuesday
2022,5,24,1800,257,740,997,Tuesday
2022,5,24,1700,325,786,1111,Tuesday
2022,5,24,1600,394,701,1095,Tuesday
2022,5,24,1500,510,672,1182,Tuesday
2022,5,24,1400,491,643,1134,Tuesday
2022,5,24,1300,591,609,1200,Tuesday
2022,5,24,1200,696,454,1150,Tuesday
2022,5,24,1100,637,339,976,Tuesday
2022,5,24,1000,639,214,853,Tuesday
2022,5,24,900,405,154,559,Tuesday
2022,5,24,800,267,102,369,Tuesday
2022,5,24,700,143,61,204,Tuesday
2022,5,24,600,55,26,81,Tuesday
2022,5,24,500,35,25,60,Tuesday
2022,5,24,400,27,21,48,Tuesday
2022,5,24,300,33,44,77,Tuesday
2022,5,24,200,21,41,62,Tuesday
2022,5,24,100,28,52,80,Tuesday
2022,5,23,2400,38,119,157,Monday
2022,5,23,2300,64,233,297,Monday
2022,5,23,2200,92,333,425,Monday
2022,5,23,2100,128,696,824,Monday
2022,5,23,2000,196,989,1185,Monday
2022,5,23,1900,218,1304,1522,Monday
2022,5,23,1800,375,1616,1991,Monday
2022,5,23,1700,401,1959,2360,Monday
2022,5,23,1600,495,2130,2625,Monday
2022,5,23,1500,607,1991,2598,Monday
2022,5,23,1400,734,1733,2467,Monday
2022,5,23,1300,834,1471,2305,Monday
2022,5,23,1200,968,1180,2148,Monday
2022,5,23,1100,890,543,1433,Monday
2022,5,23,1000,683,317,1000,Monday
2022,5,23,900,516,160,676,Monday
2022,5,23,800,275,73,348,Monday
2022,5,23,700,139,42,181,Monday
2022,5,23,600,56,20,76,Monday
2022,5,23,500,47,26,73,Monday
2022,5,23,400,27,14,41,Monday
2022,5,23,300,33,38,71,Monday
2022,5,23,200,27,42,69,Monday
2022,5,23,100,27,69,96,Monday
2022,5,22,2400,44,113,157,Sunday
2022,5,22,2300,68,204,272,Sunday
2022,5,22,2200,99,329,428,Sunday
2022,5,22,2100,151,439,590,Sunday
2022,5,22,2000,205,657,862,Sunday
2022,5,22,1900,236,926,1162,Sunday
2022,5,22,1800,345,1122,1467,Sunday
2022,5,22,1700,464,1076,1540,Sunday
2022,5,22,1600,555,1071,1626,Sunday
2022,5,22,1500,747,938,1685,Sunday
2022,5,22,1400,797,791,1588,Sunday
2022,5,22,1300,959,645,1604,Sunday
2022,5,22,1200,961,527,1488,Sunday
2022,5,22,1100,997,294,1291,Sunday
2022,5,22,1000,804,185,989,Sunday
2022,5,22,900,508,96,604,Sunday
2022,5,22,800,307,60,367,Sunday
2022,5,22,700,143,24,167,Sunday
2022,5,22,600,51,21,72,Sunday
2022,5,22,500,33,10,43,Sunday
2022,5,22,400,14,14,28,Sunday
2022,5,22,300,14,22,36,Sunday
2022,5,22,200,33,31,64,Sunday
2022,5,22,100,31,44,75,Sunday
2022,5,21,2400,32,76,108,Saturday
2022,5,21,2300,82,144,226,Saturday
2022,5,21,2200,122,183,305,Saturday
2022,5,21,2100,144,311,455,Saturday
2022,5,21,2000,215,442,657,Saturday
2022,5,21,1900,282,596,878,Saturday
2022,5,21,1800,354,745,1099,Saturday
2022,5,21,1700,451,805,1256,Saturday
2022,5,21,1600,603,765,1368,Saturday
2022,5,21,1500,729,712,1441,Saturday
2022,5,21,1400,1040,570,1610,Saturday
2022,5,21,1300,1079,478,1557,Saturday
2022,5,21,1200,1203,383,1586,Saturday
2022,5,21,1100,1099,280,1379,Saturday
2022,5,21,1000,912,187,1099,Saturday
2022,5,21,900,655,125,780,Saturday
2022,5,21,800,397,77,474,Saturday
2022,5,21,700,182,54,236,Saturday
2022,5,21,600,86,39,125,Saturday
2022,5,21,500,48,32,80,Saturday
2022,5,21,400,37,44,81,Saturday
2022,5,21,300,31,43,74,Saturday
2022,5,21,200,28,55,83,Saturday
2022,5,21,100,51,79,130,Saturday
2022,5,20,2400,72,102,174,Friday
2022,5,20,2300,128,137,265,Friday
2022,5,20,2200,189,203,392,Friday
2022,5,20,2100,378,281,659,Friday
2022,5,20,2000,656,366,1022,Friday
2022,5,20,1900,850,434,1284,Friday
2022,5,20,1800,914,486,1400,Friday
2022,5,20,1700,1046,595,1641,Friday
2022,5,20,1600,1008,732,1740,Friday
2022,5,20,1500,1127,788,1915,Friday
2022,5,20,1400,1101,702,1803,Friday
2022,5,20,1300,1167,416,1583,Friday
2022,5,20,1200,1298,340,1638,Friday
2022,5,20,1100,1134,252,1386,Friday
2022,5,20,1000,754,193,947,Friday
2022,5,20,900,506,112,618,Friday
2022,5,20,800,318,85,403,Friday
2022,5,20,700,193,43,236,Friday
2022,5,20,600,80,62,142,Friday
2022,5,20,500,44,39,83,Friday
2022,5,20,400,35,44,79,Friday
2022,5,20,300,29,37,66,Friday
2022,5,20,200,35,56,91,Friday
2022,5,20,100,47,96,143,Friday
2022,5,19,2400,62,88,150,Thursday
2022,5,19,2300,105,131,236,Thursday
2022,5,19,2200,177,164,341,Thursday
2022,5,19,2100,317,213,530,Thursday
2022,5,19,2000,523,322,845,Thursday
2022,5,19,1900,605,347,952,Thursday
2022,5,19,1800,552,432,984,Thursday
2022,5,19,1700,532,471,1003,Thursday
2022,5,19,1600,532,474,1006,Thursday
2022,5,19,1500,549,431,980,Thursday
2022,5,19,1400,590,377,967,Thursday
2022,5,19,1300,621,334,955,Thursday
2022,5,19,1200,617,291,908,Thursday
2022,5,19,1100,663,204,867,Thursday
2022,5,19,1000,566,175,741,Thursday
2022,5,19,900,400,125,525,Thursday
2022,5,19,800,269,89,358,Thursday
2022,5,19,700,139,52,191,Thursday
2022,5,19,600,58,47,105,Thursday
2022,5,19,500,34,41,75,Thursday
2022,5,19,400,28,31,59,Thursday
2022,5,19,300,39,20,59,Thursday
2022,5,19,200,34,25,59,Thursday
2022,5,19,100,36,60,96,Thursday
2022,5,18,2400,54,70,124,Wednesday
2022,5,18,2300,92,133,225,Wednesday
2022,5,18,2200,89,141,230,Wednesday
2022,5,18,2100,144,212,356,Wednesday
2022,5,18,2000,198,267,465,Wednesday
2022,5,18,1900,207,384,591,Wednesday
2022,5,18,1800,282,415,697,Wednesday
2022,5,18,1700,314,484,798,Wednesday
2022,5,18,1600,327,418,745,Wednesday
2022,5,18,1500,360,457,817,Wednesday
2022,5,18,1400,398,423,821,Wednesday
2022,5,18,1300,429,339,768,Wednesday
2022,5,18,1200,483,292,775,Wednesday
2022,5,18,1100,506,228,734,Wednesday
2022,5,18,1000,424,181,605,Wednesday
2022,5,18,900,308,104,412,Wednesday
2022,5,18,800,228,90,318,Wednesday
2022,5,18,700,117,68,185,Wednesday
2022,5,18,600,58,28,86,Wednesday
2022,5,18,500,35,34,69,Wednesday
2022,5,18,400,24,28,52,Wednesday
2022,5,18,300,26,36,62,Wednesday
2022,5,18,200,28,62,90,Wednesday
2022,5,18,100,37,67,104,Wednesday
2022,5,17,2400,53,100,153,Tuesday
2022,5,17,2300,72,116,188,Tuesday
2022,5,17,2200,107,149,256,Tuesday
2022,5,17,2100,108,206,314,Tuesday
2022,5,17,2000,146,249,395,Tuesday
2022,5,17,1900,195,333,528,Tuesday
2022,5,17,1800,246,449,695,Tuesday
2022,5,17,1700,249,445,694,Tuesday
2022,5,17,1600,310,394,704,Tuesday
2022,5,17,1500,323,428,751,Tuesday
2022,5,17,1400,361,384,745,Tuesday
2022,5,17,1300,389,315,704,Tuesday
2022,5,17,1200,468,277,745,Tuesday
2022,5,17,1100,467,203,670,Tuesday
2022,5,17,1000,432,153,585,Tuesday
2022,5,17,900,347,110,457,Tuesday
2022,5,17,800,193,80,273,Tuesday
2022,5,17,700,105,49,154,Tuesday
2022,5,17,600,50,48,98,Tuesday
2022,5,17,500,26,26,52,Tuesday
2022,5,17,400,33,39,72,Tuesday
2022,5,17,300,20,35,55,Tuesday
2022,5,17,200,21,50,71,Tuesday
2022,5,17,100,35,67,102,Tuesday
2022,5,16,2400,55,85,140,Monday
2022,5,16,2300,62,94,156,Monday
2022,5,16,2200,83,154,237,Monday
2022,5,16,2100,119,224,343,Monday
2022,5,16,2000,142,276,418,Monday
2022,5,16,1900,167,419,586,Monday
2022,5,16,1800,222,524,746,Monday
2022,5,16,1700,281,558,839,Monday
2022,5,16,1600,391,463,854,Monday
2022,5,16,1500,446,432,878,Monday
2022,5,16,1400,508,406,914,Monday
2022,5,16,1300,556,398,954,Monday
2022,5,16,1200,565,307,872,Monday
2022,5,16,1100,575,225,800,Monday
2022,5,16,1000,462,154,616,Monday
2022,5,16,900,377,108,485,Monday
2022,5,16,800,210,77,287,Monday
2022,5,16,700,110,39,149,Monday
2022,5,16,600,44,17,61,Monday
2022,5,16,500,27,22,49,Monday
2022,5,16,400,25,18,43,Monday
2022,5,16,300,22,31,53,Monday
2022,5,16,200,14,32,46,Monday
2022,5,16,100,26,78,104,Monday
2022,5,15,2400,32,92,124,Sunday
2022,5,15,2300,55,99,154,Sunday
2022,5,15,2200,95,223,318,Sunday
2022,5,15,2100,127,323,450,Sunday
2022,5,15,2000,146,465,611,Sunday
2022,5,15,1900,191,656,847,Sunday
2022,5,15,1800,286,763,1049,Sunday
2022,5,15,1700,373,866,1239,Sunday
2022,5,15,1600,424,845,1269,Sunday
2022,5,15,1500,501,819,1320,Sunday
2022,5,15,1400,518,756,1274,Sunday
2022,5,15,1300,603,637,1240,Sunday
2022,5,15,1200,708,537,1245,Sunday
2022,5,15,1100,653,340,993,Sunday
2022,5,15,1000,486,173,659,Sunday
2022,5,15,900,340,109,449,Sunday
2022,5,15,800,169,47,216,Sunday
2022,5,15,700,88,15,103,Sunday
2022,5,15,600,45,26,71,Sunday
2022,5,15,500,19,23,42,Sunday
2022,5,15,400,22,26,48,Sunday
2022,5,15,300,17,20,37,Sunday
2022,5,15,200,15,40,55,Sunday
2022,5,15,100,18,43,61,Sunday
2022,5,14,2400,44,81,125,Saturday
2022,5,14,2300,67,92,159,Saturday
2022,5,14,2200,76,175,251,Saturday
2022,5,14,2100,117,222,339,Saturday
2022,5,14,2000,125,377,502,Saturday
2022,5,14,1900,174,469,643,Saturday
2022,5,14,1800,257,572,829,Saturday
2022,5,14,1700,319,631,950,Saturday
2022,5,14,1600,337,581,918,Saturday
2022,5,14,1500,475,564,1039,Saturday
2022,5,14,1400,517,488,1005,Saturday
2022,5,14,1300,588,359,947,Saturday
2022,5,14,1200,649,292,941,Saturday
2022,5,14,1100,665,246,911,Saturday
2022,5,14,1000,549,162,711,Saturday
2022,5,14,900,390,121,511,Saturday
2022,5,14,800,241,74,315,Saturday
2022,5,14,700,119,40,159,Saturday
2022,5,14,600,40,39,79,Saturday
2022,5,14,500,25,23,48,Saturday
2022,5,14,400,25,26,51,Saturday
2022,5,14,300,27,30,57,Saturday
2022,5,14,200,23,38,61,Saturday
2022,5,14,100,31,76,107,Saturday
2022,5,13,2400,45,93,138,Friday
2022,5,13,2300,59,124,183,Friday
2022,5,13,2200,107,173,280,Friday
2022,5,13,2100,162,221,383,Friday
2022,5,13,2000,294,245,539,Friday
2022,5,13,1900,388,398,786,Friday
2022,5,13,1800,527,432,959,Friday
2022,5,13,1700,536,509,1045,Friday
2022,5,13,1600,516,531,1047,Friday
2022,5,13,1500,556,404,960,Friday
2022,5,13,1400,501,393,894,Friday
2022,5,13,1300,532,383,915,Friday
2022,5,13,1200,576,315,891,Friday
2022,5,13,1100,573,255,828,Friday
2022,5,13,1000,510,171,681,Friday
2022,5,13,900,392,135,527,Friday
2022,5,13,800,205,87,292,Friday
2022,5,13,700,121,48,169,Friday
2022,5,13,600,67,45,112,Friday
2022,5,13,500,41,47,88,Friday
2022,5,13,400,36,38,74,Friday
2022,5,13,300,27,43,70,Friday
2022,5,13,200,39,50,89,Friday
2022,5,13,100,38,62,100,Friday
2022,5,12,2400,56,90,146,Thursday
2022,5,12,2300,75,114,189,Thursday
2022,5,12,2200,109,161,270,Thursday
2022,5,12,2100,179,191,370,Thursday
2022,5,12,2000,240,309,549,Thursday
2022,5,12,1900,266,393,659,Thursday
2022,5,12,1800,309,466,775,Thursday
2022,5,12,1700,313,512,825,Thursday
2022,5,12,1600,373,467,840,Thursday
2022,5,12,1500,410,433,843,Thursday
2022,5,12,1400,422,387,809,Thursday
2022,5,12,1300,463,328,791,Thursday
2022,5,12,1200,541,311,852,Thursday
2022,5,12,1100,602,181,783,Thursday
2022,5,12,1000,476,143,619,Thursday
2022,5,12,900,317,137,454,Thursday
2022,5,12,800,233,82,315,Thursday
2022,5,12,700,108,56,164,Thursday
2022,5,12,600,58,37,95,Thursday
2022,5,12,500,30,31,61,Thursday
2022,5,12,400,31,39,70,Thursday
2022,5,12,300,23,42,65,Thursday
2022,5,12,200,35,40,75,Thursday
2022,5,12,100,37,59,96,Thursday
2022,5,11,2400,55,115,170,Wednesday
2022,5,11,2300,79,111,190,Wednesday
2022,5,11,2200,105,141,246,Wednesday
2022,5,11,2100,137,213,350,Wednesday
2022,5,11,2000,136,271,407,Wednesday
2022,5,11,1900,180,305,485,Wednesday
2022,5,11,1800,217,387,604,Wednesday
2022,5,11,1700,242,445,687,Wednesday
2022,5,11,1600,334,396,730,Wednesday
2022,5,11,1500,349,426,775,Wednesday
2022,5,11,1400,376,340,716,Wednesday
2022,5,11,1300,378,318,696,Wednesday
2022,5,11,1200,451,235,686,Wednesday
2022,5,11,1100,484,189,673,Wednesday
2022,5,11,1000,432,164,596,Wednesday
2022,5,11,900,309,90,399,Wednesday
2022,5,11,800,207,72,279,Wednesday
2022,5,11,700,95,51,146,Wednesday
2022,5,11,600,66,30,96,Wednesday
2022,5,11,500,27,36,63,Wednesday
2022,5,11,400,26,31,57,Wednesday
2022,5,11,300,9,30,39,Wednesday
2022,5,11,200,34,55,89,Wednesday
2022,5,11,100,36,69,105,Wednesday
2022,5,10,2400,52,66,118,Tuesday
2022,5,10,2300,72,101,173,Tuesday
2022,5,10,2200,77,145,222,Tuesday
2022,5,10,2100,121,177,298,Tuesday
2022,5,10,2000,164,232,396,Tuesday
2022,5,10,1900,143,312,455,Tuesday
2022,5,10,1800,198,404,602,Tuesday
2022,5,10,1700,258,372,630,Tuesday
2022,5,10,1600,300,468,768,Tuesday
2022,5,10,1500,336,363,699,Tuesday
2022,5,10,1400,364,310,674,Tuesday
2022,5,10,1300,438,288,726,Tuesday
2022,5,10,1200,449,238,687,Tuesday
2022,5,10,1100,500,195,695,Tuesday
2022,5,10,1000,383,148,531,Tuesday
2022,5,10,900,288,121,409,Tuesday
2022,5,10,800,164,69,233,Tuesday
2022,5,10,700,95,46,141,Tuesday
2022,5,10,600,48,36,84,Tuesday
2022,5,10,500,32,35,67,Tuesday
2022,5,10,400,19,37,56,Tuesday
2022,5,10,300,15,29,44,Tuesday
2022,5,10,200,28,50,78,Tuesday
2022,5,10,100,36,75,111,Tuesday
2022,5,9,2400,48,76,124,Monday
2022,5,9,2300,66,102,168,Monday
2022,5,9,2200,69,145,214,Monday
2022,5,9,2100,86,189,275,Monday
2022,5,9,2000,141,228,369,Monday
2022,5,9,1900,149,316,465,Monday
2022,5,9,1800,187,387,574,Monday
2022,5,9,1700,287,457,744,Monday
2022,5,9,1600,353,437,790,Monday
2022,5,9,1500,414,360,774,Monday
2022,5,9,1400,429,383,812,Monday
2022,5,9,1300,468,296,764,Monday
2022,5,9,1200,514,269,783,Monday
2022,5,9,1100,499,177,676,Monday
2022,5,9,1000,384,126,510,Monday
2022,5,9,900,296,92,388,Monday
2022,5,9,800,205,51,256,Monday
2022,5,9,700,83,41,124,Monday
2022,5,9,600,46,27,73,Monday
2022,5,9,500,26,13,39,Monday
2022,5,9,400,15,16,31,Monday
2022,5,9,300,9,36,45,Monday
2022,5,9,200,26,39,65,Monday
2022,5,9,100,16,48,64,Monday
2022,5,8,2400,19,89,108,Sunday
2022,5,8,2300,43,145,188,Sunday
2022,5,8,2200,76,250,326,Sunday
2022,5,8,2100,90,297,387,Sunday
2022,5,8,2000,130,388,518,Sunday
2022,5,8,1900,184,549,733,Sunday
2022,5,8,1800,231,758,989,Sunday
2022,5,8,1700,293,802,1095,Sunday
2022,5,8,1600,382,779,1161,Sunday
2022,5,8,1500,503,745,1248,Sunday
2022,5,8,1400,475,632,1107,Sunday
2022,5,8,1300,582,543,1125,Sunday
2022,5,8,1200,674,445,1119,Sunday
2022,5,8,1100,604,219,823,Sunday
2022,5,8,1000,526,129,655,Sunday
2022,5,8,900,386,104,490,Sunday
2022,5,8,800,184,38,222,Sunday
2022,5,8,700,79,21,100,Sunday
2022,5,8,600,41,12,53,Sunday
2022,5,8,500,24,11,35,Sunday
2022,5,8,400,19,19,38,Sunday
2022,5,8,300,20,33,53,Sunday
2022,5,8,200,21,42,63,Sunday
2022,5,8,100,16,55,71,Sunday
2022,5,7,2400,27,59,86,Saturday
2022,5,7,2300,51,111,162,Saturday
2022,5,7,2200,63,168,231,Saturday
2022,5,7,2100,91,243,334,Saturday
2022,5,7,2000,127,361,488,Saturday
2022,5,7,1900,156,426,582,Saturday
2022,5,7,1800,251,607,858,Saturday
2022,5,7,1700,285,717,1002,Saturday
2022,5,7,1600,386,641,1027,Saturday
2022,5,7,1500,442,556,998,Saturday
2022,5,7,1400,488,510,998,Saturday
2022,5,7,1300,562,408,970,Saturday
2022,5,7,1200,678,322,1000,Saturday
2022,5,7,1100,641,245,886,Saturday
2022,5,7,1000,614,148,762,Saturday
2022,5,7,900,445,102,547,Saturday
2022,5,7,800,207,55,262,Saturday
2022,5,7,700,104,48,152,Saturday
2022,5,7,600,44,24,68,Saturday
2022,5,7,500,27,21,48,Saturday
2022,5,7,400,24,30,54,Saturday
2022,5,7,300,25,33,58,Saturday
2022,5,7,200,26,25,51,Saturday
2022,5,7,100,41,62,103,Saturday
2022,5,6,2400,52,86,138,Friday
2022,5,6,2300,65,134,199,Friday
2022,5,6,2200,108,180,288,Friday
2022,5,6,2100,180,223,403,Friday
2022,5,6,2000,276,314,590,Friday
2022,5,6,1900,368,442,810,Friday
2022,5,6,1800,400,546,946,Friday
2022,5,6,1700,511,610,1121,Friday
2022,5,6,1600,550,599,1149,Friday
2022,5,6,1500,477,488,965,Friday
2022,5,6,1400,555,417,972,Friday
2022,5,6,1300,540,373,913,Friday
2022,5,6,1200,572,332,904,Friday
2022,5,6,1100,653,231,884,Friday
2022,5,6,1000,529,169,698,Friday
2022,5,6,900,386,140,526,Friday
2022,5,6,800,188,78,266,Friday
2022,5,6,700,112,55,167,Friday
2022,5,6,600,42,40,82,Friday
2022,5,6,500,35,27,62,Friday
2022,5,6,400,35,47,82,Friday
2022,5,6,300,30,48,78,Friday
2022,5,6,200,32,48,80,Friday
2022,5,6,100,48,73,121,Friday
2022,5,5,2400,52,113,165,Thursday
2022,5,5,2300,71,167,238,Thursday
2022,5,5,2200,97,377,474,Thursday
2022,5,5,2100,146,447,593,Thursday
2022,5,5,2000,191,301,492,Thursday
2022,5,5,1900,256,220,476,Thursday
2022,5,5,1800,310,280,590,Thursday
2022,5,5,1700,323,337,660,Thursday
2022,5,5,1600,366,370,736,Thursday
2022,5,5,1500,434,388,822,Thursday
2022,5,5,1400,398,425,823,Thursday
2022,5,5,1300,415,356,771,Thursday
2022,5,5,1200,500,274,774,Thursday
2022,5,5,1100,535,220,755,Thursday
2022,5,5,1000,446,178,624,Thursday
2022,5,5,900,319,105,424,Thursday
2022,5,5,800,201,98,299,Thursday
2022,5,5,700,112,79,191,Thursday
2022,5,5,600,71,33,104,Thursday
2022,5,5,500,39,25,64,Thursday
2022,5,5,400,21,26,47,Thursday
2022,5,5,300,19,35,54,Thursday
2022,5,5,200,23,43,66,Thursday
2022,5,5,100,40,56,96,Thursday
2022,5,4,2400,51,84,135,Wednesday
2022,5,4,2300,74,152,226,Wednesday
2022,5,4,2200,74,140,214,Wednesday
2022,5,4,2100,124,238,362,Wednesday
2022,5,4,2000,151,174,325,Wednesday
2022,5,4,1900,163,334,497,Wednesday
2022,5,4,1800,205,440,645,Wednesday
2022,5,4,1700,281,477,758,Wednesday
2022,5,4,1600,332,518,850,Wednesday
2022,5,4,1500,349,418,767,Wednesday
2022,5,4,1400,383,390,773,Wednesday
2022,5,4,1300,402,300,702,Wednesday
2022,5,4,1200,493,260,753,Wednesday
2022,5,4,1100,466,234,700,Wednesday
2022,5,4,1000,419,164,583,Wednesday
2022,5,4,900,304,126,430,Wednesday
2022,5,4,800,172,75,247,Wednesday
2022,5,4,700,117,54,171,Wednesday
2022,5,4,600,55,33,88,Wednesday
2022,5,4,500,25,33,58,Wednesday
2022,5,4,400,23,23,46,Wednesday
2022,5,4,300,18,33,51,Wednesday
2022,5,4,200,25,54,79,Wednesday
2022,5,4,100,29,66,95,Wednesday
2022,5,3,2400,42,89,131,Tuesday
2022,5,3,2300,73,98,171,Tuesday
2022,5,3,2200,81,172,253,Tuesday
2022,5,3,2100,124,216,340,Tuesday
2022,5,3,2000,147,297,444,Tuesday
2022,5,3,1900,186,356,542,Tuesday
2022,5,3,1800,198,507,705,Tuesday
2022,5,3,1700,255,528,783,Tuesday
2022,5,3,1600,308,530,838,Tuesday
2022,5,3,1500,312,443,755,Tuesday
2022,5,3,1400,387,367,754,Tuesday
2022,5,3,1300,436,320,756,Tuesday
2022,5,3,1200,518,252,770,Tuesday
2022,5,3,1100,527,194,721,Tuesday
2022,5,3,1000,486,135,621,Tuesday
2022,5,3,900,330,111,441,Tuesday
2022,5,3,800,194,76,270,Tuesday
2022,5,3,700,138,43,181,Tuesday
2022,5,3,600,58,29,87,Tuesday
2022,5,3,500,34,31,65,Tuesday
2022,5,3,400,25,39,64,Tuesday
2022,5,3,300,20,34,54,Tuesday
2022,5,3,200,29,68,97,Tuesday
2022,5,3,100,29,53,82,Tuesday
2022,5,2,2400,42,51,93,Monday
2022,5,2,2300,89,117,206,Monday
2022,5,2,2200,77,155,232,Monday
2022,5,2,2100,119,196,315,Monday
2022,5,2,2000,131,274,405,Monday
2022,5,2,1900,181,365,546,Monday
2022,5,2,1800,223,459,682,Monday
2022,5,2,1700,294,549,843,Monday
2022,5,2,1600,352,486,838,Monday
2022,5,2,1500,395,409,804,Monday
2022,5,2,1400,424,390,814,Monday
2022,5,2,1300,448,336,784,Monday
2022,5,2,1200,515,238,753,Monday
2022,5,2,1100,496,196,692,Monday
2022,5,2,1000,423,161,584,Monday
2022,5,2,900,344,86,430,Monday
2022,5,2,800,222,67,289,Monday
2022,5,2,700,101,34,135,Monday
2022,5,2,600,36,15,51,Monday
2022,5,2,500,33,22,55,Monday
2022,5,2,400,27,14,41,Monday
2022,5,2,300,17,23,40,Monday
2022,5,2,200,13,43,56,Monday
2022,5,2,100,27,72,99,Monday
2022,5,1,2400,25,92,117,Sunday
2022,5,1,2300,54,131,185,Sunday
2022,5,1,2200,55,200,255,Sunday
2022,5,1,2100,100,305,405,Sunday
2022,5,1,2000,126,419,545,Sunday
2022,5,1,1900,168,559,727,Sunday
2022,5,1,1800,229,831,1060,Sunday
2022,5,1,1700,326,974,1300,Sunday
2022,5,1,1600,373,896,1269,Sunday
2022,5,1,1500,447,811,1258,Sunday
2022,5,1,1400,493,635,1128,Sunday
2022,5,1,1300,593,622,1215,Sunday
2022,5,1,1200,681,443,1124,Sunday
2022,5,1,1100,648,295,943,Sunday
2022,5,1,1000,570,195,765,Sunday
2022,5,1,900,450,89,539,Sunday
2022,5,1,800,234,42,276,Sunday
2022,5,1,700,122,22,144,Sunday
2022,5,1,600,66,20,86,Sunday
2022,5,1,500,27,22,49,Sunday
2022,5,1,400,16,30,46,Sunday
2022,5,1,300,13,31,44,Sunday
2022,5,1,200,18,36,54,Sunday
2022,5,1,100,25,53,78,Sunday
2022,4,30,2400,17,94,111,Saturday
2022,4,30,2300,37,110,147,Saturday
2022,4,30,2200,82,183,265,Saturday
2022,4,30,2100,99,213,312,Saturday
2022,4,30,2000,135,374,509,Saturday
2022,4,30,1900,173,509,682,Saturday
2022,4,30,1800,225,757,982,Saturday
2022,4,30,1700,254,751,1005,Saturday
2022,4,30,1600,344,755,1099,Saturday
2022,4,30,1500,440,543,983,Saturday
2022,4,30,1400,459,456,915,Saturday
2022,4,30,1300,538,343,881,Saturday
2022,4,30,1200,644,333,977,Saturday
2022,4,30,1100,712,248,960,Saturday
2022,4,30,1000,709,161,870,Saturday
2022,4,30,900,554,120,674,Saturday
2022,4,30,800,289,63,352,Saturday
2022,4,30,700,114,35,149,Saturday
2022,4,30,600,57,35,92,Saturday
2022,4,30,500,53,27,80,Saturday
2022,4,30,400,37,35,72,Saturday
2022,4,30,300,29,29,58,Saturday
2022,4,30,200,23,63,86,Saturday
2022,4,30,100,36,64,100,Saturday
2022,4,29,2400,52,73,125,Friday
2022,4,29,2300,81,128,209,Friday
2022,4,29,2200,110,197,307,Friday
2022,4,29,2100,187,176,363,Friday
2022,4,29,2000,305,306,611,Friday
2022,4,29,1900,357,362,719,Friday
2022,4,29,1800,420,470,890,Friday
2022,4,29,1700,415,567,982,Friday
2022,4,29,1600,476,489,965,Friday
2022,4,29,1500,528,488,1016,Friday
2022,4,29,1400,450,376,826,Friday
2022,4,29,1300,441,330,771,Friday
2022,4,29,1200,523,298,821,Friday
2022,4,29,1100,525,265,790,Friday
2022,4,29,1000,401,171,572,Friday
2022,4,29,900,364,154,518,Friday
2022,4,29,800,215,76,291,Friday
2022,4,29,700,126,42,168,Friday
2022,4,29,600,66,33,99,Friday
2022,4,29,500,48,34,82,Friday
2022,4,29,400,39,49,88,Friday
2022,4,29,300,16,34,50,Friday
2022,4,29,200,35,52,87,Friday
2022,4,29,100,36,84,120,Friday
2022,4,28,2400,65,110,175,Thursday
2022,4,28,2300,76,129,205,Thursday
2022,4,28,2200,120,189,309,Thursday
2022,4,28,2100,162,209,371,Thursday
2022,4,28,2000,173,248,421,Thursday
2022,4,28,1900,250,357,607,Thursday
2022,4,28,1800,281,467,748,Thursday
2022,4,28,1700,301,514,815,Thursday
2022,4,28,1600,350,490,840,Thursday
2022,4,28,1500,348,429,777,Thursday
2022,4,28,1400,380,413,793,Thursday
2022,4,28,1300,387,331,718,Thursday
2022,4,28,1200,469,277,746,Thursday
2022,4,28,1100,494,237,731,Thursday
2022,4,28,1000,476,157,633,Thursday
2022,4,28,900,327,131,458,Thursday
2022,4,28,800,236,80,316,Thursday
2022,4,28,700,120,43,163,Thursday
2022,4,28,600,67,26,93,Thursday
2022,4,28,500,27,34,61,Thursday
2022,4,28,400,30,32,62,Thursday
2022,4,28,300,16,44,60,Thursday
2022,4,28,200,28,47,75,Thursday
2022,4,28,100,29,86,115,Thursday
2022,4,27,2400,50,87,137,Wednesday
2022,4,27,2300,82,106,188,Wednesday
2022,4,27,2200,108,129,237,Wednesday
2022,4,27,2100,116,216,332,Wednesday
2022,4,27,2000,155,190,345,Wednesday
2022,4,27,1900,157,267,424,Wednesday
2022,4,27,1800,200,370,570,Wednesday
2022,4,27,1700,267,430,697,Wednesday
2022,4,27,1600,281,480,761,Wednesday
2022,4,27,1500,296,336,632,Wednesday
2022,4,27,1400,331,297,628,Wednesday
2022,4,27,1300,331,299,630,Wednesday
2022,4,27,1200,420,224,644,Wednesday
2022,4,27,1100,393,186,579,Wednesday
2022,4,27,1000,413,151,564,Wednesday
2022,4,27,900,312,124,436,Wednesday
2022,4,27,800,183,74,257,Wednesday
2022,4,27,700,93,48,141,Wednesday
2022,4,27,600,49,32,81,Wednesday
2022,4,27,500,24,34,58,Wednesday
2022,4,27,400,26,32,58,Wednesday
2022,4,27,300,15,33,48,Wednesday
2022,4,27,200,29,54,83,Wednesday
2022,4,27,100,28,80,108,Wednesday
2022,4,26,2400,48,67,115,Tuesday
2022,4,26,2300,52,86,138,Tuesday
2022,4,26,2200,92,100,192,Tuesday
2022,4,26,2100,105,168,273,Tuesday
2022,4,26,2000,123,217,340,Tuesday
2022,4,26,1900,153,274,427,Tuesday
2022,4,26,1800,157,333,490,Tuesday
2022,4,26,1700,229,408,637,Tuesday
2022,4,26,1600,243,354,597,Tuesday
2022,4,26,1500,285,369,654,Tuesday
2022,4,26,1400,304,283,587,Tuesday
2022,4,26,1300,324,276,600,Tuesday
2022,4,26,1200,329,221,550,Tuesday
2022,4,26,1100,363,194,557,Tuesday
2022,4,26,1000,337,132,469,Tuesday
2022,4,26,900,273,89,362,Tuesday
2022,4,26,800,195,76,271,Tuesday
2022,4,26,700,104,37,141,Tuesday
2022,4,26,600,41,29,70,Tuesday
2022,4,26,500,32,33,65,Tuesday
2022,4,26,400,21,32,53,Tuesday
2022,4,26,300,22,25,47,Tuesday
2022,4,26,200,26,47,73,Tuesday
2022,4,26,100,36,55,91,Tuesday
2022,4,25,2400,51,86,137,Monday
2022,4,25,2300,50,118,168,Monday
2022,4,25,2200,100,133,233,Monday
2022,4,25,2100,107,168,275,Monday
2022,4,25,2000,137,190,327,Monday
2022,4,25,1900,157,317,474,Monday
2022,4,25,1800,197,431,628,Monday
2022,4,25,1700,302,521,823,Monday
2022,4,25,1600,302,492,794,Monday
2022,4,25,1500,309,387,696,Monday
2022,4,25,1400,398,355,753,Monday
2022,4,25,1300,390,301,691,Monday
2022,4,25,1200,472,262,734,Monday
2022,4,25,1100,467,195,662,Monday
2022,4,25,1000,476,142,618,Monday
2022,4,25,900,337,110,447,Monday
2022,4,25,800,244,75,319,Monday
2022,4,25,700,126,39,165,Monday
2022,4,25,600,56,21,77,Monday
2022,4,25,500,29,15,44,Monday
2022,4,25,400,16,19,35,Monday
2022,4,25,300,17,26,43,Monday
2022,4,25,200,15,38,53,Monday
2022,4,25,100,15,54,69,Monday
2022,4,24,2400,22,103,125,Sunday
2022,4,24,2300,22,257,279,Sunday
2022,4,24,2200,49,215,264,Sunday
2022,4,24,2100,78,332,410,Sunday
2022,4,24,2000,110,419,529,Sunday
2022,4,24,1900,164,626,790,Sunday
2022,4,24,1800,196,868,1064,Sunday
2022,4,24,1700,274,1138,1412,Sunday
2022,4,24,1600,319,918,1237,Sunday
2022,4,24,1500,400,764,1164,Sunday
2022,4,24,1400,401,631,1032,Sunday
2022,4,24,1300,519,507,1026,Sunday
2022,4,24,1200,615,404,1019,Sunday
2022,4,24,1100,637,225,862,Sunday
2022,4,24,1000,637,142,779,Sunday
2022,4,24,900,554,94,648,Sunday
2022,4,24,800,235,48,283,Sunday
2022,4,24,700,113,25,138,Sunday
2022,4,24,600,53,14,67,Sunday
2022,4,24,500,30,21,51,Sunday
2022,4,24,400,14,24,38,Sunday
2022,4,24,300,20,27,47,Sunday
2022,4,24,200,12,27,39,Sunday
2022,4,24,100,18,55,73,Sunday
2022,4,23,2400,21,58,79,Saturday
2022,4,23,2300,54,124,178,Saturday
2022,4,23,2200,62,166,228,Saturday
2022,4,23,2100,106,223,329,Saturday
2022,4,23,2000,105,291,396,Saturday
2022,4,23,1900,132,436,568,Saturday
2022,4,23,1800,200,765,965,Saturday
2022,4,23,1700,252,870,1122,Saturday
2022,4,23,1600,307,666,973,Saturday
2022,4,23,1500,352,605,957,Saturday
2022,4,23,1400,409,459,868,Saturday
2022,4,23,1300,435,451,886,Saturday
2022,4,23,1200,543,362,905,Saturday
2022,4,23,1100,575,150,725,Saturday
2022,4,23,1000,685,96,781,Saturday
2022,4,23,900,656,121,777,Saturday
2022,4,23,800,323,52,375,Saturday
2022,4,23,700,114,22,136,Saturday
2022,4,23,600,56,28,84,Saturday
2022,4,23,500,21,29,50,Saturday
2022,4,23,400,13,23,36,Saturday
2022,4,23,300,24,33,57,Saturday
2022,4,23,200,18,28,46,Saturday
2022,4,23,100,36,62,98,Saturday
2022,4,22,2400,30,74,104,Friday
2022,4,22,2300,64,108,172,Friday
2022,4,22,2200,91,119,210,Friday
2022,4,22,2100,154,187,341,Friday
2022,4,22,2000,209,229,438,Friday
2022,4,22,1900,279,299,578,Friday
2022,4,22,1800,362,435,797,Friday
2022,4,22,1700,342,480,822,Friday
2022,4,22,1600,441,547,988,Friday
2022,4,22,1500,430,397,827,Friday
2022,4,22,1400,358,403,761,Friday
2022,4,22,1300,425,317,742,Friday
2022,4,22,1200,430,274,704,Friday
2022,4,22,1100,469,239,708,Friday
2022,4,22,1000,428,158,586,Friday
2022,4,22,900,371,117,488,Friday
2022,4,22,800,209,62,271,Friday
2022,4,22,700,92,58,150,Friday
2022,4,22,600,35,25,60,Friday
2022,4,22,500,33,29,62,Friday
2022,4,22,400,24,35,59,Friday
2022,4,22,300,18,37,55,Friday
2022,4,22,200,29,44,73,Friday
2022,4,22,100,37,72,109,Friday
2022,4,21,2400,48,87,135,Thursday
2022,4,21,2300,92,125,217,Thursday
2022,4,21,2200,91,140,231,Thursday
2022,4,21,2100,117,165,282,Thursday
2022,4,21,2000,184,232,416,Thursday
2022,4,21,1900,216,314,530,Thursday
2022,4,21,1800,285,512,797,Thursday
2022,4,21,1700,288,621,909,Thursday
2022,4,21,1600,327,453,780,Thursday
2022,4,21,1500,352,392,744,Thursday
2022,4,21,1400,379,354,733,Thursday
2022,4,21,1300,406,327,733,Thursday
2022,4,21,1200,469,280,749,Thursday
2022,4,21,1100,516,211,727,Thursday
2022,4,21,1000,472,151,623,Thursday
2022,4,21,900,428,92,520,Thursday
2022,4,21,800,210,59,269,Thursday
2022,4,21,700,97,43,140,Thursday
2022,4,21,600,48,22,70,Thursday
2022,4,21,500,28,15,43,Thursday
2022,4,21,400,20,30,50,Thursday
2022,4,21,300,21,38,59,Thursday
2022,4,21,200,26,37,63,Thursday
2022,4,21,100,41,68,109,Thursday
2022,4,20,2400,57,106,163,Wednesday
2022,4,20,2300,54,99,153,Wednesday
2022,4,20,2200,81,131,212,Wednesday
2022,4,20,2100,131,178,309,Wednesday
2022,4,20,2000,157,213,370,Wednesday
2022,4,20,1900,197,334,531,Wednesday
2022,4,20,1800,210,460,670,Wednesday
2022,4,20,1700,291,567,858,Wednesday
2022,4,20,1600,329,463,792,Wednesday
2022,4,20,1500,371,400,771,Wednesday
2022,4,20,1400,356,354,710,Wednesday
2022,4,20,1300,325,348,673,Wednesday
2022,4,20,1200,414,202,616,Wednesday
2022,4,20,1100,452,179,631,Wednesday
2022,4,20,1000,486,131,617,Wednesday
2022,4,20,900,431,109,540,Wednesday
2022,4,20,800,181,70,251,Wednesday
2022,4,20,700,70,40,110,Wednesday
2022,4,20,600,49,39,88,Wednesday
2022,4,20,500,22,24,46,Wednesday
2022,4,20,400,19,38,57,Wednesday
2022,4,20,300,30,25,55,Wednesday
2022,4,20,200,22,40,62,Wednesday
2022,4,20,100,33,45,78,Wednesday
2022,4,19,2400,35,79,114,Tuesday
2022,4,19,2300,43,98,141,Tuesday
2022,4,19,2200,53,167,220,Tuesday
2022,4,19,2100,100,171,271,Tuesday
2022,4,19,2000,99,259,358,Tuesday
2022,4,19,1900,123,260,383,Tuesday
2022,4,19,1800,153,373,526,Tuesday
2022,4,19,1700,213,488,701,Tuesday
2022,4,19,1600,205,423,628,Tuesday
2022,4,19,1500,296,422,718,Tuesday
2022,4,19,1400,299,289,588,Tuesday
2022,4,19,1300,335,301,636,Tuesday
2022,4,19,1200,349,286,635,Tuesday
2022,4,19,1100,421,177,598,Tuesday
2022,4,19,1000,500,109,609,Tuesday
2022,4,19,900,406,114,520,Tuesday
2022,4,19,800,246,72,318,Tuesday
2022,4,19,700,115,40,155,Tuesday
2022,4,19,600,58,28,86,Tuesday
2022,4,19,500,32,22,54,Tuesday
2022,4,19,400,26,30,56,Tuesday
2022,4,19,300,24,31,55,Tuesday
2022,4,19,200,15,36,51,Tuesday
2022,4,19,100,30,63,93,Tuesday
2022,4,18,2400,37,93,130,Monday
2022,4,18,2300,58,124,182,Monday
2022,4,18,2200,88,174,262,Monday
2022,4,18,2100,111,268,379,Monday
2022,4,18,2000,167,368,535,Monday
2022,4,18,1900,209,643,852,Monday
2022,4,18,1800,279,896,1175,Monday
2022,4,18,1700,332,1056,1388,Monday
2022,4,18,1600,452,1000,1452,Monday
2022,4,18,1500,549,1001,1550,Monday
2022,4,18,1400,591,799,1390,Monday
2022,4,18,1300,706,729,1435,Monday
2022,4,18,1200,766,540,1306,Monday
2022,4,18,1100,817,327,1144,Monday
2022,4,18,1000,746,216,962,Monday
2022,4,18,900,525,97,622,Monday
2022,4,18,800,306,46,352,Monday
2022,4,18,700,144,29,173,Monday
2022,4,18,600,51,19,70,Monday
2022,4,18,500,25,15,40,Monday
2022,4,18,400,26,15,41,Monday
2022,4,18,300,17,22,39,Monday
2022,4,18,200,18,36,54,Monday
2022,4,18,100,12,53,65,Monday
2022,4,17,2400,29,90,119,Sunday
2022,4,17,2300,45,154,199,Sunday
2022,4,17,2200,74,221,295,Sunday
2022,4,17,2100,86,311,397,Sunday
2022,4,17,2000,122,494,616,Sunday
2022,4,17,1900,136,650,786,Sunday
2022,4,17,1800,211,1000,1211,Sunday
2022,4,17,1700,275,1248,1523,Sunday
2022,4,17,1600,384,1162,1546,Sunday
2022,4,17,1500,482,1029,1511,Sunday
2022,4,17,1400,564,985,1549,Sunday
2022,4,17,1300,629,773,1402,Sunday
2022,4,17,1200,716,515,1231,Sunday
2022,4,17,1100,689,284,973,Sunday
2022,4,17,1000,589,158,747,Sunday
2022,4,17,900,535,106,641,Sunday
2022,4,17,800,276,24,300,Sunday
2022,4,17,700,102,26,128,Sunday
2022,4,17,600,35,22,57,Sunday
2022,4,17,500,19,12,31,Sunday
2022,4,17,400,15,16,31,Sunday
2022,4,17,300,9,15,24,Sunday
2022,4,17,200,20,23,43,Sunday
2022,4,17,100,28,34,62,Sunday
2022,4,16,2400,33,55,88,Saturday
2022,4,16,2300,42,79,121,Saturday
2022,4,16,2200,77,131,208,Saturday
2022,4,16,2100,96,200,296,Saturday
2022,4,16,2000,98,306,404,Saturday
2022,4,16,1900,187,433,620,Saturday
2022,4,16,1800,203,816,1019,Saturday
2022,4,16,1700,286,1091,1377,Saturday
2022,4,16,1600,384,791,1175,Saturday
2022,4,16,1500,443,588,1031,Saturday
2022,4,16,1400,538,526,1064,Saturday
2022,4,16,1300,601,429,1030,Saturday
2022,4,16,1200,747,305,1052,Saturday
2022,4,16,1100,705,229,934,Saturday
2022,4,16,1000,675,174,849,Saturday
2022,4,16,900,663,90,753,Saturday
2022,4,16,800,380,38,418,Saturday
2022,4,16,700,113,10,123,Saturday
2022,4,16,600,54,17,71,Saturday
2022,4,16,500,36,20,56,Saturday
2022,4,16,400,22,19,41,Saturday
2022,4,16,300,37,11,48,Saturday
2022,4,16,200,25,28,53,Saturday
2022,4,16,100,30,37,67,Saturday
2022,4,15,2400,45,43,88,Friday
2022,4,15,2300,50,62,112,Friday
2022,4,15,2200,83,128,211,Friday
2022,4,15,2100,118,205,323,Friday
2022,4,15,2000,152,276,428,Friday
2022,4,15,1900,208,421,629,Friday
2022,4,15,1800,334,672,1006,Friday
2022,4,15,1700,477,915,1392,Friday
2022,4,15,1600,624,810,1434,Friday
2022,4,15,1500,753,687,1440,Friday
2022,4,15,1400,887,625,1512,Friday
2022,4,15,1300,1053,517,1570,Friday
2022,4,15,1200,1195,424,1619,Friday
2022,4,15,1100,1183,321,1504,Friday
2022,4,15,1000,1024,212,1236,Friday
2022,4,15,900,787,146,933,Friday
2022,4,15,800,446,74,520,Friday
2022,4,15,700,195,44,239,Friday
2022,4,15,600,59,21,80,Friday
2022,4,15,500,41,37,78,Friday
2022,4,15,400,25,22,47,Friday
2022,4,15,300,26,37,63,Friday
2022,4,15,200,28,47,75,Friday
2022,4,15,100,40,87,127,Friday
2022,4,14,2400,86,216,302,Thursday
2022,4,14,2300,101,74,175,Thursday
2022,4,14,2200,166,107,273,Thursday
2022,4,14,2100,349,232,581,Thursday
2022,4,14,2000,634,315,949,Thursday
2022,4,14,1900,746,388,1134,Thursday
2022,4,14,1800,692,468,1160,Thursday
2022,4,14,1700,572,654,1226,Thursday
2022,4,14,1600,523,573,1096,Thursday
2022,4,14,1500,501,523,1024,Thursday
2022,4,14,1400,530,488,1018,Thursday
2022,4,14,1300,507,336,843,Thursday
2022,4,14,1200,630,320,950,Thursday
2022,4,14,1100,600,260,860,Thursday
2022,4,14,1000,508,195,703,Thursday
2022,4,14,900,402,214,616,Thursday
2022,4,14,800,267,49,316,Thursday
2022,4,14,700,143,35,178,Thursday
2022,4,14,600,54,29,83,Thursday
2022,4,14,500,20,16,36,Thursday
2022,4,14,400,20,32,52,Thursday
2022,4,14,300,14,20,34,Thursday
2022,4,14,200,22,26,48,Thursday
2022,4,14,100,28,19,47,Thursday
2022,4,13,2400,46,91,137,Wednesday
2022,4,13,2300,67,101,168,Wednesday
2022,4,13,2200,75,145,220,Wednesday
2022,4,13,2100,132,172,304,Wednesday
2022,4,13,2000,213,250,463,Wednesday
2022,4,13,1900,238,320,558,Wednesday
2022,4,13,1800,259,422,681,Wednesday
2022,4,13,1700,299,497,796,Wednesday
2022,4,13,1600,335,409,744,Wednesday
2022,4,13,1500,349,368,717,Wednesday
2022,4,13,1400,344,360,704,Wednesday
2022,4,13,1300,385,315,700,Wednesday
2022,4,13,1200,437,248,685,Wednesday
2022,4,13,1100,434,189,623,Wednesday
2022,4,13,1000,444,217,661,Wednesday
2022,4,13,900,318,175,493,Wednesday
2022,4,13,800,252,30,282,Wednesday
2022,4,13,700,118,45,163,Wednesday
2022,4,13,600,49,21,70,Wednesday
2022,4,13,500,17,17,34,Wednesday
2022,4,13,400,20,16,36,Wednesday
2022,4,13,300,24,29,53,Wednesday
2022,4,13,200,26,19,45,Wednesday
2022,4,13,100,41,10,51,Wednesday
2022,4,12,2400,43,48,91,Tuesday
2022,4,12,2300,51,89,140,Tuesday
2022,4,12,2200,66,129,195,Tuesday
2022,4,12,2100,114,198,312,Tuesday
2022,4,12,2000,179,209,388,Tuesday
2022,4,12,1900,168,270,438,Tuesday
2022,4,12,1800,202,330,532,Tuesday
2022,4,12,1700,228,490,718,Tuesday
2022,4,12,1600,258,425,683,Tuesday
2022,4,12,1500,256,297,553,Tuesday
2022,4,12,1400,284,312,596,Tuesday
2022,4,12,1300,322,316,638,Tuesday
2022,4,12,1200,373,238,611,Tuesday
2022,4,12,1100,387,153,540,Tuesday
2022,4,12,1000,345,211,556,Tuesday
2022,4,12,900,291,187,478,Tuesday
2022,4,12,800,188,60,248,Tuesday
2022,4,12,700,106,41,147,Tuesday
2022,4,12,600,50,28,78,Tuesday
2022,4,12,500,26,27,53,Tuesday
2022,4,12,400,16,29,45,Tuesday
2022,4,12,300,11,22,33,Tuesday
2022,4,12,200,22,26,48,Tuesday
2022,4,12,100,33,19,52,Tuesday
2022,4,11,2400,29,99,128,Monday
2022,4,11,2300,47,84,131,Monday
2022,4,11,2200,53,121,174,Monday
2022,4,11,2100,102,190,292,Monday
2022,4,11,2000,149,189,338,Monday
2022,4,11,1900,168,306,474,Monday
2022,4,11,1800,221,393,614,Monday
2022,4,11,1700,260,513,773,Monday
2022,4,11,1600,252,436,688,Monday
2022,4,11,1500,291,373,664,Monday
2022,4,11,1400,348,319,667,Monday
2022,4,11,1300,368,274,642,Monday
2022,4,11,1200,473,276,749,Monday
2022,4,11,1100,450,173,623,Monday
2022,4,11,1000,393,152,545,Monday
2022,4,11,900,343,145,488,Monday
2022,4,11,800,226,39,265,Monday
2022,4,11,700,103,28,131,Monday
2022,4,11,600,38,13,51,Monday
2022,4,11,500,24,12,36,Monday
2022,4,11,400,8,6,14,Monday
2022,4,11,300,17,17,34,Monday
2022,4,11,200,16,20,36,Monday
2022,4,11,100,13,24,37,Monday
2022,4,10,2400,30,48,78,Sunday
2022,4,10,2300,38,87,125,Sunday
2022,4,10,2200,52,143,195,Sunday
2022,4,10,2100,87,251,338,Sunday
2022,4,10,2000,135,348,483,Sunday
2022,4,10,1900,173,563,736,Sunday
2022,4,10,1800,215,827,1042,Sunday
2022,4,10,1700,266,1074,1340,Sunday
2022,4,10,1600,277,803,1080,Sunday
2022,4,10,1500,349,732,1081,Sunday
2022,4,10,1400,360,627,987,Sunday
2022,4,10,1300,454,490,944,Sunday
2022,4,10,1200,529,422,951,Sunday
2022,4,10,1100,505,230,735,Sunday
2022,4,10,1000,559,166,725,Sunday
2022,4,10,900,598,73,671,Sunday
2022,4,10,800,398,37,435,Sunday
2022,4,10,700,120,14,134,Sunday
2022,4,10,600,32,13,45,Sunday
2022,4,10,500,6,15,21,Sunday
2022,4,10,400,13,27,40,Sunday
2022,4,10,300,14,20,34,Sunday
2022,4,10,200,24,31,55,Sunday
2022,4,10,100,26,38,64,Sunday
2022,4,9,2400,17,60,77,Saturday
2022,4,9,2300,34,79,113,Saturday
2022,4,9,2200,59,138,197,Saturday
2022,4,9,2100,102,170,272,Saturday
2022,4,9,2000,118,245,363,Saturday
2022,4,9,1900,140,334,474,Saturday
2022,4,9,1800,197,691,888,Saturday
2022,4,9,1700,272,965,1237,Saturday
2022,4,9,1600,325,600,925,Saturday
2022,4,9,1500,349,472,821,Saturday
2022,4,9,1400,360,361,721,Saturday
2022,4,9,1300,393,417,810,Saturday
2022,4,9,1200,490,289,779,Saturday
2022,4,9,1100,562,233,795,Saturday
2022,4,9,1000,564,189,753,Saturday
2022,4,9,900,721,162,883,Saturday
2022,4,9,800,510,58,568,Saturday
2022,4,9,700,176,25,201,Saturday
2022,4,9,600,56,13,69,Saturday
2022,4,9,500,15,17,32,Saturday
2022,4,9,400,8,9,17,Saturday
2022,4,9,300,20,11,31,Saturday
2022,4,9,200,19,12,31,Saturday
2022,4,9,100,28,15,43,Saturday
2022,4,8,2400,33,96,129,Friday
2022,4,8,2300,51,95,146,Friday
2022,4,8,2200,96,137,233,Friday
2022,4,8,2100,203,178,381,Friday
2022,4,8,2000,362,196,558,Friday
2022,4,8,1900,409,276,685,Friday
2022,4,8,1800,428,412,840,Friday
2022,4,8,1700,437,708,1145,Friday
2022,4,8,1600,446,493,939,Friday
2022,4,8,1500,406,381,787,Friday
2022,4,8,1400,390,421,811,Friday
2022,4,8,1300,376,372,748,Friday
2022,4,8,1200,454,326,780,Friday
2022,4,8,1100,450,241,691,Friday
2022,4,8,1000,431,236,667,Friday
2022,4,8,900,375,207,582,Friday
2022,4,8,800,244,57,301,Friday
2022,4,8,700,112,30,142,Friday
2022,4,8,600,56,28,84,Friday
2022,4,8,500,25,16,41,Friday
2022,4,8,400,18,25,43,Friday
2022,4,8,300,13,18,31,Friday
2022,4,8,200,32,21,53,Friday
2022,4,8,100,38,18,56,Friday
2022,4,7,2400,50,106,156,Thursday
2022,4,7,2300,63,104,167,Thursday
2022,4,7,2200,93,153,246,Thursday
2022,4,7,2100,159,192,351,Thursday
2022,4,7,2000,220,227,447,Thursday
2022,4,7,1900,229,301,530,Thursday
2022,4,7,1800,250,484,734,Thursday
2022,4,7,1700,266,653,919,Thursday
2022,4,7,1600,286,494,780,Thursday
2022,4,7,1500,327,410,737,Thursday
2022,4,7,1400,309,279,588,Thursday
2022,4,7,1300,344,328,672,Thursday
2022,4,7,1200,439,247,686,Thursday
2022,4,7,1100,485,208,693,Thursday
2022,4,7,1000,498,190,688,Thursday
2022,4,7,900,400,192,592,Thursday
2022,4,7,800,265,51,316,Thursday
2022,4,7,700,129,44,173,Thursday
2022,4,7,600,70,19,89,Thursday
2022,4,7,500,30,22,52,Thursday
2022,4,7,400,21,13,34,Thursday
2022,4,7,300,26,22,48,Thursday
2022,4,7,200,25,27,52,Thursday
2022,4,7,100,39,21,60,Thursday
2022,4,6,2400,42,89,131,Wednesday
2022,4,6,2300,70,76,146,Wednesday
2022,4,6,2200,88,136,224,Wednesday
2022,4,6,2100,137,189,326,Wednesday
2022,4,6,2000,205,248,453,Wednesday
2022,4,6,1900,247,284,531,Wednesday
2022,4,6,1800,241,457,698,Wednesday
2022,4,6,1700,260,604,864,Wednesday
2022,4,6,1600,279,464,743,Wednesday
2022,4,6,1500,300,380,680,Wednesday
2022,4,6,1400,314,326,640,Wednesday
2022,4,6,1300,324,277,601,Wednesday
2022,4,6,1200,376,247,623,Wednesday
2022,4,6,1100,460,188,648,Wednesday
2022,4,6,1000,413,220,633,Wednesday
2022,4,6,900,417,177,594,Wednesday
2022,4,6,800,254,51,305,Wednesday
2022,4,6,700,122,31,153,Wednesday
2022,4,6,600,47,25,72,Wednesday
2022,4,6,500,29,20,49,Wednesday
2022,4,6,400,20,17,37,Wednesday
2022,4,6,300,17,36,53,Wednesday
2022,4,6,200,25,16,41,Wednesday
2022,4,6,100,29,17,46,Wednesday
2022,4,5,2400,51,83,134,Tuesday
2022,4,5,2300,51,83,134,Tuesday
2022,4,5,2200,85,138,223,Tuesday
2022,4,5,2100,104,171,275,Tuesday
2022,4,5,2000,156,221,377,Tuesday
2022,4,5,1900,178,292,470,Tuesday
2022,4,5,1800,198,380,578,Tuesday
2022,4,5,1700,227,527,754,Tuesday
2022,4,5,1600,256,444,700,Tuesday
2022,4,5,1500,282,348,630,Tuesday
2022,4,5,1400,277,269,546,Tuesday
2022,4,5,1300,301,263,564,Tuesday
2022,4,5,1200,368,236,604,Tuesday
2022,4,5,1100,393,183,576,Tuesday
2022,4,5,1000,367,188,555,Tuesday
2022,4,5,900,372,140,512,Tuesday
2022,4,5,800,233,30,263,Tuesday
2022,4,5,700,111,24,135,Tuesday
2022,4,5,600,48,16,64,Tuesday
2022,4,5,500,21,16,37,Tuesday
2022,4,5,400,13,8,21,Tuesday
2022,4,5,300,13,20,33,Tuesday
2022,4,5,200,15,18,33,Tuesday
2022,4,5,100,23,16,39,Tuesday
2022,4,4,2400,45,70,115,Monday
2022,4,4,2300,63,91,154,Monday
2022,4,4,2200,46,129,175,Monday
2022,4,4,2100,98,170,268,Monday
2022,4,4,2000,124,266,390,Monday
2022,4,4,1900,175,610,785,Monday
2022,4,4,1800,195,425,620,Monday
2022,4,4,1700,264,380,644,Monday
2022,4,4,1600,299,307,606,Monday
2022,4,4,1500,319,247,566,Monday
2022,4,4,1400,326,230,556,Monday
2022,4,4,1300,343,220,563,Monday
2022,4,4,1200,427,214,641,Monday
2022,4,4,1100,346,161,507,Monday
2022,4,4,1000,374,154,528,Monday
2022,4,4,900,313,109,422,Monday
2022,4,4,800,231,33,264,Monday
2022,4,4,700,115,23,138,Monday
2022,4,4,600,48,12,60,Monday
2022,4,4,500,18,8,26,Monday
2022,4,4,400,25,21,46,Monday
2022,4,4,300,17,16,33,Monday
2022,4,4,200,23,17,40,Monday
2022,4,4,100,28,12,40,Monday
2022,4,3,2400,28,78,106,Sunday
2022,4,3,2300,33,95,128,Sunday
2022,4,3,2200,45,134,179,Sunday
2022,4,3,2100,106,249,355,Sunday
2022,4,3,2000,134,363,497,Sunday
2022,4,3,1900,132,507,639,Sunday
2022,4,3,1800,214,814,1028,Sunday
2022,4,3,1700,300,1170,1470,Sunday
2022,4,3,1600,315,961,1276,Sunday
2022,4,3,1500,391,855,1246,Sunday
2022,4,3,1400,455,812,1267,Sunday
2022,4,3,1300,468,663,1131,Sunday
2022,4,3,1200,534,495,1029,Sunday
2022,4,3,1100,557,325,882,Sunday
2022,4,3,1000,630,184,814,Sunday
2022,4,3,900,644,98,742,Sunday
2022,4,3,800,370,32,402,Sunday
2022,4,3,700,116,20,136,Sunday
2022,4,3,600,38,20,58,Sunday
2022,4,3,500,18,15,33,Sunday
2022,4,3,400,11,19,30,Sunday
2022,4,3,300,14,28,42,Sunday
2022,4,3,200,21,27,48,Sunday
2022,4,3,100,24,38,62,Sunday
2022,4,2,2400,32,57,89,Saturday
2022,4,2,2300,52,79,131,Saturday
2022,4,2,2200,75,117,192,Saturday
2022,4,2,2100,87,178,265,Saturday
2022,4,2,2000,138,290,428,Saturday
2022,4,2,1900,144,367,511,Saturday
2022,4,2,1800,209,712,921,Saturday
2022,4,2,1700,237,1484,1721,Saturday
2022,4,2,1600,318,831,1149,Saturday
2022,4,2,1500,336,408,744,Saturday
2022,4,2,1400,389,435,824,Saturday
2022,4,2,1300,448,357,805,Saturday
2022,4,2,1200,529,341,870,Saturday
2022,4,2,1100,555,196,751,Saturday
2022,4,2,1000,624,194,818,Saturday
2022,4,2,900,782,197,979,Saturday
2022,4,2,800,466,37,503,Saturday
2022,4,2,700,149,27,176,Saturday
2022,4,2,600,57,34,91,Saturday
2022,4,2,500,15,18,33,Saturday
2022,4,2,400,19,14,33,Saturday
2022,4,2,300,20,17,37,Saturday
2022,4,2,200,22,30,52,Saturday
2022,4,2,100,18,18,36,Saturday
2022,4,1,2400,55,90,145,Friday
2022,4,1,2300,54,91,145,Friday
2022,4,1,2200,95,127,222,Friday
2022,4,1,2100,170,218,388,Friday
2022,4,1,2000,314,236,550,Friday
2022,4,1,1900,389,388,777,Friday
2022,4,1,1800,491,676,1167,Friday
2022,4,1,1700,523,939,1462,Friday
2022,4,1,1600,475,637,1112,Friday
2022,4,1,1500,513,519,1032,Friday
2022,4,1,1400,419,496,915,Friday
2022,4,1,1300,487,467,954,Friday
2022,4,1,1200,551,456,1007,Friday
2022,4,1,1100,580,222,802,Friday
2022,4,1,1000,580,229,809,Friday
2022,4,1,900,584,182,766,Friday
2022,4,1,800,362,41,403,Friday
2022,4,1,700,159,44,203,Friday
2022,4,1,600,66,31,97,Friday
2022,4,1,500,33,27,60,Friday
2022,4,1,400,28,32,60,Friday
2022,4,1,300,36,32,68,Friday
2022,4,1,200,39,25,64,Friday
2022,4,1,100,38,18,56,Friday
2022,3,31,2400,53,76,129,Thursday
2022,3,31,2300,61,87,148,Thursday
2022,3,31,2200,88,161,249,Thursday
2022,3,31,2100,177,263,440,Thursday
2022,3,31,2000,229,229,458,Thursday
2022,3,31,1900,303,343,646,Thursday
2022,3,31,1800,286,684,970,Thursday
2022,3,31,1700,304,892,1196,Thursday
2022,3,31,1600,385,387,772,Thursday
2022,3,31,1500,411,566,977,Thursday
2022,3,31,1400,397,335,732,Thursday
2022,3,31,1300,390,314,704,Thursday
2022,3,31,1200,476,262,738,Thursday
2022,3,31,1100,465,143,608,Thursday
2022,3,31,1000,459,258,717,Thursday
2022,3,31,900,493,180,673,Thursday
2022,3,31,800,274,43,317,Thursday
2022,3,31,700,146,44,190,Thursday
2022,3,31,600,64,23,87,Thursday
2022,3,31,500,23,18,41,Thursday
2022,3,31,400,11,22,33,Thursday
2022,3,31,300,16,22,38,Thursday
2022,3,31,200,23,22,45,Thursday
2022,3,31,100,44,19,63,Thursday
2022,3,30,2400,45,87,132,Wednesday
2022,3,30,2300,85,81,166,Wednesday
2022,3,30,2200,86,122,208,Wednesday
2022,3,30,2100,138,175,313,Wednesday
2022,3,30,2000,155,249,404,Wednesday
2022,3,30,1900,204,336,540,Wednesday
2022,3,30,1800,251,464,715,Wednesday
2022,3,30,1700,255,681,936,Wednesday
2022,3,30,1600,311,671,982,Wednesday
2022,3,30,1500,347,642,989,Wednesday
2022,3,30,1400,381,429,810,Wednesday
2022,3,30,1300,354,370,724,Wednesday
2022,3,30,1200,425,262,687,Wednesday
2022,3,30,1100,432,129,561,Wednesday
2022,3,30,1000,480,398,878,Wednesday
2022,3,30,900,442,222,664,Wednesday
2022,3,30,800,243,61,304,Wednesday
2022,3,30,700,123,96,219,Wednesday
2022,3,30,600,55,46,101,Wednesday
2022,3,30,500,23,10,33,Wednesday
2022,3,30,400,19,6,25,Wednesday
2022,3,30,300,14,6,20,Wednesday
2022,3,30,200,19,7,26,Wednesday
2022,3,30,100,26,10,36,Wednesday
2022,3,29,2400,28,16,44,Tuesday
2022,3,29,2300,50,50,100,Tuesday
2022,3,29,2200,75,42,117,Tuesday
2022,3,29,2100,119,76,195,Tuesday
2022,3,29,2000,175,137,312,Tuesday
2022,3,29,1900,217,408,625,Tuesday
2022,3,29,1800,245,408,653,Tuesday
2022,3,29,1700,253,664,917,Tuesday
2022,3,29,1600,303,555,858,Tuesday
2022,3,29,1500,352,422,774,Tuesday
2022,3,29,1400,320,383,703,Tuesday
2022,3,29,1300,385,416,801,Tuesday
2022,3,29,1200,521,334,855,Tuesday
2022,3,29,1100,540,297,837,Tuesday
2022,3,29,1000,638,309,947,Tuesday
2022,3,29,900,586,195,781,Tuesday
2022,3,29,800,262,35,297,Tuesday
2022,3,29,700,108,24,132,Tuesday
2022,3,29,600,68,22,90,Tuesday
2022,3,29,500,23,22,45,Tuesday
2022,3,29,400,11,29,40,Tuesday
2022,3,29,300,11,90,101,Tuesday
2022,3,29,200,15,57,72,Tuesday
2022,3,29,100,26,15,41,Tuesday
2022,3,28,2400,43,13,56,Monday
2022,3,28,2300,47,14,61,Monday
2022,3,28,2200,41,38,79,Monday
2022,3,28,2100,97,147,244,Monday
2022,3,28,2000,168,178,346,Monday
2022,3,28,1900,171,378,549,Monday
2022,3,28,1800,250,663,913,Monday
2022,3,28,1700,314,486,800,Monday
2022,3,28,1600,393,565,958,Monday
2022,3,28,1500,388,569,957,Monday
2022,3,28,1400,388,334,722,Monday
2022,3,28,1300,465,258,723,Monday
2022,3,28,1200,509,274,783,Monday
2022,3,28,1100,530,214,744,Monday
2022,3,28,1000,531,183,714,Monday
2022,3,28,900,485,140,625,Monday
2022,3,28,800,298,40,338,Monday
2022,3,28,700,107,27,134,Monday
2022,3,28,600,56,12,68,Monday
2022,3,28,500,10,5,15,Monday
2022,3,28,400,12,18,30,Monday
2022,3,28,300,18,18,36,Monday
2022,3,28,200,17,11,28,Monday
2022,3,28,100,20,10,30,Monday
2022,3,27,2400,36,77,113,Sunday
2022,3,27,2300,48,94,142,Sunday
2022,3,27,2200,53,159,212,Sunday
2022,3,27,2100,102,260,362,Sunday
2022,3,27,2000,141,369,510,Sunday
2022,3,27,1900,215,630,845,Sunday
2022,3,27,1800,273,956,1229,Sunday
2022,3,27,1700,405,1355,1760,Sunday
2022,3,27,1600,496,1099,1595,Sunday
2022,3,27,1500,551,952,1503,Sunday
2022,3,27,1400,545,801,1346,Sunday
2022,3,27,1300,588,696,1284,Sunday
2022,3,27,1200,622,560,1182,Sunday
2022,3,27,1100,575,293,868,Sunday
2022,3,27,1000,593,180,773,Sunday
2022,3,27,900,648,119,767,Sunday
2022,3,27,800,449,36,485,Sunday
2022,3,27,700,100,16,116,Sunday
2022,3,27,600,56,30,86,Sunday
2022,3,27,500,17,22,39,Sunday
2022,3,27,400,15,10,25,Sunday
2022,3,27,300,15,21,36,Sunday
2022,3,27,200,11,30,41,Sunday
2022,3,27,100,25,45,70,Sunday
2022,3,26,2400,34,60,94,Saturday
2022,3,26,2300,42,111,153,Saturday
2022,3,26,2200,76,131,207,Saturday
2022,3,26,2100,87,187,274,Saturday
2022,3,26,2000,137,267,404,Saturday
2022,3,26,1900,197,437,634,Saturday
2022,3,26,1800,260,919,1179,Saturday
2022,3,26,1700,347,1264,1611,Saturday
2022,3,26,1600,440,960,1400,Saturday
2022,3,26,1500,501,629,1130,Saturday
2022,3,26,1400,476,407,883,Saturday
2022,3,26,1300,553,494,1047,Saturday
2022,3,26,1200,623,375,998,Saturday
2022,3,26,1100,602,258,860,Saturday
2022,3,26,1000,609,231,840,Saturday
2022,3,26,900,941,192,1133,Saturday
2022,3,26,800,520,37,557,Saturday
2022,3,26,700,152,38,190,Saturday
2022,3,26,600,53,21,74,Saturday
2022,3,26,500,11,13,24,Saturday
2022,3,26,400,20,25,45,Saturday
2022,3,26,300,20,25,45,Saturday
2022,3,26,200,19,29,48,Saturday
2022,3,26,100,43,17,60,Saturday
2022,3,25,2400,50,66,116,Friday
2022,3,25,2300,68,96,164,Friday
2022,3,25,2200,116,151,267,Friday
2022,3,25,2100,208,206,414,Friday
2022,3,25,2000,361,273,634,Friday
2022,3,25,1900,473,368,841,Friday
2022,3,25,1800,503,703,1206,Friday
2022,3,25,1700,528,1023,1551,Friday
2022,3,25,1600,559,756,1315,Friday
2022,3,25,1500,513,601,1114,Friday
2022,3,25,1400,510,603,1113,Friday
2022,3,25,1300,531,583,1114,Friday
2022,3,25,1200,555,489,1044,Friday
2022,3,25,1100,613,280,893,Friday
2022,3,25,1000,604,471,1075,Friday
2022,3,25,900,656,282,938,Friday
2022,3,25,800,334,92,426,Friday
2022,3,25,700,123,69,192,Friday
2022,3,25,600,55,27,82,Friday
2022,3,25,500,31,4,35,Friday
2022,3,25,400,32,4,36,Friday
2022,3,25,300,23,3,26,Friday
2022,3,25,200,37,6,43,Friday
2022,3,25,100,36,6,42,Friday
2022,3,24,2400,55,19,74,Thursday
2022,3,24,2300,79,26,105,Thursday
2022,3,24,2200,97,39,136,Thursday
2022,3,24,2100,191,77,268,Thursday
2022,3,24,2000,268,121,389,Thursday
2022,3,24,1900,297,245,542,Thursday
2022,3,24,1800,357,497,854,Thursday
2022,3,24,1700,411,605,1016,Thursday
2022,3,24,1600,453,579,1032,Thursday
2022,3,24,1500,478,469,947,Thursday
2022,3,24,1400,394,447,841,Thursday
2022,3,24,1300,426,402,828,Thursday
2022,3,24,1200,499,277,776,Thursday
2022,3,24,1100,480,227,707,Thursday
2022,3,24,1000,559,238,797,Thursday
2022,3,24,900,538,172,710,Thursday
2022,3,24,800,276,46,322,Thursday
2022,3,24,700,117,37,154,Thursday
2022,3,24,600,44,23,67,Thursday
2022,3,24,500,23,22,45,Thursday
2022,3,24,400,12,19,31,Thursday
2022,3,24,300,14,17,31,Thursday
2022,3,24,200,23,20,43,Thursday
2022,3,24,100,27,12,39,Thursday
2022,3,23,2400,52,80,132,Wednesday
2022,3,23,2300,49,89,138,Wednesday
2022,3,23,2200,72,116,188,Wednesday
2022,3,23,2100,153,213,366,Wednesday
2022,3,23,2000,203,383,586,Wednesday
2022,3,23,1900,213,212,425,Wednesday
2022,3,23,1800,249,463,712,Wednesday
2022,3,23,1700,311,736,1047,Wednesday
2022,3,23,1600,342,633,975,Wednesday
2022,3,23,1500,411,510,921,Wednesday
2022,3,23,1400,411,472,883,Wednesday
2022,3,23,1300,478,453,931,Wednesday
2022,3,23,1200,549,219,768,Wednesday
2022,3,23,1100,497,180,677,Wednesday
2022,3,23,1000,520,216,736,Wednesday
2022,3,23,900,486,190,676,Wednesday
2022,3,23,800,257,38,295,Wednesday
2022,3,23,700,114,39,153,Wednesday
2022,3,23,600,58,21,79,Wednesday
2022,3,23,500,21,15,36,Wednesday
2022,3,23,400,21,23,44,Wednesday
2022,3,23,300,19,19,38,Wednesday
2022,3,23,200,13,24,37,Wednesday
2022,3,23,100,35,18,53,Wednesday
2022,3,22,2400,41,98,139,Tuesday
2022,3,22,2300,65,91,156,Tuesday
2022,3,22,2200,55,148,203,Tuesday
2022,3,22,2100,109,190,299,Tuesday
2022,3,22,2000,176,237,413,Tuesday
2022,3,22,1900,176,392,568,Tuesday
2022,3,22,1800,213,572,785,Tuesday
2022,3,22,1700,265,706,971,Tuesday
2022,3,22,1600,309,571,880,Tuesday
2022,3,22,1500,338,482,820,Tuesday
2022,3,22,1400,407,412,819,Tuesday
2022,3,22,1300,432,395,827,Tuesday
2022,3,22,1200,486,283,769,Tuesday
2022,3,22,1100,499,207,706,Tuesday
2022,3,22,1000,505,217,722,Tuesday
2022,3,22,900,502,189,691,Tuesday
2022,3,22,800,244,46,290,Tuesday
2022,3,22,700,130,33,163,Tuesday
2022,3,22,600,61,19,80,Tuesday
2022,3,22,500,28,27,55,Tuesday
2022,3,22,400,15,20,35,Tuesday
2022,3,22,300,24,32,56,Tuesday
2022,3,22,200,19,27,46,Tuesday
2022,3,22,100,24,12,36,Tuesday
2022,3,21,2400,37,105,142,Monday
2022,3,21,2300,52,77,129,Monday
2022,3,21,2200,73,137,210,Monday
2022,3,21,2100,109,191,300,Monday
2022,3,21,2000,171,243,414,Monday
2022,3,21,1900,174,328,502,Monday
2022,3,21,1800,249,602,851,Monday
2022,3,21,1700,299,889,1188,Monday
2022,3,21,1600,404,602,1006,Monday
2022,3,21,1500,438,514,952,Monday
2022,3,21,1400,428,411,839,Monday
2022,3,21,1300,515,374,889,Monday
2022,3,21,1200,500,285,785,Monday
2022,3,21,1100,571,227,798,Monday
2022,3,21,1000,595,146,741,Monday
2022,3,21,900,583,150,733,Monday
2022,3,21,800,271,44,315,Monday
2022,3,21,700,144,23,167,Monday
2022,3,21,600,44,20,64,Monday
2022,3,21,500,21,11,32,Monday
2022,3,21,400,17,9,26,Monday
2022,3,21,300,13,10,23,Monday
2022,3,21,200,13,20,33,Monday
2022,3,21,100,10,13,23,Monday
2022,3,20,2400,21,81,102,Sunday
2022,3,20,2300,30,94,124,Sunday
2022,3,20,2200,63,209,272,Sunday
2022,3,20,2100,105,289,394,Sunday
2022,3,20,2000,175,332,507,Sunday
2022,3,20,1900,174,502,676,Sunday
2022,3,20,1800,272,931,1203,Sunday
2022,3,20,1700,370,1343,1713,Sunday
2022,3,20,1600,400,943,1343,Sunday
2022,3,20,1500,437,881,1318,Sunday
2022,3,20,1400,507,894,1401,Sunday
2022,3,20,1300,472,556,1028,Sunday
2022,3,20,1200,596,416,1012,Sunday
2022,3,20,1100,587,266,853,Sunday
2022,3,20,1000,605,190,795,Sunday
2022,3,20,900,894,105,999,Sunday
2022,3,20,800,425,35,460,Sunday
2022,3,20,700,90,16,106,Sunday
2022,3,20,600,38,10,48,Sunday
2022,3,20,500,17,14,31,Sunday
2022,3,20,400,5,17,22,Sunday
2022,3,20,300,15,21,36,Sunday
2022,3,20,200,16,25,41,Sunday
2022,3,20,100,16,60,76,Sunday
2022,3,19,2400,34,63,97,Saturday
2022,3,19,2300,53,86,139,Saturday
2022,3,19,2200,61,122,183,Saturday
2022,3,19,2100,111,158,269,Saturday
2022,3,19,2000,117,255,372,Saturday
2022,3,19,1900,179,431,610,Saturday
2022,3,19,1800,256,961,1217,Saturday
2022,3,19,1700,343,1240,1583,Saturday
2022,3,19,1600,429,770,1199,Saturday
2022,3,19,1500,474,662,1136,Saturday
2022,3,19,1400,493,479,972,Saturday
2022,3,19,1300,612,447,1059,Saturday
2022,3,19,1200,678,326,1004,Saturday
2022,3,19,1100,649,267,916,Saturday
2022,3,19,1000,752,207,959,Saturday
2022,3,19,900,1077,169,1246,Saturday
2022,3,19,800,627,55,682,Saturday
2022,3,19,700,150,23,173,Saturday
2022,3,19,600,56,23,79,Saturday
2022,3,19,500,21,22,43,Saturday
2022,3,19,400,10,18,28,Saturday
2022,3,19,300,8,26,34,Saturday
2022,3,19,200,15,34,49,Saturday
2022,3,19,100,39,15,54,Saturday
2022,3,18,2400,47,116,163,Friday
2022,3,18,2300,78,96,174,Friday
2022,3,18,2200,107,121,228,Friday
2022,3,18,2100,233,240,473,Friday
2022,3,18,2000,365,276,641,Friday
2022,3,18,1900,478,378,856,Friday
2022,3,18,1800,567,754,1321,Friday
2022,3,18,1700,592,896,1488,Friday
2022,3,18,1600,569,688,1257,Friday
2022,3,18,1500,564,525,1089,Friday
2022,3,18,1400,458,414,872,Friday
2022,3,18,1300,522,439,961,Friday
2022,3,18,1200,545,358,903,Friday
2022,3,18,1100,597,261,858,Friday
2022,3,18,1000,662,224,886,Friday
2022,3,18,900,706,150,856,Friday
2022,3,18,800,347,50,397,Friday
2022,3,18,700,159,37,196,Friday
2022,3,18,600,76,32,108,Friday
2022,3,18,500,25,19,44,Friday
2022,3,18,400,14,23,37,Friday
2022,3,18,300,13,19,32,Friday
2022,3,18,200,18,21,39,Friday
2022,3,18,100,25,23,48,Friday
2022,3,17,2400,45,92,137,Thursday
2022,3,17,2300,60,82,142,Thursday
2022,3,17,2200,94,143,237,Thursday
2022,3,17,2100,194,193,387,Thursday
2022,3,17,2000,269,219,488,Thursday
2022,3,17,1900,323,331,654,Thursday
2022,3,17,1800,365,602,967,Thursday
2022,3,17,1700,353,859,1212,Thursday
2022,3,17,1600,373,598,971,Thursday
2022,3,17,1500,365,433,798,Thursday
2022,3,17,1400,362,324,686,Thursday
2022,3,17,1300,393,348,741,Thursday
2022,3,17,1200,412,254,666,Thursday
2022,3,17,1100,482,212,694,Thursday
2022,3,17,1000,598,213,811,Thursday
2022,3,17,900,604,180,784,Thursday
2022,3,17,800,319,39,358,Thursday
2022,3,17,700,119,33,152,Thursday
2022,3,17,600,48,16,64,Thursday
2022,3,17,500,21,19,40,Thursday
2022,3,17,400,19,14,33,Thursday
2022,3,17,300,19,22,41,Thursday
2022,3,17,200,26,25,51,Thursday
2022,3,17,100,27,19,46,Thursday
2022,3,16,2400,46,98,144,Wednesday
2022,3,16,2300,80,87,167,Wednesday
2022,3,16,2200,71,130,201,Wednesday
2022,3,16,2100,122,160,282,Wednesday
2022,3,16,2000,169,235,404,Wednesday
2022,3,16,1900,195,335,530,Wednesday
2022,3,16,1800,238,624,862,Wednesday
2022,3,16,1700,252,706,958,Wednesday
2022,3,16,1600,286,640,926,Wednesday
2022,3,16,1500,337,453,790,Wednesday
2022,3,16,1400,298,362,660,Wednesday
2022,3,16,1300,335,317,652,Wednesday
2022,3,16,1200,435,272,707,Wednesday
2022,3,16,1100,488,199,687,Wednesday
2022,3,16,1000,593,222,815,Wednesday
2022,3,16,900,658,156,814,Wednesday
2022,3,16,800,284,30,314,Wednesday
2022,3,16,700,97,24,121,Wednesday
2022,3,16,600,48,26,74,Wednesday
2022,3,16,500,20,20,40,Wednesday
2022,3,16,400,14,16,30,Wednesday
2022,3,16,300,14,38,52,Wednesday
2022,3,16,200,21,36,57,Wednesday
2022,3,16,100,22,64,86,Wednesday
2022,3,15,2400,40,14,54,Tuesday
2022,3,15,2300,62,93,155,Tuesday
2022,3,15,2200,50,130,180,Tuesday
2022,3,15,2100,96,191,287,Tuesday
2022,3,15,2000,159,279,438,Tuesday
2022,3,15,1900,163,621,784,Tuesday
2022,3,15,1800,194,757,951,Tuesday
2022,3,15,1700,226,552,778,Tuesday
2022,3,15,1600,274,372,646,Tuesday
2022,3,15,1500,303,314,617,Tuesday
2022,3,15,1400,311,221,532,Tuesday
2022,3,15,1300,365,201,566,Tuesday
2022,3,15,1200,405,196,601,Tuesday
2022,3,15,1100,439,169,608,Tuesday
2022,3,15,1000,511,198,709,Tuesday
2022,3,15,900,530,173,703,Tuesday
2022,3,15,800,214,45,259,Tuesday
2022,3,15,700,96,19,115,Tuesday
2022,3,15,600,45,15,60,Tuesday
2022,3,15,500,17,21,38,Tuesday
2022,3,15,400,14,22,36,Tuesday
2022,3,15,300,10,15,25,Tuesday
2022,3,15,200,13,9,22,Tuesday
2022,3,15,100,31,10,41,Tuesday
2022,3,14,2400,30,79,109,Monday
2022,3,14,2300,59,85,144,Monday
2022,3,14,2200,60,116,176,Monday
2022,3,14,2100,105,142,247,Monday
2022,3,14,2000,154,210,364,Monday
2022,3,14,1900,145,580,725,Monday
2022,3,14,1800,210,538,748,Monday
2022,3,14,1700,271,647,918,Monday
2022,3,14,1600,307,390,697,Monday
2022,3,14,1500,354,395,749,Monday
2022,3,14,1400,354,363,717,Monday
2022,3,14,1300,402,313,715,Monday
2022,3,14,1200,422,281,703,Monday
2022,3,14,1100,465,200,665,Monday
2022,3,14,1000,509,154,663,Monday
2022,3,14,900,531,107,638,Monday
2022,3,14,800,243,28,271,Monday
2022,3,14,700,120,24,144,Monday
2022,3,14,600,51,10,61,Monday
2022,3,14,500,21,9,30,Monday
2022,3,14,400,10,25,35,Monday
2022,3,14,300,16,17,33,Monday
2022,3,14,200,17,13,30,Monday
2022,3,14,100,20,12,32,Monday
2022,3,13,2400,30,64,94,Sunday
2022,3,13,2300,49,91,140,Sunday
2022,3,13,2200,70,147,217,Sunday
2022,3,13,2100,98,250,348,Sunday
2022,3,13,2000,139,328,467,Sunday
2022,3,13,1900,165,542,707,Sunday
2022,3,13,1800,229,1083,1312,Sunday
2022,3,13,1700,278,1399,1677,Sunday
2022,3,13,1600,329,1006,1335,Sunday
2022,3,13,1500,390,833,1223,Sunday
2022,3,13,1400,442,665,1107,Sunday
2022,3,13,1300,460,627,1087,Sunday
2022,3,13,1200,567,477,1044,Sunday
2022,3,13,1100,515,220,735,Sunday
2022,3,13,1000,576,142,718,Sunday
2022,3,13,900,796,78,874,Sunday
2022,3,13,800,324,21,345,Sunday
2022,3,13,700,69,31,100,Sunday
2022,3,13,600,20,14,34,Sunday
2022,3,13,500,14,20,34,Sunday
2022,3,13,400,14,19,33,Sunday
2022,3,13,300,0,0,0,Sunday
2022,3,13,200,21,24,45,Sunday
2022,3,13,100,22,45,67,Sunday
2022,3,12,2400,26,39,65,Saturday
2022,3,12,2300,43,58,101,Saturday
2022,3,12,2200,72,100,172,Saturday
2022,3,12,2100,70,156,226,Saturday
2022,3,12,2000,110,196,306,Saturday
2022,3,12,1900,148,357,505,Saturday
2022,3,12,1800,176,858,1034,Saturday
2022,3,12,1700,249,1094,1343,Saturday
2022,3,12,1600,305,791,1096,Saturday
2022,3,12,1500,358,581,939,Saturday
2022,3,12,1400,385,466,851,Saturday
2022,3,12,1300,433,351,784,Saturday
2022,3,12,1200,486,267,753,Saturday
2022,3,12,1100,571,249,820,Saturday
2022,3,12,1000,618,184,802,Saturday
2022,3,12,900,968,157,1125,Saturday
2022,3,12,800,587,40,627,Saturday
2022,3,12,700,140,29,169,Saturday
2022,3,12,600,53,20,73,Saturday
2022,3,12,500,16,15,31,Saturday
2022,3,12,400,11,14,25,Saturday
2022,3,12,300,20,16,36,Saturday
2022,3,12,200,12,27,39,Saturday
2022,3,12,100,30,16,46,Saturday
2022,3,11,2400,54,80,134,Friday
2022,3,11,2300,60,67,127,Friday
2022,3,11,2200,102,105,207,Friday
2022,3,11,2100,197,125,322,Friday
2022,3,11,2000,345,237,582,Friday
2022,3,11,1900,381,286,667,Friday
2022,3,11,1800,453,517,970,Friday
2022,3,11,1700,493,830,1323,Friday
2022,3,11,1600,503,693,1196,Friday
2022,3,11,1500,439,428,867,Friday
2022,3,11,1400,442,418,860,Friday
2022,3,11,1300,428,342,770,Friday
2022,3,11,1200,458,297,755,Friday
2022,3,11,1100,503,232,735,Friday
2022,3,11,1000,613,226,839,Friday
2022,3,11,900,665,160,825,Friday
2022,3,11,800,342,48,390,Friday
2022,3,11,700,115,42,157,Friday
2022,3,11,600,46,17,63,Friday
2022,3,11,500,23,19,42,Friday
2022,3,11,400,17,27,44,Friday
2022,3,11,300,16,23,39,Friday
2022,3,11,200,16,22,38,Friday
2022,3,11,100,28,17,45,Friday
2022,3,10,2400,39,80,119,Thursday
2022,3,10,2300,69,90,159,Thursday
2022,3,10,2200,74,105,179,Thursday
2022,3,10,2100,158,153,311,Thursday
2022,3,10,2000,244,217,461,Thursday
2022,3,10,1900,294,279,573,Thursday
2022,3,10,1800,329,496,825,Thursday
2022,3,10,1700,356,752,1108,Thursday
2022,3,10,1600,356,489,845,Thursday
2022,3,10,1500,374,446,820,Thursday
2022,3,10,1400,330,305,635,Thursday
2022,3,10,1300,322,287,609,Thursday
2022,3,10,1200,426,250,676,Thursday
2022,3,10,1100,425,171,596,Thursday
2022,3,10,1000,506,201,707,Thursday
2022,3,10,900,475,179,654,Thursday
2022,3,10,800,264,46,310,Thursday
2022,3,10,700,114,33,147,Thursday
2022,3,10,600,62,16,78,Thursday
2022,3,10,500,26,16,42,Thursday
2022,3,10,400,20,18,38,Thursday
2022,3,10,300,16,25,41,Thursday
2022,3,10,200,28,25,53,Thursday
2022,3,10,100,33,13,46,Thursday
2022,3,9,2400,48,76,124,Wednesday
2022,3,9,2300,54,81,135,Wednesday
2022,3,9,2200,63,119,182,Wednesday
2022,3,9,2100,126,158,284,Wednesday
2022,3,9,2000,144,180,324,Wednesday
2022,3,9,1900,158,310,468,Wednesday
2022,3,9,1800,201,449,650,Wednesday
2022,3,9,1700,248,621,869,Wednesday
2022,3,9,1600,267,407,674,Wednesday
2022,3,9,1500,294,301,595,Wednesday
2022,3,9,1400,309,258,567,Wednesday
2022,3,9,1300,351,237,588,Wednesday
2022,3,9,1200,356,240,596,Wednesday
2022,3,9,1100,389,189,578,Wednesday
2022,3,9,1000,442,190,632,Wednesday
2022,3,9,900,378,161,539,Wednesday
2022,3,9,800,216,31,247,Wednesday
2022,3,9,700,115,28,143,Wednesday
2022,3,9,600,42,17,59,Wednesday
2022,3,9,500,27,24,51,Wednesday
2022,3,9,400,13,18,31,Wednesday
2022,3,9,300,16,23,39,Wednesday
2022,3,9,200,12,17,29,Wednesday
2022,3,9,100,37,14,51,Wednesday
2022,3,8,2400,45,72,117,Tuesday
2022,3,8,2300,51,83,134,Tuesday
2022,3,8,2200,50,136,186,Tuesday
2022,3,8,2100,95,150,245,Tuesday
2022,3,8,2000,145,195,340,Tuesday
2022,3,8,1900,154,260,414,Tuesday
2022,3,8,1800,188,432,620,Tuesday
2022,3,8,1700,249,545,794,Tuesday
2022,3,8,1600,244,473,717,Tuesday
2022,3,8,1500,266,364,630,Tuesday
2022,3,8,1400,251,331,582,Tuesday
2022,3,8,1300,270,277,547,Tuesday
2022,3,8,1200,370,237,607,Tuesday
2022,3,8,1100,408,221,629,Tuesday
2022,3,8,1000,411,162,573,Tuesday
2022,3,8,900,463,193,656,Tuesday
2022,3,8,800,238,46,284,Tuesday
2022,3,8,700,93,37,130,Tuesday
2022,3,8,600,41,21,62,Tuesday
2022,3,8,500,13,24,37,Tuesday
2022,3,8,400,13,27,40,Tuesday
2022,3,8,300,11,22,33,Tuesday
2022,3,8,200,17,25,42,Tuesday
2022,3,8,100,27,10,37,Tuesday
2022,3,7,2400,38,84,122,Monday
2022,3,7,2300,47,67,114,Monday
2022,3,7,2200,57,80,137,Monday
2022,3,7,2100,93,120,213,Monday
2022,3,7,2000,121,162,283,Monday
2022,3,7,1900,124,236,360,Monday
2022,3,7,1800,176,453,629,Monday
2022,3,7,1700,224,554,778,Monday
2022,3,7,1600,272,480,752,Monday
2022,3,7,1500,280,479,759,Monday
2022,3,7,1400,275,360,635,Monday
2022,3,7,1300,322,362,684,Monday
2022,3,7,1200,394,292,686,Monday
2022,3,7,1100,429,201,630,Monday
2022,3,7,1000,492,169,661,Monday
2022,3,7,900,536,145,681,Monday
2022,3,7,800,286,40,326,Monday
2022,3,7,700,111,25,136,Monday
2022,3,7,600,42,12,54,Monday
2022,3,7,500,15,6,21,Monday
2022,3,7,400,12,7,19,Monday
2022,3,7,300,12,7,19,Monday
2022,3,7,200,22,12,34,Monday
2022,3,7,100,13,14,27,Monday
2022,3,6,2400,24,57,81,Sunday
2022,3,6,2300,23,76,99,Sunday
2022,3,6,2200,43,130,173,Sunday
2022,3,6,2100,81,193,274,Sunday
2022,3,6,2000,121,360,481,Sunday
2022,3,6,1900,160,583,743,Sunday
2022,3,6,1800,213,1236,1449,Sunday
2022,3,6,1700,324,1538,1862,Sunday
2022,3,6,1600,303,1066,1369,Sunday
2022,3,6,1500,410,932,1342,Sunday
2022,3,6,1400,398,746,1144,Sunday
2022,3,6,1300,510,605,1115,Sunday
2022,3,6,1200,570,484,1054,Sunday
2022,3,6,1100,614,331,945,Sunday
2022,3,6,1000,761,176,937,Sunday
2022,3,6,900,1120,106,1226,Sunday
2022,3,6,800,485,40,525,Sunday
2022,3,6,700,105,26,131,Sunday
2022,3,6,600,27,15,42,Sunday
2022,3,6,500,12,14,26,Sunday
2022,3,6,400,9,20,29,Sunday
2022,3,6,300,17,12,29,Sunday
2022,3,6,200,16,21,37,Sunday
2022,3,6,100,15,29,44,Sunday
2022,3,5,2400,19,45,64,Saturday
2022,3,5,2300,41,65,106,Saturday
2022,3,5,2200,58,92,150,Saturday
2022,3,5,2100,89,122,211,Saturday
2022,3,5,2000,96,192,288,Saturday
2022,3,5,1900,125,435,560,Saturday
2022,3,5,1800,184,1203,1387,Saturday
2022,3,5,1700,275,1242,1517,Saturday
2022,3,5,1600,328,813,1141,Saturday
2022,3,5,1500,328,498,826,Saturday
2022,3,5,1400,339,427,766,Saturday
2022,3,5,1300,454,391,845,Saturday
2022,3,5,1200,529,286,815,Saturday
2022,3,5,1100,550,255,805,Saturday
2022,3,5,1000,719,225,944,Saturday
2022,3,5,900,1204,177,1381,Saturday
2022,3,5,800,696,43,739,Saturday
2022,3,5,700,161,37,198,Saturday
2022,3,5,600,56,10,66,Saturday
2022,3,5,500,22,17,39,Saturday
2022,3,5,400,5,19,24,Saturday
2022,3,5,300,12,12,24,Saturday
2022,3,5,200,22,22,44,Saturday
2022,3,5,100,21,16,37,Saturday
2022,3,4,2400,56,83,139,Friday
2022,3,4,2300,59,59,118,Friday
2022,3,4,2200,81,134,215,Friday
2022,3,4,2100,199,311,510,Friday
2022,3,4,2000,296,249,545,Friday
2022,3,4,1900,390,230,620,Friday
2022,3,4,1800,449,629,1078,Friday
2022,3,4,1700,522,1086,1608,Friday
2022,3,4,1600,491,598,1089,Friday
2022,3,4,1500,441,509,950,Friday
2022,3,4,1400,370,401,771,Friday
2022,3,4,1300,377,362,739,Friday
2022,3,4,1200,418,298,716,Friday
2022,3,4,1100,547,224,771,Friday
2022,3,4,1000,681,232,913,Friday
2022,3,4,900,942,143,1085,Friday
2022,3,4,800,471,48,519,Friday
2022,3,4,700,115,29,144,Friday
2022,3,4,600,37,20,57,Friday
2022,3,4,500,19,12,31,Friday
2022,3,4,400,10,16,26,Friday
2022,3,4,300,19,11,30,Friday
2022,3,4,200,20,9,29,Friday
2022,3,4,100,28,14,42,Friday
2022,3,3,2400,37,96,133,Thursday
2022,3,3,2300,65,100,165,Thursday
2022,3,3,2200,79,108,187,Thursday
2022,3,3,2100,162,126,288,Thursday
2022,3,3,2000,196,150,346,Thursday
2022,3,3,1900,225,270,495,Thursday
2022,3,3,1800,279,563,842,Thursday
2022,3,3,1700,318,714,1032,Thursday
2022,3,3,1600,338,543,881,Thursday
2022,3,3,1500,335,385,720,Thursday
2022,3,3,1400,312,311,623,Thursday
2022,3,3,1300,340,277,617,Thursday
2022,3,3,1200,335,263,598,Thursday
2022,3,3,1100,439,192,631,Thursday
2022,3,3,1000,547,222,769,Thursday
2022,3,3,900,651,147,798,Thursday
2022,3,3,800,311,35,346,Thursday
2022,3,3,700,103,32,135,Thursday
2022,3,3,600,52,15,67,Thursday
2022,3,3,500,16,16,32,Thursday
2022,3,3,400,11,14,25,Thursday
2022,3,3,300,10,9,19,Thursday
2022,3,3,200,24,19,43,Thursday
2022,3,3,100,29,14,43,Thursday
2022,3,2,2400,48,81,129,Wednesday
2022,3,2,2300,79,73,152,Wednesday
2022,3,2,2200,60,109,169,Wednesday
2022,3,2,2100,128,131,259,Wednesday
2022,3,2,2000,165,165,330,Wednesday
2022,3,2,1900,207,248,455,Wednesday
2022,3,2,1800,198,491,689,Wednesday
2022,3,2,1700,260,719,979,Wednesday
2022,3,2,1600,279,480,759,Wednesday
2022,3,2,1500,241,393,634,Wednesday
2022,3,2,1400,283,343,626,Wednesday
2022,3,2,1300,290,322,612,Wednesday
2022,3,2,1200,360,271,631,Wednesday
2022,3,2,1100,377,237,614,Wednesday
2022,3,2,1000,489,253,742,Wednesday
2022,3,2,900,531,231,762,Wednesday
2022,3,2,800,255,44,299,Wednesday
2022,3,2,700,86,59,145,Wednesday
2022,3,2,600,41,62,103,Wednesday
2022,3,2,500,19,29,48,Wednesday
2022,3,2,400,9,3,12,Wednesday
2022,3,2,300,13,2,15,Wednesday
2022,3,2,200,19,7,26,Wednesday
2022,3,2,100,24,4,28,Wednesday
2022,3,1,2400,39,13,52,Tuesday
2022,3,1,2300,48,19,67,Tuesday
2022,3,1,2200,50,21,71,Tuesday
2022,3,1,2100,97,43,140,Tuesday
2022,3,1,2000,147,113,260,Tuesday
2022,3,1,1900,140,241,381,Tuesday
2022,3,1,1800,183,522,705,Tuesday
2022,3,1,1700,252,617,869,Tuesday
2022,3,1,1600,229,553,782,Tuesday
2022,3,1,1500,246,393,639,Tuesday
2022,3,1,1400,287,338,625,Tuesday
2022,3,1,1300,286,285,571,Tuesday
2022,3,1,1200,389,313,702,Tuesday
2022,3,1,1100,423,144,567,Tuesday
2022,3,1,1000,449,199,648,Tuesday
2022,3,1,900,532,144,676,Tuesday
2022,3,1,800,267,38,305,Tuesday
2022,3,1,700,100,34,134,Tuesday
2022,3,1,600,46,19,65,Tuesday
2022,3,1,500,20,13,33,Tuesday
2022,3,1,400,8,21,29,Tuesday
2022,3,1,300,17,16,33,Tuesday
2022,3,1,200,20,11,31,Tuesday
2022,3,1,100,23,9,32,Tuesday
2022,2,28,2400,31,75,106,Monday
2022,2,28,2300,49,77,126,Monday
2022,2,28,2200,49,118,167,Monday
2022,2,28,2100,93,96,189,Monday
2022,2,28,2000,124,139,263,Monday
2022,2,28,1900,174,278,452,Monday
2022,2,28,1800,181,513,694,Monday
2022,2,28,1700,238,663,901,Monday
2022,2,28,1600,294,519,813,Monday
2022,2,28,1500,318,433,751,Monday
2022,2,28,1400,321,331,652,Monday
2022,2,28,1300,357,337,694,Monday
2022,2,28,1200,380,283,663,Monday
2022,2,28,1100,442,181,623,Monday
2022,2,28,1000,513,176,689,Monday
2022,2,28,900,537,116,653,Monday
2022,2,28,800,281,39,320,Monday
2022,2,28,700,105,25,130,Monday
2022,2,28,600,45,13,58,Monday
2022,2,28,500,19,13,32,Monday
2022,2,28,400,6,18,24,Monday
2022,2,28,300,12,18,30,Monday
2022,2,28,200,9,21,30,Monday
2022,2,28,100,11,11,22,Monday
2022,2,27,2400,24,34,58,Sunday
2022,2,27,2300,33,252,285,Sunday
2022,2,27,2200,55,143,198,Sunday
2022,2,27,2100,78,154,232,Sunday
2022,2,27,2000,114,185,299,Sunday
2022,2,27,1900,136,437,573,Sunday
2022,2,27,1800,205,1039,1244,Sunday
2022,2,27,1700,267,1394,1661,Sunday
2022,2,27,1600,341,1082,1423,Sunday
2022,2,27,1500,387,864,1251,Sunday
2022,2,27,1400,446,797,1243,Sunday
2022,2,27,1300,499,726,1225,Sunday
2022,2,27,1200,604,582,1186,Sunday
2022,2,27,1100,583,314,897,Sunday
2022,2,27,1000,657,188,845,Sunday
2022,2,27,900,889,119,1008,Sunday
2022,2,27,800,500,50,550,Sunday
2022,2,27,700,90,22,112,Sunday
2022,2,27,600,39,18,57,Sunday
2022,2,27,500,12,15,27,Sunday
2022,2,27,400,15,17,32,Sunday
2022,2,27,300,13,22,35,Sunday
2022,2,27,200,17,28,45,Sunday
2022,2,27,100,30,39,69,Sunday
2022,2,26,2400,29,49,78,Saturday
2022,2,26,2300,37,74,111,Saturday
2022,2,26,2200,65,91,156,Saturday
2022,2,26,2100,98,155,253,Saturday
2022,2,26,2000,103,265,368,Saturday
2022,2,26,1900,139,449,588,Saturday
2022,2,26,1800,225,1228,1453,Saturday
2022,2,26,1700,254,1374,1628,Saturday
2022,2,26,1600,339,925,1264,Saturday
2022,2,26,1500,403,781,1184,Saturday
2022,2,26,1400,431,465,896,Saturday
2022,2,26,1300,497,470,967,Saturday
2022,2,26,1200,546,376,922,Saturday
2022,2,26,1100,607,283,890,Saturday
2022,2,26,1000,686,270,956,Saturday
2022,2,26,900,1213,210,1423,Saturday
2022,2,26,800,666,41,707,Saturday
2022,2,26,700,175,39,214,Saturday
2022,2,26,600,43,14,57,Saturday
2022,2,26,500,24,21,45,Saturday
2022,2,26,400,9,18,27,Saturday
2022,2,26,300,14,23,37,Saturday
2022,2,26,200,15,17,32,Saturday
2022,2,26,100,23,18,41,Saturday
2022,2,25,2400,40,79,119,Friday
2022,2,25,2300,62,82,144,Friday
2022,2,25,2200,112,135,247,Friday
2022,2,25,2100,202,167,369,Friday
2022,2,25,2000,338,331,669,Friday
2022,2,25,1900,405,338,743,Friday
2022,2,25,1800,461,1014,1475,Friday
2022,2,25,1700,475,1204,1679,Friday
2022,2,25,1600,551,885,1436,Friday
2022,2,25,1500,532,591,1123,Friday
2022,2,25,1400,521,519,1040,Friday
2022,2,25,1300,526,516,1042,Friday
2022,2,25,1200,612,423,1035,Friday
2022,2,25,1100,628,281,909,Friday
2022,2,25,1000,736,249,985,Friday
2022,2,25,900,887,217,1104,Friday
2022,2,25,800,395,41,436,Friday
2022,2,25,700,136,40,176,Friday
2022,2,25,600,54,13,67,Friday
2022,2,25,500,28,24,52,Friday
2022,2,25,400,17,21,38,Friday
2022,2,25,300,22,27,49,Friday
2022,2,25,200,41,25,66,Friday
2022,2,25,100,42,12,54,Friday
2022,2,24,2400,51,120,171,Thursday
2022,2,24,2300,63,61,124,Thursday
2022,2,24,2200,79,108,187,Thursday
2022,2,24,2100,131,139,270,Thursday
2022,2,24,2000,210,194,404,Thursday
2022,2,24,1900,201,359,560,Thursday
2022,2,24,1800,310,963,1273,Thursday
2022,2,24,1700,358,992,1350,Thursday
2022,2,24,1600,387,722,1109,Thursday
2022,2,24,1500,382,514,896,Thursday
2022,2,24,1400,388,380,768,Thursday
2022,2,24,1300,443,414,857,Thursday
2022,2,24,1200,532,300,832,Thursday
2022,2,24,1100,559,241,800,Thursday
2022,2,24,1000,727,216,943,Thursday
2022,2,24,900,754,157,911,Thursday
2022,2,24,800,280,45,325,Thursday
2022,2,24,700,95,33,128,Thursday
2022,2,24,600,37,12,49,Thursday
2022,2,24,500,13,26,39,Thursday
2022,2,24,400,25,13,38,Thursday
2022,2,24,300,18,17,35,Thursday
2022,2,24,200,22,12,34,Thursday
2022,2,24,100,27,16,43,Thursday
2022,2,23,2400,40,55,95,Wednesday
2022,2,23,2300,46,82,128,Wednesday
2022,2,23,2200,61,126,187,Wednesday
2022,2,23,2100,126,153,279,Wednesday
2022,2,23,2000,177,211,388,Wednesday
2022,2,23,1900,187,345,532,Wednesday
2022,2,23,1800,219,797,1016,Wednesday
2022,2,23,1700,272,799,1071,Wednesday
2022,2,23,1600,336,545,881,Wednesday
2022,2,23,1500,379,483,862,Wednesday
2022,2,23,1400,347,363,710,Wednesday
2022,2,23,1300,396,365,761,Wednesday
2022,2,23,1200,492,326,818,Wednesday
2022,2,23,1100,535,241,776,Wednesday
2022,2,23,1000,586,209,795,Wednesday
2022,2,23,900,514,166,680,Wednesday
2022,2,23,800,242,44,286,Wednesday
2022,2,23,700,76,23,99,Wednesday
2022,2,23,600,30,14,44,Wednesday
2022,2,23,500,19,25,44,Wednesday
2022,2,23,400,20,17,37,Wednesday
2022,2,23,300,16,16,32,Wednesday
2022,2,23,200,21,19,40,Wednesday
2022,2,23,100,30,14,44,Wednesday
2022,2,22,2400,43,70,113,Tuesday
2022,2,22,2300,59,105,164,Tuesday
2022,2,22,2200,62,102,164,Tuesday
2022,2,22,2100,107,160,267,Tuesday
2022,2,22,2000,165,176,341,Tuesday
2022,2,22,1900,203,375,578,Tuesday
2022,2,22,1800,220,744,964,Tuesday
2022,2,22,1700,313,830,1143,Tuesday
2022,2,22,1600,378,518,896,Tuesday
2022,2,22,1500,484,436,920,Tuesday
2022,2,22,1400,448,400,848,Tuesday
2022,2,22,1300,478,366,844,Tuesday
2022,2,22,1200,544,283,827,Tuesday
2022,2,22,1100,512,231,743,Tuesday
2022,2,22,1000,456,181,637,Tuesday
2022,2,22,900,512,93,605,Tuesday
2022,2,22,800,229,52,281,Tuesday
2022,2,22,700,106,36,142,Tuesday
2022,2,22,600,25,16,41,Tuesday
2022,2,22,500,12,9,21,Tuesday
2022,2,22,400,11,23,34,Tuesday
2022,2,22,300,16,20,36,Tuesday
2022,2,22,200,28,23,51,Tuesday
2022,2,22,100,17,31,48,Tuesday
2022,2,21,2400,24,59,83,Monday
2022,2,21,2300,41,166,207,Monday
2022,2,21,2200,68,367,435,Monday
2022,2,21,2100,88,503,591,Monday
2022,2,21,2000,115,313,428,Monday
2022,2,21,1900,164,401,565,Monday
2022,2,21,1800,278,752,1030,Monday
2022,2,21,1700,385,1087,1472,Monday
2022,2,21,1600,446,1063,1509,Monday
2022,2,21,1500,536,1223,1759,Monday
2022,2,21,1400,593,1172,1765,Monday
2022,2,21,1300,594,1164,1758,Monday
2022,2,21,1200,606,798,1404,Monday
2022,2,21,1100,590,427,1017,Monday
2022,2,21,1000,540,210,750,Monday
2022,2,21,900,606,113,719,Monday
2022,2,21,800,273,38,311,Monday
2022,2,21,700,92,29,121,Monday
2022,2,21,600,38,12,50,Monday
2022,2,21,500,16,8,24,Monday
2022,2,21,400,10,12,22,Monday
2022,2,21,300,11,7,18,Monday
2022,2,21,200,14,31,45,Monday
2022,2,21,100,12,43,55,Monday
2022,2,20,2400,17,18,35,Sunday
2022,2,20,2300,37,107,144,Sunday
2022,2,20,2200,52,84,136,Sunday
2022,2,20,2100,71,182,253,Sunday
2022,2,20,2000,96,199,295,Sunday
2022,2,20,1900,129,438,567,Sunday
2022,2,20,1800,189,1174,1363,Sunday
2022,2,20,1700,294,1076,1370,Sunday
2022,2,20,1600,387,838,1225,Sunday
2022,2,20,1500,441,737,1178,Sunday
2022,2,20,1400,426,637,1063,Sunday
2022,2,20,1300,470,528,998,Sunday
2022,2,20,1200,561,339,900,Sunday
2022,2,20,1100,511,218,729,Sunday
2022,2,20,1000,743,136,879,Sunday
2022,2,20,900,1112,73,1185,Sunday
2022,2,20,800,512,41,553,Sunday
2022,2,20,700,62,19,81,Sunday
2022,2,20,600,18,24,42,Sunday
2022,2,20,500,6,17,23,Sunday
2022,2,20,400,9,15,24,Sunday
2022,2,20,300,16,19,35,Sunday
2022,2,20,200,23,69,92,Sunday
2022,2,20,100,17,44,61,Sunday
2022,2,19,2400,27,45,72,Saturday
2022,2,19,2300,61,45,106,Saturday
2022,2,19,2200,78,319,397,Saturday
2022,2,19,2100,96,493,589,Saturday
2022,2,19,2000,120,209,329,Saturday
2022,2,19,1900,138,318,456,Saturday
2022,2,19,1800,296,981,1277,Saturday
2022,2,19,1700,395,981,1376,Saturday
2022,2,19,1600,436,683,1119,Saturday
2022,2,19,1500,521,531,1052,Saturday
2022,2,19,1400,575,386,961,Saturday
2022,2,19,1300,704,356,1060,Saturday
2022,2,19,1200,761,314,1075,Saturday
2022,2,19,1100,732,287,1019,Saturday
2022,2,19,1000,805,170,975,Saturday
2022,2,19,900,1120,134,1254,Saturday
2022,2,19,800,656,60,716,Saturday
2022,2,19,700,144,34,178,Saturday
2022,2,19,600,58,19,77,Saturday
2022,2,19,500,20,22,42,Saturday
2022,2,19,400,15,27,42,Saturday
2022,2,19,300,22,23,45,Saturday
2022,2,19,200,24,45,69,Saturday
2022,2,19,100,35,52,87,Saturday
2022,2,18,2400,61,76,137,Friday
2022,2,18,2300,104,94,198,Friday
2022,2,18,2200,166,135,301,Friday
2022,2,18,2100,291,163,454,Friday
2022,2,18,2000,470,226,696,Friday
2022,2,18,1900,575,373,948,Friday
2022,2,18,1800,725,755,1480,Friday
2022,2,18,1700,780,995,1775,Friday
2022,2,18,1600,774,805,1579,Friday
2022,2,18,1500,785,616,1401,Friday
2022,2,18,1400,651,496,1147,Friday
2022,2,18,1300,594,435,1029,Friday
2022,2,18,1200,641,327,968,Friday
2022,2,18,1100,658,257,915,Friday
2022,2,18,1000,754,207,961,Friday
2022,2,18,900,865,167,1032,Friday
2022,2,18,800,415,40,455,Friday
2022,2,18,700,124,39,163,Friday
2022,2,18,600,56,22,78,Friday
2022,2,18,500,20,17,37,Friday
2022,2,18,400,17,23,40,Friday
2022,2,18,300,10,16,26,Friday
2022,2,18,200,28,31,59,Friday
2022,2,18,100,32,29,61,Friday
2022,2,17,2400,46,143,189,Thursday
2022,2,17,2300,53,85,138,Thursday
2022,2,17,2200,96,66,162,Thursday
2022,2,17,2100,207,126,333,Thursday
2022,2,17,2000,311,216,527,Thursday
2022,2,17,1900,366,324,690,Thursday
2022,2,17,1800,419,577,996,Thursday
2022,2,17,1700,449,960,1409,Thursday
2022,2,17,1600,488,589,1077,Thursday
2022,2,17,1500,516,432,948,Thursday
2022,2,17,1400,498,260,758,Thursday
2022,2,17,1300,457,215,672,Thursday
2022,2,17,1200,544,253,797,Thursday
2022,2,17,1100,546,186,732,Thursday
2022,2,17,1000,670,190,860,Thursday
2022,2,17,900,637,150,787,Thursday
2022,2,17,800,357,56,413,Thursday
2022,2,17,700,130,37,167,Thursday
2022,2,17,600,43,13,56,Thursday
2022,2,17,500,15,21,36,Thursday
2022,2,17,400,16,23,39,Thursday
2022,2,17,300,11,21,32,Thursday
2022,2,17,200,19,24,43,Thursday
2022,2,17,100,34,25,59,Thursday
2022,2,16,2400,46,83,129,Wednesday
2022,2,16,2300,66,61,127,Wednesday
2022,2,16,2200,78,120,198,Wednesday
2022,2,16,2100,141,137,278,Wednesday
2022,2,16,2000,209,188,397,Wednesday
2022,2,16,1900,284,271,555,Wednesday
2022,2,16,1800,316,467,783,Wednesday
2022,2,16,1700,296,668,964,Wednesday
2022,2,16,1600,265,398,663,Wednesday
2022,2,16,1500,309,428,737,Wednesday
2022,2,16,1400,307,293,600,Wednesday
2022,2,16,1300,321,271,592,Wednesday
2022,2,16,1200,367,202,569,Wednesday
2022,2,16,1100,420,205,625,Wednesday
2022,2,16,1000,452,174,626,Wednesday
2022,2,16,900,430,160,590,Wednesday
2022,2,16,800,206,54,260,Wednesday
2022,2,16,700,91,43,134,Wednesday
2022,2,16,600,38,21,59,Wednesday
2022,2,16,500,16,36,52,Wednesday
2022,2,16,400,11,22,33,Wednesday
2022,2,16,300,15,17,32,Wednesday
2022,2,16,200,5,15,20,Wednesday
2022,2,16,100,15,12,27,Wednesday
2022,2,15,2400,31,88,119,Tuesday
2022,2,15,2300,39,64,103,Tuesday
2022,2,15,2200,48,102,150,Tuesday
2022,2,15,2100,92,126,218,Tuesday
2022,2,15,2000,129,145,274,Tuesday
2022,2,15,1900,140,235,375,Tuesday
2022,2,15,1800,197,374,571,Tuesday
2022,2,15,1700,249,585,834,Tuesday
2022,2,15,1600,219,404,623,Tuesday
2022,2,15,1500,302,363,665,Tuesday
2022,2,15,1400,320,296,616,Tuesday
2022,2,15,1300,307,257,564,Tuesday
2022,2,15,1200,363,261,624,Tuesday
2022,2,15,1100,398,162,560,Tuesday
2022,2,15,1000,403,206,609,Tuesday
2022,2,15,900,435,162,597,Tuesday
2022,2,15,800,205,53,258,Tuesday
2022,2,15,700,102,33,135,Tuesday
2022,2,15,600,45,17,62,Tuesday
2022,2,15,500,23,12,35,Tuesday
2022,2,15,400,18,20,38,Tuesday
2022,2,15,300,15,11,26,Tuesday
2022,2,15,200,19,19,38,Tuesday
2022,2,15,100,21,15,36,Tuesday
2022,2,14,2400,32,71,103,Monday
2022,2,14,2300,37,55,92,Monday
2022,2,14,2200,54,103,157,Monday
2022,2,14,2100,74,117,191,Monday
2022,2,14,2000,147,168,315,Monday
2022,2,14,1900,149,220,369,Monday
2022,2,14,1800,191,439,630,Monday
2022,2,14,1700,253,600,853,Monday
2022,2,14,1600,288,511,799,Monday
2022,2,14,1500,279,432,711,Monday
2022,2,14,1400,327,326,653,Monday
2022,2,14,1300,368,376,744,Monday
2022,2,14,1200,395,266,661,Monday
2022,2,14,1100,411,201,612,Monday
2022,2,14,1000,418,185,603,Monday
2022,2,14,900,471,131,602,Monday
2022,2,14,800,217,44,261,Monday
2022,2,14,700,85,23,108,Monday
2022,2,14,600,46,17,63,Monday
2022,2,14,500,14,6,20,Monday
2022,2,14,400,14,6,20,Monday
2022,2,14,300,12,17,29,Monday
2022,2,14,200,17,17,34,Monday
2022,2,14,100,13,12,25,Monday
2022,2,13,2400,19,47,66,Sunday
2022,2,13,2300,31,68,99,Sunday
2022,2,13,2200,36,125,161,Sunday
2022,2,13,2100,61,181,242,Sunday
2022,2,13,2000,97,259,356,Sunday
2022,2,13,1900,113,460,573,Sunday
2022,2,13,1800,174,954,1128,Sunday
2022,2,13,1700,242,1240,1482,Sunday
2022,2,13,1600,304,1103,1407,Sunday
2022,2,13,1500,444,944,1388,Sunday
2022,2,13,1400,423,792,1215,Sunday
2022,2,13,1300,475,704,1179,Sunday
2022,2,13,1200,542,563,1105,Sunday
2022,2,13,1100,516,329,845,Sunday
2022,2,13,1000,549,186,735,Sunday
2022,2,13,900,771,100,871,Sunday
2022,2,13,800,440,45,485,Sunday
2022,2,13,700,99,17,116,Sunday
2022,2,13,600,32,12,44,Sunday
2022,2,13,500,20,17,37,Sunday
2022,2,13,400,13,13,26,Sunday
2022,2,13,300,10,12,22,Sunday
2022,2,13,200,25,22,47,Sunday
2022,2,13,100,16,39,55,Sunday
2022,2,12,2400,25,41,66,Saturday
2022,2,12,2300,42,47,89,Saturday
2022,2,12,2200,50,101,151,Saturday
2022,2,12,2100,79,145,224,Saturday
2022,2,12,2000,119,237,356,Saturday
2022,2,12,1900,129,452,581,Saturday
2022,2,12,1800,207,1200,1407,Saturday
2022,2,12,1700,263,1335,1598,Saturday
2022,2,12,1600,341,795,1136,Saturday
2022,2,12,1500,401,650,1051,Saturday
2022,2,12,1400,455,467,922,Saturday
2022,2,12,1300,524,398,922,Saturday
2022,2,12,1200,601,353,954,Saturday
2022,2,12,1100,693,226,919,Saturday
2022,2,12,1000,779,192,971,Saturday
2022,2,12,900,1107,164,1271,Saturday
2022,2,12,800,706,33,739,Saturday
2022,2,12,700,138,24,162,Saturday
2022,2,12,600,57,16,73,Saturday
2022,2,12,500,19,24,43,Saturday
2022,2,12,400,11,20,31,Saturday
2022,2,12,300,15,11,26,Saturday
2022,2,12,200,17,16,33,Saturday
2022,2,12,100,25,20,45,Saturday
2022,2,11,2400,45,75,120,Friday
2022,2,11,2300,49,68,117,Friday
2022,2,11,2200,74,91,165,Friday
2022,2,11,2100,163,257,420,Friday
2022,2,11,2000,341,229,570,Friday
2022,2,11,1900,414,319,733,Friday
2022,2,11,1800,489,608,1097,Friday
2022,2,11,1700,529,828,1357,Friday
2022,2,11,1600,450,633,1083,Friday
2022,2,11,1500,497,437,934,Friday
2022,2,11,1400,465,415,880,Friday
2022,2,11,1300,478,359,837,Friday
2022,2,11,1200,484,280,764,Friday
2022,2,11,1100,511,213,724,Friday
2022,2,11,1000,648,207,855,Friday
2022,2,11,900,720,156,876,Friday
2022,2,11,800,376,42,418,Friday
2022,2,11,700,129,28,157,Friday
2022,2,11,600,66,25,91,Friday
2022,2,11,500,19,22,41,Friday
2022,2,11,400,19,24,43,Friday
2022,2,11,300,17,27,44,Friday
2022,2,11,200,18,17,35,Friday
2022,2,11,100,23,18,41,Friday
2022,2,10,2400,50,67,117,Thursday
2022,2,10,2300,44,58,102,Thursday
2022,2,10,2200,83,150,233,Thursday
2022,2,10,2100,154,309,463,Thursday
2022,2,10,2000,205,163,368,Thursday
2022,2,10,1900,256,214,470,Thursday
2022,2,10,1800,273,361,634,Thursday
2022,2,10,1700,331,747,1078,Thursday
2022,2,10,1600,365,484,849,Thursday
2022,2,10,1500,371,462,833,Thursday
2022,2,10,1400,354,320,674,Thursday
2022,2,10,1300,322,259,581,Thursday
2022,2,10,1200,372,236,608,Thursday
2022,2,10,1100,422,193,615,Thursday
2022,2,10,1000,530,193,723,Thursday
2022,2,10,900,548,160,708,Thursday
2022,2,10,800,300,35,335,Thursday
2022,2,10,700,136,18,154,Thursday
2022,2,10,600,42,20,62,Thursday
2022,2,10,500,21,23,44,Thursday
2022,2,10,400,10,21,31,Thursday
2022,2,10,300,12,14,26,Thursday
2022,2,10,200,19,23,42,Thursday
2022,2,10,100,23,14,37,Thursday
2022,2,9,2400,36,75,111,Wednesday
2022,2,9,2300,60,70,130,Wednesday
2022,2,9,2200,55,99,154,Wednesday
2022,2,9,2100,121,123,244,Wednesday
2022,2,9,2000,164,173,337,Wednesday
2022,2,9,1900,185,324,509,Wednesday
2022,2,9,1800,214,384,598,Wednesday
2022,2,9,1700,263,780,1043,Wednesday
2022,2,9,1600,261,389,650,Wednesday
2022,2,9,1500,275,417,692,Wednesday
2022,2,9,1400,283,287,570,Wednesday
2022,2,9,1300,299,274,573,Wednesday
2022,2,9,1200,365,226,591,Wednesday
2022,2,9,1100,385,198,583,Wednesday
2022,2,9,1000,482,189,671,Wednesday
2022,2,9,900,512,140,652,Wednesday
2022,2,9,800,254,38,292,Wednesday
2022,2,9,700,90,22,112,Wednesday
2022,2,9,600,52,10,62,Wednesday
2022,2,9,500,21,16,37,Wednesday
2022,2,9,400,13,17,30,Wednesday
2022,2,9,300,14,26,40,Wednesday
2022,2,9,200,13,19,32,Wednesday
2022,2,9,100,31,13,44,Wednesday
2022,2,8,2400,45,73,118,Tuesday
2022,2,8,2300,36,72,108,Tuesday
2022,2,8,2200,48,91,139,Tuesday
2022,2,8,2100,108,132,240,Tuesday
2022,2,8,2000,134,178,312,Tuesday
2022,2,8,1900,136,265,401,Tuesday
2022,2,8,1800,177,414,591,Tuesday
2022,2,8,1700,207,638,845,Tuesday
2022,2,8,1600,229,537,766,Tuesday
2022,2,8,1500,241,362,603,Tuesday
2022,2,8,1400,261,305,566,Tuesday
2022,2,8,1300,272,259,531,Tuesday
2022,2,8,1200,297,209,506,Tuesday
2022,2,8,1100,358,189,547,Tuesday
2022,2,8,1000,454,174,628,Tuesday
2022,2,8,900,487,164,651,Tuesday
2022,2,8,800,287,40,327,Tuesday
2022,2,8,700,104,29,133,Tuesday
2022,2,8,600,44,26,70,Tuesday
2022,2,8,500,20,13,33,Tuesday
2022,2,8,400,7,15,22,Tuesday
2022,2,8,300,12,18,30,Tuesday
2022,2,8,200,11,26,37,Tuesday
2022,2,8,100,34,9,43,Tuesday
2022,2,7,2400,29,57,86,Monday
2022,2,7,2300,42,55,97,Monday
2022,2,7,2200,56,80,136,Monday
2022,2,7,2100,74,122,196,Monday
2022,2,7,2000,117,177,294,Monday
2022,2,7,1900,129,280,409,Monday
2022,2,7,1800,163,349,512,Monday
2022,2,7,1700,224,492,716,Monday
2022,2,7,1600,259,502,761,Monday
2022,2,7,1500,286,410,696,Monday
2022,2,7,1400,297,336,633,Monday
2022,2,7,1300,291,307,598,Monday
2022,2,7,1200,376,254,630,Monday
2022,2,7,1100,406,197,603,Monday
2022,2,7,1000,401,142,543,Monday
2022,2,7,900,451,143,594,Monday
2022,2,7,800,281,44,325,Monday
2022,2,7,700,102,15,117,Monday
2022,2,7,600,32,19,51,Monday
2022,2,7,500,16,7,23,Monday
2022,2,7,400,13,7,20,Monday
2022,2,7,300,11,12,23,Monday
2022,2,7,200,19,16,35,Monday
2022,2,7,100,16,13,29,Monday
2022,2,6,2400,21,85,106,Sunday
2022,2,6,2300,44,325,369,Sunday
2022,2,6,2200,42,116,158,Sunday
2022,2,6,2100,80,228,308,Sunday
2022,2,6,2000,109,391,500,Sunday
2022,2,6,1900,124,476,600,Sunday
2022,2,6,1800,186,940,1126,Sunday
2022,2,6,1700,266,1368,1634,Sunday
2022,2,6,1600,344,1039,1383,Sunday
2022,2,6,1500,376,949,1325,Sunday
2022,2,6,1400,443,756,1199,Sunday
2022,2,6,1300,500,661,1161,Sunday
2022,2,6,1200,549,422,971,Sunday
2022,2,6,1100,530,275,805,Sunday
2022,2,6,1000,645,167,812,Sunday
2022,2,6,900,1016,84,1100,Sunday
2022,2,6,800,505,33,538,Sunday
2022,2,6,700,99,19,118,Sunday
2022,2,6,600,32,18,50,Sunday
2022,2,6,500,10,17,27,Sunday
2022,2,6,400,13,8,21,Sunday
2022,2,6,300,13,14,27,Sunday
2022,2,6,200,11,15,26,Sunday
2022,2,6,100,19,32,51,Sunday
2022,2,5,2400,16,40,56,Saturday
2022,2,5,2300,43,80,123,Saturday
2022,2,5,2200,75,108,183,Saturday
2022,2,5,2100,83,135,218,Saturday
2022,2,5,2000,97,233,330,Saturday
2022,2,5,1900,133,430,563,Saturday
2022,2,5,1800,177,1004,1181,Saturday
2022,2,5,1700,219,1201,1420,Saturday
2022,2,5,1600,303,999,1302,Saturday
2022,2,5,1500,358,569,927,Saturday
2022,2,5,1400,396,435,831,Saturday
2022,2,5,1300,447,246,693,Saturday
2022,2,5,1200,584,173,757,Saturday
2022,2,5,1100,541,184,725,Saturday
2022,2,5,1000,678,159,837,Saturday
2022,2,5,900,1155,62,1217,Saturday
2022,2,5,800,635,22,657,Saturday
2022,2,5,700,117,11,128,Saturday
2022,2,5,600,58,7,65,Saturday
2022,2,5,500,6,7,13,Saturday
2022,2,5,400,9,1,10,Saturday
2022,2,5,300,8,2,10,Saturday
2022,2,5,200,11,10,21,Saturday
2022,2,5,100,21,10,31,Saturday
2022,2,4,2400,41,118,159,Friday
2022,2,4,2300,67,91,158,Friday
2022,2,4,2200,99,50,149,Friday
2022,2,4,2100,172,55,227,Friday
2022,2,4,2000,288,108,396,Friday
2022,2,4,1900,429,273,702,Friday
2022,2,4,1800,466,508,974,Friday
2022,2,4,1700,507,723,1230,Friday
2022,2,4,1600,476,565,1041,Friday
2022,2,4,1500,457,467,924,Friday
2022,2,4,1400,391,289,680,Friday
2022,2,4,1300,376,248,624,Friday
2022,2,4,1200,422,189,611,Friday
2022,2,4,1100,428,157,585,Friday
2022,2,4,1000,514,179,693,Friday
2022,2,4,900,582,132,714,Friday
2022,2,4,800,326,39,365,Friday
2022,2,4,700,115,33,148,Friday
2022,2,4,600,37,27,64,Friday
2022,2,4,500,21,7,28,Friday
2022,2,4,400,11,7,18,Friday
2022,2,4,300,18,11,29,Friday
2022,2,4,200,18,25,43,Friday
2022,2,4,100,37,10,47,Friday
2022,2,3,2400,48,92,140,Thursday
2022,2,3,2300,49,74,123,Thursday
2022,2,3,2200,73,123,196,Thursday
2022,2,3,2100,125,112,237,Thursday
2022,2,3,2000,206,179,385,Thursday
2022,2,3,1900,274,235,509,Thursday
2022,2,3,1800,276,430,706,Thursday
2022,2,3,1700,282,569,851,Thursday
2022,2,3,1600,303,435,738,Thursday
2022,2,3,1500,277,289,566,Thursday
2022,2,3,1400,299,234,533,Thursday
2022,2,3,1300,330,221,551,Thursday
2022,2,3,1200,345,166,511,Thursday
2022,2,3,1100,364,125,489,Thursday
2022,2,3,1000,470,155,625,Thursday
2022,2,3,900,418,117,535,Thursday
2022,2,3,800,242,29,271,Thursday
2022,2,3,700,98,14,112,Thursday
2022,2,3,600,52,10,62,Thursday
2022,2,3,500,11,9,20,Thursday
2022,2,3,400,32,17,49,Thursday
2022,2,3,300,22,24,46,Thursday
2022,2,3,200,27,15,42,Thursday
2022,2,3,100,32,12,44,Thursday
2022,2,2,2400,47,56,103,Wednesday
2022,2,2,2300,51,63,114,Wednesday
2022,2,2,2200,42,107,149,Wednesday
2022,2,2,2100,113,126,239,Wednesday
2022,2,2,2000,126,172,298,Wednesday
2022,2,2,1900,134,254,388,Wednesday
2022,2,2,1800,177,213,390,Wednesday
2022,2,2,1700,184,385,569,Wednesday
2022,2,2,1600,189,298,487,Wednesday
2022,2,2,1500,231,295,526,Wednesday
2022,2,2,1400,236,339,575,Wednesday
2022,2,2,1300,272,106,378,Wednesday
2022,2,2,1200,259,154,413,Wednesday
2022,2,2,1100,235,134,369,Wednesday
2022,2,2,1000,275,146,421,Wednesday
2022,2,2,900,253,125,378,Wednesday
2022,2,2,800,206,34,240,Wednesday
2022,2,2,700,70,18,88,Wednesday
2022,2,2,600,36,18,54,Wednesday
2022,2,2,500,17,16,33,Wednesday
2022,2,2,400,23,15,38,Wednesday
2022,2,2,300,10,15,25,Wednesday
2022,2,2,200,23,16,39,Wednesday
2022,2,2,100,16,17,33,Wednesday
2022,2,1,2400,32,73,105,Tuesday
2022,2,1,2300,39,49,88,Tuesday
2022,2,1,2200,54,105,159,Tuesday
2022,2,1,2100,92,177,269,Tuesday
2022,2,1,2000,135,142,277,Tuesday
2022,2,1,1900,150,177,327,Tuesday
2022,2,1,1800,153,321,474,Tuesday
2022,2,1,1700,188,498,686,Tuesday
2022,2,1,1600,200,377,577,Tuesday
2022,2,1,1500,222,267,489,Tuesday
2022,2,1,1400,206,242,448,Tuesday
2022,2,1,1300,225,256,481,Tuesday
2022,2,1,1200,242,231,473,Tuesday
2022,2,1,1100,267,136,403,Tuesday
2022,2,1,1000,300,194,494,Tuesday
2022,2,1,900,370,116,486,Tuesday
2022,2,1,800,196,23,219,Tuesday
2022,2,1,700,81,32,113,Tuesday
2022,2,1,600,40,18,58,Tuesday
2022,2,1,500,16,12,28,Tuesday
2022,2,1,400,9,13,22,Tuesday
2022,2,1,300,9,11,20,Tuesday
2022,2,1,200,13,12,25,Tuesday
2022,2,1,100,17,14,31,Tuesday
2022,1,31,2400,27,76,103,Monday
2022,1,31,2300,43,76,119,Monday
2022,1,31,2200,50,71,121,Monday
2022,1,31,2100,89,159,248,Monday
2022,1,31,2000,122,250,372,Monday
2022,1,31,1900,119,215,334,Monday
2022,1,31,1800,139,514,653,Monday
2022,1,31,1700,147,686,833,Monday
2022,1,31,1600,224,689,913,Monday
2022,1,31,1500,199,610,809,Monday
2022,1,31,1400,261,585,846,Monday
2022,1,31,1300,279,342,621,Monday
2022,1,31,1200,285,202,487,Monday
2022,1,31,1100,353,157,510,Monday
2022,1,31,1000,491,112,603,Monday
2022,1,31,900,669,88,757,Monday
2022,1,31,800,292,33,325,Monday
2022,1,31,700,83,19,102,Monday
2022,1,31,600,29,12,41,Monday
2022,1,31,500,23,5,28,Monday
2022,1,31,400,13,4,17,Monday
2022,1,31,300,17,8,25,Monday
2022,1,31,200,8,21,29,Monday
2022,1,31,100,16,13,29,Monday
2022,1,30,2400,10,85,95,Sunday
2022,1,30,2300,23,65,88,Sunday
2022,1,30,2200,33,286,319,Sunday
2022,1,30,2100,58,97,155,Sunday
2022,1,30,2000,115,88,203,Sunday
2022,1,30,1900,135,270,405,Sunday
2022,1,30,1800,154,911,1065,Sunday
2022,1,30,1700,255,1302,1557,Sunday
2022,1,30,1600,283,1076,1359,Sunday
2022,1,30,1500,360,974,1334,Sunday
2022,1,30,1400,446,706,1152,Sunday
2022,1,30,1300,456,618,1074,Sunday
2022,1,30,1200,554,487,1041,Sunday
2022,1,30,1100,566,233,799,Sunday
2022,1,30,1000,615,151,766,Sunday
2022,1,30,900,917,68,985,Sunday
2022,1,30,800,473,39,512,Sunday
2022,1,30,700,108,14,122,Sunday
2022,1,30,600,33,14,47,Sunday
2022,1,30,500,10,15,25,Sunday
2022,1,30,400,8,18,26,Sunday
2022,1,30,300,11,25,36,Sunday
2022,1,30,200,12,28,40,Sunday
2022,1,30,100,13,23,36,Sunday
2022,1,29,2400,26,45,71,Saturday
2022,1,29,2300,38,59,97,Saturday
2022,1,29,2200,62,66,128,Saturday
2022,1,29,2100,65,149,214,Saturday
2022,1,29,2000,104,192,296,Saturday
2022,1,29,1900,121,424,545,Saturday
2022,1,29,1800,203,1049,1252,Saturday
2022,1,29,1700,257,1373,1630,Saturday
2022,1,29,1600,334,899,1233,Saturday
2022,1,29,1500,438,702,1140,Saturday
2022,1,29,1400,462,486,948,Saturday
2022,1,29,1300,615,394,1009,Saturday
2022,1,29,1200,684,262,946,Saturday
2022,1,29,1100,588,184,772,Saturday
2022,1,29,1000,717,169,886,Saturday
2022,1,29,900,1175,145,1320,Saturday
2022,1,29,800,614,24,638,Saturday
2022,1,29,700,125,26,151,Saturday
2022,1,29,600,38,10,48,Saturday
2022,1,29,500,10,10,20,Saturday
2022,1,29,400,13,16,29,Saturday
2022,1,29,300,12,9,21,Saturday
2022,1,29,200,11,15,26,Saturday
2022,1,29,100,22,16,38,Saturday
2022,1,28,2400,39,80,119,Friday
2022,1,28,2300,53,83,136,Friday
2022,1,28,2200,100,92,192,Friday
2022,1,28,2100,186,107,293,Friday
2022,1,28,2000,313,178,491,Friday
2022,1,28,1900,395,288,683,Friday
2022,1,28,1800,483,571,1054,Friday
2022,1,28,1700,531,875,1406,Friday
2022,1,28,1600,560,683,1243,Friday
2022,1,28,1500,526,456,982,Friday
2022,1,28,1400,458,367,825,Friday
2022,1,28,1300,428,289,717,Friday
2022,1,28,1200,485,285,770,Friday
2022,1,28,1100,531,174,705,Friday
2022,1,28,1000,561,183,744,Friday
2022,1,28,900,633,174,807,Friday
2022,1,28,800,302,52,354,Friday
2022,1,28,700,129,28,157,Friday
2022,1,28,600,69,18,87,Friday
2022,1,28,500,21,21,42,Friday
2022,1,28,400,20,29,49,Friday
2022,1,28,300,18,14,32,Friday
2022,1,28,200,23,22,45,Friday
2022,1,28,100,36,16,52,Friday
2022,1,27,2400,41,66,107,Thursday
2022,1,27,2300,49,69,118,Thursday
2022,1,27,2200,76,103,179,Thursday
2022,1,27,2100,134,153,287,Thursday
2022,1,27,2000,249,156,405,Thursday
2022,1,27,1900,260,262,522,Thursday
2022,1,27,1800,305,446,751,Thursday
2022,1,27,1700,326,772,1098,Thursday
2022,1,27,1600,358,557,915,Thursday
2022,1,27,1500,339,388,727,Thursday
2022,1,27,1400,344,360,704,Thursday
2022,1,27,1300,341,228,569,Thursday
2022,1,27,1200,441,230,671,Thursday
2022,1,27,1100,416,171,587,Thursday
2022,1,27,1000,515,169,684,Thursday
2022,1,27,900,519,173,692,Thursday
2022,1,27,800,258,38,296,Thursday
2022,1,27,700,98,32,130,Thursday
2022,1,27,600,34,15,49,Thursday
2022,1,27,500,18,11,29,Thursday
2022,1,27,400,22,20,42,Thursday
2022,1,27,300,13,23,36,Thursday
2022,1,27,200,23,20,43,Thursday
2022,1,27,100,27,14,41,Thursday
2022,1,26,2400,44,85,129,Wednesday
2022,1,26,2300,53,62,115,Wednesday
2022,1,26,2200,67,78,145,Wednesday
2022,1,26,2100,130,124,254,Wednesday
2022,1,26,2000,168,156,324,Wednesday
2022,1,26,1900,175,235,410,Wednesday
2022,1,26,1800,211,501,712,Wednesday
2022,1,26,1700,244,634,878,Wednesday
2022,1,26,1600,220,561,781,Wednesday
2022,1,26,1500,277,307,584,Wednesday
2022,1,26,1400,283,295,578,Wednesday
2022,1,26,1300,317,302,619,Wednesday
2022,1,26,1200,370,185,555,Wednesday
2022,1,26,1100,415,170,585,Wednesday
2022,1,26,1000,514,212,726,Wednesday
2022,1,26,900,460,174,634,Wednesday
2022,1,26,800,246,37,283,Wednesday
2022,1,26,700,107,35,142,Wednesday
2022,1,26,600,55,17,72,Wednesday
2022,1,26,500,17,12,29,Wednesday
2022,1,26,400,15,39,54,Wednesday
2022,1,26,300,17,26,43,Wednesday
2022,1,26,200,15,16,31,Wednesday
2022,1,26,100,19,18,37,Wednesday
2022,1,25,2400,34,80,114,Tuesday
2022,1,25,2300,35,51,86,Tuesday
2022,1,25,2200,47,110,157,Tuesday
2022,1,25,2100,85,118,203,Tuesday
2022,1,25,2000,119,201,320,Tuesday
2022,1,25,1900,129,219,348,Tuesday
2022,1,25,1800,183,428,611,Tuesday
2022,1,25,1700,203,612,815,Tuesday
2022,1,25,1600,249,483,732,Tuesday
2022,1,25,1500,275,391,666,Tuesday
2022,1,25,1400,246,263,509,Tuesday
2022,1,25,1300,299,243,542,Tuesday
2022,1,25,1200,306,180,486,Tuesday
2022,1,25,1100,404,153,557,Tuesday
2022,1,25,1000,431,181,612,Tuesday
2022,1,25,900,464,154,618,Tuesday
2022,1,25,800,207,33,240,Tuesday
2022,1,25,700,109,22,131,Tuesday
2022,1,25,600,50,18,68,Tuesday
2022,1,25,500,17,18,35,Tuesday
2022,1,25,400,13,20,33,Tuesday
2022,1,25,300,9,21,30,Tuesday
2022,1,25,200,10,11,21,Tuesday
2022,1,25,100,23,16,39,Tuesday
2022,1,24,2400,35,72,107,Monday
2022,1,24,2300,49,58,107,Monday
2022,1,24,2200,48,113,161,Monday
2022,1,24,2100,72,125,197,Monday
2022,1,24,2000,129,137,266,Monday
2022,1,24,1900,145,216,361,Monday
2022,1,24,1800,154,376,530,Monday
2022,1,24,1700,206,578,784,Monday
2022,1,24,1600,248,491,739,Monday
2022,1,24,1500,265,390,655,Monday
2022,1,24,1400,267,286,553,Monday
2022,1,24,1300,300,269,569,Monday
2022,1,24,1200,372,205,577,Monday
2022,1,24,1100,384,201,585,Monday
2022,1,24,1000,399,142,541,Monday
2022,1,24,900,469,106,575,Monday
2022,1,24,800,237,35,272,Monday
2022,1,24,700,98,27,125,Monday
2022,1,24,600,36,16,52,Monday
2022,1,24,500,15,13,28,Monday
2022,1,24,400,13,14,27,Monday
2022,1,24,300,12,14,26,Monday
2022,1,24,200,10,17,27,Monday
2022,1,24,100,9,19,28,Monday
2022,1,23,2400,20,47,67,Sunday
2022,1,23,2300,45,116,161,Sunday
2022,1,23,2200,48,153,201,Sunday
2022,1,23,2100,68,221,289,Sunday
2022,1,23,2000,102,307,409,Sunday
2022,1,23,1900,117,433,550,Sunday
2022,1,23,1800,175,1103,1278,Sunday
2022,1,23,1700,261,1537,1798,Sunday
2022,1,23,1600,352,1140,1492,Sunday
2022,1,23,1500,379,914,1293,Sunday
2022,1,23,1400,470,783,1253,Sunday
2022,1,23,1300,563,700,1263,Sunday
2022,1,23,1200,564,401,965,Sunday
2022,1,23,1100,572,255,827,Sunday
2022,1,23,1000,619,144,763,Sunday
2022,1,23,900,1018,79,1097,Sunday
2022,1,23,800,526,39,565,Sunday
2022,1,23,700,118,22,140,Sunday
2022,1,23,600,30,18,48,Sunday
2022,1,23,500,14,10,24,Sunday
2022,1,23,400,6,15,21,Sunday
2022,1,23,300,21,17,38,Sunday
2022,1,23,200,17,37,54,Sunday
2022,1,23,100,17,19,36,Sunday
2022,1,22,2400,33,47,80,Saturday
2022,1,22,2300,33,121,154,Saturday
2022,1,22,2200,39,241,280,Saturday
2022,1,22,2100,68,67,135,Saturday
2022,1,22,2000,87,154,241,Saturday
2022,1,22,1900,120,441,561,Saturday
2022,1,22,1800,167,1094,1261,Saturday
2022,1,22,1700,214,1272,1486,Saturday
2022,1,22,1600,341,869,1210,Saturday
2022,1,22,1500,369,640,1009,Saturday
2022,1,22,1400,464,516,980,Saturday
2022,1,22,1300,590,375,965,Saturday
2022,1,22,1200,594,248,842,Saturday
2022,1,22,1100,588,171,759,Saturday
2022,1,22,1000,783,177,960,Saturday
2022,1,22,900,1310,98,1408,Saturday
2022,1,22,800,633,26,659,Saturday
2022,1,22,700,144,15,159,Saturday
2022,1,22,600,47,17,64,Saturday
2022,1,22,500,10,9,19,Saturday
2022,1,22,400,7,13,20,Saturday
2022,1,22,300,14,19,33,Saturday
2022,1,22,200,12,14,26,Saturday
2022,1,22,100,21,9,30,Saturday
2022,1,21,2400,38,73,111,Friday
2022,1,21,2300,60,66,126,Friday
2022,1,21,2200,91,74,165,Friday
2022,1,21,2100,160,128,288,Friday
2022,1,21,2000,331,148,479,Friday
2022,1,21,1900,379,306,685,Friday
2022,1,21,1800,410,572,982,Friday
2022,1,21,1700,498,770,1268,Friday
2022,1,21,1600,515,555,1070,Friday
2022,1,21,1500,439,433,872,Friday
2022,1,21,1400,393,368,761,Friday
2022,1,21,1300,376,310,686,Friday
2022,1,21,1200,398,182,580,Friday
2022,1,21,1100,469,184,653,Friday
2022,1,21,1000,544,175,719,Friday
2022,1,21,900,634,133,767,Friday
2022,1,21,800,314,48,362,Friday
2022,1,21,700,118,28,146,Friday
2022,1,21,600,46,16,62,Friday
2022,1,21,500,26,21,47,Friday
2022,1,21,400,14,20,34,Friday
2022,1,21,300,13,122,135,Friday
2022,1,21,200,16,192,208,Friday
2022,1,21,100,26,39,65,Friday
2022,1,20,2400,29,13,42,Thursday
2022,1,20,2300,53,8,61,Thursday
2022,1,20,2200,68,11,79,Thursday
2022,1,20,2100,129,36,165,Thursday
2022,1,20,2000,215,140,355,Thursday
2022,1,20,1900,222,301,523,Thursday
2022,1,20,1800,225,432,657,Thursday
2022,1,20,1700,265,505,770,Thursday
2022,1,20,1600,281,327,608,Thursday
2022,1,20,1500,296,301,597,Thursday
2022,1,20,1400,283,251,534,Thursday
2022,1,20,1300,287,211,498,Thursday
2022,1,20,1200,290,179,469,Thursday
2022,1,20,1100,333,143,476,Thursday
2022,1,20,1000,436,169,605,Thursday
2022,1,20,900,445,83,528,Thursday
2022,1,20,800,184,32,216,Thursday
2022,1,20,700,87,24,111,Thursday
2022,1,20,600,27,19,46,Thursday
2022,1,20,500,11,15,26,Thursday
2022,1,20,400,17,14,31,Thursday
2022,1,20,300,14,10,24,Thursday
2022,1,20,200,22,12,34,Thursday
2022,1,20,100,21,15,36,Thursday
2022,1,19,2400,42,70,112,Wednesday
2022,1,19,2300,38,66,104,Wednesday
2022,1,19,2200,57,121,178,Wednesday
2022,1,19,2100,80,137,217,Wednesday
2022,1,19,2000,120,122,242,Wednesday
2022,1,19,1900,155,216,371,Wednesday
2022,1,19,1800,176,359,535,Wednesday
2022,1,19,1700,214,562,776,Wednesday
2022,1,19,1600,209,511,720,Wednesday
2022,1,19,1500,255,309,564,Wednesday
2022,1,19,1400,265,263,528,Wednesday
2022,1,19,1300,298,290,588,Wednesday
2022,1,19,1200,330,158,488,Wednesday
2022,1,19,1100,316,171,487,Wednesday
2022,1,19,1000,475,138,613,Wednesday
2022,1,19,900,416,104,520,Wednesday
2022,1,19,800,190,31,221,Wednesday
2022,1,19,700,80,26,106,Wednesday
2022,1,19,600,38,11,49,Wednesday
2022,1,19,500,18,9,27,Wednesday
2022,1,19,400,10,12,22,Wednesday
2022,1,19,300,13,17,30,Wednesday
2022,1,19,200,19,20,39,Wednesday
2022,1,19,100,26,10,36,Wednesday
2022,1,18,2400,41,64,105,Tuesday
2022,1,18,2300,50,53,103,Tuesday
2022,1,18,2200,59,90,149,Tuesday
2022,1,18,2100,62,122,184,Tuesday
2022,1,18,2000,130,238,368,Tuesday
2022,1,18,1900,104,467,571,Tuesday
2022,1,18,1800,130,564,694,Tuesday
2022,1,18,1700,144,512,656,Tuesday
2022,1,18,1600,167,292,459,Tuesday
2022,1,18,1500,176,291,467,Tuesday
2022,1,18,1400,179,224,403,Tuesday
2022,1,18,1300,215,146,361,Tuesday
2022,1,18,1200,254,100,354,Tuesday
2022,1,18,1100,280,96,376,Tuesday
2022,1,18,1000,379,104,483,Tuesday
2022,1,18,900,441,72,513,Tuesday
2022,1,18,800,170,38,208,Tuesday
2022,1,18,700,89,19,108,Tuesday
2022,1,18,600,31,6,37,Tuesday
2022,1,18,500,13,3,16,Tuesday
2022,1,18,400,3,5,8,Tuesday
2022,1,18,300,11,6,17,Tuesday
2022,1,18,200,5,1,6,Tuesday
2022,1,18,100,15,9,24,Tuesday
2022,1,17,2400,21,18,39,Monday
2022,1,17,2300,33,16,49,Monday
2022,1,17,2200,50,18,68,Monday
2022,1,17,2100,64,38,102,Monday
2022,1,17,2000,112,46,158,Monday
2022,1,17,1900,140,121,261,Monday
2022,1,17,1800,152,340,492,Monday
2022,1,17,1700,145,470,615,Monday
2022,1,17,1600,205,460,665,Monday
2022,1,17,1500,253,299,552,Monday
2022,1,17,1400,266,298,564,Monday
2022,1,17,1300,285,280,565,Monday
2022,1,17,1200,294,220,514,Monday
2022,1,17,1100,350,146,496,Monday
2022,1,17,1000,432,144,576,Monday
2022,1,17,900,429,103,532,Monday
2022,1,17,800,186,22,208,Monday
2022,1,17,700,98,23,121,Monday
2022,1,17,600,35,7,42,Monday
2022,1,17,500,14,6,20,Monday
2022,1,17,400,15,12,27,Monday
2022,1,17,300,11,3,14,Monday
2022,1,17,200,13,12,25,Monday
2022,1,17,100,14,16,30,Monday
2022,1,16,2400,20,54,74,Sunday
2022,1,16,2300,29,63,92,Sunday
2022,1,16,2200,46,109,155,Sunday
2022,1,16,2100,78,168,246,Sunday
2022,1,16,2000,99,254,353,Sunday
2022,1,16,1900,114,490,604,Sunday
2022,1,16,1800,142,1217,1359,Sunday
2022,1,16,1700,227,1166,1393,Sunday
2022,1,16,1600,297,1101,1398,Sunday
2022,1,16,1500,347,822,1169,Sunday
2022,1,16,1400,361,739,1100,Sunday
2022,1,16,1300,448,530,978,Sunday
2022,1,16,1200,543,381,924,Sunday
2022,1,16,1100,545,234,779,Sunday
2022,1,16,1000,636,146,782,Sunday
2022,1,16,900,1021,85,1106,Sunday
2022,1,16,800,488,24,512,Sunday
2022,1,16,700,81,23,104,Sunday
2022,1,16,600,25,16,41,Sunday
2022,1,16,500,16,8,24,Sunday
2022,1,16,400,7,13,20,Sunday
2022,1,16,300,8,11,19,Sunday
2022,1,16,200,12,17,29,Sunday
2022,1,16,100,21,37,58,Sunday
2022,1,15,2400,24,43,67,Saturday
2022,1,15,2300,36,50,86,Saturday
2022,1,15,2200,41,84,125,Saturday
2022,1,15,2100,66,102,168,Saturday
2022,1,15,2000,81,190,271,Saturday
2022,1,15,1900,95,432,527,Saturday
2022,1,15,1800,166,1181,1347,Saturday
2022,1,15,1700,214,1241,1455,Saturday
2022,1,15,1600,324,839,1163,Saturday
2022,1,15,1500,333,602,935,Saturday
2022,1,15,1400,376,451,827,Saturday
2022,1,15,1300,443,283,726,Saturday
2022,1,15,1200,535,260,795,Saturday
2022,1,15,1100,591,196,787,Saturday
2022,1,15,1000,869,161,1030,Saturday
2022,1,15,900,1290,85,1375,Saturday
2022,1,15,800,633,25,658,Saturday
2022,1,15,700,118,15,133,Saturday
2022,1,15,600,32,12,44,Saturday
2022,1,15,500,12,11,23,Saturday
2022,1,15,400,7,13,20,Saturday
2022,1,15,300,19,15,34,Saturday
2022,1,15,200,11,29,40,Saturday
2022,1,15,100,32,14,46,Saturday
2022,1,14,2400,49,49,98,Friday
2022,1,14,2300,49,75,124,Friday
2022,1,14,2200,70,77,147,Friday
2022,1,14,2100,184,97,281,Friday
2022,1,14,2000,263,312,575,Friday
2022,1,14,1900,343,227,570,Friday
2022,1,14,1800,429,477,906,Friday
2022,1,14,1700,438,647,1085,Friday
2022,1,14,1600,443,548,991,Friday
2022,1,14,1500,380,625,1005,Friday
2022,1,14,1400,323,297,620,Friday
2022,1,14,1300,335,187,522,Friday
2022,1,14,1200,419,150,569,Friday
2022,1,14,1100,423,101,524,Friday
2022,1,14,1000,517,128,645,Friday
2022,1,14,900,596,101,697,Friday
2022,1,14,800,287,33,320,Friday
2022,1,14,700,112,18,130,Friday
2022,1,14,600,41,15,56,Friday
2022,1,14,500,18,5,23,Friday
2022,1,14,400,17,18,35,Friday
2022,1,14,300,11,19,30,Friday
2022,1,14,200,11,31,42,Friday
2022,1,14,100,12,29,41,Friday
2022,1,13,2400,29,47,76,Thursday
2022,1,13,2300,50,61,111,Thursday
2022,1,13,2200,58,85,143,Thursday
2022,1,13,2100,115,96,211,Thursday
2022,1,13,2000,184,109,293,Thursday
2022,1,13,1900,239,230,469,Thursday
2022,1,13,1800,201,393,594,Thursday
2022,1,13,1700,246,627,873,Thursday
2022,1,13,1600,252,526,778,Thursday
2022,1,13,1500,300,490,790,Thursday
2022,1,13,1400,276,408,684,Thursday
2022,1,13,1300,278,221,499,Thursday
2022,1,13,1200,291,148,439,Thursday
2022,1,13,1100,362,102,464,Thursday
2022,1,13,1000,540,119,659,Thursday
2022,1,13,900,529,79,608,Thursday
2022,1,13,800,255,20,275,Thursday
2022,1,13,700,91,22,113,Thursday
2022,1,13,600,39,10,49,Thursday
2022,1,13,500,15,3,18,Thursday
2022,1,13,400,13,8,21,Thursday
2022,1,13,300,16,5,21,Thursday
2022,1,13,200,18,22,40,Thursday
2022,1,13,100,23,39,62,Thursday
2022,1,12,2400,36,109,145,Wednesday
2022,1,12,2300,41,112,153,Wednesday
2022,1,12,2200,54,26,80,Wednesday
2022,1,12,2100,93,26,119,Wednesday
2022,1,12,2000,116,92,208,Wednesday
2022,1,12,1900,114,195,309,Wednesday
2022,1,12,1800,142,424,566,Wednesday
2022,1,12,1700,200,554,754,Wednesday
2022,1,12,1600,213,391,604,Wednesday
2022,1,12,1500,227,305,532,Wednesday
2022,1,12,1400,228,327,555,Wednesday
2022,1,12,1300,269,256,525,Wednesday
2022,1,12,1200,292,204,496,Wednesday
2022,1,12,1100,327,203,530,Wednesday
2022,1,12,1000,456,265,721,Wednesday
2022,1,12,900,477,133,610,Wednesday
2022,1,12,800,194,35,229,Wednesday
2022,1,12,700,104,18,122,Wednesday
2022,1,12,600,44,21,65,Wednesday
2022,1,12,500,10,21,31,Wednesday
2022,1,12,400,11,80,91,Wednesday
2022,1,12,300,13,38,51,Wednesday
2022,1,12,200,23,19,42,Wednesday
2022,1,12,100,15,11,26,Wednesday
2022,1,11,2400,28,16,44,Tuesday
2022,1,11,2300,40,17,57,Tuesday
2022,1,11,2200,30,18,48,Tuesday
2022,1,11,2100,76,46,122,Tuesday
2022,1,11,2000,101,140,241,Tuesday
2022,1,11,1900,116,119,235,Tuesday
2022,1,11,1800,177,283,460,Tuesday
2022,1,11,1700,203,369,572,Tuesday
2022,1,11,1600,194,334,528,Tuesday
2022,1,11,1500,206,325,531,Tuesday
2022,1,11,1400,249,273,522,Tuesday
2022,1,11,1300,223,196,419,Tuesday
2022,1,11,1200,274,183,457,Tuesday
2022,1,11,1100,327,165,492,Tuesday
2022,1,11,1000,391,128,519,Tuesday
2022,1,11,900,390,105,495,Tuesday
2022,1,11,800,197,28,225,Tuesday
2022,1,11,700,92,20,112,Tuesday
2022,1,11,600,31,13,44,Tuesday
2022,1,11,500,18,13,31,Tuesday
2022,1,11,400,11,24,35,Tuesday
2022,1,11,300,16,18,34,Tuesday
2022,1,11,200,18,18,36,Tuesday
2022,1,11,100,23,9,32,Tuesday
2022,1,10,2400,28,62,90,Monday
2022,1,10,2300,42,72,114,Monday
2022,1,10,2200,52,84,136,Monday
2022,1,10,2100,94,99,193,Monday
2022,1,10,2000,95,125,220,Monday
2022,1,10,1900,114,235,349,Monday
2022,1,10,1800,148,381,529,Monday
2022,1,10,1700,199,625,824,Monday
2022,1,10,1600,222,535,757,Monday
2022,1,10,1500,230,286,516,Monday
2022,1,10,1400,293,244,537,Monday
2022,1,10,1300,237,238,475,Monday
2022,1,10,1200,391,188,579,Monday
2022,1,10,1100,383,152,535,Monday
2022,1,10,1000,451,132,583,Monday
2022,1,10,900,436,115,551,Monday
2022,1,10,800,216,34,250,Monday
2022,1,10,700,81,13,94,Monday
2022,1,10,600,37,8,45,Monday
2022,1,10,500,15,10,25,Monday
2022,1,10,400,13,11,24,Monday
2022,1,10,300,16,9,25,Monday
2022,1,10,200,20,18,38,Monday
2022,1,10,100,25,22,47,Monday
2022,1,9,2400,26,71,97,Sunday
2022,1,9,2300,23,109,132,Sunday
2022,1,9,2200,48,171,219,Sunday
2022,1,9,2100,76,157,233,Sunday
2022,1,9,2000,76,443,519,Sunday
2022,1,9,1900,91,497,588,Sunday
2022,1,9,1800,144,975,1119,Sunday
2022,1,9,1700,197,1156,1353,Sunday
2022,1,9,1600,237,929,1166,Sunday
2022,1,9,1500,318,749,1067,Sunday
2022,1,9,1400,299,548,847,Sunday
2022,1,9,1300,403,394,797,Sunday
2022,1,9,1200,492,314,806,Sunday
2022,1,9,1100,629,213,842,Sunday
2022,1,9,1000,652,123,775,Sunday
2022,1,9,900,886,74,960,Sunday
2022,1,9,800,401,28,429,Sunday
2022,1,9,700,67,14,81,Sunday
2022,1,9,600,24,21,45,Sunday
2022,1,9,500,10,22,32,Sunday
2022,1,9,400,11,30,41,Sunday
2022,1,9,300,6,17,23,Sunday
2022,1,9,200,18,63,81,Sunday
2022,1,9,100,13,57,70,Sunday
2022,1,8,2400,12,31,43,Saturday
2022,1,8,2300,19,90,109,Saturday
2022,1,8,2200,32,100,132,Saturday
2022,1,8,2100,48,144,192,Saturday
2022,1,8,2000,75,338,413,Saturday
2022,1,8,1900,75,205,280,Saturday
2022,1,8,1800,104,605,709,Saturday
2022,1,8,1700,181,848,1029,Saturday
2022,1,8,1600,214,628,842,Saturday
2022,1,8,1500,253,484,737,Saturday
2022,1,8,1400,262,342,604,Saturday
2022,1,8,1300,355,298,653,Saturday
2022,1,8,1200,428,210,638,Saturday
2022,1,8,1100,383,139,522,Saturday
2022,1,8,1000,489,117,606,Saturday
2022,1,8,900,836,60,896,Saturday
2022,1,8,800,469,20,489,Saturday
2022,1,8,700,105,17,122,Saturday
2022,1,8,600,28,14,42,Saturday
2022,1,8,500,12,9,21,Saturday
2022,1,8,400,6,9,15,Saturday
2022,1,8,300,10,7,17,Saturday
2022,1,8,200,10,65,75,Saturday
2022,1,8,100,23,169,192,Saturday
2022,1,7,2400,15,45,60,Friday
2022,1,7,2300,37,13,50,Friday
2022,1,7,2200,55,13,68,Friday
2022,1,7,2100,101,50,151,Friday
2022,1,7,2000,187,66,253,Friday
2022,1,7,1900,191,111,302,Friday
2022,1,7,1800,240,385,625,Friday
2022,1,7,1700,319,631,950,Friday
2022,1,7,1600,326,400,726,Friday
2022,1,7,1500,296,318,614,Friday
2022,1,7,1400,287,223,510,Friday
2022,1,7,1300,293,197,490,Friday
2022,1,7,1200,280,149,429,Friday
2022,1,7,1100,365,134,499,Friday
2022,1,7,1000,462,113,575,Friday
2022,1,7,900,547,38,585,Friday
2022,1,7,800,244,14,258,Friday
2022,1,7,700,64,10,74,Friday
2022,1,7,600,28,15,43,Friday
2022,1,7,500,15,12,27,Friday
2022,1,7,400,10,9,19,Friday
2022,1,7,300,14,8,22,Friday
2022,1,7,200,12,10,22,Friday
2022,1,7,100,18,43,61,Friday
2022,1,6,2400,27,27,54,Thursday
2022,1,6,2300,35,29,64,Thursday
2022,1,6,2200,60,62,122,Thursday
2022,1,6,2100,96,53,149,Thursday
2022,1,6,2000,146,142,288,Thursday
2022,1,6,1900,161,139,300,Thursday
2022,1,6,1800,211,302,513,Thursday
2022,1,6,1700,239,392,631,Thursday
2022,1,6,1600,284,408,692,Thursday
2022,1,6,1500,290,270,560,Thursday
2022,1,6,1400,259,247,506,Thursday
2022,1,6,1300,242,163,405,Thursday
2022,1,6,1200,264,156,420,Thursday
2022,1,6,1100,267,159,426,Thursday
2022,1,6,1000,310,144,454,Thursday
2022,1,6,900,307,95,402,Thursday
2022,1,6,800,163,27,190,Thursday
2022,1,6,700,71,26,97,Thursday
2022,1,6,600,31,22,53,Thursday
2022,1,6,500,16,9,25,Thursday
2022,1,6,400,11,14,25,Thursday
2022,1,6,300,18,13,31,Thursday
2022,1,6,200,21,16,37,Thursday
2022,1,6,100,25,13,38,Thursday
2022,1,5,2400,37,49,86,Wednesday
2022,1,5,2300,34,48,82,Wednesday
2022,1,5,2200,62,94,156,Wednesday
2022,1,5,2100,95,91,186,Wednesday
2022,1,5,2000,129,110,239,Wednesday
2022,1,5,1900,141,226,367,Wednesday
2022,1,5,1800,150,397,547,Wednesday
2022,1,5,1700,217,537,754,Wednesday
2022,1,5,1600,236,360,596,Wednesday
2022,1,5,1500,277,397,674,Wednesday
2022,1,5,1400,280,290,570,Wednesday
2022,1,5,1300,289,298,587,Wednesday
2022,1,5,1200,354,217,571,Wednesday
2022,1,5,1100,332,160,492,Wednesday
2022,1,5,1000,337,133,470,Wednesday
2022,1,5,900,306,96,402,Wednesday
2022,1,5,800,170,21,191,Wednesday
2022,1,5,700,78,29,107,Wednesday
2022,1,5,600,18,18,36,Wednesday
2022,1,5,500,12,17,29,Wednesday
2022,1,5,400,17,22,39,Wednesday
2022,1,5,300,24,18,42,Wednesday
2022,1,5,200,21,10,31,Wednesday
2022,1,5,100,30,10,40,Wednesday
2022,1,4,2400,31,48,79,Tuesday
2022,1,4,2300,27,57,84,Tuesday
2022,1,4,2200,64,66,130,Tuesday
2022,1,4,2100,87,115,202,Tuesday
2022,1,4,2000,105,161,266,Tuesday
2022,1,4,1900,136,226,362,Tuesday
2022,1,4,1800,169,362,531,Tuesday
2022,1,4,1700,183,524,707,Tuesday
2022,1,4,1600,244,438,682,Tuesday
2022,1,4,1500,256,366,622,Tuesday
2022,1,4,1400,264,325,589,Tuesday
2022,1,4,1300,334,366,700,Tuesday
2022,1,4,1200,336,271,607,Tuesday
2022,1,4,1100,320,208,528,Tuesday
2022,1,4,1000,323,142,465,Tuesday
2022,1,4,900,349,53,402,Tuesday
2022,1,4,800,139,64,203,Tuesday
2022,1,4,700,72,39,111,Tuesday
2022,1,4,600,29,22,51,Tuesday
2022,1,4,500,18,3,21,Tuesday
2022,1,4,400,15,10,25,Tuesday
2022,1,4,300,18,14,32,Tuesday
2022,1,4,200,16,38,54,Tuesday
2022,1,4,100,18,46,64,Tuesday
2022,1,3,2400,29,72,101,Monday
2022,1,3,2300,31,85,116,Monday
2022,1,3,2200,47,92,139,Monday
2022,1,3,2100,63,188,251,Monday
2022,1,3,2000,69,269,338,Monday
2022,1,3,1900,94,363,457,Monday
2022,1,3,1800,136,811,947,Monday
2022,1,3,1700,182,902,1084,Monday
2022,1,3,1600,236,637,873,Monday
2022,1,3,1500,310,406,716,Monday
2022,1,3,1400,420,390,810,Monday
2022,1,3,1300,684,361,1045,Monday
2022,1,3,1200,522,358,880,Monday
2022,1,3,1100,416,163,579,Monday
2022,1,3,1000,425,101,526,Monday
2022,1,3,900,408,45,453,Monday
2022,1,3,800,290,32,322,Monday
2022,1,3,700,75,26,101,Monday
2022,1,3,600,30,9,39,Monday
2022,1,3,500,19,8,27,Monday
2022,1,3,400,11,24,35,Monday
2022,1,3,300,9,6,15,Monday
2022,1,3,200,11,10,21,Monday
2022,1,3,100,18,24,42,Monday
2022,1,2,2400,19,56,75,Sunday
2022,1,2,2300,27,72,99,Sunday
2022,1,2,2200,33,89,122,Sunday
2022,1,2,2100,59,144,203,Sunday
2022,1,2,2000,87,272,359,Sunday
2022,1,2,1900,107,537,644,Sunday
2022,1,2,1800,168,1470,1638,Sunday
2022,1,2,1700,246,1293,1539,Sunday
2022,1,2,1600,380,1332,1712,Sunday
2022,1,2,1500,509,1121,1630,Sunday
2022,1,2,1400,563,820,1383,Sunday
2022,1,2,1300,661,602,1263,Sunday
2022,1,2,1200,693,467,1160,Sunday
2022,1,2,1100,722,205,927,Sunday
2022,1,2,1000,896,144,1040,Sunday
2022,1,2,900,965,70,1035,Sunday
2022,1,2,800,412,36,448,Sunday
2022,1,2,700,81,19,100,Sunday
2022,1,2,600,29,9,38,Sunday
2022,1,2,500,12,10,22,Sunday
2022,1,2,400,10,8,18,Sunday
2022,1,2,300,6,18,24,Sunday
2022,1,2,200,10,34,44,Sunday
2022,1,2,100,16,37,53,Sunday
2022,1,1,2400,25,8,33,Saturday
2022,1,1,2300,28,40,68,Saturday
2022,1,1,2200,39,64,103,Saturday
2022,1,1,2100,45,85,130,Saturday
2022,1,1,2000,73,155,228,Saturday
2022,1,1,1900,113,299,412,Saturday
2022,1,1,1800,118,540,658,Saturday
2022,1,1,1700,225,772,997,Saturday
2022,1,1,1600,293,824,1117,Saturday
2022,1,1,1500,379,715,1094,Saturday
2022,1,1,1400,440,575,1015,Saturday
2022,1,1,1300,510,498,1008,Saturday
2022,1,1,1200,491,313,804,Saturday
2022,1,1,1100,407,174,581,Saturday
2022,1,1,1000,379,89,468,Saturday
2022,1,1,900,241,35,276,Saturday
2022,1,1,800,124,19,143,Saturday
2022,1,1,700,52,22,74,Saturday
2022,1,1,600,17,13,30,Saturday
2022,1,1,500,9,11,20,Saturday
2022,1,1,400,9,10,19,Saturday
2022,1,1,300,13,21,34,Saturday
2022,1,1,200,7,24,31,Saturday
2022,1,1,100,22,22,44,Saturday
2021,12,31,2400,29,31,60,Friday
2021,12,31,2300,24,48,72,Friday
2021,12,31,2200,44,69,113,Friday
2021,12,31,2100,64,81,145,Friday
2021,12,31,2000,91,118,209,Friday
2021,12,31,1900,130,268,398,Friday
2021,12,31,1800,191,699,890,Friday
2021,12,31,1700,271,583,854,Friday
2021,12,31,1600,361,425,786,Friday
2021,12,31,1500,480,528,1008,Friday
2021,12,31,1400,473,473,946,Friday
2021,12,31,1300,439,422,861,Friday
2021,12,31,1200,520,309,829,Friday
2021,12,31,1100,508,193,701,Friday
2021,12,31,1000,448,134,582,Friday
2021,12,31,900,387,73,460,Friday
2021,12,31,800,148,49,197,Friday
2021,12,31,700,74,30,104,Friday
2021,12,31,600,29,16,45,Friday
2021,12,31,500,16,16,32,Friday
2021,12,31,400,15,29,44,Friday
2021,12,31,300,12,26,38,Friday
2021,12,31,200,12,18,30,Friday
2021,12,31,100,26,27,53,Friday
2021,12,30,2400,24,49,73,Thursday
2021,12,30,2300,54,81,135,Thursday
2021,12,30,2200,78,95,173,Thursday
2021,12,30,2100,76,107,183,Thursday
2021,12,30,2000,123,156,279,Thursday
2021,12,30,1900,178,322,500,Thursday
2021,12,30,1800,243,736,979,Thursday
2021,12,30,1700,342,981,1323,Thursday
2021,12,30,1600,495,724,1219,Thursday
2021,12,30,1500,540,555,1095,Thursday
2021,12,30,1400,602,587,1189,Thursday
2021,12,30,1300,601,484,1085,Thursday
2021,12,30,1200,604,352,956,Thursday
2021,12,30,1100,588,259,847,Thursday
2021,12,30,1000,582,129,711,Thursday
2021,12,30,900,535,97,632,Thursday
2021,12,30,800,244,43,287,Thursday
2021,12,30,700,89,31,120,Thursday
2021,12,30,600,30,21,51,Thursday
2021,12,30,500,28,17,45,Thursday
2021,12,30,400,15,27,42,Thursday
2021,12,30,300,17,31,48,Thursday
2021,12,30,200,23,41,64,Thursday
2021,12,30,100,27,20,47,Thursday
2021,12,29,2400,43,49,92,Wednesday
2021,12,29,2300,57,94,151,Wednesday
2021,12,29,2200,67,94,161,Wednesday
2021,12,29,2100,88,180,268,Wednesday
2021,12,29,2000,135,162,297,Wednesday
2021,12,29,1900,193,190,383,Wednesday
2021,12,29,1800,227,535,762,Wednesday
2021,12,29,1700,351,860,1211,Wednesday
2021,12,29,1600,445,724,1169,Wednesday
2021,12,29,1500,568,569,1137,Wednesday
2021,12,29,1400,655,582,1237,Wednesday
2021,12,29,1300,632,459,1091,Wednesday
2021,12,29,1200,640,290,930,Wednesday
2021,12,29,1100,580,199,779,Wednesday
2021,12,29,1000,537,119,656,Wednesday
2021,12,29,900,390,87,477,Wednesday
2021,12,29,800,199,43,242,Wednesday
2021,12,29,700,77,32,109,Wednesday
2021,12,29,600,38,23,61,Wednesday
2021,12,29,500,15,20,35,Wednesday
2021,12,29,400,10,31,41,Wednesday
2021,12,29,300,21,24,45,Wednesday
2021,12,29,200,9,36,45,Wednesday
2021,12,29,100,23,37,60,Wednesday
2021,12,28,2400,37,49,86,Tuesday
2021,12,28,2300,37,79,116,Tuesday
2021,12,28,2200,81,82,163,Tuesday
2021,12,28,2100,102,109,211,Tuesday
2021,12,28,2000,149,155,304,Tuesday
2021,12,28,1900,176,282,458,Tuesday
2021,12,28,1800,246,683,929,Tuesday
2021,12,28,1700,327,840,1167,Tuesday
2021,12,28,1600,482,653,1135,Tuesday
2021,12,28,1500,590,536,1126,Tuesday
2021,12,28,1400,657,544,1201,Tuesday
2021,12,28,1300,688,410,1098,Tuesday
2021,12,28,1200,735,282,1017,Tuesday
2021,12,28,1100,621,202,823,Tuesday
2021,12,28,1000,591,118,709,Tuesday
2021,12,28,900,459,63,522,Tuesday
2021,12,28,800,234,39,273,Tuesday
2021,12,28,700,82,29,111,Tuesday
2021,12,28,600,29,14,43,Tuesday
2021,12,28,500,18,19,37,Tuesday
2021,12,28,400,9,16,25,Tuesday
2021,12,28,300,17,14,31,Tuesday
2021,12,28,200,22,25,47,Tuesday
2021,12,28,100,16,39,55,Tuesday
2021,12,27,2400,29,39,68,Monday
2021,12,27,2300,45,61,106,Monday
2021,12,27,2200,72,72,144,Monday
2021,12,27,2100,72,114,186,Monday
2021,12,27,2000,146,165,311,Monday
2021,12,27,1900,159,255,414,Monday
2021,12,27,1800,241,589,830,Monday
2021,12,27,1700,413,703,1116,Monday
2021,12,27,1600,644,610,1254,Monday
2021,12,27,1500,857,608,1465,Monday
2021,12,27,1400,786,582,1368,Monday
2021,12,27,1300,822,507,1329,Monday
2021,12,27,1200,850,331,1181,Monday
2021,12,27,1100,680,214,894,Monday
2021,12,27,1000,497,112,609,Monday
2021,12,27,900,378,51,429,Monday
2021,12,27,800,190,27,217,Monday
2021,12,27,700,93,18,111,Monday
2021,12,27,600,24,11,35,Monday
2021,12,27,500,12,8,20,Monday
2021,12,27,400,13,14,27,Monday
2021,12,27,300,13,16,29,Monday
2021,12,27,200,9,20,29,Monday
2021,12,27,100,15,34,49,Monday
2021,12,26,2400,26,37,63,Sunday
2021,12,26,2300,42,45,87,Sunday
2021,12,26,2200,58,55,113,Sunday
2021,12,26,2100,58,106,164,Sunday
2021,12,26,2000,103,131,234,Sunday
2021,12,26,1900,173,198,371,Sunday
2021,12,26,1800,191,286,477,Sunday
2021,12,26,1700,326,441,767,Sunday
2021,12,26,1600,558,438,996,Sunday
2021,12,26,1500,646,436,1082,Sunday
2021,12,26,1400,661,420,1081,Sunday
2021,12,26,1300,617,392,1009,Sunday
2021,12,26,1200,522,268,790,Sunday
2021,12,26,1100,402,121,523,Sunday
2021,12,26,1000,317,72,389,Sunday
2021,12,26,900,214,29,243,Sunday
2021,12,26,800,152,22,174,Sunday
2021,12,26,700,52,12,64,Sunday
2021,12,26,600,29,4,33,Sunday
2021,12,26,500,9,7,16,Sunday
2021,12,26,400,7,13,20,Sunday
2021,12,26,300,10,8,18,Sunday
2021,12,26,200,12,11,23,Sunday
2021,12,26,100,6,18,24,Sunday
2021,12,25,2400,12,31,43,Saturday
2021,12,25,2300,21,25,46,Saturday
2021,12,25,2200,37,31,68,Saturday
2021,12,25,2100,33,55,88,Saturday
2021,12,25,2000,30,60,90,Saturday
2021,12,25,1900,51,120,171,Saturday
2021,12,25,1800,68,273,341,Saturday
2021,12,25,1700,125,336,461,Saturday
2021,12,25,1600,206,276,482,Saturday
2021,12,25,1500,293,273,566,Saturday
2021,12,25,1400,287,226,513,Saturday
2021,12,25,1300,314,165,479,Saturday
2021,12,25,1200,278,134,412,Saturday
2021,12,25,1100,237,69,306,Saturday
2021,12,25,1000,175,65,240,Saturday
2021,12,25,900,173,34,207,Saturday
2021,12,25,800,105,23,128,Saturday
2021,12,25,700,35,4,39,Saturday
2021,12,25,600,11,12,23,Saturday
2021,12,25,500,6,20,26,Saturday
2021,12,25,400,7,12,19,Saturday
2021,12,25,300,9,9,18,Saturday
2021,12,25,200,12,25,37,Saturday
2021,12,25,100,17,30,47,Saturday
2021,12,24,2400,18,31,49,Friday
2021,12,24,2300,28,42,70,Friday
2021,12,24,2200,31,71,102,Friday
2021,12,24,2100,60,84,144,Friday
2021,12,24,2000,84,104,188,Friday
2021,12,24,1900,91,143,234,Friday
2021,12,24,1800,164,304,468,Friday
2021,12,24,1700,211,505,716,Friday
2021,12,24,1600,310,539,849,Friday
2021,12,24,1500,395,469,864,Friday
2021,12,24,1400,432,472,904,Friday
2021,12,24,1300,443,398,841,Friday
2021,12,24,1200,400,345,745,Friday
2021,12,24,1100,413,238,651,Friday
2021,12,24,1000,418,152,570,Friday
2021,12,24,900,487,96,583,Friday
2021,12,24,800,202,57,259,Friday
2021,12,24,700,56,27,83,Friday
2021,12,24,600,31,14,45,Friday
2021,12,24,500,9,22,31,Friday
2021,12,24,400,15,18,33,Friday
2021,12,24,300,14,33,47,Friday
2021,12,24,200,17,44,61,Friday
2021,12,24,100,22,43,65,Friday
2021,12,23,2400,37,218,255,Thursday
2021,12,23,2300,37,401,438,Thursday
2021,12,23,2200,64,321,385,Thursday
2021,12,23,2100,114,165,279,Thursday
2021,12,23,2000,147,74,221,Thursday
2021,12,23,1900,175,151,326,Thursday
2021,12,23,1800,185,500,685,Thursday
2021,12,23,1700,287,692,979,Thursday
2021,12,23,1600,329,796,1125,Thursday
2021,12,23,1500,407,635,1042,Thursday
2021,12,23,1400,460,501,961,Thursday
2021,12,23,1300,521,397,918,Thursday
2021,12,23,1200,534,324,858,Thursday
2021,12,23,1100,543,306,849,Thursday
2021,12,23,1000,602,208,810,Thursday
2021,12,23,900,825,121,946,Thursday
2021,12,23,800,345,37,382,Thursday
2021,12,23,700,111,36,147,Thursday
2021,12,23,600,33,17,50,Thursday
2021,12,23,500,18,15,33,Thursday
2021,12,23,400,13,17,30,Thursday
2021,12,23,300,17,28,45,Thursday
2021,12,23,200,24,21,45,Thursday
2021,12,23,100,31,17,48,Thursday
2021,12,22,2400,40,107,147,Wednesday
2021,12,22,2300,55,121,176,Wednesday
2021,12,22,2200,63,216,279,Wednesday
2021,12,22,2100,99,119,218,Wednesday
2021,12,22,2000,138,194,332,Wednesday
2021,12,22,1900,187,344,531,Wednesday
2021,12,22,1800,187,862,1049,Wednesday
2021,12,22,1700,263,1059,1322,Wednesday
2021,12,22,1600,341,788,1129,Wednesday
2021,12,22,1500,399,691,1090,Wednesday
2021,12,22,1400,463,517,980,Wednesday
2021,12,22,1300,443,389,832,Wednesday
2021,12,22,1200,519,371,890,Wednesday
2021,12,22,1100,580,211,791,Wednesday
2021,12,22,1000,764,196,960,Wednesday
2021,12,22,900,797,96,893,Wednesday
2021,12,22,800,358,37,395,Wednesday
2021,12,22,700,122,22,144,Wednesday
2021,12,22,600,45,15,60,Wednesday
2021,12,22,500,23,14,37,Wednesday
2021,12,22,400,17,14,31,Wednesday
2021,12,22,300,12,15,27,Wednesday
2021,12,22,200,21,25,46,Wednesday
2021,12,22,100,36,14,50,Wednesday
2021,12,21,2400,40,89,129,Tuesday
2021,12,21,2300,61,81,142,Tuesday
2021,12,21,2200,71,129,200,Tuesday
2021,12,21,2100,107,144,251,Tuesday
2021,12,21,2000,163,185,348,Tuesday
2021,12,21,1900,169,332,501,Tuesday
2021,12,21,1800,202,800,1002,Tuesday
2021,12,21,1700,259,1542,1801,Tuesday
2021,12,21,1600,345,509,854,Tuesday
2021,12,21,1500,400,249,649,Tuesday
2021,12,21,1400,449,453,902,Tuesday
2021,12,21,1300,502,362,864,Tuesday
2021,12,21,1200,513,346,859,Tuesday
2021,12,21,1100,499,232,731,Tuesday
2021,12,21,1000,644,207,851,Tuesday
2021,12,21,900,720,188,908,Tuesday
2021,12,21,800,324,39,363,Tuesday
2021,12,21,700,104,31,135,Tuesday
2021,12,21,600,50,26,76,Tuesday
2021,12,21,500,15,10,25,Tuesday
2021,12,21,400,17,20,37,Tuesday
2021,12,21,300,21,17,38,Tuesday
2021,12,21,200,22,25,47,Tuesday
2021,12,21,100,23,14,37,Tuesday
2021,12,20,2400,41,82,123,Monday
2021,12,20,2300,41,77,118,Monday
2021,12,20,2200,53,121,174,Monday
2021,12,20,2100,120,168,288,Monday
2021,12,20,2000,144,226,370,Monday
2021,12,20,1900,150,448,598,Monday
2021,12,20,1800,205,591,796,Monday
2021,12,20,1700,257,955,1212,Monday
2021,12,20,1600,347,548,895,Monday
2021,12,20,1500,448,419,867,Monday
2021,12,20,1400,438,391,829,Monday
2021,12,20,1300,459,372,831,Monday
2021,12,20,1200,575,308,883,Monday
2021,12,20,1100,498,228,726,Monday
2021,12,20,1000,534,209,743,Monday
2021,12,20,900,609,155,764,Monday
2021,12,20,800,282,29,311,Monday
2021,12,20,700,107,19,126,Monday
2021,12,20,600,40,18,58,Monday
2021,12,20,500,15,13,28,Monday
2021,12,20,400,14,11,25,Monday
2021,12,20,300,18,9,27,Monday
2021,12,20,200,20,18,38,Monday
2021,12,20,100,26,13,39,Monday
2021,12,19,2400,32,76,108,Sunday
2021,12,19,2300,41,93,134,Sunday
2021,12,19,2200,54,89,143,Sunday
2021,12,19,2100,73,203,276,Sunday
2021,12,19,2000,112,495,607,Sunday
2021,12,19,1900,132,339,471,Sunday
2021,12,19,1800,189,748,937,Sunday
2021,12,19,1700,384,1046,1430,Sunday
2021,12,19,1600,299,603,902,Sunday
2021,12,19,1500,427,523,950,Sunday
2021,12,19,1400,457,589,1046,Sunday
2021,12,19,1300,462,351,813,Sunday
2021,12,19,1200,493,234,727,Sunday
2021,12,19,1100,486,174,660,Sunday
2021,12,19,1000,553,183,736,Sunday
2021,12,19,900,730,104,834,Sunday
2021,12,19,800,457,26,483,Sunday
2021,12,19,700,100,7,107,Sunday
2021,12,19,600,28,1,29,Sunday
2021,12,19,500,11,12,23,Sunday
2021,12,19,400,9,5,14,Sunday
2021,12,19,300,12,18,30,Sunday
2021,12,19,200,13,23,36,Sunday
2021,12,19,100,12,16,28,Sunday
2021,12,18,2400,21,94,115,Saturday
2021,12,18,2300,31,30,61,Saturday
2021,12,18,2200,54,45,99,Saturday
2021,12,18,2100,68,105,173,Saturday
2021,12,18,2000,121,117,238,Saturday
2021,12,18,1900,150,157,307,Saturday
2021,12,18,1800,97,547,644,Saturday
2021,12,18,1700,217,762,979,Saturday
2021,12,18,1600,313,462,775,Saturday
2021,12,18,1500,384,368,752,Saturday
2021,12,18,1400,390,259,649,Saturday
2021,12,18,1300,402,253,655,Saturday
2021,12,18,1200,411,234,645,Saturday
2021,12,18,1100,383,160,543,Saturday
2021,12,18,1000,498,189,687,Saturday
2021,12,18,900,742,125,867,Saturday
2021,12,18,800,468,32,500,Saturday
2021,12,18,700,101,24,125,Saturday
2021,12,18,600,30,15,45,Saturday
2021,12,18,500,10,18,28,Saturday
2021,12,18,400,15,20,35,Saturday
2021,12,18,300,17,19,36,Saturday
2021,12,18,200,26,31,57,Saturday
2021,12,18,100,20,33,53,Saturday
2021,12,17,2400,36,81,117,Friday
2021,12,17,2300,56,62,118,Friday
2021,12,17,2200,80,119,199,Friday
2021,12,17,2100,162,138,300,Friday
2021,12,17,2000,239,162,401,Friday
2021,12,17,1900,244,285,529,Friday
2021,12,17,1800,364,436,800,Friday
2021,12,17,1700,434,576,1010,Friday
2021,12,17,1600,489,489,978,Friday
2021,12,17,1500,463,455,918,Friday
2021,12,17,1400,402,341,743,Friday
2021,12,17,1300,378,328,706,Friday
2021,12,17,1200,355,263,618,Friday
2021,12,17,1100,376,216,592,Friday
2021,12,17,1000,380,205,585,Friday
2021,12,17,900,389,144,533,Friday
2021,12,17,800,217,53,270,Friday
2021,12,17,700,112,46,158,Friday
2021,12,17,600,52,16,68,Friday
2021,12,17,500,12,21,33,Friday
2021,12,17,400,12,23,35,Friday
2021,12,17,300,17,23,40,Friday
2021,12,17,200,17,40,57,Friday
2021,12,17,100,28,177,205,Friday
2021,12,16,2400,45,59,104,Thursday
2021,12,16,2300,54,29,83,Thursday
2021,12,16,2200,58,28,86,Thursday
2021,12,16,2100,108,27,135,Thursday
2021,12,16,2000,154,54,208,Thursday
2021,12,16,1900,167,191,358,Thursday
2021,12,16,1800,149,348,497,Thursday
2021,12,16,1700,225,544,769,Thursday
2021,12,16,1600,262,455,717,Thursday
2021,12,16,1500,287,329,616,Thursday
2021,12,16,1400,276,253,529,Thursday
2021,12,16,1300,271,204,475,Thursday
2021,12,16,1200,331,194,525,Thursday
2021,12,16,1100,279,162,441,Thursday
2021,12,16,1000,330,159,489,Thursday
2021,12,16,900,338,146,484,Thursday
2021,12,16,800,199,32,231,Thursday
2021,12,16,700,103,23,126,Thursday
2021,12,16,600,31,18,49,Thursday
2021,12,16,500,9,20,29,Thursday
2021,12,16,400,10,18,28,Thursday
2021,12,16,300,14,9,23,Thursday
2021,12,16,200,21,13,34,Thursday
2021,12,16,100,24,18,42,Thursday
2021,12,15,2400,37,80,117,Wednesday
2021,12,15,2300,38,55,93,Wednesday
2021,12,15,2200,67,93,160,Wednesday
2021,12,15,2100,109,120,229,Wednesday
2021,12,15,2000,142,144,286,Wednesday
2021,12,15,1900,146,200,346,Wednesday
2021,12,15,1800,166,369,535,Wednesday
2021,12,15,1700,231,535,766,Wednesday
2021,12,15,1600,222,481,703,Wednesday
2021,12,15,1500,236,398,634,Wednesday
2021,12,15,1400,236,313,549,Wednesday
2021,12,15,1300,295,257,552,Wednesday
2021,12,15,1200,317,245,562,Wednesday
2021,12,15,1100,320,168,488,Wednesday
2021,12,15,1000,370,177,547,Wednesday
2021,12,15,900,391,113,504,Wednesday
2021,12,15,800,227,30,257,Wednesday
2021,12,15,700,104,35,139,Wednesday
2021,12,15,600,44,24,68,Wednesday
2021,12,15,500,16,25,41,Wednesday
2021,12,15,400,19,8,27,Wednesday
2021,12,15,300,14,3,17,Wednesday
2021,12,15,200,21,12,33,Wednesday
2021,12,15,100,28,10,38,Wednesday
2021,12,14,2400,36,58,94,Tuesday
2021,12,14,2300,37,72,109,Tuesday
2021,12,14,2200,48,91,139,Tuesday
2021,12,14,2100,71,85,156,Tuesday
2021,12,14,2000,117,117,234,Tuesday
2021,12,14,1900,120,218,338,Tuesday
2021,12,14,1800,133,347,480,Tuesday
2021,12,14,1700,167,562,729,Tuesday
2021,12,14,1600,189,413,602,Tuesday
2021,12,14,1500,214,479,693,Tuesday
2021,12,14,1400,236,216,452,Tuesday
2021,12,14,1300,260,112,372,Tuesday
2021,12,14,1200,253,181,434,Tuesday
2021,12,14,1100,305,161,466,Tuesday
2021,12,14,1000,395,140,535,Tuesday
2021,12,14,900,386,96,482,Tuesday
2021,12,14,800,198,25,223,Tuesday
2021,12,14,700,65,26,91,Tuesday
2021,12,14,600,30,16,46,Tuesday
2021,12,14,500,14,20,34,Tuesday
2021,12,14,400,12,20,32,Tuesday
2021,12,14,300,9,8,17,Tuesday
2021,12,14,200,13,17,30,Tuesday
2021,12,14,100,23,7,30,Tuesday
2021,12,13,2400,26,54,80,Monday
2021,12,13,2300,41,58,99,Monday
2021,12,13,2200,58,102,160,Monday
2021,12,13,2100,83,92,175,Monday
2021,12,13,2000,140,133,273,Monday
2021,12,13,1900,151,175,326,Monday
2021,12,13,1800,165,368,533,Monday
2021,12,13,1700,226,564,790,Monday
2021,12,13,1600,205,424,629,Monday
2021,12,13,1500,267,339,606,Monday
2021,12,13,1400,266,332,598,Monday
2021,12,13,1300,272,258,530,Monday
2021,12,13,1200,304,220,524,Monday
2021,12,13,1100,346,167,513,Monday
2021,12,13,1000,401,156,557,Monday
2021,12,13,900,384,142,526,Monday
2021,12,13,800,193,30,223,Monday
2021,12,13,700,96,23,119,Monday
2021,12,13,600,24,17,41,Monday
2021,12,13,500,20,7,27,Monday
2021,12,13,400,7,15,22,Monday
2021,12,13,300,11,7,18,Monday
2021,12,13,200,13,12,25,Monday
2021,12,13,100,16,8,24,Monday
2021,12,12,2400,15,57,72,Sunday
2021,12,12,2300,23,58,81,Sunday
2021,12,12,2200,33,81,114,Sunday
2021,12,12,2100,55,93,148,Sunday
2021,12,12,2000,77,163,240,Sunday
2021,12,12,1900,124,286,410,Sunday
2021,12,12,1800,152,740,892,Sunday
2021,12,12,1700,205,1088,1293,Sunday
2021,12,12,1600,266,823,1089,Sunday
2021,12,12,1500,249,721,970,Sunday
2021,12,12,1400,282,552,834,Sunday
2021,12,12,1300,342,432,774,Sunday
2021,12,12,1200,386,344,730,Sunday
2021,12,12,1100,383,193,576,Sunday
2021,12,12,1000,580,130,710,Sunday
2021,12,12,900,856,85,941,Sunday
2021,12,12,800,451,30,481,Sunday
2021,12,12,700,94,16,110,Sunday
2021,12,12,600,32,6,38,Sunday
2021,12,12,500,11,13,24,Sunday
2021,12,12,400,3,5,8,Sunday
2021,12,12,300,9,12,21,Sunday
2021,12,12,200,8,21,29,Sunday
2021,12,12,100,17,19,36,Sunday
2021,12,11,2400,24,49,73,Saturday
2021,12,11,2300,41,87,128,Saturday
2021,12,11,2200,51,83,134,Saturday
2021,12,11,2100,72,87,159,Saturday
2021,12,11,2000,58,89,147,Saturday
2021,12,11,1900,104,172,276,Saturday
2021,12,11,1800,137,551,688,Saturday
2021,12,11,1700,171,851,1022,Saturday
2021,12,11,1600,219,569,788,Saturday
2021,12,11,1500,241,352,593,Saturday
2021,12,11,1400,251,303,554,Saturday
2021,12,11,1300,276,221,497,Saturday
2021,12,11,1200,317,241,558,Saturday
2021,12,11,1100,324,136,460,Saturday
2021,12,11,1000,444,133,577,Saturday
2021,12,11,900,819,67,886,Saturday
2021,12,11,800,448,32,480,Saturday
2021,12,11,700,104,24,128,Saturday
2021,12,11,600,37,23,60,Saturday
2021,12,11,500,15,11,26,Saturday
2021,12,11,400,13,13,26,Saturday
2021,12,11,300,12,10,22,Saturday
2021,12,11,200,26,20,46,Saturday
2021,12,11,100,21,5,26,Saturday
2021,12,10,2400,37,46,83,Friday
2021,12,10,2300,53,76,129,Friday
2021,12,10,2200,68,103,171,Friday
2021,12,10,2100,128,115,243,Friday
2021,12,10,2000,225,131,356,Friday
2021,12,10,1900,320,238,558,Friday
2021,12,10,1800,385,450,835,Friday
2021,12,10,1700,374,611,985,Friday
2021,12,10,1600,423,543,966,Friday
2021,12,10,1500,426,392,818,Friday
2021,12,10,1400,357,342,699,Friday
2021,12,10,1300,355,291,646,Friday
2021,12,10,1200,338,249,587,Friday
2021,12,10,1100,370,181,551,Friday
2021,12,10,1000,429,191,620,Friday
2021,12,10,900,475,132,607,Friday
2021,12,10,800,263,51,314,Friday
2021,12,10,700,104,26,130,Friday
2021,12,10,600,44,21,65,Friday
2021,12,10,500,10,21,31,Friday
2021,12,10,400,23,18,41,Friday
2021,12,10,300,16,17,33,Friday
2021,12,10,200,14,16,30,Friday
2021,12,10,100,21,15,36,Friday
2021,12,9,2400,35,83,118,Thursday
2021,12,9,2300,54,51,105,Thursday
2021,12,9,2200,70,83,153,Thursday
2021,12,9,2100,132,95,227,Thursday
2021,12,9,2000,165,136,301,Thursday
2021,12,9,1900,240,183,423,Thursday
2021,12,9,1800,229,275,504,Thursday
2021,12,9,1700,286,494,780,Thursday
2021,12,9,1600,290,412,702,Thursday
2021,12,9,1500,289,355,644,Thursday
2021,12,9,1400,265,297,562,Thursday
2021,12,9,1300,283,219,502,Thursday
2021,12,9,1200,280,212,492,Thursday
2021,12,9,1100,319,131,450,Thursday
2021,12,9,1000,378,189,567,Thursday
2021,12,9,900,361,102,463,Thursday
2021,12,9,800,195,26,221,Thursday
2021,12,9,700,112,22,134,Thursday
2021,12,9,600,30,13,43,Thursday
2021,12,9,500,11,16,27,Thursday
2021,12,9,400,11,18,29,Thursday
2021,12,9,300,17,12,29,Thursday
2021,12,9,200,25,12,37,Thursday
2021,12,9,100,28,13,41,Thursday
2021,12,8,2400,41,60,101,Wednesday
2021,12,8,2300,58,44,102,Wednesday
2021,12,8,2200,69,71,140,Wednesday
2021,12,8,2100,113,91,204,Wednesday
2021,12,8,2000,130,109,239,Wednesday
2021,12,8,1900,125,155,280,Wednesday
2021,12,8,1800,149,284,433,Wednesday
2021,12,8,1700,183,403,586,Wednesday
2021,12,8,1600,173,385,558,Wednesday
2021,12,8,1500,194,305,499,Wednesday
2021,12,8,1400,195,277,472,Wednesday
2021,12,8,1300,226,173,399,Wednesday
2021,12,8,1200,229,159,388,Wednesday
2021,12,8,1100,279,149,428,Wednesday
2021,12,8,1000,330,147,477,Wednesday
2021,12,8,900,310,102,412,Wednesday
2021,12,8,800,188,38,226,Wednesday
2021,12,8,700,84,30,114,Wednesday
2021,12,8,600,32,17,49,Wednesday
2021,12,8,500,15,12,27,Wednesday
2021,12,8,400,16,20,36,Wednesday
2021,12,8,300,22,8,30,Wednesday
2021,12,8,200,23,7,30,Wednesday
2021,12,8,100,21,14,35,Wednesday
2021,12,7,2400,37,53,90,Tuesday
2021,12,7,2300,25,48,73,Tuesday
2021,12,7,2200,47,63,110,Tuesday
2021,12,7,2100,75,110,185,Tuesday
2021,12,7,2000,137,99,236,Tuesday
2021,12,7,1900,105,146,251,Tuesday
2021,12,7,1800,165,258,423,Tuesday
2021,12,7,1700,174,462,636,Tuesday
2021,12,7,1600,208,393,601,Tuesday
2021,12,7,1500,228,346,574,Tuesday
2021,12,7,1400,219,263,482,Tuesday
2021,12,7,1300,225,204,429,Tuesday
2021,12,7,1200,324,228,552,Tuesday
2021,12,7,1100,282,153,435,Tuesday
2021,12,7,1000,331,162,493,Tuesday
2021,12,7,900,324,123,447,Tuesday
2021,12,7,800,171,40,211,Tuesday
2021,12,7,700,83,27,110,Tuesday
2021,12,7,600,37,19,56,Tuesday
2021,12,7,500,14,16,30,Tuesday
2021,12,7,400,10,12,22,Tuesday
2021,12,7,300,9,13,22,Tuesday
2021,12,7,200,24,17,41,Tuesday
2021,12,7,100,22,12,34,Tuesday
2021,12,6,2400,30,48,78,Monday
2021,12,6,2300,44,42,86,Monday
2021,12,6,2200,60,49,109,Monday
2021,12,6,2100,81,73,154,Monday
2021,12,6,2000,98,86,184,Monday
2021,12,6,1900,127,171,298,Monday
2021,12,6,1800,157,298,455,Monday
2021,12,6,1700,205,431,636,Monday
2021,12,6,1600,226,384,610,Monday
2021,12,6,1500,252,306,558,Monday
2021,12,6,1400,297,245,542,Monday
2021,12,6,1300,309,218,527,Monday
2021,12,6,1200,275,249,524,Monday
2021,12,6,1100,306,171,477,Monday
2021,12,6,1000,326,149,475,Monday
2021,12,6,900,338,103,441,Monday
2021,12,6,800,173,34,207,Monday
2021,12,6,700,92,19,111,Monday
2021,12,6,600,30,16,46,Monday
2021,12,6,500,13,4,17,Monday
2021,12,6,400,5,21,26,Monday
2021,12,6,300,7,7,14,Monday
2021,12,6,200,15,9,24,Monday
2021,12,6,100,15,16,31,Monday
2021,12,5,2400,27,62,89,Sunday
2021,12,5,2300,32,62,94,Sunday
2021,12,5,2200,40,84,124,Sunday
2021,12,5,2100,59,128,187,Sunday
2021,12,5,2000,82,133,215,Sunday
2021,12,5,1900,112,281,393,Sunday
2021,12,5,1800,153,581,734,Sunday
2021,12,5,1700,203,1114,1317,Sunday
2021,12,5,1600,219,875,1094,Sunday
2021,12,5,1500,277,684,961,Sunday
2021,12,5,1400,339,640,979,Sunday
2021,12,5,1300,343,406,749,Sunday
2021,12,5,1200,411,302,713,Sunday
2021,12,5,1100,427,225,652,Sunday
2021,12,5,1000,467,137,604,Sunday
2021,12,5,900,731,92,823,Sunday
2021,12,5,800,453,31,484,Sunday
2021,12,5,700,96,13,109,Sunday
2021,12,5,600,20,10,30,Sunday
2021,12,5,500,13,12,25,Sunday
2021,12,5,400,9,8,17,Sunday
2021,12,5,300,5,6,11,Sunday
2021,12,5,200,15,12,27,Sunday
2021,12,5,100,13,8,21,Sunday
2021,12,4,2400,9,59,68,Saturday
2021,12,4,2300,31,46,77,Saturday
2021,12,4,2200,24,65,89,Saturday
2021,12,4,2100,56,78,134,Saturday
2021,12,4,2000,98,126,224,Saturday
2021,12,4,1900,80,214,294,Saturday
2021,12,4,1800,127,726,853,Saturday
2021,12,4,1700,195,884,1079,Saturday
2021,12,4,1600,209,644,853,Saturday
2021,12,4,1500,234,515,749,Saturday
2021,12,4,1400,268,347,615,Saturday
2021,12,4,1300,312,267,579,Saturday
2021,12,4,1200,374,217,591,Saturday
2021,12,4,1100,379,167,546,Saturday
2021,12,4,1000,556,143,699,Saturday
2021,12,4,900,974,135,1109,Saturday
2021,12,4,800,620,34,654,Saturday
2021,12,4,700,102,19,121,Saturday
2021,12,4,600,34,11,45,Saturday
2021,12,4,500,8,11,19,Saturday
2021,12,4,400,7,10,17,Saturday
2021,12,4,300,19,10,29,Saturday
2021,12,4,200,13,17,30,Saturday
2021,12,4,100,22,12,34,Saturday
2021,12,3,2400,31,52,83,Friday
2021,12,3,2300,40,55,95,Friday
2021,12,3,2200,79,90,169,Friday
2021,12,3,2100,118,108,226,Friday
2021,12,3,2000,195,128,323,Friday
2021,12,3,1900,288,206,494,Friday
2021,12,3,1800,252,372,624,Friday
2021,12,3,1700,331,682,1013,Friday
2021,12,3,1600,394,532,926,Friday
2021,12,3,1500,380,336,716,Friday
2021,12,3,1400,397,325,722,Friday
2021,12,3,1300,391,255,646,Friday
2021,12,3,1200,350,247,597,Friday
2021,12,3,1100,391,167,558,Friday
2021,12,3,1000,460,184,644,Friday
2021,12,3,900,482,123,605,Friday
2021,12,3,800,241,35,276,Friday
2021,12,3,700,103,23,126,Friday
2021,12,3,600,34,10,44,Friday
2021,12,3,500,9,15,24,Friday
2021,12,3,400,9,16,25,Friday
2021,12,3,300,14,15,29,Friday
2021,12,3,200,13,16,29,Friday
2021,12,3,100,26,94,120,Friday
2021,12,2,2400,34,48,82,Thursday
2021,12,2,2300,40,18,58,Thursday
2021,12,2,2200,52,25,77,Thursday
2021,12,2,2100,82,70,152,Thursday
2021,12,2,2000,119,95,214,Thursday
2021,12,2,1900,152,165,317,Thursday
2021,12,2,1800,131,342,473,Thursday
2021,12,2,1700,203,666,869,Thursday
2021,12,2,1600,218,430,648,Thursday
2021,12,2,1500,251,283,534,Thursday
2021,12,2,1400,221,441,662,Thursday
2021,12,2,1300,202,226,428,Thursday
2021,12,2,1200,274,8,282,Thursday
2021,12,2,1100,313,78,391,Thursday
2021,12,2,1000,403,108,511,Thursday
2021,12,2,900,616,78,694,Thursday
2021,12,2,800,282,29,311,Thursday
2021,12,2,700,75,32,107,Thursday
2021,12,2,600,28,20,48,Thursday
2021,12,2,500,11,12,23,Thursday
2021,12,2,400,10,19,29,Thursday
2021,12,2,300,9,29,38,Thursday
2021,12,2,200,23,41,64,Thursday
2021,12,2,100,23,29,52,Thursday
2021,12,1,2400,20,55,75,Wednesday
2021,12,1,2300,35,41,76,Wednesday
2021,12,1,2200,47,47,94,Wednesday
2021,12,1,2100,96,59,155,Wednesday
2021,12,1,2000,106,147,253,Wednesday
2021,12,1,1900,96,87,183,Wednesday
2021,12,1,1800,119,299,418,Wednesday
2021,12,1,1700,139,304,443,Wednesday
2021,12,1,1600,188,363,551,Wednesday
2021,12,1,1500,184,265,449,Wednesday
2021,12,1,1400,202,232,434,Wednesday
2021,12,1,1300,211,153,364,Wednesday
2021,12,1,1200,267,182,449,Wednesday
2021,12,1,1100,291,128,419,Wednesday
2021,12,1,1000,347,117,464,Wednesday
2021,12,1,900,382,115,497,Wednesday
2021,12,1,800,204,67,271,Wednesday
2021,12,1,700,73,42,115,Wednesday
2021,12,1,600,48,23,71,Wednesday
2021,12,1,500,17,15,32,Wednesday
2021,12,1,400,12,36,48,Wednesday
2021,12,1,300,9,38,47,Wednesday
2021,12,1,200,30,16,46,Wednesday
2021,12,1,100,25,43,68,Wednesday
2021,11,30,2400,35,51,86,Tuesday
2021,11,30,2300,47,60,107,Tuesday
2021,11,30,2200,47,66,113,Tuesday
2021,11,30,2100,69,96,165,Tuesday
2021,11,30,2000,88,98,186,Tuesday
2021,11,30,1900,90,152,242,Tuesday
2021,11,30,1800,138,255,393,Tuesday
2021,11,30,1700,144,370,514,Tuesday
2021,11,30,1600,185,354,539,Tuesday
2021,11,30,1500,188,303,491,Tuesday
2021,11,30,1400,175,209,384,Tuesday
2021,11,30,1300,193,208,401,Tuesday
2021,11,30,1200,231,139,370,Tuesday
2021,11,30,1100,284,122,406,Tuesday
2021,11,30,1000,277,81,358,Tuesday
2021,11,30,900,281,91,372,Tuesday
2021,11,30,800,166,32,198,Tuesday
2021,11,30,700,71,22,93,Tuesday
2021,11,30,600,28,26,54,Tuesday
2021,11,30,500,21,15,36,Tuesday
2021,11,30,400,11,26,37,Tuesday
2021,11,30,300,12,24,36,Tuesday
2021,11,30,200,15,32,47,Tuesday
2021,11,30,100,21,19,40,Tuesday
2021,11,29,2400,27,18,45,Monday
2021,11,29,2300,46,23,69,Monday
2021,11,29,2200,61,43,104,Monday
2021,11,29,2100,63,62,125,Monday
2021,11,29,2000,78,70,148,Monday
2021,11,29,1900,114,161,275,Monday
2021,11,29,1800,116,289,405,Monday
2021,11,29,1700,130,405,535,Monday
2021,11,29,1600,170,413,583,Monday
2021,11,29,1500,189,279,468,Monday
2021,11,29,1400,191,284,475,Monday
2021,11,29,1300,196,156,352,Monday
2021,11,29,1200,279,152,431,Monday
2021,11,29,1100,332,132,464,Monday
2021,11,29,1000,345,73,418,Monday
2021,11,29,900,378,71,449,Monday
2021,11,29,800,166,30,196,Monday
2021,11,29,700,62,15,77,Monday
2021,11,29,600,23,11,34,Monday
2021,11,29,500,11,11,22,Monday
2021,11,29,400,10,10,20,Monday
2021,11,29,300,12,11,23,Monday
2021,11,29,200,9,15,24,Monday
2021,11,29,100,15,12,27,Monday
2021,11,28,2400,11,25,36,Sunday
2021,11,28,2300,29,52,81,Sunday
2021,11,28,2200,34,134,168,Sunday
2021,11,28,2100,45,240,285,Sunday
2021,11,28,2000,69,69,138,Sunday
2021,11,28,1900,89,123,212,Sunday
2021,11,28,1800,124,411,535,Sunday
2021,11,28,1700,140,774,914,Sunday
2021,11,28,1600,206,635,841,Sunday
2021,11,28,1500,225,614,839,Sunday
2021,11,28,1400,247,511,758,Sunday
2021,11,28,1300,316,379,695,Sunday
2021,11,28,1200,309,341,650,Sunday
2021,11,28,1100,365,195,560,Sunday
2021,11,28,1000,430,130,560,Sunday
2021,11,28,900,642,54,696,Sunday
2021,11,28,800,310,15,325,Sunday
2021,11,28,700,56,29,85,Sunday
2021,11,28,600,18,15,33,Sunday
2021,11,28,500,12,6,18,Sunday
2021,11,28,400,6,7,13,Sunday
2021,11,28,300,5,13,18,Sunday
2021,11,28,200,8,15,23,Sunday
2021,11,28,100,9,24,33,Sunday
2021,11,27,2400,16,46,62,Saturday
2021,11,27,2300,28,69,97,Saturday
2021,11,27,2200,29,80,109,Saturday
2021,11,27,2100,60,87,147,Saturday
2021,11,27,2000,55,117,172,Saturday
2021,11,27,1900,93,215,308,Saturday
2021,11,27,1800,85,569,654,Saturday
2021,11,27,1700,158,943,1101,Saturday
2021,11,27,1600,180,779,959,Saturday
2021,11,27,1500,241,570,811,Saturday
2021,11,27,1400,282,401,683,Saturday
2021,11,27,1300,326,297,623,Saturday
2021,11,27,1200,405,193,598,Saturday
2021,11,27,1100,450,143,593,Saturday
2021,11,27,1000,610,85,695,Saturday
2021,11,27,900,917,72,989,Saturday
2021,11,27,800,481,31,512,Saturday
2021,11,27,700,76,9,85,Saturday
2021,11,27,600,24,10,34,Saturday
2021,11,27,500,9,8,17,Saturday
2021,11,27,400,13,1,14,Saturday
2021,11,27,300,18,5,23,Saturday
2021,11,27,200,12,20,32,Saturday
2021,11,27,100,26,25,51,Saturday
2021,11,26,2400,28,34,62,Friday
2021,11,26,2300,50,34,84,Friday
2021,11,26,2200,62,32,94,Friday
2021,11,26,2100,111,64,175,Friday
2021,11,26,2000,152,112,264,Friday
2021,11,26,1900,177,169,346,Friday
2021,11,26,1800,229,354,583,Friday
2021,11,26,1700,275,614,889,Friday
2021,11,26,1600,339,478,817,Friday
2021,11,26,1500,351,357,708,Friday
2021,11,26,1400,341,344,685,Friday
2021,11,26,1300,310,271,581,Friday
2021,11,26,1200,333,181,514,Friday
2021,11,26,1100,340,167,507,Friday
2021,11,26,1000,395,107,502,Friday
2021,11,26,900,489,86,575,Friday
2021,11,26,800,253,41,294,Friday
2021,11,26,700,69,17,86,Friday
2021,11,26,600,31,20,51,Friday
2021,11,26,500,20,29,49,Friday
2021,11,26,400,20,18,38,Friday
2021,11,26,300,15,13,28,Friday
2021,11,26,200,22,59,81,Friday
2021,11,26,100,27,67,94,Friday
2021,11,25,2400,20,50,70,Thursday
2021,11,25,2300,48,26,74,Thursday
2021,11,25,2200,58,75,133,Thursday
2021,11,25,2100,100,107,207,Thursday
2021,11,25,2000,117,88,205,Thursday
2021,11,25,1900,124,170,294,Thursday
2021,11,25,1800,159,266,425,Thursday
2021,11,25,1700,171,328,499,Thursday
2021,11,25,1600,193,331,524,Thursday
2021,11,25,1500,210,259,469,Thursday
2021,11,25,1400,210,242,452,Thursday
2021,11,25,1300,235,206,441,Thursday
2021,11,25,1200,273,175,448,Thursday
2021,11,25,1100,284,156,440,Thursday
2021,11,25,1000,309,99,408,Thursday
2021,11,25,900,290,75,365,Thursday
2021,11,25,800,145,34,179,Thursday
2021,11,25,700,67,22,89,Thursday
2021,11,25,600,28,19,47,Thursday
2021,11,25,500,21,22,43,Thursday
2021,11,25,400,21,27,48,Thursday
2021,11,25,300,17,24,41,Thursday
2021,11,25,200,27,23,50,Thursday
2021,11,25,100,31,46,77,Thursday
2021,11,24,2400,49,23,72,Wednesday
2021,11,24,2300,51,39,90,Wednesday
2021,11,24,2200,60,70,130,Wednesday
2021,11,24,2100,90,85,175,Wednesday
2021,11,24,2000,95,119,214,Wednesday
2021,11,24,1900,103,143,246,Wednesday
2021,11,24,1800,160,267,427,Wednesday
2021,11,24,1700,194,368,562,Wednesday
2021,11,24,1600,203,409,612,Wednesday
2021,11,24,1500,237,297,534,Wednesday
2021,11,24,1400,247,264,511,Wednesday
2021,11,24,1300,248,234,482,Wednesday
2021,11,24,1200,294,189,483,Wednesday
2021,11,24,1100,276,142,418,Wednesday
2021,11,24,1000,333,95,428,Wednesday
2021,11,24,900,293,85,378,Wednesday
2021,11,24,800,163,53,216,Wednesday
2021,11,24,700,68,28,96,Wednesday
2021,11,24,600,28,21,49,Wednesday
2021,11,24,500,19,17,36,Wednesday
2021,11,24,400,12,28,40,Wednesday
2021,11,24,300,13,26,39,Wednesday
2021,11,24,200,22,41,63,Wednesday
2021,11,24,100,29,46,75,Wednesday
2021,11,23,2400,23,35,58,Tuesday
2021,11,23,2300,43,40,83,Tuesday
2021,11,23,2200,75,52,127,Tuesday
2021,11,23,2100,70,57,127,Tuesday
2021,11,23,2000,67,75,142,Tuesday
2021,11,23,1900,81,130,211,Tuesday
2021,11,23,1800,120,253,373,Tuesday
2021,11,23,1700,140,334,474,Tuesday
2021,11,23,1600,154,285,439,Tuesday
2021,11,23,1500,172,277,449,Tuesday
2021,11,23,1400,189,236,425,Tuesday
2021,11,23,1300,209,192,401,Tuesday
2021,11,23,1200,248,139,387,Tuesday
2021,11,23,1100,270,97,367,Tuesday
2021,11,23,1000,280,83,363,Tuesday
2021,11,23,900,249,80,329,Tuesday
2021,11,23,800,153,42,195,Tuesday
2021,11,23,700,63,29,92,Tuesday
2021,11,23,600,32,13,45,Tuesday
2021,11,23,500,23,17,40,Tuesday
2021,11,23,400,14,12,26,Tuesday
2021,11,23,300,17,16,33,Tuesday
2021,11,23,200,20,18,38,Tuesday
2021,11,23,100,33,37,70,Tuesday
2021,11,22,2400,32,23,55,Monday
2021,11,22,2300,50,52,102,Monday
2021,11,22,2200,58,56,114,Monday
2021,11,22,2100,113,71,184,Monday
2021,11,22,2000,88,89,177,Monday
2021,11,22,1900,105,144,249,Monday
2021,11,22,1800,127,264,391,Monday
2021,11,22,1700,146,357,503,Monday
2021,11,22,1600,187,398,585,Monday
2021,11,22,1500,226,379,605,Monday
2021,11,22,1400,238,282,520,Monday
2021,11,22,1300,298,236,534,Monday
2021,11,22,1200,314,171,485,Monday
2021,11,22,1100,313,144,457,Monday
2021,11,22,1000,339,105,444,Monday
2021,11,22,900,273,57,330,Monday
2021,11,22,800,177,37,214,Monday
2021,11,22,700,63,23,86,Monday
2021,11,22,600,41,24,65,Monday
2021,11,22,500,16,15,31,Monday
2021,11,22,400,12,16,28,Monday
2021,11,22,300,9,16,25,Monday
2021,11,22,200,14,17,31,Monday
2021,11,22,100,13,27,40,Monday
2021,11,21,2400,20,19,39,Sunday
2021,11,21,2300,39,57,96,Sunday
2021,11,21,2200,47,40,87,Sunday
2021,11,21,2100,62,67,129,Sunday
2021,11,21,2000,73,108,181,Sunday
2021,11,21,1900,81,195,276,Sunday
2021,11,21,1800,126,477,603,Sunday
2021,11,21,1700,179,800,979,Sunday
2021,11,21,1600,220,619,839,Sunday
2021,11,21,1500,262,556,818,Sunday
2021,11,21,1400,302,580,882,Sunday
2021,11,21,1300,347,396,743,Sunday
2021,11,21,1200,365,243,608,Sunday
2021,11,21,1100,405,158,563,Sunday
2021,11,21,1000,454,90,544,Sunday
2021,11,21,900,531,52,583,Sunday
2021,11,21,800,314,29,343,Sunday
2021,11,21,700,62,12,74,Sunday
2021,11,21,600,12,9,21,Sunday
2021,11,21,500,13,6,19,Sunday
2021,11,21,400,6,4,10,Sunday
2021,11,21,300,5,10,15,Sunday
2021,11,21,200,12,11,23,Sunday
2021,11,21,100,12,13,25,Sunday
2021,11,20,2400,20,23,43,Saturday
2021,11,20,2300,28,28,56,Saturday
2021,11,20,2200,50,33,83,Saturday
2021,11,20,2100,52,67,119,Saturday
2021,11,20,2000,77,69,146,Saturday
2021,11,20,1900,83,147,230,Saturday
2021,11,20,1800,115,418,533,Saturday
2021,11,20,1700,144,734,878,Saturday
2021,11,20,1600,194,578,772,Saturday
2021,11,20,1500,245,444,689,Saturday
2021,11,20,1400,286,374,660,Saturday
2021,11,20,1300,309,269,578,Saturday
2021,11,20,1200,379,213,592,Saturday
2021,11,20,1100,431,131,562,Saturday
2021,11,20,1000,444,87,531,Saturday
2021,11,20,900,682,61,743,Saturday
2021,11,20,800,324,26,350,Saturday
2021,11,20,700,82,18,100,Saturday
2021,11,20,600,32,5,37,Saturday
2021,11,20,500,10,10,20,Saturday
2021,11,20,400,8,9,17,Saturday
2021,11,20,300,9,17,26,Saturday
2021,11,20,200,12,16,28,Saturday
2021,11,20,100,21,31,52,Saturday
2021,11,19,2400,34,23,57,Friday
2021,11,19,2300,47,42,89,Friday
2021,11,19,2200,57,61,118,Friday
2021,11,19,2100,87,92,179,Friday
2021,11,19,2000,135,106,241,Friday
2021,11,19,1900,165,195,360,Friday
2021,11,19,1800,185,335,520,Friday
2021,11,19,1700,248,420,668,Friday
2021,11,19,1600,279,364,643,Friday
2021,11,19,1500,313,347,660,Friday
2021,11,19,1400,280,275,555,Friday
2021,11,19,1300,306,193,499,Friday
2021,11,19,1200,313,186,499,Friday
2021,11,19,1100,293,118,411,Friday
2021,11,19,1000,319,84,403,Friday
2021,11,19,900,260,76,336,Friday
2021,11,19,800,146,52,198,Friday
2021,11,19,700,53,16,69,Friday
2021,11,19,600,37,16,53,Friday
2021,11,19,500,11,12,23,Friday
2021,11,19,400,10,16,26,Friday
2021,11,19,300,12,14,26,Friday
2021,11,19,200,18,11,29,Friday
2021,11,19,100,18,25,43,Friday
2021,11,18,2400,34,107,141,Thursday
2021,11,18,2300,35,14,49,Thursday
2021,11,18,2200,44,11,55,Thursday
2021,11,18,2100,59,55,114,Thursday
2021,11,18,2000,77,109,186,Thursday
2021,11,18,1900,89,155,244,Thursday
2021,11,18,1800,131,243,374,Thursday
2021,11,18,1700,159,346,505,Thursday
2021,11,18,1600,188,347,535,Thursday
2021,11,18,1500,193,286,479,Thursday
2021,11,18,1400,206,248,454,Thursday
2021,11,18,1300,235,186,421,Thursday
2021,11,18,1200,259,155,414,Thursday
2021,11,18,1100,258,126,384,Thursday
2021,11,18,1000,262,68,330,Thursday
2021,11,18,900,245,60,305,Thursday
2021,11,18,800,127,39,166,Thursday
2021,11,18,700,47,25,72,Thursday
2021,11,18,600,18,12,30,Thursday
2021,11,18,500,12,13,25,Thursday
2021,11,18,400,13,19,32,Thursday
2021,11,18,300,12,12,24,Thursday
2021,11,18,200,18,29,47,Thursday
2021,11,18,100,9,23,32,Thursday
2021,11,17,2400,28,37,65,Wednesday
2021,11,17,2300,28,57,85,Wednesday
2021,11,17,2200,39,54,93,Wednesday
2021,11,17,2100,45,87,132,Wednesday
2021,11,17,2000,52,177,229,Wednesday
2021,11,17,1900,85,111,196,Wednesday
2021,11,17,1800,97,257,354,Wednesday
2021,11,17,1700,110,341,451,Wednesday
2021,11,17,1600,148,355,503,Wednesday
2021,11,17,1500,183,271,454,Wednesday
2021,11,17,1400,219,241,460,Wednesday
2021,11,17,1300,240,209,449,Wednesday
2021,11,17,1200,291,141,432,Wednesday
2021,11,17,1100,305,76,381,Wednesday
2021,11,17,1000,270,86,356,Wednesday
2021,11,17,900,202,57,259,Wednesday
2021,11,17,800,135,26,161,Wednesday
2021,11,17,700,47,16,63,Wednesday
2021,11,17,600,16,13,29,Wednesday
2021,11,17,500,11,12,23,Wednesday
2021,11,17,400,10,10,20,Wednesday
2021,11,17,300,6,14,20,Wednesday
2021,11,17,200,11,22,33,Wednesday
2021,11,17,100,17,39,56,Wednesday
2021,11,16,2400,16,28,44,Tuesday
2021,11,16,2300,19,31,50,Tuesday
2021,11,16,2200,27,63,90,Tuesday
2021,11,16,2100,39,78,117,Tuesday
2021,11,16,2000,45,63,108,Tuesday
2021,11,16,1900,62,154,216,Tuesday
2021,11,16,1800,56,216,272,Tuesday
2021,11,16,1700,105,265,370,Tuesday
2021,11,16,1600,104,325,429,Tuesday
2021,11,16,1500,122,271,393,Tuesday
2021,11,16,1400,177,239,416,Tuesday
2021,11,16,1300,210,231,441,Tuesday
2021,11,16,1200,287,157,444,Tuesday
2021,11,16,1100,272,120,392,Tuesday
2021,11,16,1000,280,70,350,Tuesday
2021,11,16,900,270,42,312,Tuesday
2021,11,16,800,146,31,177,Tuesday
2021,11,16,700,75,12,87,Tuesday
2021,11,16,600,25,7,32,Tuesday
2021,11,16,500,10,5,15,Tuesday
2021,11,16,400,7,5,12,Tuesday
2021,11,16,300,10,7,17,Tuesday
2021,11,16,200,3,12,15,Tuesday
2021,11,16,100,12,18,30,Tuesday
2021,11,15,2400,8,21,29,Monday
2021,11,15,2300,25,24,49,Monday
2021,11,15,2200,11,24,35,Monday
2021,11,15,2100,27,61,88,Monday
2021,11,15,2000,42,52,94,Monday
2021,11,15,1900,37,87,124,Monday
2021,11,15,1800,40,88,128,Monday
2021,11,15,1700,64,168,232,Monday
2021,11,15,1600,95,186,281,Monday
2021,11,15,1500,132,317,449,Monday
2021,11,15,1400,115,334,449,Monday
2021,11,15,1300,119,194,313,Monday
2021,11,15,1200,164,151,315,Monday
2021,11,15,1100,149,348,497,Monday
2021,11,15,1000,123,95,218,Monday
2021,11,15,900,206,88,294,Monday
2021,11,15,800,147,44,191,Monday
2021,11,15,700,49,196,245,Monday
2021,11,15,600,30,45,75,Monday
2021,11,15,500,16,8,24,Monday
2021,11,15,400,10,128,138,Monday
2021,11,15,300,2,218,220,Monday
2021,11,15,200,6,244,250,Monday
2021,11,15,100,8,241,249,Monday
2021,11,14,2400,13,87,100,Sunday
2021,11,14,2300,17,84,101,Sunday
2021,11,14,2200,21,115,136,Sunday
2021,11,14,2100,36,47,83,Sunday
2021,11,14,2000,54,76,130,Sunday
2021,11,14,1900,76,136,212,Sunday
2021,11,14,1800,99,528,627,Sunday
2021,11,14,1700,163,535,698,Sunday
2021,11,14,1600,251,449,700,Sunday
2021,11,14,1500,290,344,634,Sunday
2021,11,14,1400,323,243,566,Sunday
2021,11,14,1300,343,205,548,Sunday
2021,11,14,1200,443,163,606,Sunday
2021,11,14,1100,405,152,557,Sunday
2021,11,14,1000,361,115,476,Sunday
2021,11,14,900,289,42,331,Sunday
2021,11,14,800,234,13,247,Sunday
2021,11,14,700,90,15,105,Sunday
2021,11,14,600,28,9,37,Sunday
2021,11,14,500,15,21,36,Sunday
2021,11,14,400,11,25,36,Sunday
2021,11,14,300,19,15,34,Sunday
2021,11,14,200,21,37,58,Sunday
2021,11,14,100,14,52,66,Sunday
2021,11,13,2400,30,45,75,Saturday
2021,11,13,2300,31,46,77,Saturday
2021,11,13,2200,63,97,160,Saturday
2021,11,13,2100,72,138,210,Saturday
2021,11,13,2000,83,160,243,Saturday
2021,11,13,1900,98,295,393,Saturday
2021,11,13,1800,145,511,656,Saturday
2021,11,13,1700,225,860,1085,Saturday
2021,11,13,1600,269,760,1029,Saturday
2021,11,13,1500,348,650,998,Saturday
2021,11,13,1400,414,568,982,Saturday
2021,11,13,1300,580,475,1055,Saturday
2021,11,13,1200,603,336,939,Saturday
2021,11,13,1100,583,219,802,Saturday
2021,11,13,1000,494,145,639,Saturday
2021,11,13,900,431,109,540,Saturday
2021,11,13,800,229,78,307,Saturday
2021,11,13,700,92,45,137,Saturday
2021,11,13,600,41,30,71,Saturday
2021,11,13,500,16,34,50,Saturday
2021,11,13,400,16,50,66,Saturday
2021,11,13,300,22,67,89,Saturday
2021,11,13,200,10,31,41,Saturday
2021,11,13,100,22,64,86,Saturday
2021,11,12,2400,35,35,70,Friday
2021,11,12,2300,57,85,142,Friday
2021,11,12,2200,70,78,148,Friday
2021,11,12,2100,104,106,210,Friday
2021,11,12,2000,149,178,327,Friday
2021,11,12,1900,211,243,454,Friday
2021,11,12,1800,240,433,673,Friday
2021,11,12,1700,321,570,891,Friday
2021,11,12,1600,353,603,956,Friday
2021,11,12,1500,423,496,919,Friday
2021,11,12,1400,456,409,865,Friday
2021,11,12,1300,464,394,858,Friday
2021,11,12,1200,550,283,833,Friday
2021,11,12,1100,473,178,651,Friday
2021,11,12,1000,397,139,536,Friday
2021,11,12,900,342,98,440,Friday
2021,11,12,800,200,54,254,Friday
2021,11,12,700,83,33,116,Friday
2021,11,12,600,42,26,68,Friday
2021,11,12,500,25,18,43,Friday
2021,11,12,400,32,19,51,Friday
2021,11,12,300,10,31,41,Friday
2021,11,12,200,28,46,74,Friday
2021,11,12,100,27,40,67,Friday
2021,11,11,2400,29,58,87,Thursday
2021,11,11,2300,61,84,145,Thursday
2021,11,11,2200,78,125,203,Thursday
2021,11,11,2100,107,155,262,Thursday
2021,11,11,2000,134,227,361,Thursday
2021,11,11,1900,155,363,518,Thursday
2021,11,11,1800,256,533,789,Thursday
2021,11,11,1700,366,757,1123,Thursday
2021,11,11,1600,503,798,1301,Thursday
2021,11,11,1500,570,578,1148,Thursday
2021,11,11,1400,646,536,1182,Thursday
2021,11,11,1300,717,377,1094,Thursday
2021,11,11,1200,794,275,1069,Thursday
2021,11,11,1100,765,203,968,Thursday
2021,11,11,1000,609,150,759,Thursday
2021,11,11,900,470,103,573,Thursday
2021,11,11,800,273,58,331,Thursday
2021,11,11,700,130,36,166,Thursday
2021,11,11,600,53,37,90,Thursday
2021,11,11,500,24,36,60,Thursday
2021,11,11,400,30,29,59,Thursday
2021,11,11,300,23,42,65,Thursday
2021,11,11,200,31,37,68,Thursday
2021,11,11,100,43,89,132,Thursday
2021,11,10,2400,56,99,155,Wednesday
2021,11,10,2300,68,116,184,Wednesday
2021,11,10,2200,95,91,186,Wednesday
2021,11,10,2100,132,157,289,Wednesday
2021,11,10,2000,231,200,431,Wednesday
2021,11,10,1900,285,237,522,Wednesday
2021,11,10,1800,262,381,643,Wednesday
2021,11,10,1700,289,440,729,Wednesday
2021,11,10,1600,315,460,775,Wednesday
2021,11,10,1500,379,424,803,Wednesday
2021,11,10,1400,360,345,705,Wednesday
2021,11,10,1300,361,271,632,Wednesday
2021,11,10,1200,410,227,637,Wednesday
2021,11,10,1100,419,199,618,Wednesday
2021,11,10,1000,333,130,463,Wednesday
2021,11,10,900,293,104,397,Wednesday
2021,11,10,800,156,61,217,Wednesday
2021,11,10,700,97,34,131,Wednesday
2021,11,10,600,37,49,86,Wednesday
2021,11,10,500,19,141,160,Wednesday
2021,11,10,400,28,99,127,Wednesday
2021,11,10,300,19,111,130,Wednesday
2021,11,10,200,24,32,56,Wednesday
2021,11,10,100,26,8,34,Wednesday
2021,11,9,2400,48,14,62,Tuesday
2021,11,9,2300,68,31,99,Tuesday
2021,11,9,2200,52,19,71,Tuesday
2021,11,9,2100,76,70,146,Tuesday
2021,11,9,2000,101,96,197,Tuesday
2021,11,9,1900,119,198,317,Tuesday
2021,11,9,1800,151,337,488,Tuesday
2021,11,9,1700,175,374,549,Tuesday
2021,11,9,1600,234,393,627,Tuesday
2021,11,9,1500,250,412,662,Tuesday
2021,11,9,1400,277,354,631,Tuesday
2021,11,9,1300,300,248,548,Tuesday
2021,11,9,1200,387,150,537,Tuesday
2021,11,9,1100,355,163,518,Tuesday
2021,11,9,1000,339,123,462,Tuesday
2021,11,9,900,296,114,410,Tuesday
2021,11,9,800,158,51,209,Tuesday
2021,11,9,700,91,47,138,Tuesday
2021,11,9,600,39,30,69,Tuesday
2021,11,9,500,22,25,47,Tuesday
2021,11,9,400,19,22,41,Tuesday
2021,11,9,300,22,35,57,Tuesday
2021,11,9,200,21,46,67,Tuesday
2021,11,9,100,27,49,76,Tuesday
2021,11,8,2400,43,69,112,Monday
2021,11,8,2300,61,61,122,Monday
2021,11,8,2200,54,87,141,Monday
2021,11,8,2100,87,124,211,Monday
2021,11,8,2000,101,168,269,Monday
2021,11,8,1900,134,209,343,Monday
2021,11,8,1800,152,328,480,Monday
2021,11,8,1700,206,401,607,Monday
2021,11,8,1600,274,338,612,Monday
2021,11,8,1500,338,359,697,Monday
2021,11,8,1400,328,282,610,Monday
2021,11,8,1300,335,238,573,Monday
2021,11,8,1200,390,273,663,Monday
2021,11,8,1100,403,104,507,Monday
2021,11,8,1000,345,101,446,Monday
2021,11,8,900,255,100,355,Monday
2021,11,8,800,172,35,207,Monday
2021,11,8,700,93,36,129,Monday
2021,11,8,600,44,20,64,Monday
2021,11,8,500,25,14,39,Monday
2021,11,8,400,30,21,51,Monday
2021,11,8,300,18,22,40,Monday
2021,11,8,200,13,23,36,Monday
2021,11,8,100,15,37,52,Monday
2021,11,7,2400,27,60,87,Sunday
2021,11,7,2300,45,86,131,Sunday
2021,11,7,2200,54,86,140,Sunday
2021,11,7,2100,77,211,288,Sunday
2021,11,7,2000,90,180,270,Sunday
2021,11,7,1900,121,237,358,Sunday
2021,11,7,1800,162,402,564,Sunday
2021,11,7,1700,221,596,817,Sunday
2021,11,7,1600,327,667,994,Sunday
2021,11,7,1500,318,591,909,Sunday
2021,11,7,1400,395,499,894,Sunday
2021,11,7,1300,445,434,879,Sunday
2021,11,7,1200,499,303,802,Sunday
2021,11,7,1100,465,198,663,Sunday
2021,11,7,1000,371,86,457,Sunday
2021,11,7,900,311,76,387,Sunday
2021,11,7,800,180,28,208,Sunday
2021,11,7,700,70,38,108,Sunday
2021,11,7,600,27,16,43,Sunday
2021,11,7,500,10,10,20,Sunday
2021,11,7,400,20,15,35,Sunday
2021,11,7,300,23,11,34,Sunday
2021,11,7,200,18,19,37,Sunday
2021,11,7,100,18,55,73,Sunday
2021,11,6,2400,36,47,83,Saturday
2021,11,6,2300,51,49,100,Saturday
2021,11,6,2200,51,100,151,Saturday
2021,11,6,2100,74,93,167,Saturday
2021,11,6,2000,93,162,255,Saturday
2021,11,6,1900,110,217,327,Saturday
2021,11,6,1800,143,421,564,Saturday
2021,11,6,1700,207,488,695,Saturday
2021,11,6,1600,279,525,804,Saturday
2021,11,6,1500,316,426,742,Saturday
2021,11,6,1400,397,348,745,Saturday
2021,11,6,1300,425,300,725,Saturday
2021,11,6,1200,459,224,683,Saturday
2021,11,6,1100,468,152,620,Saturday
2021,11,6,1000,365,125,490,Saturday
2021,11,6,900,260,81,341,Saturday
2021,11,6,800,152,49,201,Saturday
2021,11,6,700,96,35,131,Saturday
2021,11,6,600,39,30,69,Saturday
2021,11,6,500,26,31,57,Saturday
2021,11,6,400,22,32,54,Saturday
2021,11,6,300,19,37,56,Saturday
2021,11,6,200,20,71,91,Saturday
2021,11,6,100,23,76,99,Saturday
2021,11,5,2400,54,41,95,Friday
2021,11,5,2300,77,105,182,Friday
2021,11,5,2200,88,89,177,Friday
2021,11,5,2100,120,136,256,Friday
2021,11,5,2000,178,185,363,Friday
2021,11,5,1900,266,254,520,Friday
2021,11,5,1800,296,362,658,Friday
2021,11,5,1700,309,433,742,Friday
2021,11,5,1600,365,382,747,Friday
2021,11,5,1500,366,367,733,Friday
2021,11,5,1400,303,309,612,Friday
2021,11,5,1300,404,269,673,Friday
2021,11,5,1200,392,250,642,Friday
2021,11,5,1100,356,171,527,Friday
2021,11,5,1000,290,119,409,Friday
2021,11,5,900,242,115,357,Friday
2021,11,5,800,173,59,232,Friday
2021,11,5,700,83,46,129,Friday
2021,11,5,600,41,24,65,Friday
2021,11,5,500,33,36,69,Friday
2021,11,5,400,22,42,64,Friday
2021,11,5,300,30,41,71,Friday
2021,11,5,200,23,35,58,Friday
2021,11,5,100,28,82,110,Friday
2021,11,4,2400,49,142,191,Thursday
2021,11,4,2300,59,81,140,Thursday
2021,11,4,2200,79,31,110,Thursday
2021,11,4,2100,90,69,159,Thursday
2021,11,4,2000,123,145,268,Thursday
2021,11,4,1900,155,247,402,Thursday
2021,11,4,1800,177,281,458,Thursday
2021,11,4,1700,217,275,492,Thursday
2021,11,4,1600,240,307,547,Thursday
2021,11,4,1500,247,306,553,Thursday
2021,11,4,1400,273,305,578,Thursday
2021,11,4,1300,281,320,601,Thursday
2021,11,4,1200,290,248,538,Thursday
2021,11,4,1100,266,190,456,Thursday
2021,11,4,1000,214,108,322,Thursday
2021,11,4,900,205,85,290,Thursday
2021,11,4,800,146,68,214,Thursday
2021,11,4,700,96,53,149,Thursday
2021,11,4,600,44,42,86,Thursday
2021,11,4,500,36,43,79,Thursday
2021,11,4,400,25,30,55,Thursday
2021,11,4,300,28,41,69,Thursday
2021,11,4,200,23,55,78,Thursday
2021,11,4,100,41,41,82,Thursday
2021,11,3,2400,49,69,118,Wednesday
2021,11,3,2300,65,78,143,Wednesday
2021,11,3,2200,95,110,205,Wednesday
2021,11,3,2100,88,132,220,Wednesday
2021,11,3,2000,107,160,267,Wednesday
2021,11,3,1900,144,210,354,Wednesday
2021,11,3,1800,175,269,444,Wednesday
2021,11,3,1700,193,264,457,Wednesday
2021,11,3,1600,236,273,509,Wednesday
2021,11,3,1500,227,281,508,Wednesday
2021,11,3,1400,240,227,467,Wednesday
2021,11,3,1300,293,192,485,Wednesday
2021,11,3,1200,297,215,512,Wednesday
2021,11,3,1100,268,146,414,Wednesday
2021,11,3,1000,251,120,371,Wednesday
2021,11,3,900,184,98,282,Wednesday
2021,11,3,800,135,60,195,Wednesday
2021,11,3,700,67,40,107,Wednesday
2021,11,3,600,37,35,72,Wednesday
2021,11,3,500,37,43,80,Wednesday
2021,11,3,400,22,27,49,Wednesday
2021,11,3,300,32,42,74,Wednesday
2021,11,3,200,23,54,77,Wednesday
2021,11,3,100,28,75,103,Wednesday
2021,11,2,2400,52,96,148,Tuesday
2021,11,2,2300,63,109,172,Tuesday
2021,11,2,2200,71,114,185,Tuesday
2021,11,2,2100,105,128,233,Tuesday
2021,11,2,2000,112,165,277,Tuesday
2021,11,2,1900,116,285,401,Tuesday
2021,11,2,1800,156,266,422,Tuesday
2021,11,2,1700,171,255,426,Tuesday
2021,11,2,1600,252,299,551,Tuesday
2021,11,2,1500,251,343,594,Tuesday
2021,11,2,1400,232,164,396,Tuesday
2021,11,2,1300,290,156,446,Tuesday
2021,11,2,1200,309,177,486,Tuesday
2021,11,2,1100,288,146,434,Tuesday
2021,11,2,1000,226,137,363,Tuesday
2021,11,2,900,187,132,319,Tuesday
2021,11,2,800,111,61,172,Tuesday
2021,11,2,700,85,48,133,Tuesday
2021,11,2,600,44,35,79,Tuesday
2021,11,2,500,32,40,72,Tuesday
2021,11,2,400,25,39,64,Tuesday
2021,11,2,300,24,30,54,Tuesday
2021,11,2,200,25,57,82,Tuesday
2021,11,2,100,48,73,121,Tuesday
2021,11,1,2400,60,74,134,Monday
2021,11,1,2300,67,82,149,Monday
2021,11,1,2200,64,109,173,Monday
2021,11,1,2100,76,114,190,Monday
2021,11,1,2000,103,161,264,Monday
2021,11,1,1900,119,250,369,Monday
2021,11,1,1800,175,322,497,Monday
2021,11,1,1700,243,326,569,Monday
2021,11,1,1600,307,333,640,Monday
2021,11,1,1500,345,247,592,Monday
2021,11,1,1400,361,215,576,Monday
2021,11,1,1300,330,191,521,Monday
2021,11,1,1200,347,167,514,Monday
2021,11,1,1100,305,143,448,Monday
2021,11,1,1000,269,101,370,Monday
2021,11,1,900,202,76,278,Monday
2021,11,1,800,141,51,192,Monday
2021,11,1,700,92,34,126,Monday
2021,11,1,600,40,22,62,Monday
2021,11,1,500,21,32,53,Monday
2021,11,1,400,24,22,46,Monday
2021,11,1,300,19,34,53,Monday
2021,11,1,200,23,23,46,Monday
2021,11,1,100,18,39,57,Monday
2021,10,31,2400,30,80,110,Sunday
2021,10,31,2300,52,132,184,Sunday
2021,10,31,2200,61,79,140,Sunday
2021,10,31,2100,74,148,222,Sunday
2021,10,31,2000,90,188,278,Sunday
2021,10,31,1900,110,284,394,Sunday
2021,10,31,1800,165,360,525,Sunday
2021,10,31,1700,224,438,662,Sunday
2021,10,31,1600,242,413,655,Sunday
2021,10,31,1500,277,432,709,Sunday
2021,10,31,1400,304,372,676,Sunday
2021,10,31,1300,366,358,724,Sunday
2021,10,31,1200,369,272,641,Sunday
2021,10,31,1100,313,127,440,Sunday
2021,10,31,1000,245,102,347,Sunday
2021,10,31,900,155,65,220,Sunday
2021,10,31,800,96,23,119,Sunday
2021,10,31,700,53,24,77,Sunday
2021,10,31,600,27,26,53,Sunday
2021,10,31,500,18,37,55,Sunday
2021,10,31,400,15,40,55,Sunday
2021,10,31,300,22,30,52,Sunday
2021,10,31,200,30,55,85,Sunday
2021,10,31,100,27,56,83,Sunday
2021,10,30,2400,42,59,101,Saturday
2021,10,30,2300,56,75,131,Saturday
2021,10,30,2200,65,92,157,Saturday
2021,10,30,2100,91,126,217,Saturday
2021,10,30,2000,101,187,288,Saturday
2021,10,30,1900,124,240,364,Saturday
2021,10,30,1800,139,354,493,Saturday
2021,10,30,1700,207,370,577,Saturday
2021,10,30,1600,237,414,651,Saturday
2021,10,30,1500,319,403,722,Saturday
2021,10,30,1400,372,279,651,Saturday
2021,10,30,1300,404,277,681,Saturday
2021,10,30,1200,350,239,589,Saturday
2021,10,30,1100,330,184,514,Saturday
2021,10,30,1000,252,114,366,Saturday
2021,10,30,900,156,80,236,Saturday
2021,10,30,800,102,48,150,Saturday
2021,10,30,700,50,49,99,Saturday
2021,10,30,600,33,45,78,Saturday
2021,10,30,500,11,36,47,Saturday
2021,10,30,400,19,40,59,Saturday
2021,10,30,300,21,39,60,Saturday
2021,10,30,200,33,47,80,Saturday
2021,10,30,100,12,49,61,Saturday
2021,10,29,2400,22,51,73,Friday
2021,10,29,2300,42,58,100,Friday
2021,10,29,2200,68,61,129,Friday
2021,10,29,2100,95,102,197,Friday
2021,10,29,2000,114,180,294,Friday
2021,10,29,1900,177,228,405,Friday
2021,10,29,1800,249,274,523,Friday
2021,10,29,1700,224,295,519,Friday
2021,10,29,1600,257,291,548,Friday
2021,10,29,1500,288,275,563,Friday
2021,10,29,1400,271,258,529,Friday
2021,10,29,1300,275,237,512,Friday
2021,10,29,1200,280,220,500,Friday
2021,10,29,1100,276,163,439,Friday
2021,10,29,1000,216,122,338,Friday
2021,10,29,900,160,99,259,Friday
2021,10,29,800,108,42,150,Friday
2021,10,29,700,76,39,115,Friday
2021,10,29,600,50,26,76,Friday
2021,10,29,500,34,42,76,Friday
2021,10,29,400,22,35,57,Friday
2021,10,29,300,26,47,73,Friday
2021,10,29,200,32,53,85,Friday
2021,10,29,100,24,78,102,Friday
2021,10,28,2400,41,93,134,Thursday
2021,10,28,2300,55,116,171,Thursday
2021,10,28,2200,104,115,219,Thursday
2021,10,28,2100,107,138,245,Thursday
2021,10,28,2000,130,146,276,Thursday
2021,10,28,1900,183,248,431,Thursday
2021,10,28,1800,201,287,488,Thursday
2021,10,28,1700,260,330,590,Thursday
2021,10,28,1600,265,303,568,Thursday
2021,10,28,1500,294,309,603,Thursday
2021,10,28,1400,286,279,565,Thursday
2021,10,28,1300,302,289,591,Thursday
2021,10,28,1200,327,202,529,Thursday
2021,10,28,1100,329,175,504,Thursday
2021,10,28,1000,222,135,357,Thursday
2021,10,28,900,209,93,302,Thursday
2021,10,28,800,126,61,187,Thursday
2021,10,28,700,105,52,157,Thursday
2021,10,28,600,38,34,72,Thursday
2021,10,28,500,34,33,67,Thursday
2021,10,28,400,30,36,66,Thursday
2021,10,28,300,25,35,60,Thursday
2021,10,28,200,44,59,103,Thursday
2021,10,28,100,35,69,104,Thursday
2021,10,27,2400,55,76,131,Wednesday
2021,10,27,2300,73,96,169,Wednesday
2021,10,27,2200,90,101,191,Wednesday
2021,10,27,2100,92,152,244,Wednesday
2021,10,27,2000,143,186,329,Wednesday
2021,10,27,1900,165,313,478,Wednesday
2021,10,27,1800,174,317,491,Wednesday
2021,10,27,1700,204,359,563,Wednesday
2021,10,27,1600,229,355,584,Wednesday
2021,10,27,1500,239,311,550,Wednesday
2021,10,27,1400,295,309,604,Wednesday
2021,10,27,1300,310,268,578,Wednesday
2021,10,27,1200,329,215,544,Wednesday
2021,10,27,1100,318,159,477,Wednesday
2021,10,27,1000,271,118,389,Wednesday
2021,10,27,900,201,115,316,Wednesday
2021,10,27,800,168,67,235,Wednesday
2021,10,27,700,74,54,128,Wednesday
2021,10,27,600,50,40,90,Wednesday
2021,10,27,500,27,49,76,Wednesday
2021,10,27,400,28,43,71,Wednesday
2021,10,27,300,27,47,74,Wednesday
2021,10,27,200,31,46,77,Wednesday
2021,10,27,100,34,68,102,Wednesday
2021,10,26,2400,45,92,137,Tuesday
2021,10,26,2300,57,100,157,Tuesday
2021,10,26,2200,76,126,202,Tuesday
2021,10,26,2100,96,127,223,Tuesday
2021,10,26,2000,114,199,313,Tuesday
2021,10,26,1900,136,279,415,Tuesday
2021,10,26,1800,164,317,481,Tuesday
2021,10,26,1700,211,334,545,Tuesday
2021,10,26,1600,254,352,606,Tuesday
2021,10,26,1500,263,314,577,Tuesday
2021,10,26,1400,274,264,538,Tuesday
2021,10,26,1300,331,266,597,Tuesday
2021,10,26,1200,323,222,545,Tuesday
2021,10,26,1100,313,191,504,Tuesday
2021,10,26,1000,284,108,392,Tuesday
2021,10,26,900,217,108,325,Tuesday
2021,10,26,800,136,75,211,Tuesday
2021,10,26,700,97,53,150,Tuesday
2021,10,26,600,47,39,86,Tuesday
2021,10,26,500,35,39,74,Tuesday
2021,10,26,400,22,36,58,Tuesday
2021,10,26,300,18,36,54,Tuesday
2021,10,26,200,42,42,84,Tuesday
2021,10,26,100,35,61,96,Tuesday
2021,10,25,2400,49,84,133,Monday
2021,10,25,2300,71,104,175,Monday
2021,10,25,2200,65,89,154,Monday
2021,10,25,2100,98,135,233,Monday
2021,10,25,2000,118,201,319,Monday
2021,10,25,1900,155,281,436,Monday
2021,10,25,1800,213,351,564,Monday
2021,10,25,1700,208,339,547,Monday
2021,10,25,1600,247,342,589,Monday
2021,10,25,1500,281,343,624,Monday
2021,10,25,1400,333,291,624,Monday
2021,10,25,1300,345,294,639,Monday
2021,10,25,1200,372,164,536,Monday
2021,10,25,1100,375,165,540,Monday
2021,10,25,1000,311,106,417,Monday
2021,10,25,900,216,85,301,Monday
2021,10,25,800,170,39,209,Monday
2021,10,25,700,87,31,118,Monday
2021,10,25,600,36,27,63,Monday
2021,10,25,500,20,20,40,Monday
2021,10,25,400,19,31,50,Monday
2021,10,25,300,16,28,44,Monday
2021,10,25,200,24,47,71,Monday
2021,10,25,100,23,67,90,Monday
2021,10,24,2400,33,72,105,Sunday
2021,10,24,2300,56,122,178,Sunday
2021,10,24,2200,69,152,221,Sunday
2021,10,24,2100,86,216,302,Sunday
2021,10,24,2000,107,351,458,Sunday
2021,10,24,1900,137,479,616,Sunday
2021,10,24,1800,204,661,865,Sunday
2021,10,24,1700,277,755,1032,Sunday
2021,10,24,1600,365,675,1040,Sunday
2021,10,24,1500,398,653,1051,Sunday
2021,10,24,1400,431,499,930,Sunday
2021,10,24,1300,480,445,925,Sunday
2021,10,24,1200,543,364,907,Sunday
2021,10,24,1100,451,201,652,Sunday
2021,10,24,1000,399,112,511,Sunday
2021,10,24,900,261,64,325,Sunday
2021,10,24,800,162,39,201,Sunday
2021,10,24,700,77,29,106,Sunday
2021,10,24,600,47,28,75,Sunday
2021,10,24,500,24,17,41,Sunday
2021,10,24,400,11,19,30,Sunday
2021,10,24,300,20,27,47,Sunday
2021,10,24,200,31,29,60,Sunday
2021,10,24,100,9,51,60,Sunday
2021,10,23,2400,36,57,93,Saturday
2021,10,23,2300,57,91,148,Saturday
2021,10,23,2200,65,88,153,Saturday
2021,10,23,2100,69,172,241,Saturday
2021,10,23,2000,104,207,311,Saturday
2021,10,23,1900,103,306,409,Saturday
2021,10,23,1800,156,424,580,Saturday
2021,10,23,1700,215,459,674,Saturday
2021,10,23,1600,285,395,680,Saturday
2021,10,23,1500,339,348,687,Saturday
2021,10,23,1400,358,321,679,Saturday
2021,10,23,1300,371,291,662,Saturday
2021,10,23,1200,399,229,628,Saturday
2021,10,23,1100,403,194,597,Saturday
2021,10,23,1000,362,107,469,Saturday
2021,10,23,900,214,102,316,Saturday
2021,10,23,800,179,53,232,Saturday
2021,10,23,700,81,64,145,Saturday
2021,10,23,600,30,37,67,Saturday
2021,10,23,500,31,40,71,Saturday
2021,10,23,400,17,31,48,Saturday
2021,10,23,300,32,50,82,Saturday
2021,10,23,200,26,42,68,Saturday
2021,10,23,100,37,56,93,Saturday
2021,10,22,2400,56,62,118,Friday
2021,10,22,2300,51,93,144,Friday
2021,10,22,2200,109,108,217,Friday
2021,10,22,2100,158,315,473,Friday
2021,10,22,2000,225,187,412,Friday
2021,10,22,1900,283,414,697,Friday
2021,10,22,1800,360,368,728,Friday
2021,10,22,1700,382,642,1024,Friday
2021,10,22,1600,389,471,860,Friday
2021,10,22,1500,403,308,711,Friday
2021,10,22,1400,405,311,716,Friday
2021,10,22,1300,419,317,736,Friday
2021,10,22,1200,473,385,858,Friday
2021,10,22,1100,400,115,515,Friday
2021,10,22,1000,334,154,488,Friday
2021,10,22,900,245,116,361,Friday
2021,10,22,800,195,64,259,Friday
2021,10,22,700,120,54,174,Friday
2021,10,22,600,57,32,89,Friday
2021,10,22,500,34,43,77,Friday
2021,10,22,400,39,48,87,Friday
2021,10,22,300,28,61,89,Friday
2021,10,22,200,32,61,93,Friday
2021,10,22,100,42,62,104,Friday
2021,10,21,2400,52,95,147,Thursday
2021,10,21,2300,71,109,180,Thursday
2021,10,21,2200,78,162,240,Thursday
2021,10,21,2100,123,189,312,Thursday
2021,10,21,2000,151,261,412,Thursday
2021,10,21,1900,177,395,572,Thursday
2021,10,21,1800,240,490,730,Thursday
2021,10,21,1700,279,450,729,Thursday
2021,10,21,1600,326,418,744,Thursday
2021,10,21,1500,338,354,692,Thursday
2021,10,21,1400,377,328,705,Thursday
2021,10,21,1300,421,276,697,Thursday
2021,10,21,1200,481,220,701,Thursday
2021,10,21,1100,391,190,581,Thursday
2021,10,21,1000,355,136,491,Thursday
2021,10,21,900,283,104,387,Thursday
2021,10,21,800,185,67,252,Thursday
2021,10,21,700,101,69,170,Thursday
2021,10,21,600,59,39,98,Thursday
2021,10,21,500,31,60,91,Thursday
2021,10,21,400,34,28,62,Thursday
2021,10,21,300,29,37,66,Thursday
2021,10,21,200,30,50,80,Thursday
2021,10,21,100,49,70,119,Thursday
2021,10,20,2400,45,74,119,Wednesday
2021,10,20,2300,69,117,186,Wednesday
2021,10,20,2200,81,113,194,Wednesday
2021,10,20,2100,111,182,293,Wednesday
2021,10,20,2000,129,203,332,Wednesday
2021,10,20,1900,153,333,486,Wednesday
2021,10,20,1800,213,329,542,Wednesday
2021,10,20,1700,238,403,641,Wednesday
2021,10,20,1600,261,397,658,Wednesday
2021,10,20,1500,301,361,662,Wednesday
2021,10,20,1400,338,299,637,Wednesday
2021,10,20,1300,377,255,632,Wednesday
2021,10,20,1200,358,240,598,Wednesday
2021,10,20,1100,411,214,625,Wednesday
2021,10,20,1000,324,159,483,Wednesday
2021,10,20,900,233,113,346,Wednesday
2021,10,20,800,189,68,257,Wednesday
2021,10,20,700,106,49,155,Wednesday
2021,10,20,600,60,46,106,Wednesday
2021,10,20,500,30,39,69,Wednesday
2021,10,20,400,31,40,71,Wednesday
2021,10,20,300,20,43,63,Wednesday
2021,10,20,200,32,57,89,Wednesday
2021,10,20,100,32,64,96,Wednesday
2021,10,19,2400,67,83,150,Tuesday
2021,10,19,2300,72,84,156,Tuesday
2021,10,19,2200,68,112,180,Tuesday
2021,10,19,2100,81,172,253,Tuesday
2021,10,19,2000,118,239,357,Tuesday
2021,10,19,1900,137,350,487,Tuesday
2021,10,19,1800,184,406,590,Tuesday
2021,10,19,1700,232,421,653,Tuesday
2021,10,19,1600,255,385,640,Tuesday
2021,10,19,1500,291,350,641,Tuesday
2021,10,19,1400,341,302,643,Tuesday
2021,10,19,1300,369,265,634,Tuesday
2021,10,19,1200,401,230,631,Tuesday
2021,10,19,1100,438,163,601,Tuesday
2021,10,19,1000,299,131,430,Tuesday
2021,10,19,900,271,111,382,Tuesday
2021,10,19,800,188,79,267,Tuesday
2021,10,19,700,101,56,157,Tuesday
2021,10,19,600,64,50,114,Tuesday
2021,10,19,500,36,39,75,Tuesday
2021,10,19,400,26,43,69,Tuesday
2021,10,19,300,26,47,73,Tuesday
2021,10,19,200,25,46,71,Tuesday
2021,10,19,100,43,54,97,Tuesday
2021,10,18,2400,57,73,130,Monday
2021,10,18,2300,48,90,138,Monday
2021,10,18,2200,72,104,176,Monday
2021,10,18,2100,98,203,301,Monday
2021,10,18,2000,142,226,368,Monday
2021,10,18,1900,146,363,509,Monday
2021,10,18,1800,170,433,603,Monday
2021,10,18,1700,260,424,684,Monday
2021,10,18,1600,300,443,743,Monday
2021,10,18,1500,314,375,689,Monday
2021,10,18,1400,400,331,731,Monday
2021,10,18,1300,419,264,683,Monday
2021,10,18,1200,510,234,744,Monday
2021,10,18,1100,456,175,631,Monday
2021,10,18,1000,384,118,502,Monday
2021,10,18,900,273,107,380,Monday
2021,10,18,800,183,45,228,Monday
2021,10,18,700,119,39,158,Monday
2021,10,18,600,58,39,97,Monday
2021,10,18,500,28,15,43,Monday
2021,10,18,400,24,21,45,Monday
2021,10,18,300,20,34,54,Monday
2021,10,18,200,29,45,74,Monday
2021,10,18,100,29,45,74,Monday
2021,10,17,2400,34,75,109,Sunday
2021,10,17,2300,60,131,191,Sunday
2021,10,17,2200,72,165,237,Sunday
2021,10,17,2100,90,273,363,Sunday
2021,10,17,2000,134,419,553,Sunday
2021,10,17,1900,158,551,709,Sunday
2021,10,17,1800,236,789,1025,Sunday
2021,10,17,1700,282,850,1132,Sunday
2021,10,17,1600,380,799,1179,Sunday
2021,10,17,1500,419,682,1101,Sunday
2021,10,17,1400,483,603,1086,Sunday
2021,10,17,1300,550,479,1029,Sunday
2021,10,17,1200,599,350,949,Sunday
2021,10,17,1100,604,245,849,Sunday
2021,10,17,1000,464,135,599,Sunday
2021,10,17,900,310,64,374,Sunday
2021,10,17,800,206,33,239,Sunday
2021,10,17,700,98,15,113,Sunday
2021,10,17,600,45,36,81,Sunday
2021,10,17,500,23,13,36,Sunday
2021,10,17,400,19,25,44,Sunday
2021,10,17,300,20,31,51,Sunday
2021,10,17,200,17,39,56,Sunday
2021,10,17,100,27,51,78,Sunday
2021,10,16,2400,22,70,92,Saturday
2021,10,16,2300,58,100,158,Saturday
2021,10,16,2200,68,122,190,Saturday
2021,10,16,2100,88,176,264,Saturday
2021,10,16,2000,114,322,436,Saturday
2021,10,16,1900,133,548,681,Saturday
2021,10,16,1800,164,509,673,Saturday
2021,10,16,1700,281,609,890,Saturday
2021,10,16,1600,372,604,976,Saturday
2021,10,16,1500,445,558,1003,Saturday
2021,10,16,1400,472,414,886,Saturday
2021,10,16,1300,622,387,1009,Saturday
2021,10,16,1200,620,273,893,Saturday
2021,10,16,1100,532,229,761,Saturday
2021,10,16,1000,507,149,656,Saturday
2021,10,16,900,317,92,409,Saturday
2021,10,16,800,195,63,258,Saturday
2021,10,16,700,100,60,160,Saturday
2021,10,16,600,48,29,77,Saturday
2021,10,16,500,36,30,66,Saturday
2021,10,16,400,23,31,54,Saturday
2021,10,16,300,16,31,47,Saturday
2021,10,16,200,23,43,66,Saturday
2021,10,16,100,43,61,104,Saturday
2021,10,15,2400,50,90,140,Friday
2021,10,15,2300,63,165,228,Friday
2021,10,15,2200,121,127,248,Friday
2021,10,15,2100,166,128,294,Friday
2021,10,15,2000,255,284,539,Friday
2021,10,15,1900,324,370,694,Friday
2021,10,15,1800,385,471,856,Friday
2021,10,15,1700,411,577,988,Friday
2021,10,15,1600,447,501,948,Friday
2021,10,15,1500,485,475,960,Friday
2021,10,15,1400,453,387,840,Friday
2021,10,15,1300,481,363,844,Friday
2021,10,15,1200,556,310,866,Friday
2021,10,15,1100,510,233,743,Friday
2021,10,15,1000,376,166,542,Friday
2021,10,15,900,319,130,449,Friday
2021,10,15,800,191,59,250,Friday
2021,10,15,700,117,49,166,Friday
2021,10,15,600,56,34,90,Friday
2021,10,15,500,39,37,76,Friday
2021,10,15,400,31,42,73,Friday
2021,10,15,300,28,52,80,Friday
2021,10,15,200,46,59,105,Friday
2021,10,15,100,34,62,96,Friday
2021,10,14,2400,63,75,138,Thursday
2021,10,14,2300,63,141,204,Thursday
2021,10,14,2200,97,137,234,Thursday
2021,10,14,2100,151,191,342,Thursday
2021,10,14,2000,178,264,442,Thursday
2021,10,14,1900,214,362,576,Thursday
2021,10,14,1800,235,477,712,Thursday
2021,10,14,1700,301,510,811,Thursday
2021,10,14,1600,347,533,880,Thursday
2021,10,14,1500,399,446,845,Thursday
2021,10,14,1400,418,386,804,Thursday
2021,10,14,1300,406,337,743,Thursday
2021,10,14,1200,537,283,820,Thursday
2021,10,14,1100,527,222,749,Thursday
2021,10,14,1000,434,137,571,Thursday
2021,10,14,900,315,118,433,Thursday
2021,10,14,800,231,64,295,Thursday
2021,10,14,700,105,58,163,Thursday
2021,10,14,600,45,44,89,Thursday
2021,10,14,500,28,38,66,Thursday
2021,10,14,400,23,42,65,Thursday
2021,10,14,300,34,56,90,Thursday
2021,10,14,200,28,62,90,Thursday
2021,10,14,100,43,68,111,Thursday
2021,10,13,2400,45,92,137,Wednesday
2021,10,13,2300,71,94,165,Wednesday
2021,10,13,2200,92,144,236,Wednesday
2021,10,13,2100,97,178,275,Wednesday
2021,10,13,2000,142,281,423,Wednesday
2021,10,13,1900,154,330,484,Wednesday
2021,10,13,1800,192,777,969,Wednesday
2021,10,13,1700,248,460,708,Wednesday
2021,10,13,1600,286,395,681,Wednesday
2021,10,13,1500,303,391,694,Wednesday
2021,10,13,1400,339,293,632,Wednesday
2021,10,13,1300,401,198,599,Wednesday
2021,10,13,1200,448,109,557,Wednesday
2021,10,13,1100,418,154,572,Wednesday
2021,10,13,1000,363,160,523,Wednesday
2021,10,13,900,257,92,349,Wednesday
2021,10,13,800,164,81,245,Wednesday
2021,10,13,700,108,64,172,Wednesday
2021,10,13,600,41,44,85,Wednesday
2021,10,13,500,25,43,68,Wednesday
2021,10,13,400,28,32,60,Wednesday
2021,10,13,300,23,49,72,Wednesday
2021,10,13,200,32,65,97,Wednesday
2021,10,13,100,42,76,118,Wednesday
2021,10,12,2400,55,79,134,Tuesday
2021,10,12,2300,83,101,184,Tuesday
2021,10,12,2200,98,140,238,Tuesday
2021,10,12,2100,116,215,331,Tuesday
2021,10,12,2000,139,283,422,Tuesday
2021,10,12,1900,180,463,643,Tuesday
2021,10,12,1800,254,499,753,Tuesday
2021,10,12,1700,306,532,838,Tuesday
2021,10,12,1600,335,544,879,Tuesday
2021,10,12,1500,419,409,828,Tuesday
2021,10,12,1400,416,393,809,Tuesday
2021,10,12,1300,525,508,1033,Tuesday
2021,10,12,1200,520,377,897,Tuesday
2021,10,12,1100,602,241,843,Tuesday
2021,10,12,1000,636,170,806,Tuesday
2021,10,12,900,406,113,519,Tuesday
2021,10,12,800,223,80,303,Tuesday
2021,10,12,700,146,51,197,Tuesday
2021,10,12,600,61,30,91,Tuesday
2021,10,12,500,24,24,48,Tuesday
2021,10,12,400,21,23,44,Tuesday
2021,10,12,300,17,41,58,Tuesday
2021,10,12,200,28,46,74,Tuesday
2021,10,12,100,37,69,106,Tuesday
2021,10,11,2400,29,109,138,Monday
2021,10,11,2300,67,131,198,Monday
2021,10,11,2200,81,214,295,Monday
2021,10,11,2100,102,392,494,Monday
2021,10,11,2000,151,655,806,Monday
2021,10,11,1900,192,1011,1203,Monday
2021,10,11,1800,251,1338,1589,Monday
2021,10,11,1700,360,1460,1820,Monday
2021,10,11,1600,451,1563,2014,Monday
2021,10,11,1500,608,1570,2178,Monday
2021,10,11,1400,702,1285,1987,Monday
2021,10,11,1300,846,1071,1917,Monday
2021,10,11,1200,861,847,1708,Monday
2021,10,11,1100,822,358,1180,Monday
2021,10,11,1000,695,174,869,Monday
2021,10,11,900,499,103,602,Monday
2021,10,11,800,226,50,276,Monday
2021,10,11,700,151,28,179,Monday
2021,10,11,600,68,50,118,Monday
2021,10,11,500,40,6,46,Monday
2021,10,11,400,30,8,38,Monday
2021,10,11,300,17,29,46,Monday
2021,10,11,200,19,34,53,Monday
2021,10,11,100,29,33,62,Monday
2021,10,10,2400,40,60,100,Sunday
2021,10,10,2300,41,100,141,Sunday
2021,10,10,2200,69,143,212,Sunday
2021,10,10,2100,107,240,347,Sunday
2021,10,10,2000,118,371,489,Sunday
2021,10,10,1900,148,525,673,Sunday
2021,10,10,1800,217,634,851,Sunday
2021,10,10,1700,302,787,1089,Sunday
2021,10,10,1600,362,893,1255,Sunday
2021,10,10,1500,471,758,1229,Sunday
2021,10,10,1400,530,905,1435,Sunday
2021,10,10,1300,643,579,1222,Sunday
2021,10,10,1200,678,460,1138,Sunday
2021,10,10,1100,628,263,891,Sunday
2021,10,10,1000,496,165,661,Sunday
2021,10,10,900,365,66,431,Sunday
2021,10,10,800,205,44,249,Sunday
2021,10,10,700,126,32,158,Sunday
2021,10,10,600,51,28,79,Sunday
2021,10,10,500,27,33,60,Sunday
2021,10,10,400,18,25,43,Sunday
2021,10,10,300,25,45,70,Sunday
2021,10,10,200,21,35,56,Sunday
2021,10,10,100,20,51,71,Sunday
2021,10,9,2400,37,78,115,Saturday
2021,10,9,2300,72,103,175,Saturday
2021,10,9,2200,61,149,210,Saturday
2021,10,9,2100,111,318,429,Saturday
2021,10,9,2000,145,599,744,Saturday
2021,10,9,1900,183,789,972,Saturday
2021,10,9,1800,307,990,1297,Saturday
2021,10,9,1700,444,911,1355,Saturday
2021,10,9,1600,554,887,1441,Saturday
2021,10,9,1500,655,746,1401,Saturday
2021,10,9,1400,854,639,1493,Saturday
2021,10,9,1300,1036,545,1581,Saturday
2021,10,9,1200,980,413,1393,Saturday
2021,10,9,1100,1078,300,1378,Saturday
2021,10,9,1000,910,224,1134,Saturday
2021,10,9,900,678,123,801,Saturday
2021,10,9,800,434,80,514,Saturday
2021,10,9,700,239,64,303,Saturday
2021,10,9,600,131,40,171,Saturday
2021,10,9,500,72,46,118,Saturday
2021,10,9,400,39,39,78,Saturday
2021,10,9,300,29,50,79,Saturday
2021,10,9,200,36,58,94,Saturday
2021,10,9,100,55,85,140,Saturday
2021,10,8,2400,79,139,218,Friday
2021,10,8,2300,128,160,288,Friday
2021,10,8,2200,205,229,434,Friday
2021,10,8,2100,369,313,682,Friday
2021,10,8,2000,554,538,1092,Friday
2021,10,8,1900,752,673,1425,Friday
2021,10,8,1800,885,779,1664,Friday
2021,10,8,1700,855,882,1737,Friday
2021,10,8,1600,811,859,1670,Friday
2021,10,8,1500,953,796,1749,Friday
2021,10,8,1400,886,737,1623,Friday
2021,10,8,1300,927,415,1342,Friday
2021,10,8,1200,1084,348,1432,Friday
2021,10,8,1100,989,220,1209,Friday
2021,10,8,1000,644,183,827,Friday
2021,10,8,900,508,137,645,Friday
2021,10,8,800,344,77,421,Friday
2021,10,8,700,225,68,293,Friday
2021,10,8,600,89,53,142,Friday
2021,10,8,500,48,57,105,Friday
2021,10,8,400,39,49,88,Friday
2021,10,8,300,39,63,102,Friday
2021,10,8,200,34,81,115,Friday
2021,10,8,100,60,90,150,Friday
2021,10,7,2400,64,106,170,Thursday
2021,10,7,2300,120,135,255,Thursday
2021,10,7,2200,161,169,330,Thursday
2021,10,7,2100,248,263,511,Thursday
2021,10,7,2000,386,322,708,Thursday
2021,10,7,1900,443,462,905,Thursday
2021,10,7,1800,450,589,1039,Thursday
2021,10,7,1700,427,586,1013,Thursday
2021,10,7,1600,441,538,979,Thursday
2021,10,7,1500,525,437,962,Thursday
2021,10,7,1400,488,349,837,Thursday
2021,10,7,1300,525,331,856,Thursday
2021,10,7,1200,592,333,925,Thursday
2021,10,7,1100,583,210,793,Thursday
2021,10,7,1000,515,173,688,Thursday
2021,10,7,900,437,132,569,Thursday
2021,10,7,800,278,75,353,Thursday
2021,10,7,700,158,54,212,Thursday
2021,10,7,600,79,45,124,Thursday
2021,10,7,500,53,31,84,Thursday
2021,10,7,400,39,35,74,Thursday
2021,10,7,300,33,49,82,Thursday
2021,10,7,200,33,54,87,Thursday
2021,10,7,100,51,58,109,Thursday
2021,10,6,2400,62,105,167,Wednesday
2021,10,6,2300,86,98,184,Wednesday
2021,10,6,2200,122,173,295,Wednesday
2021,10,6,2100,134,220,354,Wednesday
2021,10,6,2000,178,283,461,Wednesday
2021,10,6,1900,211,421,632,Wednesday
2021,10,6,1800,244,417,661,Wednesday
2021,10,6,1700,311,586,897,Wednesday
2021,10,6,1600,325,436,761,Wednesday
2021,10,6,1500,375,397,772,Wednesday
2021,10,6,1400,380,394,774,Wednesday
2021,10,6,1300,404,363,767,Wednesday
2021,10,6,1200,493,310,803,Wednesday
2021,10,6,1100,519,244,763,Wednesday
2021,10,6,1000,403,214,617,Wednesday
2021,10,6,900,331,131,462,Wednesday
2021,10,6,800,223,89,312,Wednesday
2021,10,6,700,130,77,207,Wednesday
2021,10,6,600,60,56,116,Wednesday
2021,10,6,500,41,40,81,Wednesday
2021,10,6,400,29,49,78,Wednesday
2021,10,6,300,28,45,73,Wednesday
2021,10,6,200,25,49,74,Wednesday
2021,10,6,100,38,59,97,Wednesday
2021,10,5,2400,61,97,158,Tuesday
2021,10,5,2300,80,122,202,Tuesday
2021,10,5,2200,79,212,291,Tuesday
2021,10,5,2100,114,287,401,Tuesday
2021,10,5,2000,134,393,527,Tuesday
2021,10,5,1900,187,459,646,Tuesday
2021,10,5,1800,215,605,820,Tuesday
2021,10,5,1700,268,665,933,Tuesday
2021,10,5,1600,307,545,852,Tuesday
2021,10,5,1500,357,454,811,Tuesday
2021,10,5,1400,387,403,790,Tuesday
2021,10,5,1300,455,365,820,Tuesday
2021,10,5,1200,573,271,844,Tuesday
2021,10,5,1100,571,230,801,Tuesday
2021,10,5,1000,511,189,700,Tuesday
2021,10,5,900,417,155,572,Tuesday
2021,10,5,800,288,108,396,Tuesday
2021,10,5,700,169,136,305,Tuesday
2021,10,5,600,98,35,133,Tuesday
2021,10,5,500,43,31,74,Tuesday
2021,10,5,400,31,20,51,Tuesday
2021,10,5,300,27,16,43,Tuesday
2021,10,5,200,31,21,52,Tuesday
2021,10,5,100,32,54,86,Tuesday
2021,10,4,2400,57,88,145,Monday
2021,10,4,2300,68,111,179,Monday
2021,10,4,2200,99,158,257,Monday
2021,10,4,2100,112,317,429,Monday
2021,10,4,2000,156,378,534,Monday
2021,10,4,1900,172,585,757,Monday
2021,10,4,1800,264,641,905,Monday
2021,10,4,1700,293,676,969,Monday
2021,10,4,1600,338,597,935,Monday
2021,10,4,1500,416,517,933,Monday
2021,10,4,1400,428,395,823,Monday
2021,10,4,1300,515,391,906,Monday
2021,10,4,1200,649,284,933,Monday
2021,10,4,1100,666,223,889,Monday
2021,10,4,1000,581,163,744,Monday
2021,10,4,900,471,106,577,Monday
2021,10,4,800,311,55,366,Monday
2021,10,4,700,203,47,250,Monday
2021,10,4,600,93,29,122,Monday
2021,10,4,500,53,24,77,Monday
2021,10,4,400,42,23,65,Monday
2021,10,4,300,25,39,64,Monday
2021,10,4,200,21,45,66,Monday
2021,10,4,100,37,72,109,Monday
2021,10,3,2400,25,74,99,Sunday
2021,10,3,2300,53,162,215,Sunday
2021,10,3,2200,94,286,380,Sunday
2021,10,3,2100,117,458,575,Sunday
2021,10,3,2000,154,684,838,Sunday
2021,10,3,1900,195,1021,1216,Sunday
2021,10,3,1800,277,1132,1409,Sunday
2021,10,3,1700,370,1200,1570,Sunday
2021,10,3,1600,486,1199,1685,Sunday
2021,10,3,1500,520,993,1513,Sunday
2021,10,3,1400,641,950,1591,Sunday
2021,10,3,1300,750,729,1479,Sunday
2021,10,3,1200,754,495,1249,Sunday
2021,10,3,1100,861,302,1163,Sunday
2021,10,3,1000,741,207,948,Sunday
2021,10,3,900,631,92,723,Sunday
2021,10,3,800,369,53,422,Sunday
2021,10,3,700,209,38,247,Sunday
2021,10,3,600,113,20,133,Sunday
2021,10,3,500,58,21,79,Sunday
2021,10,3,400,42,19,61,Sunday
2021,10,3,300,20,39,59,Sunday
2021,10,3,200,19,40,59,Sunday
2021,10,3,100,25,56,81,Sunday
2021,10,2,2400,38,96,134,Saturday
2021,10,2,2300,54,113,167,Saturday
2021,10,2,2200,75,205,280,Saturday
2021,10,2,2100,90,352,442,Saturday
2021,10,2,2000,152,513,665,Saturday
2021,10,2,1900,186,814,1000,Saturday
2021,10,2,1800,271,1096,1367,Saturday
2021,10,2,1700,318,1034,1352,Saturday
2021,10,2,1600,407,906,1313,Saturday
2021,10,2,1500,558,784,1342,Saturday
2021,10,2,1400,612,650,1262,Saturday
2021,10,2,1300,791,539,1330,Saturday
2021,10,2,1200,954,319,1273,Saturday
2021,10,2,1100,955,293,1248,Saturday
2021,10,2,1000,869,196,1065,Saturday
2021,10,2,900,737,121,858,Saturday
2021,10,2,800,486,66,552,Saturday
2021,10,2,700,268,67,335,Saturday
2021,10,2,600,129,48,177,Saturday
2021,10,2,500,89,25,114,Saturday
2021,10,2,400,50,37,87,Saturday
2021,10,2,300,40,54,94,Saturday
2021,10,2,200,30,37,67,Saturday
2021,10,2,100,31,65,96,Saturday
2021,10,1,2400,58,139,197,Friday
2021,10,1,2300,101,158,259,Friday
2021,10,1,2200,140,176,316,Friday
2021,10,1,2100,235,338,573,Friday
2021,10,1,2000,336,518,854,Friday
2021,10,1,1900,420,703,1123,Friday
2021,10,1,1800,520,736,1256,Friday
2021,10,1,1700,571,762,1333,Friday
2021,10,1,1600,601,736,1337,Friday
2021,10,1,1500,650,606,1256,Friday
2021,10,1,1400,601,493,1094,Friday
2021,10,1,1300,672,430,1102,Friday
2021,10,1,1200,797,340,1137,Friday
2021,10,1,1100,791,286,1077,Friday
2021,10,1,1000,747,167,914,Friday
2021,10,1,900,577,122,699,Friday
2021,10,1,800,388,76,464,Friday
2021,10,1,700,234,72,306,Friday
2021,10,1,600,124,40,164,Friday
2021,10,1,500,82,39,121,Friday
2021,10,1,400,46,41,87,Friday
2021,10,1,300,20,63,83,Friday
2021,10,1,200,36,51,87,Friday
2021,10,1,100,36,85,121,Friday
2021,9,30,2400,62,120,182,Thursday
2021,9,30,2300,89,133,222,Thursday
2021,9,30,2200,109,171,280,Thursday
2021,9,30,2100,170,318,488,Thursday
2021,9,30,2000,225,422,647,Thursday
2021,9,30,1900,283,689,972,Thursday
2021,9,30,1800,354,781,1135,Thursday
2021,9,30,1700,434,863,1297,Thursday
2021,9,30,1600,541,830,1371,Thursday
2021,9,30,1500,619,641,1260,Thursday
2021,9,30,1400,608,600,1208,Thursday
2021,9,30,1300,711,427,1138,Thursday
2021,9,30,1200,846,396,1242,Thursday
2021,9,30,1100,814,275,1089,Thursday
2021,9,30,1000,789,218,1007,Thursday
2021,9,30,900,623,134,757,Thursday
2021,9,30,800,387,66,453,Thursday
2021,9,30,700,228,74,302,Thursday
2021,9,30,600,119,32,151,Thursday
2021,9,30,500,62,43,105,Thursday
2021,9,30,400,46,35,81,Thursday
2021,9,30,300,24,60,84,Thursday
2021,9,30,200,38,77,115,Thursday
2021,9,30,100,37,68,105,Thursday
2021,9,29,2400,65,106,171,Wednesday
2021,9,29,2300,109,128,237,Wednesday
2021,9,29,2200,136,181,317,Wednesday
2021,9,29,2100,185,297,482,Wednesday
2021,9,29,2000,240,433,673,Wednesday
2021,9,29,1900,277,520,797,Wednesday
2021,9,29,1800,305,671,976,Wednesday
2021,9,29,1700,319,658,977,Wednesday
2021,9,29,1600,379,627,1006,Wednesday
2021,9,29,1500,410,549,959,Wednesday
2021,9,29,1400,459,457,916,Wednesday
2021,9,29,1300,471,400,871,Wednesday
2021,9,29,1200,568,301,869,Wednesday
2021,9,29,1100,672,240,912,Wednesday
2021,9,29,1000,670,165,835,Wednesday
2021,9,29,900,499,132,631,Wednesday
2021,9,29,800,311,96,407,Wednesday
2021,9,29,700,233,53,286,Wednesday
2021,9,29,600,119,49,168,Wednesday
2021,9,29,500,72,48,120,Wednesday
2021,9,29,400,28,40,68,Wednesday
2021,9,29,300,34,43,77,Wednesday
2021,9,29,200,36,61,97,Wednesday
2021,9,29,100,32,56,88,Wednesday
2021,9,28,2400,62,105,167,Tuesday
2021,9,28,2300,66,132,198,Tuesday
2021,9,28,2200,79,170,249,Tuesday
2021,9,28,2100,135,329,464,Tuesday
2021,9,28,2000,150,417,567,Tuesday
2021,9,28,1900,226,489,715,Tuesday
2021,9,28,1800,225,620,845,Tuesday
2021,9,28,1700,269,601,870,Tuesday
2021,9,28,1600,312,611,923,Tuesday
2021,9,28,1500,389,462,851,Tuesday
2021,9,28,1400,438,355,793,Tuesday
2021,9,28,1300,501,396,897,Tuesday
2021,9,28,1200,586,309,895,Tuesday
2021,9,28,1100,581,281,862,Tuesday
2021,9,28,1000,587,185,772,Tuesday
2021,9,28,900,412,154,566,Tuesday
2021,9,28,800,272,78,350,Tuesday
2021,9,28,700,163,76,239,Tuesday
2021,9,28,600,56,26,82,Tuesday
2021,9,28,500,40,49,89,Tuesday
2021,9,28,400,38,44,82,Tuesday
2021,9,28,300,17,51,68,Tuesday
2021,9,28,200,29,56,85,Tuesday
2021,9,28,100,40,153,193,Tuesday
2021,9,27,2400,47,61,108,Monday
2021,9,27,2300,70,308,378,Monday
2021,9,27,2200,97,50,147,Monday
2021,9,27,2100,115,193,308,Monday
2021,9,27,2000,166,339,505,Monday
2021,9,27,1900,213,537,750,Monday
2021,9,27,1800,264,636,900,Monday
2021,9,27,1700,292,658,950,Monday
2021,9,27,1600,400,624,1024,Monday
2021,9,27,1500,448,560,1008,Monday
2021,9,27,1400,486,526,1012,Monday
2021,9,27,1300,542,666,1208,Monday
2021,9,27,1200,547,550,1097,Monday
2021,9,27,1100,654,324,978,Monday
2021,9,27,1000,721,244,965,Monday
2021,9,27,900,479,189,668,Monday
2021,9,27,800,322,62,384,Monday
2021,9,27,700,244,50,294,Monday
2021,9,27,600,115,28,143,Monday
2021,9,27,500,65,21,86,Monday
2021,9,27,400,36,26,62,Monday
2021,9,27,300,21,26,47,Monday
2021,9,27,200,20,42,62,Monday
2021,9,27,100,25,32,57,Monday
2021,9,26,2400,41,72,113,Sunday
2021,9,26,2300,56,167,223,Sunday
2021,9,26,2200,82,253,335,Sunday
2021,9,26,2100,115,582,697,Sunday
2021,9,26,2000,195,880,1075,Sunday
2021,9,26,1900,211,1196,1407,Sunday
2021,9,26,1800,345,1493,1838,Sunday
2021,9,26,1700,435,1654,2089,Sunday
2021,9,26,1600,471,1534,2005,Sunday
2021,9,26,1500,644,1361,2005,Sunday
2021,9,26,1400,703,1110,1813,Sunday
2021,9,26,1300,862,933,1795,Sunday
2021,9,26,1200,873,726,1599,Sunday
2021,9,26,1100,939,441,1380,Sunday
2021,9,26,1000,822,268,1090,Sunday
2021,9,26,900,799,162,961,Sunday
2021,9,26,800,489,51,540,Sunday
2021,9,26,700,297,55,352,Sunday
2021,9,26,600,149,34,183,Sunday
2021,9,26,500,104,29,133,Sunday
2021,9,26,400,96,21,117,Sunday
2021,9,26,300,46,39,85,Sunday
2021,9,26,200,26,40,66,Sunday
2021,9,26,100,22,28,50,Sunday
2021,9,25,2400,38,59,97,Saturday
2021,9,25,2300,73,145,218,Saturday
2021,9,25,2200,85,216,301,Saturday
2021,9,25,2100,136,525,661,Saturday
2021,9,25,2000,170,829,999,Saturday
2021,9,25,1900,228,1127,1355,Saturday
2021,9,25,1800,304,1236,1540,Saturday
2021,9,25,1700,399,1190,1589,Saturday
2021,9,25,1600,564,1117,1681,Saturday
2021,9,25,1500,647,828,1475,Saturday
2021,9,25,1400,787,690,1477,Saturday
2021,9,25,1300,917,658,1575,Saturday
2021,9,25,1200,1165,509,1674,Saturday
2021,9,25,1100,1075,385,1460,Saturday
2021,9,25,1000,1170,334,1504,Saturday
2021,9,25,900,973,239,1212,Saturday
2021,9,25,800,695,67,762,Saturday
2021,9,25,700,371,103,474,Saturday
2021,9,25,600,201,37,238,Saturday
2021,9,25,500,169,35,204,Saturday
2021,9,25,400,106,38,144,Saturday
2021,9,25,300,42,50,92,Saturday
2021,9,25,200,35,42,77,Saturday
2021,9,25,100,51,39,90,Saturday
2021,9,24,2400,85,72,157,Friday
2021,9,24,2300,106,146,252,Friday
2021,9,24,2200,171,208,379,Friday
2021,9,24,2100,280,583,863,Friday
2021,9,24,2000,447,894,1341,Friday
2021,9,24,1900,616,667,1283,Friday
2021,9,24,1800,637,716,1353,Friday
2021,9,24,1700,755,943,1698,Friday
2021,9,24,1600,718,862,1580,Friday
2021,9,24,1500,754,665,1419,Friday
2021,9,24,1400,822,562,1384,Friday
2021,9,24,1300,840,469,1309,Friday
2021,9,24,1200,947,373,1320,Friday
2021,9,24,1100,858,300,1158,Friday
2021,9,24,1000,805,207,1012,Friday
2021,9,24,900,678,150,828,Friday
2021,9,24,800,445,89,534,Friday
2021,9,24,700,254,71,325,Friday
2021,9,24,600,150,40,190,Friday
2021,9,24,500,113,41,154,Friday
2021,9,24,400,53,39,92,Friday
2021,9,24,300,30,54,84,Friday
2021,9,24,200,39,58,97,Friday
2021,9,24,100,27,88,115,Friday
2021,9,23,2400,57,103,160,Thursday
2021,9,23,2300,98,122,220,Thursday
2021,9,23,2200,145,193,338,Thursday
2021,9,23,2100,209,350,559,Thursday
2021,9,23,2000,300,481,781,Thursday
2021,9,23,1900,383,612,995,Thursday
2021,9,23,1800,428,750,1178,Thursday
2021,9,23,1700,450,730,1180,Thursday
2021,9,23,1600,458,663,1121,Thursday
2021,9,23,1500,541,608,1149,Thursday
2021,9,23,1400,540,471,1011,Thursday
2021,9,23,1300,641,409,1050,Thursday
2021,9,23,1200,773,334,1107,Thursday
2021,9,23,1100,810,250,1060,Thursday
2021,9,23,1000,717,165,882,Thursday
2021,9,23,900,542,132,674,Thursday
2021,9,23,800,391,91,482,Thursday
2021,9,23,700,256,68,324,Thursday
2021,9,23,600,128,46,174,Thursday
2021,9,23,500,76,37,113,Thursday
2021,9,23,400,35,39,74,Thursday
2021,9,23,300,30,48,78,Thursday
2021,9,23,200,43,67,110,Thursday
2021,9,23,100,40,78,118,Thursday
2021,9,22,2400,56,104,160,Wednesday
2021,9,22,2300,98,154,252,Wednesday
2021,9,22,2200,113,192,305,Wednesday
2021,9,22,2100,152,318,470,Wednesday
2021,9,22,2000,175,397,572,Wednesday
2021,9,22,1900,240,531,771,Wednesday
2021,9,22,1800,309,680,989,Wednesday
2021,9,22,1700,369,665,1034,Wednesday
2021,9,22,1600,396,707,1103,Wednesday
2021,9,22,1500,426,539,965,Wednesday
2021,9,22,1400,487,513,1000,Wednesday
2021,9,22,1300,568,452,1020,Wednesday
2021,9,22,1200,667,329,996,Wednesday
2021,9,22,1100,747,260,1007,Wednesday
2021,9,22,1000,666,208,874,Wednesday
2021,9,22,900,502,141,643,Wednesday
2021,9,22,800,343,102,445,Wednesday
2021,9,22,700,229,51,280,Wednesday
2021,9,22,600,98,36,134,Wednesday
2021,9,22,500,86,39,125,Wednesday
2021,9,22,400,32,35,67,Wednesday
2021,9,22,300,29,46,75,Wednesday
2021,9,22,200,24,61,85,Wednesday
2021,9,22,100,40,82,122,Wednesday
2021,9,21,2400,67,91,158,Tuesday
2021,9,21,2300,69,129,198,Tuesday
2021,9,21,2200,102,199,301,Tuesday
2021,9,21,2100,130,392,522,Tuesday
2021,9,21,2000,203,490,693,Tuesday
2021,9,21,1900,197,649,846,Tuesday
2021,9,21,1800,275,768,1043,Tuesday
2021,9,21,1700,336,725,1061,Tuesday
2021,9,21,1600,370,715,1085,Tuesday
2021,9,21,1500,431,568,999,Tuesday
2021,9,21,1400,482,472,954,Tuesday
2021,9,21,1300,552,378,930,Tuesday
2021,9,21,1200,725,346,1071,Tuesday
2021,9,21,1100,791,311,1102,Tuesday
2021,9,21,1000,756,186,942,Tuesday
2021,9,21,900,564,128,692,Tuesday
2021,9,21,800,453,78,531,Tuesday
2021,9,21,700,245,70,315,Tuesday
2021,9,21,600,138,49,187,Tuesday
2021,9,21,500,85,41,126,Tuesday
2021,9,21,400,45,48,93,Tuesday
2021,9,21,300,27,36,63,Tuesday
2021,9,21,200,38,62,100,Tuesday
2021,9,21,100,36,90,126,Tuesday
2021,9,20,2400,61,119,180,Monday
2021,9,20,2300,75,144,219,Monday
2021,9,20,2200,99,175,274,Monday
2021,9,20,2100,153,354,507,Monday
2021,9,20,2000,156,502,658,Monday
2021,9,20,1900,221,596,817,Monday
2021,9,20,1800,288,712,1000,Monday
2021,9,20,1700,349,745,1094,Monday
2021,9,20,1600,425,651,1076,Monday
2021,9,20,1500,509,444,953,Monday
2021,9,20,1400,553,462,1015,Monday
2021,9,20,1300,654,547,1201,Monday
2021,9,20,1200,770,428,1198,Monday
2021,9,20,1100,797,272,1069,Monday
2021,9,20,1000,778,216,994,Monday
2021,9,20,900,585,153,738,Monday
2021,9,20,800,383,56,439,Monday
2021,9,20,700,230,56,286,Monday
2021,9,20,600,126,20,146,Monday
2021,9,20,500,45,16,61,Monday
2021,9,20,400,25,34,59,Monday
2021,9,20,300,21,30,51,Monday
2021,9,20,200,22,31,53,Monday
2021,9,20,100,20,26,46,Monday
2021,9,19,2400,39,89,128,Sunday
2021,9,19,2300,90,151,241,Sunday
2021,9,19,2200,93,276,369,Sunday
2021,9,19,2100,146,436,582,Sunday
2021,9,19,2000,216,727,943,Sunday
2021,9,19,1900,264,1009,1273,Sunday
2021,9,19,1800,368,1317,1685,Sunday
2021,9,19,1700,456,1306,1762,Sunday
2021,9,19,1600,538,1330,1868,Sunday
2021,9,19,1500,651,1118,1769,Sunday
2021,9,19,1400,707,870,1577,Sunday
2021,9,19,1300,774,855,1629,Sunday
2021,9,19,1200,912,699,1611,Sunday
2021,9,19,1100,934,426,1360,Sunday
2021,9,19,1000,875,210,1085,Sunday
2021,9,19,900,687,137,824,Sunday
2021,9,19,800,422,50,472,Sunday
2021,9,19,700,212,24,236,Sunday
2021,9,19,600,112,31,143,Sunday
2021,9,19,500,78,18,96,Sunday
2021,9,19,400,30,22,52,Sunday
2021,9,19,300,16,31,47,Sunday
2021,9,19,200,26,39,65,Sunday
2021,9,19,100,36,53,89,Sunday
2021,9,18,2400,40,79,119,Saturday
2021,9,18,2300,50,116,166,Saturday
2021,9,18,2200,84,171,255,Saturday
2021,9,18,2100,114,295,409,Saturday
2021,9,18,2000,209,497,706,Saturday
2021,9,18,1900,206,597,803,Saturday
2021,9,18,1800,317,887,1204,Saturday
2021,9,18,1700,372,904,1276,Saturday
2021,9,18,1600,483,859,1342,Saturday
2021,9,18,1500,518,771,1289,Saturday
2021,9,18,1400,657,863,1520,Saturday
2021,9,18,1300,737,546,1283,Saturday
2021,9,18,1200,863,454,1317,Saturday
2021,9,18,1100,795,320,1115,Saturday
2021,9,18,1000,733,289,1022,Saturday
2021,9,18,900,542,207,749,Saturday
2021,9,18,800,383,54,437,Saturday
2021,9,18,700,176,39,215,Saturday
2021,9,18,600,91,33,124,Saturday
2021,9,18,500,57,31,88,Saturday
2021,9,18,400,28,39,67,Saturday
2021,9,18,300,20,43,63,Saturday
2021,9,18,200,38,60,98,Saturday
2021,9,18,100,53,27,80,Saturday
2021,9,17,2400,65,72,137,Friday
2021,9,17,2300,107,133,240,Friday
2021,9,17,2200,187,215,402,Friday
2021,9,17,2100,257,272,529,Friday
2021,9,17,2000,364,505,869,Friday
2021,9,17,1900,524,701,1225,Friday
2021,9,17,1800,600,926,1526,Friday
2021,9,17,1700,634,1080,1714,Friday
2021,9,17,1600,674,970,1644,Friday
2021,9,17,1500,705,726,1431,Friday
2021,9,17,1400,698,706,1404,Friday
2021,9,17,1300,728,594,1322,Friday
2021,9,17,1200,898,551,1449,Friday
2021,9,17,1100,930,389,1319,Friday
2021,9,17,1000,784,300,1084,Friday
2021,9,17,900,639,258,897,Friday
2021,9,17,800,401,65,466,Friday
2021,9,17,700,232,62,294,Friday
2021,9,17,600,105,61,166,Friday
2021,9,17,500,65,37,102,Friday
2021,9,17,400,28,37,65,Friday
2021,9,17,300,26,27,53,Friday
2021,9,17,200,41,51,92,Friday
2021,9,17,100,38,26,64,Friday
2021,9,16,2400,71,83,154,Thursday
2021,9,16,2300,87,198,285,Thursday
2021,9,16,2200,146,207,353,Thursday
2021,9,16,2100,218,444,662,Thursday
2021,9,16,2000,349,588,937,Thursday
2021,9,16,1900,360,779,1139,Thursday
2021,9,16,1800,423,825,1248,Thursday
2021,9,16,1700,432,873,1305,Thursday
2021,9,16,1600,533,873,1406,Thursday
2021,9,16,1500,568,674,1242,Thursday
2021,9,16,1400,607,585,1192,Thursday
2021,9,16,1300,688,508,1196,Thursday
2021,9,16,1200,789,414,1203,Thursday
2021,9,16,1100,926,352,1278,Thursday
2021,9,16,1000,781,246,1027,Thursday
2021,9,16,900,674,219,893,Thursday
2021,9,16,800,467,71,538,Thursday
2021,9,16,700,283,42,325,Thursday
2021,9,16,600,126,43,169,Thursday
2021,9,16,500,61,55,116,Thursday
2021,9,16,400,33,33,66,Thursday
2021,9,16,300,32,28,60,Thursday
2021,9,16,200,38,41,79,Thursday
2021,9,16,100,42,28,70,Thursday
2021,9,15,2400,57,93,150,Wednesday
2021,9,15,2300,75,205,280,Wednesday
2021,9,15,2200,121,184,305,Wednesday
2021,9,15,2100,170,340,510,Wednesday
2021,9,15,2000,213,522,735,Wednesday
2021,9,15,1900,229,643,872,Wednesday
2021,9,15,1800,317,710,1027,Wednesday
2021,9,15,1700,372,689,1061,Wednesday
2021,9,15,1600,479,684,1163,Wednesday
2021,9,15,1500,508,618,1126,Wednesday
2021,9,15,1400,518,577,1095,Wednesday
2021,9,15,1300,591,427,1018,Wednesday
2021,9,15,1200,749,379,1128,Wednesday
2021,9,15,1100,717,260,977,Wednesday
2021,9,15,1000,588,251,839,Wednesday
2021,9,15,900,465,227,692,Wednesday
2021,9,15,800,334,82,416,Wednesday
2021,9,15,700,188,73,261,Wednesday
2021,9,15,600,88,37,125,Wednesday
2021,9,15,500,36,52,88,Wednesday
2021,9,15,400,28,40,68,Wednesday
2021,9,15,300,25,28,53,Wednesday
2021,9,15,200,36,30,66,Wednesday
2021,9,15,100,38,25,63,Wednesday
2021,9,14,2400,56,166,222,Tuesday
2021,9,14,2300,71,94,165,Tuesday
2021,9,14,2200,124,183,307,Tuesday
2021,9,14,2100,138,402,540,Tuesday
2021,9,14,2000,213,616,829,Tuesday
2021,9,14,1900,249,767,1016,Tuesday
2021,9,14,1800,327,973,1300,Tuesday
2021,9,14,1700,353,940,1293,Tuesday
2021,9,14,1600,447,879,1326,Tuesday
2021,9,14,1500,510,680,1190,Tuesday
2021,9,14,1400,562,546,1108,Tuesday
2021,9,14,1300,668,495,1163,Tuesday
2021,9,14,1200,772,371,1143,Tuesday
2021,9,14,1100,869,343,1212,Tuesday
2021,9,14,1000,767,265,1032,Tuesday
2021,9,14,900,609,250,859,Tuesday
2021,9,14,800,425,68,493,Tuesday
2021,9,14,700,244,64,308,Tuesday
2021,9,14,600,126,47,173,Tuesday
2021,9,14,500,92,43,135,Tuesday
2021,9,14,400,33,32,65,Tuesday
2021,9,14,300,29,48,77,Tuesday
2021,9,14,200,28,47,75,Tuesday
2021,9,14,100,35,32,67,Tuesday
2021,9,13,2400,73,99,172,Monday
2021,9,13,2300,107,136,243,Monday
2021,9,13,2200,117,248,365,Monday
2021,9,13,2100,175,452,627,Monday
2021,9,13,2000,225,667,892,Monday
2021,9,13,1900,281,834,1115,Monday
2021,9,13,1800,351,986,1337,Monday
2021,9,13,1700,399,915,1314,Monday
2021,9,13,1600,532,813,1345,Monday
2021,9,13,1500,630,707,1337,Monday
2021,9,13,1400,676,628,1304,Monday
2021,9,13,1300,744,516,1260,Monday
2021,9,13,1200,948,420,1368,Monday
2021,9,13,1100,918,355,1273,Monday
2021,9,13,1000,805,234,1039,Monday
2021,9,13,900,691,200,891,Monday
2021,9,13,800,421,67,488,Monday
2021,9,13,700,275,44,319,Monday
2021,9,13,600,150,39,189,Monday
2021,9,13,500,89,16,105,Monday
2021,9,13,400,37,25,62,Monday
2021,9,13,300,26,31,57,Monday
2021,9,13,200,30,40,70,Monday
2021,9,13,100,23,34,57,Monday
2021,9,12,2400,47,95,142,Sunday
2021,9,12,2300,69,177,246,Sunday
2021,9,12,2200,96,251,347,Sunday
2021,9,12,2100,170,478,648,Sunday
2021,9,12,2000,222,673,895,Sunday
2021,9,12,1900,323,867,1190,Sunday
2021,9,12,1800,338,1107,1445,Sunday
2021,9,12,1700,472,1155,1627,Sunday
2021,9,12,1600,572,1212,1784,Sunday
2021,9,12,1500,698,1124,1822,Sunday
2021,9,12,1400,721,1015,1736,Sunday
2021,9,12,1300,833,1013,1846,Sunday
2021,9,12,1200,931,927,1858,Sunday
2021,9,12,1100,854,601,1455,Sunday
2021,9,12,1000,694,257,951,Sunday
2021,9,12,900,532,175,707,Sunday
2021,9,12,800,330,69,399,Sunday
2021,9,12,700,136,40,176,Sunday
2021,9,12,600,87,43,130,Sunday
2021,9,12,500,39,21,60,Sunday
2021,9,12,400,35,29,64,Sunday
2021,9,12,300,8,27,35,Sunday
2021,9,12,200,21,45,66,Sunday
2021,9,12,100,29,64,93,Sunday
2021,9,11,2400,44,94,138,Saturday
2021,9,11,2300,84,179,263,Saturday
2021,9,11,2200,131,283,414,Saturday
2021,9,11,2100,143,480,623,Saturday
2021,9,11,2000,182,684,866,Saturday
2021,9,11,1900,277,921,1198,Saturday
2021,9,11,1800,308,1075,1383,Saturday
2021,9,11,1700,403,1026,1429,Saturday
2021,9,11,1600,530,961,1491,Saturday
2021,9,11,1500,657,771,1428,Saturday
2021,9,11,1400,700,609,1309,Saturday
2021,9,11,1300,838,567,1405,Saturday
2021,9,11,1200,1025,518,1543,Saturday
2021,9,11,1100,975,374,1349,Saturday
2021,9,11,1000,906,238,1144,Saturday
2021,9,11,900,744,161,905,Saturday
2021,9,11,800,479,77,556,Saturday
2021,9,11,700,274,72,346,Saturday
2021,9,11,600,120,55,175,Saturday
2021,9,11,500,67,30,97,Saturday
2021,9,11,400,39,37,76,Saturday
2021,9,11,300,24,48,72,Saturday
2021,9,11,200,24,44,68,Saturday
2021,9,11,100,50,88,138,Saturday
2021,9,10,2400,54,204,258,Friday
2021,9,10,2300,121,167,288,Friday
2021,9,10,2200,184,117,301,Friday
2021,9,10,2100,338,439,777,Friday
2021,9,10,2000,462,680,1142,Friday
2021,9,10,1900,627,858,1485,Friday
2021,9,10,1800,643,1043,1686,Friday
2021,9,10,1700,678,902,1580,Friday
2021,9,10,1600,712,905,1617,Friday
2021,9,10,1500,688,727,1415,Friday
2021,9,10,1400,767,681,1448,Friday
2021,9,10,1300,845,632,1477,Friday
2021,9,10,1200,935,564,1499,Friday
2021,9,10,1100,1042,385,1427,Friday
2021,9,10,1000,930,286,1216,Friday
2021,9,10,900,646,288,934,Friday
2021,9,10,800,446,75,521,Friday
2021,9,10,700,243,47,290,Friday
2021,9,10,600,142,48,190,Friday
2021,9,10,500,103,36,139,Friday
2021,9,10,400,48,44,92,Friday
2021,9,10,300,25,27,52,Friday
2021,9,10,200,45,40,85,Friday
2021,9,10,100,42,37,79,Friday
2021,9,9,2400,65,102,167,Thursday
2021,9,9,2300,110,178,288,Thursday
2021,9,9,2200,137,262,399,Thursday
2021,9,9,2100,224,380,604,Thursday
2021,9,9,2000,298,573,871,Thursday
2021,9,9,1900,360,730,1090,Thursday
2021,9,9,1800,460,862,1322,Thursday
2021,9,9,1700,447,861,1308,Thursday
2021,9,9,1600,507,848,1355,Thursday
2021,9,9,1500,567,681,1248,Thursday
2021,9,9,1400,599,578,1177,Thursday
2021,9,9,1300,697,533,1230,Thursday
2021,9,9,1200,844,422,1266,Thursday
2021,9,9,1100,899,332,1231,Thursday
2021,9,9,1000,778,270,1048,Thursday
2021,9,9,900,647,262,909,Thursday
2021,9,9,800,428,70,498,Thursday
2021,9,9,700,232,81,313,Thursday
2021,9,9,600,148,32,180,Thursday
2021,9,9,500,56,30,86,Thursday
2021,9,9,400,35,35,70,Thursday
2021,9,9,300,24,25,49,Thursday
2021,9,9,200,31,54,85,Thursday
2021,9,9,100,48,33,81,Thursday
2021,9,8,2400,69,89,158,Wednesday
2021,9,8,2300,83,156,239,Wednesday
2021,9,8,2200,115,236,351,Wednesday
2021,9,8,2100,189,387,576,Wednesday
2021,9,8,2000,231,498,729,Wednesday
2021,9,8,1900,291,709,1000,Wednesday
2021,9,8,1800,312,962,1274,Wednesday
2021,9,8,1700,377,886,1263,Wednesday
2021,9,8,1600,464,908,1372,Wednesday
2021,9,8,1500,539,719,1258,Wednesday
2021,9,8,1400,568,568,1136,Wednesday
2021,9,8,1300,674,536,1210,Wednesday
2021,9,8,1200,841,420,1261,Wednesday
2021,9,8,1100,833,325,1158,Wednesday
2021,9,8,1000,794,305,1099,Wednesday
2021,9,8,900,574,259,833,Wednesday
2021,9,8,800,393,65,458,Wednesday
2021,9,8,700,211,50,261,Wednesday
2021,9,8,600,106,37,143,Wednesday
2021,9,8,500,59,32,91,Wednesday
2021,9,8,400,36,48,84,Wednesday
2021,9,8,300,30,49,79,Wednesday
2021,9,8,200,23,54,77,Wednesday
2021,9,8,100,45,38,83,Wednesday
2021,9,7,2400,60,78,138,Tuesday
2021,9,7,2300,84,186,270,Tuesday
2021,9,7,2200,116,279,395,Tuesday
2021,9,7,2100,166,517,683,Tuesday
2021,9,7,2000,224,605,829,Tuesday
2021,9,7,1900,285,874,1159,Tuesday
2021,9,7,1800,369,961,1330,Tuesday
2021,9,7,1700,441,1041,1482,Tuesday
2021,9,7,1600,526,980,1506,Tuesday
2021,9,7,1500,614,800,1414,Tuesday
2021,9,7,1400,718,715,1433,Tuesday
2021,9,7,1300,796,662,1458,Tuesday
2021,9,7,1200,1054,474,1528,Tuesday
2021,9,7,1100,991,365,1356,Tuesday
2021,9,7,1000,875,257,1132,Tuesday
2021,9,7,900,677,170,847,Tuesday
2021,9,7,800,484,74,558,Tuesday
2021,9,7,700,256,59,315,Tuesday
2021,9,7,600,151,39,190,Tuesday
2021,9,7,500,70,32,102,Tuesday
2021,9,7,400,31,34,65,Tuesday
2021,9,7,300,22,39,61,Tuesday
2021,9,7,200,25,55,80,Tuesday
2021,9,7,100,33,84,117,Tuesday
2021,9,6,2400,41,143,184,Monday
2021,9,6,2300,82,299,381,Monday
2021,9,6,2200,122,637,759,Monday
2021,9,6,2100,174,938,1112,Monday
2021,9,6,2000,231,1453,1684,Monday
2021,9,6,1900,286,1809,2095,Monday
2021,9,6,1800,375,2044,2419,Monday
2021,9,6,1700,563,2240,2803,Monday
2021,9,6,1600,660,2011,2671,Monday
2021,9,6,1500,828,2024,2852,Monday
2021,9,6,1400,950,1812,2762,Monday
2021,9,6,1300,1125,1578,2703,Monday
2021,9,6,1200,1264,1284,2548,Monday
2021,9,6,1100,1251,722,1973,Monday
2021,9,6,1000,1102,437,1539,Monday
2021,9,6,900,817,208,1025,Monday
2021,9,6,800,500,88,588,Monday
2021,9,6,700,323,53,376,Monday
2021,9,6,600,148,14,162,Monday
2021,9,6,500,91,22,113,Monday
2021,9,6,400,43,20,63,Monday
2021,9,6,300,27,37,64,Monday
2021,9,6,200,29,50,79,Monday
2021,9,6,100,37,105,142,Monday
2021,9,5,2400,59,156,215,Sunday
2021,9,5,2300,87,324,411,Sunday
2021,9,5,2200,123,655,778,Sunday
2021,9,5,2100,199,1183,1382,Sunday
2021,9,5,2000,226,1722,1948,Sunday
2021,9,5,1900,316,1913,2229,Sunday
2021,9,5,1800,475,1663,2138,Sunday
2021,9,5,1700,623,1247,1870,Sunday
2021,9,5,1600,751,1202,1953,Sunday
2021,9,5,1500,974,1045,2019,Sunday
2021,9,5,1400,1098,942,2040,Sunday
2021,9,5,1300,1217,800,2017,Sunday
2021,9,5,1200,1352,603,1955,Sunday
2021,9,5,1100,1412,477,1889,Sunday
2021,9,5,1000,1242,264,1506,Sunday
2021,9,5,900,937,163,1100,Sunday
2021,9,5,800,648,76,724,Sunday
2021,9,5,700,293,51,344,Sunday
2021,9,5,600,184,36,220,Sunday
2021,9,5,500,114,32,146,Sunday
2021,9,5,400,41,37,78,Sunday
2021,9,5,300,33,45,78,Sunday
2021,9,5,200,29,51,80,Sunday
2021,9,5,100,52,70,122,Sunday
2021,9,4,2400,51,132,183,Saturday
2021,9,4,2300,120,214,334,Saturday
2021,9,4,2200,160,447,607,Saturday
2021,9,4,2100,177,746,923,Saturday
2021,9,4,2000,251,1043,1294,Saturday
2021,9,4,1900,398,1208,1606,Saturday
2021,9,4,1800,495,1354,1849,Saturday
2021,9,4,1700,629,1304,1933,Saturday
2021,9,4,1600,812,1192,2004,Saturday
2021,9,4,1500,1076,939,2015,Saturday
2021,9,4,1400,1255,665,1920,Saturday
2021,9,4,1300,1461,697,2158,Saturday
2021,9,4,1200,1621,548,2169,Saturday
2021,9,4,1100,1639,352,1991,Saturday
2021,9,4,1000,1452,250,1702,Saturday
2021,9,4,900,1200,204,1404,Saturday
2021,9,4,800,812,93,905,Saturday
2021,9,4,700,407,64,471,Saturday
2021,9,4,600,206,81,287,Saturday
2021,9,4,500,128,61,189,Saturday
2021,9,4,400,58,45,103,Saturday
2021,9,4,300,43,66,109,Saturday
2021,9,4,200,48,74,122,Saturday
2021,9,4,100,85,96,181,Saturday
2021,9,3,2400,121,138,259,Friday
2021,9,3,2300,229,231,460,Friday
2021,9,3,2200,349,394,743,Friday
2021,9,3,2100,596,638,1234,Friday
2021,9,3,2000,970,747,1717,Friday
2021,9,3,1900,1257,981,2238,Friday
2021,9,3,1800,1335,1097,2432,Friday
2021,9,3,1700,1341,1083,2424,Friday
2021,9,3,1600,1352,918,2270,Friday
2021,9,3,1500,1265,819,2084,Friday
2021,9,3,1400,1249,786,2035,Friday
2021,9,3,1300,1521,581,2102,Friday
2021,9,3,1200,1573,487,2060,Friday
2021,9,3,1100,914,384,1298,Friday
2021,9,3,1000,892,290,1182,Friday
2021,9,3,900,908,262,1170,Friday
2021,9,3,800,601,100,701,Friday
2021,9,3,700,356,62,418,Friday
2021,9,3,600,200,52,252,Friday
2021,9,3,500,112,41,153,Friday
2021,9,3,400,48,55,103,Friday
2021,9,3,300,27,68,95,Friday
2021,9,3,200,54,62,116,Friday
2021,9,3,100,64,54,118,Friday
2021,9,2,2400,99,145,244,Thursday
2021,9,2,2300,133,147,280,Thursday
2021,9,2,2200,222,308,530,Thursday
2021,9,2,2100,392,479,871,Thursday
2021,9,2,2000,582,657,1239,Thursday
2021,9,2,1900,676,894,1570,Thursday
2021,9,2,1800,703,900,1603,Thursday
2021,9,2,1700,662,906,1568,Thursday
2021,9,2,1600,720,807,1527,Thursday
2021,9,2,1500,797,693,1490,Thursday
2021,9,2,1400,769,595,1364,Thursday
2021,9,2,1300,872,505,1377,Thursday
2021,9,2,1200,1059,406,1465,Thursday
2021,9,2,1100,1005,321,1326,Thursday
2021,9,2,1000,901,254,1155,Thursday
2021,9,2,900,739,241,980,Thursday
2021,9,2,800,495,79,574,Thursday
2021,9,2,700,275,61,336,Thursday
2021,9,2,600,173,59,232,Thursday
2021,9,2,500,65,45,110,Thursday
2021,9,2,400,32,36,68,Thursday
2021,9,2,300,37,61,98,Thursday
2021,9,2,200,41,52,93,Thursday
2021,9,2,100,48,40,88,Thursday
2021,9,1,2400,60,166,226,Wednesday
2021,9,1,2300,102,146,248,Wednesday
2021,9,1,2200,145,415,560,Wednesday
2021,9,1,2100,260,237,497,Wednesday
2021,9,1,2000,278,510,788,Wednesday
2021,9,1,1900,378,701,1079,Wednesday
2021,9,1,1800,435,780,1215,Wednesday
2021,9,1,1700,475,886,1361,Wednesday
2021,9,1,1600,571,1028,1599,Wednesday
2021,9,1,1500,610,836,1446,Wednesday
2021,9,1,1400,725,424,1149,Wednesday
2021,9,1,1300,776,331,1107,Wednesday
2021,9,1,1200,934,245,1179,Wednesday
2021,9,1,1100,847,316,1163,Wednesday
2021,9,1,1000,747,231,978,Wednesday
2021,9,1,900,557,261,818,Wednesday
2021,9,1,800,415,75,490,Wednesday
2021,9,1,700,210,63,273,Wednesday
2021,9,1,600,106,36,142,Wednesday
2021,9,1,500,45,29,74,Wednesday
2021,9,1,400,25,35,60,Wednesday
2021,9,1,300,33,38,71,Wednesday
2021,9,1,200,31,65,96,Wednesday
2021,9,1,100,44,34,78,Wednesday
2021,8,31,2400,68,123,191,Tuesday
2021,8,31,2300,78,179,257,Tuesday
2021,8,31,2200,135,260,395,Tuesday
2021,8,31,2100,176,389,565,Tuesday
2021,8,31,2000,277,583,860,Tuesday
2021,8,31,1900,283,784,1067,Tuesday
2021,8,31,1800,385,880,1265,Tuesday
2021,8,31,1700,439,870,1309,Tuesday
2021,8,31,1600,485,982,1467,Tuesday
2021,8,31,1500,619,857,1476,Tuesday
2021,8,31,1400,714,771,1485,Tuesday
2021,8,31,1300,742,686,1428,Tuesday
2021,8,31,1200,845,504,1349,Tuesday
2021,8,31,1100,869,407,1276,Tuesday
2021,8,31,1000,772,272,1044,Tuesday
2021,8,31,900,565,307,872,Tuesday
2021,8,31,800,390,78,468,Tuesday
2021,8,31,700,201,60,261,Tuesday
2021,8,31,600,106,35,141,Tuesday
2021,8,31,500,46,35,81,Tuesday
2021,8,31,400,30,39,69,Tuesday
2021,8,31,300,15,54,69,Tuesday
2021,8,31,200,32,60,92,Tuesday
2021,8,31,100,41,36,77,Tuesday
2021,8,30,2400,76,153,229,Monday
2021,8,30,2300,105,187,292,Monday
2021,8,30,2200,128,363,491,Monday
2021,8,30,2100,198,721,919,Monday
2021,8,30,2000,282,926,1208,Monday
2021,8,30,1900,321,1134,1455,Monday
2021,8,30,1800,435,1317,1752,Monday
2021,8,30,1700,531,1371,1902,Monday
2021,8,30,1600,633,1173,1806,Monday
2021,8,30,1500,719,988,1707,Monday
2021,8,30,1400,822,932,1754,Monday
2021,8,30,1300,1015,767,1782,Monday
2021,8,30,1200,1058,631,1689,Monday
2021,8,30,1100,1064,436,1500,Monday
2021,8,30,1000,989,281,1270,Monday
2021,8,30,900,728,264,992,Monday
2021,8,30,800,516,92,608,Monday
2021,8,30,700,290,53,343,Monday
2021,8,30,600,161,46,207,Monday
2021,8,30,500,83,36,119,Monday
2021,8,30,400,38,35,73,Monday
2021,8,30,300,31,36,67,Monday
2021,8,30,200,22,77,99,Monday
2021,8,30,100,37,48,85,Monday
2021,8,29,2400,49,136,185,Sunday
2021,8,29,2300,69,404,473,Sunday
2021,8,29,2200,135,640,775,Sunday
2021,8,29,2100,200,1128,1328,Sunday
2021,8,29,2000,305,1448,1753,Sunday
2021,8,29,1900,384,1776,2160,Sunday
2021,8,29,1800,497,1959,2456,Sunday
2021,8,29,1700,646,1990,2636,Sunday
2021,8,29,1600,943,2033,2976,Sunday
2021,8,29,1500,1087,1585,2672,Sunday
2021,8,29,1400,948,1030,1978,Sunday
2021,8,29,1300,996,1172,2168,Sunday
2021,8,29,1200,1356,901,2257,Sunday
2021,8,29,1100,1329,568,1897,Sunday
2021,8,29,1000,1106,279,1385,Sunday
2021,8,29,900,858,206,1064,Sunday
2021,8,29,800,588,91,679,Sunday
2021,8,29,700,321,39,360,Sunday
2021,8,29,600,199,20,219,Sunday
2021,8,29,500,119,29,148,Sunday
2021,8,29,400,52,31,83,Sunday
2021,8,29,300,33,54,87,Sunday
2021,8,29,200,44,65,109,Sunday
2021,8,29,100,42,83,125,Sunday
2021,8,28,2400,55,140,195,Saturday
2021,8,28,2300,88,245,333,Saturday
2021,8,28,2200,143,538,681,Saturday
2021,8,28,2100,219,855,1074,Saturday
2021,8,28,2000,259,1072,1331,Saturday
2021,8,28,1900,325,1461,1786,Saturday
2021,8,28,1800,429,1564,1993,Saturday
2021,8,28,1700,643,1509,2152,Saturday
2021,8,28,1600,657,1370,2027,Saturday
2021,8,28,1500,904,1199,2103,Saturday
2021,8,28,1400,1111,949,2060,Saturday
2021,8,28,1300,1274,796,2070,Saturday
2021,8,28,1200,1367,670,2037,Saturday
2021,8,28,1100,1487,452,1939,Saturday
2021,8,28,1000,1388,288,1676,Saturday
2021,8,28,900,1099,233,1332,Saturday
2021,8,28,800,785,96,881,Saturday
2021,8,28,700,375,66,441,Saturday
2021,8,28,600,178,54,232,Saturday
2021,8,28,500,114,52,166,Saturday
2021,8,28,400,56,46,102,Saturday
2021,8,28,300,34,54,88,Saturday
2021,8,28,200,34,86,120,Saturday
2021,8,28,100,54,100,154,Saturday
2021,8,27,2400,71,147,218,Friday
2021,8,27,2300,124,298,422,Friday
2021,8,27,2200,201,331,532,Friday
2021,8,27,2100,385,530,915,Friday
2021,8,27,2000,601,718,1319,Friday
2021,8,27,1900,743,1121,1864,Friday
2021,8,27,1800,842,1045,1887,Friday
2021,8,27,1700,872,1130,2002,Friday
2021,8,27,1600,1039,1149,2188,Friday
2021,8,27,1500,956,1058,2014,Friday
2021,8,27,1400,1021,964,1985,Friday
2021,8,27,1300,1131,978,2109,Friday
2021,8,27,1200,1232,646,1878,Friday
2021,8,27,1100,1164,474,1638,Friday
2021,8,27,1000,952,309,1261,Friday
2021,8,27,900,756,273,1029,Friday
2021,8,27,800,486,58,544,Friday
2021,8,27,700,249,89,338,Friday
2021,8,27,600,122,44,166,Friday
2021,8,27,500,67,27,94,Friday
2021,8,27,400,48,43,91,Friday
2021,8,27,300,30,44,74,Friday
2021,8,27,200,33,47,80,Friday
2021,8,27,100,47,55,102,Friday
2021,8,26,2400,86,175,261,Thursday
2021,8,26,2300,108,242,350,Thursday
2021,8,26,2200,175,355,530,Thursday
2021,8,26,2100,282,609,891,Thursday
2021,8,26,2000,441,798,1239,Thursday
2021,8,26,1900,511,1144,1655,Thursday
2021,8,26,1800,514,1195,1709,Thursday
2021,8,26,1700,666,1396,2062,Thursday
2021,8,26,1600,717,1231,1948,Thursday
2021,8,26,1500,805,1068,1873,Thursday
2021,8,26,1400,886,786,1672,Thursday
2021,8,26,1300,1117,735,1852,Thursday
2021,8,26,1200,1354,606,1960,Thursday
2021,8,26,1100,1143,388,1531,Thursday
2021,8,26,1000,1053,345,1398,Thursday
2021,8,26,900,871,314,1185,Thursday
2021,8,26,800,537,100,637,Thursday
2021,8,26,700,310,58,368,Thursday
2021,8,26,600,178,58,236,Thursday
2021,8,26,500,99,55,154,Thursday
2021,8,26,400,44,46,90,Thursday
2021,8,26,300,32,48,80,Thursday
2021,8,26,200,35,52,87,Thursday
2021,8,26,100,55,50,105,Thursday
2021,8,25,2400,87,161,248,Wednesday
2021,8,25,2300,128,305,433,Wednesday
2021,8,25,2200,168,431,599,Wednesday
2021,8,25,2100,272,711,983,Wednesday
2021,8,25,2000,342,954,1296,Wednesday
2021,8,25,1900,412,1201,1613,Wednesday
2021,8,25,1800,487,1219,1706,Wednesday
2021,8,25,1700,564,1254,1818,Wednesday
2021,8,25,1600,670,1153,1823,Wednesday
2021,8,25,1500,819,959,1778,Wednesday
2021,8,25,1400,879,806,1685,Wednesday
2021,8,25,1300,1102,727,1829,Wednesday
2021,8,25,1200,1348,566,1914,Wednesday
2021,8,25,1100,1249,412,1661,Wednesday
2021,8,25,1000,1050,304,1354,Wednesday
2021,8,25,900,860,306,1166,Wednesday
2021,8,25,800,604,113,717,Wednesday
2021,8,25,700,311,63,374,Wednesday
2021,8,25,600,227,47,274,Wednesday
2021,8,25,500,143,42,185,Wednesday
2021,8,25,400,51,43,94,Wednesday
2021,8,25,300,25,44,69,Wednesday
2021,8,25,200,33,60,93,Wednesday
2021,8,25,100,50,52,102,Wednesday
2021,8,24,2400,67,120,187,Tuesday
2021,8,24,2300,114,269,383,Tuesday
2021,8,24,2200,141,405,546,Tuesday
2021,8,24,2100,201,785,986,Tuesday
2021,8,24,2000,305,1160,1465,Tuesday
2021,8,24,1900,381,1082,1463,Tuesday
2021,8,24,1800,445,1031,1476,Tuesday
2021,8,24,1700,509,1115,1624,Tuesday
2021,8,24,1600,657,1104,1761,Tuesday
2021,8,24,1500,778,945,1723,Tuesday
2021,8,24,1400,911,753,1664,Tuesday
2021,8,24,1300,1027,693,1720,Tuesday
2021,8,24,1200,1160,544,1704,Tuesday
2021,8,24,1100,1193,387,1580,Tuesday
2021,8,24,1000,1028,277,1305,Tuesday
2021,8,24,900,811,282,1093,Tuesday
2021,8,24,800,567,90,657,Tuesday
2021,8,24,700,342,54,396,Tuesday
2021,8,24,600,208,45,253,Tuesday
2021,8,24,500,109,44,153,Tuesday
2021,8,24,400,44,39,83,Tuesday
2021,8,24,300,31,46,77,Tuesday
2021,8,24,200,35,52,87,Tuesday
2021,8,24,100,50,50,100,Tuesday
2021,8,23,2400,66,154,220,Monday
2021,8,23,2300,89,198,287,Monday
2021,8,23,2200,128,258,386,Monday
2021,8,23,2100,225,462,687,Monday
2021,8,23,2000,298,699,997,Monday
2021,8,23,1900,382,904,1286,Monday
2021,8,23,1800,445,1002,1447,Monday
2021,8,23,1700,605,1150,1755,Monday
2021,8,23,1600,711,1175,1886,Monday
2021,8,23,1500,844,933,1777,Monday
2021,8,23,1400,1001,839,1840,Monday
2021,8,23,1300,1019,773,1792,Monday
2021,8,23,1200,1170,570,1740,Monday
2021,8,23,1100,1078,413,1491,Monday
2021,8,23,1000,868,271,1139,Monday
2021,8,23,900,627,208,835,Monday
2021,8,23,800,441,90,531,Monday
2021,8,23,700,241,44,285,Monday
2021,8,23,600,102,22,124,Monday
2021,8,23,500,46,20,66,Monday
2021,8,23,400,31,27,58,Monday
2021,8,23,300,20,36,56,Monday
2021,8,23,200,28,57,85,Monday
2021,8,23,100,25,43,68,Monday
2021,8,22,2400,47,123,170,Sunday
2021,8,22,2300,86,283,369,Sunday
2021,8,22,2200,134,360,494,Sunday
2021,8,22,2100,196,742,938,Sunday
2021,8,22,2000,279,1097,1376,Sunday
2021,8,22,1900,366,1778,2144,Sunday
2021,8,22,1800,486,1488,1974,Sunday
2021,8,22,1700,659,1855,2514,Sunday
2021,8,22,1600,816,1793,2609,Sunday
2021,8,22,1500,911,1684,2595,Sunday
2021,8,22,1400,1120,1472,2592,Sunday
2021,8,22,1300,1194,1270,2464,Sunday
2021,8,22,1200,1341,950,2291,Sunday
2021,8,22,1100,1147,545,1692,Sunday
2021,8,22,1000,995,285,1280,Sunday
2021,8,22,900,713,149,862,Sunday
2021,8,22,800,408,83,491,Sunday
2021,8,22,700,233,49,282,Sunday
2021,8,22,600,140,36,176,Sunday
2021,8,22,500,62,31,93,Sunday
2021,8,22,400,32,25,57,Sunday
2021,8,22,300,27,46,73,Sunday
2021,8,22,200,36,57,93,Sunday
2021,8,22,100,34,70,104,Sunday
2021,8,21,2400,51,146,197,Saturday
2021,8,21,2300,76,287,363,Saturday
2021,8,21,2200,143,467,610,Saturday
2021,8,21,2100,171,713,884,Saturday
2021,8,21,2000,289,976,1265,Saturday
2021,8,21,1900,354,1325,1679,Saturday
2021,8,21,1800,420,1691,2111,Saturday
2021,8,21,1700,543,1528,2071,Saturday
2021,8,21,1600,742,1386,2128,Saturday
2021,8,21,1500,1170,1134,2304,Saturday
2021,8,21,1400,1248,949,2197,Saturday
2021,8,21,1300,982,821,1803,Saturday
2021,8,21,1200,1092,710,1802,Saturday
2021,8,21,1100,1464,446,1910,Saturday
2021,8,21,1000,1251,284,1535,Saturday
2021,8,21,900,963,188,1151,Saturday
2021,8,21,800,632,84,716,Saturday
2021,8,21,700,288,55,343,Saturday
2021,8,21,600,164,49,213,Saturday
2021,8,21,500,88,37,125,Saturday
2021,8,21,400,44,53,97,Saturday
2021,8,21,300,30,62,92,Saturday
2021,8,21,200,40,87,127,Saturday
2021,8,21,100,45,148,193,Saturday
2021,8,20,2400,81,217,298,Friday
2021,8,20,2300,133,174,307,Friday
2021,8,20,2200,218,365,583,Friday
2021,8,20,2100,382,662,1044,Friday
2021,8,20,2000,591,852,1443,Friday
2021,8,20,1900,797,1172,1969,Friday
2021,8,20,1800,796,1359,2155,Friday
2021,8,20,1700,860,1244,2104,Friday
2021,8,20,1600,976,1237,2213,Friday
2021,8,20,1500,993,985,1978,Friday
2021,8,20,1400,1090,954,2044,Friday
2021,8,20,1300,1121,889,2010,Friday
2021,8,20,1200,1328,683,2011,Friday
2021,8,20,1100,1274,513,1787,Friday
2021,8,20,1000,1049,307,1356,Friday
2021,8,20,900,821,281,1102,Friday
2021,8,20,800,523,87,610,Friday
2021,8,20,700,301,62,363,Friday
2021,8,20,600,163,57,220,Friday
2021,8,20,500,88,41,129,Friday
2021,8,20,400,34,41,75,Friday
2021,8,20,300,19,50,69,Friday
2021,8,20,200,42,46,88,Friday
2021,8,20,100,52,44,96,Friday
2021,8,19,2400,82,149,231,Thursday
2021,8,19,2300,99,222,321,Thursday
2021,8,19,2200,164,405,569,Thursday
2021,8,19,2100,268,602,870,Thursday
2021,8,19,2000,449,755,1204,Thursday
2021,8,19,1900,500,941,1441,Thursday
2021,8,19,1800,590,1157,1747,Thursday
2021,8,19,1700,599,1118,1717,Thursday
2021,8,19,1600,681,1058,1739,Thursday
2021,8,19,1500,804,929,1733,Thursday
2021,8,19,1400,864,867,1731,Thursday
2021,8,19,1300,1022,707,1729,Thursday
2021,8,19,1200,1170,558,1728,Thursday
2021,8,19,1100,1086,414,1500,Thursday
2021,8,19,1000,943,330,1273,Thursday
2021,8,19,900,666,282,948,Thursday
2021,8,19,800,477,62,539,Thursday
2021,8,19,700,276,45,321,Thursday
2021,8,19,600,133,41,174,Thursday
2021,8,19,500,67,41,108,Thursday
2021,8,19,400,36,47,83,Thursday
2021,8,19,300,31,33,64,Thursday
2021,8,19,200,39,64,103,Thursday
2021,8,19,100,58,38,96,Thursday
2021,8,18,2400,76,149,225,Wednesday
2021,8,18,2300,113,279,392,Wednesday
2021,8,18,2200,149,520,669,Wednesday
2021,8,18,2100,231,726,957,Wednesday
2021,8,18,2000,365,1061,1426,Wednesday
2021,8,18,1900,449,1157,1606,Wednesday
2021,8,18,1800,558,1369,1927,Wednesday
2021,8,18,1700,584,1270,1854,Wednesday
2021,8,18,1600,746,1096,1842,Wednesday
2021,8,18,1500,877,941,1818,Wednesday
2021,8,18,1400,946,838,1784,Wednesday
2021,8,18,1300,1091,696,1787,Wednesday
2021,8,18,1200,1264,530,1794,Wednesday
2021,8,18,1100,1176,429,1605,Wednesday
2021,8,18,1000,1111,357,1468,Wednesday
2021,8,18,900,857,300,1157,Wednesday
2021,8,18,800,582,94,676,Wednesday
2021,8,18,700,383,54,437,Wednesday
2021,8,18,600,245,41,286,Wednesday
2021,8,18,500,118,37,155,Wednesday
2021,8,18,400,41,38,79,Wednesday
2021,8,18,300,23,60,83,Wednesday
2021,8,18,200,36,64,100,Wednesday
2021,8,18,100,44,76,120,Wednesday
2021,8,17,2400,74,160,234,Tuesday
2021,8,17,2300,95,323,418,Tuesday
2021,8,17,2200,123,392,515,Tuesday
2021,8,17,2100,178,570,748,Tuesday
2021,8,17,2000,270,616,886,Tuesday
2021,8,17,1900,326,777,1103,Tuesday
2021,8,17,1800,386,950,1336,Tuesday
2021,8,17,1700,478,892,1370,Tuesday
2021,8,17,1600,572,858,1430,Tuesday
2021,8,17,1500,714,801,1515,Tuesday
2021,8,17,1400,743,791,1534,Tuesday
2021,8,17,1300,861,682,1543,Tuesday
2021,8,17,1200,990,531,1521,Tuesday
2021,8,17,1100,859,372,1231,Tuesday
2021,8,17,1000,659,269,928,Tuesday
2021,8,17,900,512,218,730,Tuesday
2021,8,17,800,331,74,405,Tuesday
2021,8,17,700,164,54,218,Tuesday
2021,8,17,600,86,29,115,Tuesday
2021,8,17,500,36,45,81,Tuesday
2021,8,17,400,29,51,80,Tuesday
2021,8,17,300,19,58,77,Tuesday
2021,8,17,200,36,57,93,Tuesday
2021,8,17,100,43,36,79,Tuesday
2021,8,16,2400,63,126,189,Monday
2021,8,16,2300,100,276,376,Monday
2021,8,16,2200,164,293,457,Monday
2021,8,16,2100,197,527,724,Monday
2021,8,16,2000,248,748,996,Monday
2021,8,16,1900,318,1083,1401,Monday
2021,8,16,1800,443,1168,1611,Monday
2021,8,16,1700,523,1112,1635,Monday
2021,8,16,1600,662,1259,1921,Monday
2021,8,16,1500,841,1056,1897,Monday
2021,8,16,1400,932,1041,1973,Monday
2021,8,16,1300,1027,792,1819,Monday
2021,8,16,1200,1181,693,1874,Monday
2021,8,16,1100,1150,476,1626,Monday
2021,8,16,1000,943,337,1280,Monday
2021,8,16,900,724,199,923,Monday
2021,8,16,800,518,90,608,Monday
2021,8,16,700,267,39,306,Monday
2021,8,16,600,148,26,174,Monday
2021,8,16,500,76,17,93,Monday
2021,8,16,400,25,39,64,Monday
2021,8,16,300,23,40,63,Monday
2021,8,16,200,24,61,85,Monday
2021,8,16,100,39,32,71,Monday
2021,8,15,2400,58,113,171,Sunday
2021,8,15,2300,84,317,401,Sunday
2021,8,15,2200,139,503,642,Sunday
2021,8,15,2100,232,979,1211,Sunday
2021,8,15,2000,321,1452,1773,Sunday
2021,8,15,1900,395,1576,1971,Sunday
2021,8,15,1800,471,1761,2232,Sunday
2021,8,15,1700,579,1759,2338,Sunday
2021,8,15,1600,842,1835,2677,Sunday
2021,8,15,1500,949,1677,2626,Sunday
2021,8,15,1400,1063,1629,2692,Sunday
2021,8,15,1300,1261,1385,2646,Sunday
2021,8,15,1200,1382,1069,2451,Sunday
2021,8,15,1100,1307,643,1950,Sunday
2021,8,15,1000,1106,324,1430,Sunday
2021,8,15,900,808,183,991,Sunday
2021,8,15,800,585,97,682,Sunday
2021,8,15,700,254,40,294,Sunday
2021,8,15,600,133,40,173,Sunday
2021,8,15,500,88,26,114,Sunday
2021,8,15,400,38,40,78,Sunday
2021,8,15,300,29,53,82,Sunday
2021,8,15,200,40,64,104,Sunday
2021,8,15,100,33,103,136,Sunday
2021,8,14,2400,68,180,248,Saturday
2021,8,14,2300,91,347,438,Saturday
2021,8,14,2200,173,562,735,Saturday
2021,8,14,2100,183,917,1100,Saturday
2021,8,14,2000,280,1203,1483,Saturday
2021,8,14,1900,353,1569,1922,Saturday
2021,8,14,1800,465,1718,2183,Saturday
2021,8,14,1700,605,1649,2254,Saturday
2021,8,14,1600,793,1510,2303,Saturday
2021,8,14,1500,1080,1295,2375,Saturday
2021,8,14,1400,1121,1108,2229,Saturday
2021,8,14,1300,1445,949,2394,Saturday
2021,8,14,1200,1608,722,2330,Saturday
2021,8,14,1100,1617,480,2097,Saturday
2021,8,14,1000,1360,342,1702,Saturday
2021,8,14,900,1255,259,1514,Saturday
2021,8,14,800,814,92,906,Saturday
2021,8,14,700,406,49,455,Saturday
2021,8,14,600,236,30,266,Saturday
2021,8,14,500,141,26,167,Saturday
2021,8,14,400,56,35,91,Saturday
2021,8,14,300,36,70,106,Saturday
2021,8,14,200,31,78,109,Saturday
2021,8,14,100,74,127,201,Saturday
2021,8,13,2400,117,200,317,Friday
2021,8,13,2300,222,368,590,Friday
2021,8,13,2200,601,504,1105,Friday
2021,8,13,2100,495,700,1195,Friday
2021,8,13,2000,439,955,1394,Friday
2021,8,13,1900,782,1182,1964,Friday
2021,8,13,1800,906,1336,2242,Friday
2021,8,13,1700,975,1405,2380,Friday
2021,8,13,1600,1055,1290,2345,Friday
2021,8,13,1500,1171,1160,2331,Friday
2021,8,13,1400,1202,958,2160,Friday
2021,8,13,1300,1479,865,2344,Friday
2021,8,13,1200,1203,711,1914,Friday
2021,8,13,1100,1394,491,1885,Friday
2021,8,13,1000,1164,349,1513,Friday
2021,8,13,900,895,315,1210,Friday
2021,8,13,800,663,94,757,Friday
2021,8,13,700,350,65,415,Friday
2021,8,13,600,228,45,273,Friday
2021,8,13,500,110,56,166,Friday
2021,8,13,400,45,38,83,Friday
2021,8,13,300,38,56,94,Friday
2021,8,13,200,53,70,123,Friday
2021,8,13,100,69,67,136,Friday
2021,8,12,2400,78,144,222,Thursday
2021,8,12,2300,176,334,510,Thursday
2021,8,12,2200,212,475,687,Thursday
2021,8,12,2100,321,707,1028,Thursday
2021,8,12,2000,466,864,1330,Thursday
2021,8,12,1900,590,1126,1716,Thursday
2021,8,12,1800,612,1244,1856,Thursday
2021,8,12,1700,667,1271,1938,Thursday
2021,8,12,1600,747,1137,1884,Thursday
2021,8,12,1500,889,977,1866,Thursday
2021,8,12,1400,996,839,1835,Thursday
2021,8,12,1300,1228,777,2005,Thursday
2021,8,12,1200,1300,599,1899,Thursday
2021,8,12,1100,1242,388,1630,Thursday
2021,8,12,1000,1064,346,1410,Thursday
2021,8,12,900,830,258,1088,Thursday
2021,8,12,800,609,96,705,Thursday
2021,8,12,700,308,59,367,Thursday
2021,8,12,600,190,35,225,Thursday
2021,8,12,500,106,48,154,Thursday
2021,8,12,400,37,43,80,Thursday
2021,8,12,300,30,49,79,Thursday
2021,8,12,200,38,82,120,Thursday
2021,8,12,100,52,42,94,Thursday
2021,8,11,2400,74,163,237,Wednesday
2021,8,11,2300,147,296,443,Wednesday
2021,8,11,2200,235,437,672,Wednesday
2021,8,11,2100,328,611,939,Wednesday
2021,8,11,2000,384,829,1213,Wednesday
2021,8,11,1900,597,1020,1617,Wednesday
2021,8,11,1800,679,1170,1849,Wednesday
2021,8,11,1700,614,1112,1726,Wednesday
2021,8,11,1600,617,1050,1667,Wednesday
2021,8,11,1500,505,833,1338,Wednesday
2021,8,11,1400,553,769,1322,Wednesday
2021,8,11,1300,632,669,1301,Wednesday
2021,8,11,1200,1216,563,1779,Wednesday
2021,8,11,1100,1192,403,1595,Wednesday
2021,8,11,1000,1061,316,1377,Wednesday
2021,8,11,900,831,276,1107,Wednesday
2021,8,11,800,536,101,637,Wednesday
2021,8,11,700,288,61,349,Wednesday
2021,8,11,600,167,61,228,Wednesday
2021,8,11,500,99,36,135,Wednesday
2021,8,11,400,37,50,87,Wednesday
2021,8,11,300,45,44,89,Wednesday
2021,8,11,200,42,45,87,Wednesday
2021,8,11,100,37,61,98,Wednesday
2021,8,10,2400,69,113,182,Tuesday
2021,8,10,2300,99,231,330,Tuesday
2021,8,10,2200,125,361,486,Tuesday
2021,8,10,2100,241,582,823,Tuesday
2021,8,10,2000,290,827,1117,Tuesday
2021,8,10,1900,376,967,1343,Tuesday
2021,8,10,1800,440,1075,1515,Tuesday
2021,8,10,1700,492,1108,1600,Tuesday
2021,8,10,1600,586,1055,1641,Tuesday
2021,8,10,1500,780,950,1730,Tuesday
2021,8,10,1400,822,765,1587,Tuesday
2021,8,10,1300,1021,716,1737,Tuesday
2021,8,10,1200,1124,525,1649,Tuesday
2021,8,10,1100,1081,481,1562,Tuesday
2021,8,10,1000,1025,261,1286,Tuesday
2021,8,10,900,787,192,979,Tuesday
2021,8,10,800,515,88,603,Tuesday
2021,8,10,700,257,63,320,Tuesday
2021,8,10,600,136,35,171,Tuesday
2021,8,10,500,71,35,106,Tuesday
2021,8,10,400,27,47,74,Tuesday
2021,8,10,300,25,40,65,Tuesday
2021,8,10,200,29,65,94,Tuesday
2021,8,10,100,52,58,110,Tuesday
2021,8,9,2400,53,122,175,Monday
2021,8,9,2300,112,285,397,Monday
2021,8,9,2200,145,373,518,Monday
2021,8,9,2100,191,706,897,Monday
2021,8,9,2000,294,910,1204,Monday
2021,8,9,1900,448,1129,1577,Monday
2021,8,9,1800,598,1271,1869,Monday
2021,8,9,1700,641,1268,1909,Monday
2021,8,9,1600,770,1078,1848,Monday
2021,8,9,1500,787,983,1770,Monday
2021,8,9,1400,955,821,1776,Monday
2021,8,9,1300,1452,782,2234,Monday
2021,8,9,1200,1106,526,1632,Monday
2021,8,9,1100,1156,391,1547,Monday
2021,8,9,1000,987,253,1240,Monday
2021,8,9,900,871,204,1075,Monday
2021,8,9,800,552,105,657,Monday
2021,8,9,700,314,60,374,Monday
2021,8,9,600,161,30,191,Monday
2021,8,9,500,89,34,123,Monday
2021,8,9,400,43,24,67,Monday
2021,8,9,300,30,52,82,Monday
2021,8,9,200,16,79,95,Monday
2021,8,9,100,40,45,85,Monday
2021,8,8,2400,51,158,209,Sunday
2021,8,8,2300,78,337,415,Sunday
2021,8,8,2200,138,446,584,Sunday
2021,8,8,2100,178,880,1058,Sunday
2021,8,8,2000,287,1247,1534,Sunday
2021,8,8,1900,404,1407,1811,Sunday
2021,8,8,1800,458,1588,2046,Sunday
2021,8,8,1700,608,1728,2336,Sunday
2021,8,8,1600,831,1704,2535,Sunday
2021,8,8,1500,991,1474,2465,Sunday
2021,8,8,1400,1111,1433,2544,Sunday
2021,8,8,1300,1231,1281,2512,Sunday
2021,8,8,1200,1292,968,2260,Sunday
2021,8,8,1100,1177,589,1766,Sunday
2021,8,8,1000,974,293,1267,Sunday
2021,8,8,900,699,166,865,Sunday
2021,8,8,800,474,83,557,Sunday
2021,8,8,700,220,29,249,Sunday
2021,8,8,600,108,35,143,Sunday
2021,8,8,500,50,27,77,Sunday
2021,8,8,400,36,26,62,Sunday
2021,8,8,300,41,37,78,Sunday
2021,8,8,200,23,78,101,Sunday
2021,8,8,100,41,105,146,Sunday
2021,8,7,2400,48,183,231,Saturday
2021,8,7,2300,88,315,403,Saturday
2021,8,7,2200,142,514,656,Saturday
2021,8,7,2100,188,880,1068,Saturday
2021,8,7,2000,284,1176,1460,Saturday
2021,8,7,1900,316,1474,1790,Saturday
2021,8,7,1800,489,1532,2021,Saturday
2021,8,7,1700,591,1742,2333,Saturday
2021,8,7,1600,776,1458,2234,Saturday
2021,8,7,1500,958,1322,2280,Saturday
2021,8,7,1400,1191,1192,2383,Saturday
2021,8,7,1300,1356,999,2355,Saturday
2021,8,7,1200,1541,764,2305,Saturday
2021,8,7,1100,1434,512,1946,Saturday
2021,8,7,1000,1363,335,1698,Saturday
2021,8,7,900,1018,223,1241,Saturday
2021,8,7,800,764,125,889,Saturday
2021,8,7,700,383,45,428,Saturday
2021,8,7,600,205,63,268,Saturday
2021,8,7,500,103,36,139,Saturday
2021,8,7,400,53,62,115,Saturday
2021,8,7,300,31,62,93,Saturday
2021,8,7,200,39,79,118,Saturday
2021,8,7,100,68,105,173,Saturday
2021,8,6,2400,76,213,289,Friday
2021,8,6,2300,140,371,511,Friday
2021,8,6,2200,232,326,558,Friday
2021,8,6,2100,356,530,886,Friday
2021,8,6,2000,615,877,1492,Friday
2021,8,6,1900,807,1142,1949,Friday
2021,8,6,1800,810,1345,2155,Friday
2021,8,6,1700,909,1391,2300,Friday
2021,8,6,1600,997,1406,2403,Friday
2021,8,6,1500,1137,1264,2401,Friday
2021,8,6,1400,1162,1089,2251,Friday
2021,8,6,1300,1167,943,2110,Friday
2021,8,6,1200,1415,773,2188,Friday
2021,8,6,1100,1339,539,1878,Friday
2021,8,6,1000,1195,340,1535,Friday
2021,8,6,900,907,297,1204,Friday
2021,8,6,800,624,108,732,Friday
2021,8,6,700,314,46,360,Friday
2021,8,6,600,180,48,228,Friday
2021,8,6,500,93,50,143,Friday
2021,8,6,400,35,41,76,Friday
2021,8,6,300,34,55,89,Friday
2021,8,6,200,36,73,109,Friday
2021,8,6,100,48,37,85,Friday
2021,8,5,2400,83,137,220,Thursday
2021,8,5,2300,116,388,504,Thursday
2021,8,5,2200,158,452,610,Thursday
2021,8,5,2100,264,659,923,Thursday
2021,8,5,2000,431,861,1292,Thursday
2021,8,5,1900,528,1101,1629,Thursday
2021,8,5,1800,511,1140,1651,Thursday
2021,8,5,1700,644,1252,1896,Thursday
2021,8,5,1600,739,1054,1793,Thursday
2021,8,5,1500,835,941,1776,Thursday
2021,8,5,1400,899,837,1736,Thursday
2021,8,5,1300,1061,754,1815,Thursday
2021,8,5,1200,1136,899,2035,Thursday
2021,8,5,1100,1213,318,1531,Thursday
2021,8,5,1000,1073,309,1382,Thursday
2021,8,5,900,860,256,1116,Thursday
2021,8,5,800,537,107,644,Thursday
2021,8,5,700,301,66,367,Thursday
2021,8,5,600,177,46,223,Thursday
2021,8,5,500,113,33,146,Thursday
2021,8,5,400,34,55,89,Thursday
2021,8,5,300,40,47,87,Thursday
2021,8,5,200,36,53,89,Thursday
2021,8,5,100,51,56,107,Thursday
2021,8,4,2400,72,145,217,Wednesday
2021,8,4,2300,115,287,402,Wednesday
2021,8,4,2200,147,346,493,Wednesday
2021,8,4,2100,223,498,721,Wednesday
2021,8,4,2000,286,895,1181,Wednesday
2021,8,4,1900,355,1142,1497,Wednesday
2021,8,4,1800,472,1263,1735,Wednesday
2021,8,4,1700,606,1150,1756,Wednesday
2021,8,4,1600,665,1160,1825,Wednesday
2021,8,4,1500,747,994,1741,Wednesday
2021,8,4,1400,818,876,1694,Wednesday
2021,8,4,1300,1112,734,1846,Wednesday
2021,8,4,1200,1142,609,1751,Wednesday
2021,8,4,1100,1147,411,1558,Wednesday
2021,8,4,1000,1006,310,1316,Wednesday
2021,8,4,900,814,314,1128,Wednesday
2021,8,4,800,532,85,617,Wednesday
2021,8,4,700,326,61,387,Wednesday
2021,8,4,600,158,47,205,Wednesday
2021,8,4,500,111,47,158,Wednesday
2021,8,4,400,29,49,78,Wednesday
2021,8,4,300,31,60,91,Wednesday
2021,8,4,200,35,77,112,Wednesday
2021,8,4,100,48,52,100,Wednesday
2021,8,3,2400,83,135,218,Tuesday
2021,8,3,2300,121,357,478,Tuesday
2021,8,3,2200,130,454,584,Tuesday
2021,8,3,2100,246,701,947,Tuesday
2021,8,3,2000,295,1009,1304,Tuesday
2021,8,3,1900,359,1249,1608,Tuesday
2021,8,3,1800,508,1343,1851,Tuesday
2021,8,3,1700,579,1309,1888,Tuesday
2021,8,3,1600,710,1233,1943,Tuesday
2021,8,3,1500,836,1084,1920,Tuesday
2021,8,3,1400,951,898,1849,Tuesday
2021,8,3,1300,1141,863,2004,Tuesday
2021,8,3,1200,1178,692,1870,Tuesday
2021,8,3,1100,1327,462,1789,Tuesday
2021,8,3,1000,1137,283,1420,Tuesday
2021,8,3,900,837,194,1031,Tuesday
2021,8,3,800,604,131,735,Tuesday
2021,8,3,700,350,73,423,Tuesday
2021,8,3,600,175,33,208,Tuesday
2021,8,3,500,117,40,157,Tuesday
2021,8,3,400,29,27,56,Tuesday
2021,8,3,300,19,36,55,Tuesday
2021,8,3,200,44,77,121,Tuesday
2021,8,3,100,41,112,153,Tuesday
2021,8,2,2400,55,200,255,Monday
2021,8,2,2300,75,434,509,Monday
2021,8,2,2200,122,631,753,Monday
2021,8,2,2100,169,1121,1290,Monday
2021,8,2,2000,302,1254,1556,Monday
2021,8,2,1900,360,1622,1982,Monday
2021,8,2,1800,499,1764,2263,Monday
2021,8,2,1700,659,1966,2625,Monday
2021,8,2,1600,852,1922,2774,Monday
2021,8,2,1500,1039,2117,3156,Monday
2021,8,2,1400,1320,1906,3226,Monday
2021,8,2,1300,1398,1599,2997,Monday
2021,8,2,1200,1514,1221,2735,Monday
2021,8,2,1100,1356,729,2085,Monday
2021,8,2,1000,1172,340,1512,Monday
2021,8,2,900,854,188,1042,Monday
2021,8,2,800,553,100,653,Monday
2021,8,2,700,296,44,340,Monday
2021,8,2,600,148,42,190,Monday
2021,8,2,500,79,27,106,Monday
2021,8,2,400,39,19,58,Monday
2021,8,2,300,40,42,82,Monday
2021,8,2,200,34,74,108,Monday
2021,8,2,100,43,110,153,Monday
2021,8,1,2400,70,233,303,Sunday
2021,8,1,2300,104,412,516,Sunday
2021,8,1,2200,132,778,910,Sunday
2021,8,1,2100,232,1166,1398,Sunday
2021,8,1,2000,287,1513,1800,Sunday
2021,8,1,1900,412,1860,2272,Sunday
2021,8,1,1800,483,2024,2507,Sunday
2021,8,1,1700,697,2075,2772,Sunday
2021,8,1,1600,846,1724,2570,Sunday
2021,8,1,1500,1145,1229,2374,Sunday
2021,8,1,1400,1337,1057,2394,Sunday
2021,8,1,1300,1434,946,2380,Sunday
2021,8,1,1200,1698,801,2499,Sunday
2021,8,1,1100,1556,497,2053,Sunday
2021,8,1,1000,1423,296,1719,Sunday
2021,8,1,900,1093,173,1266,Sunday
2021,8,1,800,765,111,876,Sunday
2021,8,1,700,382,39,421,Sunday
2021,8,1,600,191,39,230,Sunday
2021,8,1,500,123,22,145,Sunday
2021,8,1,400,38,30,68,Sunday
2021,8,1,300,34,35,69,Sunday
2021,8,1,200,41,84,125,Sunday
2021,8,1,100,56,123,179,Sunday
2021,7,31,2400,86,197,283,Saturday
2021,7,31,2300,122,413,535,Saturday
2021,7,31,2200,150,641,791,Saturday
2021,7,31,2100,220,941,1161,Saturday
2021,7,31,2000,348,1431,1779,Saturday
2021,7,31,1900,481,1301,1782,Saturday
2021,7,31,1800,560,1580,2140,Saturday
2021,7,31,1700,726,1561,2287,Saturday
2021,7,31,1600,905,1519,2424,Saturday
2021,7,31,1500,1231,1192,2423,Saturday
2021,7,31,1400,1593,1035,2628,Saturday
2021,7,31,1300,1739,938,2677,Saturday
2021,7,31,1200,1876,739,2615,Saturday
2021,7,31,1100,1939,435,2374,Saturday
2021,7,31,1000,1700,299,1999,Saturday
2021,7,31,900,1513,210,1723,Saturday
2021,7,31,800,1034,129,1163,Saturday
2021,7,31,700,545,72,617,Saturday
2021,7,31,600,289,53,342,Saturday
2021,7,31,500,160,55,215,Saturday
2021,7,31,400,75,40,115,Saturday
2021,7,31,300,60,66,126,Saturday
2021,7,31,200,59,95,154,Saturday
2021,7,31,100,91,141,232,Saturday
2021,7,30,2400,118,221,339,Friday
2021,7,30,2300,229,320,549,Friday
2021,7,30,2200,402,503,905,Friday
2021,7,30,2100,609,732,1341,Friday
2021,7,30,2000,967,920,1887,Friday
2021,7,30,1900,1131,1136,2267,Friday
2021,7,30,1800,1273,1292,2565,Friday
2021,7,30,1700,1184,1362,2546,Friday
2021,7,30,1600,1361,1252,2613,Friday
2021,7,30,1500,1420,1126,2546,Friday
2021,7,30,1400,1449,919,2368,Friday
2021,7,30,1300,1473,839,2312,Friday
2021,7,30,1200,1605,787,2392,Friday
2021,7,30,1100,1501,509,2010,Friday
2021,7,30,1000,1414,368,1782,Friday
2021,7,30,900,1093,327,1420,Friday
2021,7,30,800,837,95,932,Friday
2021,7,30,700,486,62,548,Friday
2021,7,30,600,218,45,263,Friday
2021,7,30,500,99,39,138,Friday
2021,7,30,400,55,39,94,Friday
2021,7,30,300,52,63,115,Friday
2021,7,30,200,48,62,110,Friday
2021,7,30,100,73,62,135,Friday
2021,7,29,2400,107,139,246,Thursday
2021,7,29,2300,160,287,447,Thursday
2021,7,29,2200,259,464,723,Thursday
2021,7,29,2100,440,611,1051,Thursday
2021,7,29,2000,674,817,1491,Thursday
2021,7,29,1900,740,1178,1918,Thursday
2021,7,29,1800,984,950,1934,Thursday
2021,7,29,1700,1115,1225,2340,Thursday
2021,7,29,1600,962,1130,2092,Thursday
2021,7,29,1500,996,972,1968,Thursday
2021,7,29,1400,869,834,1703,Thursday
2021,7,29,1300,960,767,1727,Thursday
2021,7,29,1200,1210,639,1849,Thursday
2021,7,29,1100,1077,416,1493,Thursday
2021,7,29,1000,1164,319,1483,Thursday
2021,7,29,900,927,262,1189,Thursday
2021,7,29,800,644,105,749,Thursday
2021,7,29,700,376,43,419,Thursday
2021,7,29,600,172,45,217,Thursday
2021,7,29,500,94,39,133,Thursday
2021,7,29,400,46,40,86,Thursday
2021,7,29,300,31,19,50,Thursday
2021,7,29,200,37,65,102,Thursday
2021,7,29,100,53,52,105,Thursday
2021,7,28,2400,97,172,269,Wednesday
2021,7,28,2300,132,290,422,Wednesday
2021,7,28,2200,166,299,465,Wednesday
2021,7,28,2100,251,572,823,Wednesday
2021,7,28,2000,360,741,1101,Wednesday
2021,7,28,1900,515,959,1474,Wednesday
2021,7,28,1800,613,1071,1684,Wednesday
2021,7,28,1700,642,1109,1751,Wednesday
2021,7,28,1600,790,1078,1868,Wednesday
2021,7,28,1500,823,925,1748,Wednesday
2021,7,28,1400,891,757,1648,Wednesday
2021,7,28,1300,925,734,1659,Wednesday
2021,7,28,1200,1010,572,1582,Wednesday
2021,7,28,1100,1028,435,1463,Wednesday
2021,7,28,1000,1003,288,1291,Wednesday
2021,7,28,900,791,290,1081,Wednesday
2021,7,28,800,537,91,628,Wednesday
2021,7,28,700,293,49,342,Wednesday
2021,7,28,600,150,46,196,Wednesday
2021,7,28,500,67,34,101,Wednesday
2021,7,28,400,36,43,79,Wednesday
2021,7,28,300,30,43,73,Wednesday
2021,7,28,200,31,48,79,Wednesday
2021,7,28,100,40,46,86,Wednesday
2021,7,27,2400,83,180,263,Tuesday
2021,7,27,2300,129,308,437,Tuesday
2021,7,27,2200,145,313,458,Tuesday
2021,7,27,2100,212,482,694,Tuesday
2021,7,27,2000,315,757,1072,Tuesday
2021,7,27,1900,380,942,1322,Tuesday
2021,7,27,1800,430,1065,1495,Tuesday
2021,7,27,1700,564,1095,1659,Tuesday
2021,7,27,1600,627,1045,1672,Tuesday
2021,7,27,1500,678,912,1590,Tuesday
2021,7,27,1400,759,780,1539,Tuesday
2021,7,27,1300,918,725,1643,Tuesday
2021,7,27,1200,1076,573,1649,Tuesday
2021,7,27,1100,1073,398,1471,Tuesday
2021,7,27,1000,972,311,1283,Tuesday
2021,7,27,900,783,300,1083,Tuesday
2021,7,27,800,508,104,612,Tuesday
2021,7,27,700,277,64,341,Tuesday
2021,7,27,600,140,44,184,Tuesday
2021,7,27,500,104,41,145,Tuesday
2021,7,27,400,37,44,81,Tuesday
2021,7,27,300,23,20,43,Tuesday
2021,7,27,200,25,58,83,Tuesday
2021,7,27,100,43,54,97,Tuesday
2021,7,26,2400,80,97,177,Monday
2021,7,26,2300,112,307,419,Monday
2021,7,26,2200,143,425,568,Monday
2021,7,26,2100,216,641,857,Monday
2021,7,26,2000,297,802,1099,Monday
2021,7,26,1900,410,1136,1546,Monday
2021,7,26,1800,477,1215,1692,Monday
2021,7,26,1700,540,1316,1856,Monday
2021,7,26,1600,730,1119,1849,Monday
2021,7,26,1500,913,955,1868,Monday
2021,7,26,1400,946,847,1793,Monday
2021,7,26,1300,1058,755,1813,Monday
2021,7,26,1200,1258,633,1891,Monday
2021,7,26,1100,1171,437,1608,Monday
2021,7,26,1000,1068,294,1362,Monday
2021,7,26,900,822,198,1020,Monday
2021,7,26,800,585,115,700,Monday
2021,7,26,700,311,50,361,Monday
2021,7,26,600,150,30,180,Monday
2021,7,26,500,100,26,126,Monday
2021,7,26,400,40,29,69,Monday
2021,7,26,300,28,37,65,Monday
2021,7,26,200,25,62,87,Monday
2021,7,26,100,46,57,103,Monday
2021,7,25,2400,69,137,206,Sunday
2021,7,25,2300,107,367,474,Sunday
2021,7,25,2200,136,511,647,Sunday
2021,7,25,2100,221,1025,1246,Sunday
2021,7,25,2000,310,1257,1567,Sunday
2021,7,25,1900,371,1590,1961,Sunday
2021,7,25,1800,507,1773,2280,Sunday
2021,7,25,1700,650,1783,2433,Sunday
2021,7,25,1600,908,1738,2646,Sunday
2021,7,25,1500,1026,1529,2555,Sunday
2021,7,25,1400,1238,1388,2626,Sunday
2021,7,25,1300,1286,1114,2400,Sunday
2021,7,25,1200,1373,876,2249,Sunday
2021,7,25,1100,1287,475,1762,Sunday
2021,7,25,1000,1161,302,1463,Sunday
2021,7,25,900,863,177,1040,Sunday
2021,7,25,800,594,101,695,Sunday
2021,7,25,700,266,38,304,Sunday
2021,7,25,600,136,25,161,Sunday
2021,7,25,500,81,25,106,Sunday
2021,7,25,400,42,21,63,Sunday
2021,7,25,300,26,45,71,Sunday
2021,7,25,200,29,73,102,Sunday
2021,7,25,100,40,94,134,Sunday
2021,7,24,2400,61,176,237,Saturday
2021,7,24,2300,87,351,438,Saturday
2021,7,24,2200,155,489,644,Saturday
2021,7,24,2100,223,789,1012,Saturday
2021,7,24,2000,280,1067,1347,Saturday
2021,7,24,1900,387,1367,1754,Saturday
2021,7,24,1800,510,1401,1911,Saturday
2021,7,24,1700,604,1388,1992,Saturday
2021,7,24,1600,857,1311,2168,Saturday
2021,7,24,1500,974,1106,2080,Saturday
2021,7,24,1400,1196,902,2098,Saturday
2021,7,24,1300,1364,810,2174,Saturday
2021,7,24,1200,1631,708,2339,Saturday
2021,7,24,1100,1563,439,2002,Saturday
2021,7,24,1000,1436,271,1707,Saturday
2021,7,24,900,1176,245,1421,Saturday
2021,7,24,800,735,101,836,Saturday
2021,7,24,700,422,67,489,Saturday
2021,7,24,600,181,50,231,Saturday
2021,7,24,500,112,64,176,Saturday
2021,7,24,400,53,45,98,Saturday
2021,7,24,300,31,72,103,Saturday
2021,7,24,200,44,69,113,Saturday
2021,7,24,100,61,107,168,Saturday
2021,7,23,2400,122,163,285,Friday
2021,7,23,2300,181,338,519,Friday
2021,7,23,2200,265,383,648,Friday
2021,7,23,2100,506,628,1134,Friday
2021,7,23,2000,728,770,1498,Friday
2021,7,23,1900,922,1098,2020,Friday
2021,7,23,1800,980,1194,2174,Friday
2021,7,23,1700,993,1118,2111,Friday
2021,7,23,1600,1049,1198,2247,Friday
2021,7,23,1500,1221,1079,2300,Friday
2021,7,23,1400,1205,982,2187,Friday
2021,7,23,1300,1186,925,2111,Friday
2021,7,23,1200,1391,716,2107,Friday
2021,7,23,1100,1218,464,1682,Friday
2021,7,23,1000,1119,325,1444,Friday
2021,7,23,900,866,297,1163,Friday
2021,7,23,800,682,105,787,Friday
2021,7,23,700,303,70,373,Friday
2021,7,23,600,155,47,202,Friday
2021,7,23,500,103,37,140,Friday
2021,7,23,400,34,32,66,Friday
2021,7,23,300,46,79,125,Friday
2021,7,23,200,37,124,161,Friday
2021,7,23,100,57,180,237,Friday
2021,7,22,2400,81,365,446,Thursday
2021,7,22,2300,152,490,642,Thursday
2021,7,22,2200,214,266,480,Thursday
2021,7,22,2100,326,272,598,Thursday
2021,7,22,2000,526,498,1024,Thursday
2021,7,22,1900,589,798,1387,Thursday
2021,7,22,1800,673,1074,1747,Thursday
2021,7,22,1700,686,1109,1795,Thursday
2021,7,22,1600,725,1067,1792,Thursday
2021,7,22,1500,893,934,1827,Thursday
2021,7,22,1400,927,795,1722,Thursday
2021,7,22,1300,1112,772,1884,Thursday
2021,7,22,1200,1193,636,1829,Thursday
2021,7,22,1100,1192,428,1620,Thursday
2021,7,22,1000,1072,272,1344,Thursday
2021,7,22,900,817,267,1084,Thursday
2021,7,22,800,535,109,644,Thursday
2021,7,22,700,305,45,350,Thursday
2021,7,22,600,172,41,213,Thursday
2021,7,22,500,94,37,131,Thursday
2021,7,22,400,41,35,76,Thursday
2021,7,22,300,39,45,84,Thursday
2021,7,22,200,52,60,112,Thursday
2021,7,22,100,43,53,96,Thursday
2021,7,21,2400,90,180,270,Wednesday
2021,7,21,2300,108,194,302,Wednesday
2021,7,21,2200,171,313,484,Wednesday
2021,7,21,2100,296,488,784,Wednesday
2021,7,21,2000,346,877,1223,Wednesday
2021,7,21,1900,421,999,1420,Wednesday
2021,7,21,1800,444,1038,1482,Wednesday
2021,7,21,1700,580,1051,1631,Wednesday
2021,7,21,1600,676,962,1638,Wednesday
2021,7,21,1500,757,875,1632,Wednesday
2021,7,21,1400,801,684,1485,Wednesday
2021,7,21,1300,897,688,1585,Wednesday
2021,7,21,1200,1042,569,1611,Wednesday
2021,7,21,1100,1056,381,1437,Wednesday
2021,7,21,1000,929,287,1216,Wednesday
2021,7,21,900,769,281,1050,Wednesday
2021,7,21,800,490,96,586,Wednesday
2021,7,21,700,274,71,345,Wednesday
2021,7,21,600,131,37,168,Wednesday
2021,7,21,500,90,65,155,Wednesday
2021,7,21,400,31,66,97,Wednesday
2021,7,21,300,30,25,55,Wednesday
2021,7,21,200,34,49,83,Wednesday
2021,7,21,100,51,50,101,Wednesday
2021,7,20,2400,77,145,222,Tuesday
2021,7,20,2300,143,274,417,Tuesday
2021,7,20,2200,142,286,428,Tuesday
2021,7,20,2100,212,527,739,Tuesday
2021,7,20,2000,311,760,1071,Tuesday
2021,7,20,1900,355,996,1351,Tuesday
2021,7,20,1800,468,1025,1493,Tuesday
2021,7,20,1700,494,940,1434,Tuesday
2021,7,20,1600,650,967,1617,Tuesday
2021,7,20,1500,721,781,1502,Tuesday
2021,7,20,1400,745,739,1484,Tuesday
2021,7,20,1300,933,701,1634,Tuesday
2021,7,20,1200,1078,520,1598,Tuesday
2021,7,20,1100,1068,377,1445,Tuesday
2021,7,20,1000,877,297,1174,Tuesday
2021,7,20,900,640,284,924,Tuesday
2021,7,20,800,463,67,530,Tuesday
2021,7,20,700,271,60,331,Tuesday
2021,7,20,600,152,32,184,Tuesday
2021,7,20,500,76,36,112,Tuesday
2021,7,20,400,34,38,72,Tuesday
2021,7,20,300,30,66,96,Tuesday
2021,7,20,200,39,59,98,Tuesday
2021,7,20,100,39,55,94,Tuesday
2021,7,19,2400,83,163,246,Monday
2021,7,19,2300,128,257,385,Monday
2021,7,19,2200,147,385,532,Monday
2021,7,19,2100,248,678,926,Monday
2021,7,19,2000,301,688,989,Monday
2021,7,19,1900,344,1027,1371,Monday
2021,7,19,1800,500,1152,1652,Monday
2021,7,19,1700,616,1130,1746,Monday
2021,7,19,1600,729,1102,1831,Monday
2021,7,19,1500,906,848,1754,Monday
2021,7,19,1400,1064,799,1863,Monday
2021,7,19,1300,1094,705,1799,Monday
2021,7,19,1200,1244,527,1771,Monday
2021,7,19,1100,1213,400,1613,Monday
2021,7,19,1000,1030,248,1278,Monday
2021,7,19,900,846,258,1104,Monday
2021,7,19,800,511,119,630,Monday
2021,7,19,700,329,57,386,Monday
2021,7,19,600,140,31,171,Monday
2021,7,19,500,79,24,103,Monday
2021,7,19,400,37,29,66,Monday
2021,7,19,300,42,47,89,Monday
2021,7,19,200,28,77,105,Monday
2021,7,19,100,51,62,113,Monday
2021,7,18,2400,46,146,192,Sunday
2021,7,18,2300,74,420,494,Sunday
2021,7,18,2200,147,493,640,Sunday
2021,7,18,2100,203,895,1098,Sunday
2021,7,18,2000,313,1251,1564,Sunday
2021,7,18,1900,430,1413,1843,Sunday
2021,7,18,1800,528,1655,2183,Sunday
2021,7,18,1700,720,1711,2431,Sunday
2021,7,18,1600,1235,1671,2906,Sunday
2021,7,18,1500,1430,1452,2882,Sunday
2021,7,18,1400,952,1401,2353,Sunday
2021,7,18,1300,822,1166,1988,Sunday
2021,7,18,1200,1162,935,2097,Sunday
2021,7,18,1100,1246,565,1811,Sunday
2021,7,18,1000,1126,318,1444,Sunday
2021,7,18,900,793,190,983,Sunday
2021,7,18,800,529,93,622,Sunday
2021,7,18,700,294,40,334,Sunday
2021,7,18,600,130,22,152,Sunday
2021,7,18,500,86,27,113,Sunday
2021,7,18,400,45,32,77,Sunday
2021,7,18,300,35,49,84,Sunday
2021,7,18,200,39,68,107,Sunday
2021,7,18,100,28,123,151,Sunday
2021,7,17,2400,57,211,268,Saturday
2021,7,17,2300,102,334,436,Saturday
2021,7,17,2200,159,578,737,Saturday
2021,7,17,2100,176,762,938,Saturday
2021,7,17,2000,298,901,1199,Saturday
2021,7,17,1900,372,1188,1560,Saturday
2021,7,17,1800,500,1313,1813,Saturday
2021,7,17,1700,620,1321,1941,Saturday
2021,7,17,1600,813,1248,2061,Saturday
2021,7,17,1500,997,1097,2094,Saturday
2021,7,17,1400,1126,908,2034,Saturday
2021,7,17,1300,1261,816,2077,Saturday
2021,7,17,1200,1513,652,2165,Saturday
2021,7,17,1100,1504,458,1962,Saturday
2021,7,17,1000,1356,302,1658,Saturday
2021,7,17,900,1106,212,1318,Saturday
2021,7,17,800,777,108,885,Saturday
2021,7,17,700,403,65,468,Saturday
2021,7,17,600,197,61,258,Saturday
2021,7,17,500,121,64,185,Saturday
2021,7,17,400,62,61,123,Saturday
2021,7,17,300,29,53,82,Saturday
2021,7,17,200,53,97,150,Saturday
2021,7,17,100,67,189,256,Saturday
2021,7,16,2400,99,102,201,Friday
2021,7,16,2300,139,331,470,Friday
2021,7,16,2200,247,348,595,Friday
2021,7,16,2100,496,586,1082,Friday
2021,7,16,2000,722,828,1550,Friday
2021,7,16,1900,898,1025,1923,Friday
2021,7,16,1800,893,1077,1970,Friday
2021,7,16,1700,1017,1126,2143,Friday
2021,7,16,1600,1064,1174,2238,Friday
2021,7,16,1500,1132,972,2104,Friday
2021,7,16,1400,1159,946,2105,Friday
2021,7,16,1300,1187,813,2000,Friday
2021,7,16,1200,1353,655,2008,Friday
2021,7,16,1100,1347,498,1845,Friday
2021,7,16,1000,1078,352,1430,Friday
2021,7,16,900,902,280,1182,Friday
2021,7,16,800,625,92,717,Friday
2021,7,16,700,362,68,430,Friday
2021,7,16,600,165,58,223,Friday
2021,7,16,500,76,52,128,Friday
2021,7,16,400,35,41,76,Friday
2021,7,16,300,37,62,99,Friday
2021,7,16,200,45,104,149,Friday
2021,7,16,100,47,75,122,Friday
2021,7,15,2400,95,157,252,Thursday
2021,7,15,2300,165,369,534,Thursday
2021,7,15,2200,203,265,468,Thursday
2021,7,15,2100,310,576,886,Thursday
2021,7,15,2000,478,727,1205,Thursday
2021,7,15,1900,600,963,1563,Thursday
2021,7,15,1800,661,963,1624,Thursday
2021,7,15,1700,738,1116,1854,Thursday
2021,7,15,1600,775,974,1749,Thursday
2021,7,15,1500,879,896,1775,Thursday
2021,7,15,1400,1070,735,1805,Thursday
2021,7,15,1300,979,725,1704,Thursday
2021,7,15,1200,1043,555,1598,Thursday
2021,7,15,1100,1052,424,1476,Thursday
2021,7,15,1000,999,320,1319,Thursday
2021,7,15,900,825,241,1066,Thursday
2021,7,15,800,514,97,611,Thursday
2021,7,15,700,282,75,357,Thursday
2021,7,15,600,166,44,210,Thursday
2021,7,15,500,79,46,125,Thursday
2021,7,15,400,45,50,95,Thursday
2021,7,15,300,33,54,87,Thursday
2021,7,15,200,32,51,83,Thursday
2021,7,15,100,42,49,91,Thursday
2021,7,14,2400,93,154,247,Wednesday
2021,7,14,2300,108,257,365,Wednesday
2021,7,14,2200,185,304,489,Wednesday
2021,7,14,2100,237,456,693,Wednesday
2021,7,14,2000,348,682,1030,Wednesday
2021,7,14,1900,415,851,1266,Wednesday
2021,7,14,1800,465,949,1414,Wednesday
2021,7,14,1700,529,1024,1553,Wednesday
2021,7,14,1600,620,840,1460,Wednesday
2021,7,14,1500,685,766,1451,Wednesday
2021,7,14,1400,724,688,1412,Wednesday
2021,7,14,1300,969,551,1520,Wednesday
2021,7,14,1200,1025,521,1546,Wednesday
2021,7,14,1100,1026,378,1404,Wednesday
2021,7,14,1000,940,291,1231,Wednesday
2021,7,14,900,728,278,1006,Wednesday
2021,7,14,800,454,87,541,Wednesday
2021,7,14,700,261,64,325,Wednesday
2021,7,14,600,107,59,166,Wednesday
2021,7,14,500,82,35,117,Wednesday
2021,7,14,400,35,45,80,Wednesday
2021,7,14,300,34,52,86,Wednesday
2021,7,14,200,39,49,88,Wednesday
2021,7,14,100,41,40,81,Wednesday
2021,7,13,2400,88,177,265,Tuesday
2021,7,13,2300,97,253,350,Tuesday
2021,7,13,2200,120,315,435,Tuesday
2021,7,13,2100,232,562,794,Tuesday
2021,7,13,2000,276,669,945,Tuesday
2021,7,13,1900,309,822,1131,Tuesday
2021,7,13,1800,329,948,1277,Tuesday
2021,7,13,1700,518,985,1503,Tuesday
2021,7,13,1600,535,932,1467,Tuesday
2021,7,13,1500,689,816,1505,Tuesday
2021,7,13,1400,758,706,1464,Tuesday
2021,7,13,1300,865,621,1486,Tuesday
2021,7,13,1200,980,523,1503,Tuesday
2021,7,13,1100,1047,334,1381,Tuesday
2021,7,13,1000,823,279,1102,Tuesday
2021,7,13,900,639,266,905,Tuesday
2021,7,13,800,451,93,544,Tuesday
2021,7,13,700,267,69,336,Tuesday
2021,7,13,600,125,46,171,Tuesday
2021,7,13,500,85,39,124,Tuesday
2021,7,13,400,27,61,88,Tuesday
2021,7,13,300,28,52,80,Tuesday
2021,7,13,200,30,85,115,Tuesday
2021,7,13,100,49,50,99,Tuesday
2021,7,12,2400,75,147,222,Monday
2021,7,12,2300,91,298,389,Monday
2021,7,12,2200,127,337,464,Monday
2021,7,12,2100,219,600,819,Monday
2021,7,12,2000,273,795,1068,Monday
2021,7,12,1900,312,973,1285,Monday
2021,7,12,1800,412,1061,1473,Monday
2021,7,12,1700,537,1187,1724,Monday
2021,7,12,1600,690,922,1612,Monday
2021,7,12,1500,773,787,1560,Monday
2021,7,12,1400,877,725,1602,Monday
2021,7,12,1300,1001,630,1631,Monday
2021,7,12,1200,1129,518,1647,Monday
2021,7,12,1100,1079,379,1458,Monday
2021,7,12,1000,957,276,1233,Monday
2021,7,12,900,694,257,951,Monday
2021,7,12,800,485,113,598,Monday
2021,7,12,700,311,17,328,Monday
2021,7,12,600,123,10,133,Monday
2021,7,12,500,80,33,113,Monday
2021,7,12,400,48,29,77,Monday
2021,7,12,300,36,43,79,Monday
2021,7,12,200,35,65,100,Monday
2021,7,12,100,42,63,105,Monday
2021,7,11,2400,43,119,162,Sunday
2021,7,11,2300,82,364,446,Sunday
2021,7,11,2200,136,497,633,Sunday
2021,7,11,2100,210,881,1091,Sunday
2021,7,11,2000,313,1172,1485,Sunday
2021,7,11,1900,388,1453,1841,Sunday
2021,7,11,1800,499,1471,1970,Sunday
2021,7,11,1700,646,1720,2366,Sunday
2021,7,11,1600,753,1479,2232,Sunday
2021,7,11,1500,944,1368,2312,Sunday
2021,7,11,1400,971,1148,2119,Sunday
2021,7,11,1300,1087,1083,2170,Sunday
2021,7,11,1200,1177,903,2080,Sunday
2021,7,11,1100,1115,528,1643,Sunday
2021,7,11,1000,1024,292,1316,Sunday
2021,7,11,900,733,190,923,Sunday
2021,7,11,800,512,120,632,Sunday
2021,7,11,700,265,35,300,Sunday
2021,7,11,600,80,23,103,Sunday
2021,7,11,500,55,36,91,Sunday
2021,7,11,400,43,28,71,Sunday
2021,7,11,300,47,32,79,Sunday
2021,7,11,200,30,57,87,Sunday
2021,7,11,100,37,105,142,Sunday
2021,7,10,2400,65,203,268,Saturday
2021,7,10,2300,87,316,403,Saturday
2021,7,10,2200,144,539,683,Saturday
2021,7,10,2100,197,694,891,Saturday
2021,7,10,2000,265,941,1206,Saturday
2021,7,10,1900,309,1113,1422,Saturday
2021,7,10,1800,466,1284,1750,Saturday
2021,7,10,1700,538,1275,1813,Saturday
2021,7,10,1600,778,1197,1975,Saturday
2021,7,10,1500,921,1036,1957,Saturday
2021,7,10,1400,1098,919,2017,Saturday
2021,7,10,1300,1200,770,1970,Saturday
2021,7,10,1200,1291,636,1927,Saturday
2021,7,10,1100,1291,420,1711,Saturday
2021,7,10,1000,1288,288,1576,Saturday
2021,7,10,900,1062,205,1267,Saturday
2021,7,10,800,723,123,846,Saturday
2021,7,10,700,408,80,488,Saturday
2021,7,10,600,171,38,209,Saturday
2021,7,10,500,121,53,174,Saturday
2021,7,10,400,74,51,125,Saturday
2021,7,10,300,33,69,102,Saturday
2021,7,10,200,53,79,132,Saturday
2021,7,10,100,62,164,226,Saturday
2021,7,9,2400,85,152,237,Friday
2021,7,9,2300,135,332,467,Friday
2021,7,9,2200,253,448,701,Friday
2021,7,9,2100,423,529,952,Friday
2021,7,9,2000,648,625,1273,Friday
2021,7,9,1900,799,781,1580,Friday
2021,7,9,1800,867,1071,1938,Friday
2021,7,9,1700,867,1117,1984,Friday
2021,7,9,1600,1045,942,1987,Friday
2021,7,9,1500,1113,982,2095,Friday
2021,7,9,1400,1016,852,1868,Friday
2021,7,9,1300,1184,757,1941,Friday
2021,7,9,1200,1190,585,1775,Friday
2021,7,9,1100,1205,440,1645,Friday
2021,7,9,1000,1002,305,1307,Friday
2021,7,9,900,888,268,1156,Friday
2021,7,9,800,569,73,642,Friday
2021,7,9,700,287,77,364,Friday
2021,7,9,600,155,55,210,Friday
2021,7,9,500,101,42,143,Friday
2021,7,9,400,45,43,88,Friday
2021,7,9,300,40,53,93,Friday
2021,7,9,200,53,99,152,Friday
2021,7,9,100,45,59,104,Friday
2021,7,8,2400,75,108,183,Thursday
2021,7,8,2300,139,238,377,Thursday
2021,7,8,2200,200,356,556,Thursday
2021,7,8,2100,340,535,875,Thursday
2021,7,8,2000,448,626,1074,Thursday
2021,7,8,1900,509,845,1354,Thursday
2021,7,8,1800,594,923,1517,Thursday
2021,7,8,1700,632,999,1631,Thursday
2021,7,8,1600,674,926,1600,Thursday
2021,7,8,1500,872,741,1613,Thursday
2021,7,8,1400,882,681,1563,Thursday
2021,7,8,1300,880,636,1516,Thursday
2021,7,8,1200,942,423,1365,Thursday
2021,7,8,1100,1000,361,1361,Thursday
2021,7,8,1000,894,254,1148,Thursday
2021,7,8,900,643,252,895,Thursday
2021,7,8,800,447,85,532,Thursday
2021,7,8,700,272,65,337,Thursday
2021,7,8,600,147,42,189,Thursday
2021,7,8,500,54,42,96,Thursday
2021,7,8,400,49,46,95,Thursday
2021,7,8,300,40,35,75,Thursday
2021,7,8,200,42,75,117,Thursday
2021,7,8,100,41,42,83,Thursday
2021,7,7,2400,83,163,246,Wednesday
2021,7,7,2300,95,213,308,Wednesday
2021,7,7,2200,151,262,413,Wednesday
2021,7,7,2100,212,454,666,Wednesday
2021,7,7,2000,319,623,942,Wednesday
2021,7,7,1900,360,794,1154,Wednesday
2021,7,7,1800,392,822,1214,Wednesday
2021,7,7,1700,481,884,1365,Wednesday
2021,7,7,1600,600,810,1410,Wednesday
2021,7,7,1500,624,792,1416,Wednesday
2021,7,7,1400,686,684,1370,Wednesday
2021,7,7,1300,777,552,1329,Wednesday
2021,7,7,1200,902,458,1360,Wednesday
2021,7,7,1100,898,334,1232,Wednesday
2021,7,7,1000,724,273,997,Wednesday
2021,7,7,900,653,267,920,Wednesday
2021,7,7,800,433,82,515,Wednesday
2021,7,7,700,229,65,294,Wednesday
2021,7,7,600,94,42,136,Wednesday
2021,7,7,500,53,54,107,Wednesday
2021,7,7,400,31,35,66,Wednesday
2021,7,7,300,29,71,100,Wednesday
2021,7,7,200,39,115,154,Wednesday
2021,7,7,100,59,52,111,Wednesday
2021,7,6,2400,79,104,183,Tuesday
2021,7,6,2300,106,286,392,Tuesday
2021,7,6,2200,137,342,479,Tuesday
2021,7,6,2100,204,523,727,Tuesday
2021,7,6,2000,290,703,993,Tuesday
2021,7,6,1900,337,796,1133,Tuesday
2021,7,6,1800,368,886,1254,Tuesday
2021,7,6,1700,433,952,1385,Tuesday
2021,7,6,1600,507,845,1352,Tuesday
2021,7,6,1500,653,792,1445,Tuesday
2021,7,6,1400,683,613,1296,Tuesday
2021,7,6,1300,796,554,1350,Tuesday
2021,7,6,1200,884,428,1312,Tuesday
2021,7,6,1100,931,344,1275,Tuesday
2021,7,6,1000,798,252,1050,Tuesday
2021,7,6,900,649,268,917,Tuesday
2021,7,6,800,427,89,516,Tuesday
2021,7,6,700,252,55,307,Tuesday
2021,7,6,600,124,45,169,Tuesday
2021,7,6,500,55,38,93,Tuesday
2021,7,6,400,36,35,71,Tuesday
2021,7,6,300,35,51,86,Tuesday
2021,7,6,200,36,64,100,Tuesday
2021,7,6,100,46,25,71,Tuesday
2021,7,5,2400,67,154,221,Monday
2021,7,5,2300,105,230,335,Monday
2021,7,5,2200,132,329,461,Monday
2021,7,5,2100,183,575,758,Monday
2021,7,5,2000,254,690,944,Monday
2021,7,5,1900,307,902,1209,Monday
2021,7,5,1800,351,1027,1378,Monday
2021,7,5,1700,476,1200,1676,Monday
2021,7,5,1600,591,1210,1801,Monday
2021,7,5,1500,769,913,1682,Monday
2021,7,5,1400,837,809,1646,Monday
2021,7,5,1300,895,704,1599,Monday
2021,7,5,1200,972,589,1561,Monday
2021,7,5,1100,924,383,1307,Monday
2021,7,5,1000,835,232,1067,Monday
2021,7,5,900,609,216,825,Monday
2021,7,5,800,426,124,550,Monday
2021,7,5,700,248,75,323,Monday
2021,7,5,600,92,33,125,Monday
2021,7,5,500,54,25,79,Monday
2021,7,5,400,19,39,58,Monday
2021,7,5,300,27,61,88,Monday
2021,7,5,200,31,100,131,Monday
2021,7,5,100,41,67,108,Monday
2021,7,4,2400,56,124,180,Sunday
2021,7,4,2300,79,446,525,Sunday
2021,7,4,2200,113,901,1014,Sunday
2021,7,4,2100,203,1363,1566,Sunday
2021,7,4,2000,265,1400,1665,Sunday
2021,7,4,1900,333,1652,1985,Sunday
2021,7,4,1800,413,1820,2233,Sunday
2021,7,4,1700,560,1924,2484,Sunday
2021,7,4,1600,692,2080,2772,Sunday
2021,7,4,1500,916,1781,2697,Sunday
2021,7,4,1400,972,1725,2697,Sunday
2021,7,4,1300,1083,1510,2593,Sunday
2021,7,4,1200,1206,1209,2415,Sunday
2021,7,4,1100,1052,699,1751,Sunday
2021,7,4,1000,905,361,1266,Sunday
2021,7,4,900,637,190,827,Sunday
2021,7,4,800,443,77,520,Sunday
2021,7,4,700,241,48,289,Sunday
2021,7,4,600,112,32,144,Sunday
2021,7,4,500,55,27,82,Sunday
2021,7,4,400,31,33,64,Sunday
2021,7,4,300,19,43,62,Sunday
2021,7,4,200,20,71,91,Sunday
2021,7,4,100,40,101,141,Sunday
2021,7,3,2400,84,238,322,Saturday
2021,7,3,2300,95,404,499,Saturday
2021,7,3,2200,125,673,798,Saturday
2021,7,3,2100,177,860,1037,Saturday
2021,7,3,2000,252,1132,1384,Saturday
2021,7,3,1900,337,1248,1585,Saturday
2021,7,3,1800,441,1438,1879,Saturday
2021,7,3,1700,558,1571,2129,Saturday
2021,7,3,1600,713,1232,1945,Saturday
2021,7,3,1500,908,898,1806,Saturday
2021,7,3,1400,1090,926,2016,Saturday
2021,7,3,1300,1181,798,1979,Saturday
2021,7,3,1200,1393,627,2020,Saturday
2021,7,3,1100,1398,495,1893,Saturday
2021,7,3,1000,1183,346,1529,Saturday
2021,7,3,900,1011,159,1170,Saturday
2021,7,3,800,656,108,764,Saturday
2021,7,3,700,315,56,371,Saturday
2021,7,3,600,204,39,243,Saturday
2021,7,3,500,103,36,139,Saturday
2021,7,3,400,53,39,92,Saturday
2021,7,3,300,27,68,95,Saturday
2021,7,3,200,35,80,115,Saturday
2021,7,3,100,38,115,153,Saturday
2021,7,2,2400,84,189,273,Friday
2021,7,2,2300,125,312,437,Friday
2021,7,2,2200,209,444,653,Friday
2021,7,2,2100,298,588,886,Friday
2021,7,2,2000,422,730,1152,Friday
2021,7,2,1900,544,951,1495,Friday
2021,7,2,1800,647,709,1356,Friday
2021,7,2,1700,749,926,1675,Friday
2021,7,2,1600,939,1023,1962,Friday
2021,7,2,1500,966,868,1834,Friday
2021,7,2,1400,996,779,1775,Friday
2021,7,2,1300,1161,663,1824,Friday
2021,7,2,1200,1322,537,1859,Friday
2021,7,2,1100,1249,330,1579,Friday
2021,7,2,1000,1034,222,1256,Friday
2021,7,2,900,873,164,1037,Friday
2021,7,2,800,600,97,697,Friday
2021,7,2,700,316,69,385,Friday
2021,7,2,600,175,33,208,Friday
2021,7,2,500,109,21,130,Friday
2021,7,2,400,52,38,90,Friday
2021,7,2,300,36,40,76,Friday
2021,7,2,200,44,57,101,Friday
2021,7,2,100,48,87,135,Friday
2021,7,1,2400,103,191,294,Thursday
2021,7,1,2300,111,245,356,Thursday
2021,7,1,2200,174,427,601,Thursday
2021,7,1,2100,246,607,853,Thursday
2021,7,1,2000,347,771,1118,Thursday
2021,7,1,1900,442,936,1378,Thursday
2021,7,1,1800,590,995,1585,Thursday
2021,7,1,1700,780,996,1776,Thursday
2021,7,1,1600,991,1068,2059,Thursday
2021,7,1,1500,1278,847,2125,Thursday
2021,7,1,1400,1457,830,2287,Thursday
2021,7,1,1300,1647,633,2280,Thursday
2021,7,1,1200,1811,559,2370,Thursday
2021,7,1,1100,1765,394,2159,Thursday
2021,7,1,1000,1645,268,1913,Thursday
2021,7,1,900,1438,202,1640,Thursday
2021,7,1,800,1119,131,1250,Thursday
2021,7,1,700,654,77,731,Thursday
2021,7,1,600,282,51,333,Thursday
2021,7,1,500,176,56,232,Thursday
2021,7,1,400,109,65,174,Thursday
2021,7,1,300,73,43,116,Thursday
2021,7,1,200,80,54,134,Thursday
2021,7,1,100,107,83,190,Thursday
2021,6,30,2400,195,183,378,Wednesday
2021,6,30,2300,281,284,565,Wednesday
2021,6,30,2200,471,344,815,Wednesday
2021,6,30,2100,751,395,1146,Wednesday
2021,6,30,2000,1027,502,1529,Wednesday
2021,6,30,1900,1121,621,1742,Wednesday
2021,6,30,1800,1140,635,1775,Wednesday
2021,6,30,1700,1086,756,1842,Wednesday
2021,6,30,1600,1042,673,1715,Wednesday
2021,6,30,1500,1116,703,1819,Wednesday
2021,6,30,1400,1023,660,1683,Wednesday
2021,6,30,1300,999,622,1621,Wednesday
2021,6,30,1200,1046,504,1550,Wednesday
2021,6,30,1100,998,363,1361,Wednesday
2021,6,30,1000,944,275,1219,Wednesday
2021,6,30,900,736,294,1030,Wednesday
2021,6,30,800,582,99,681,Wednesday
2021,6,30,700,341,79,420,Wednesday
2021,6,30,600,145,39,184,Wednesday
2021,6,30,500,117,43,160,Wednesday
2021,6,30,400,47,45,92,Wednesday
2021,6,30,300,37,39,76,Wednesday
2021,6,30,200,45,59,104,Wednesday
2021,6,30,100,46,49,95,Wednesday
2021,6,29,2400,90,139,229,Tuesday
2021,6,29,2300,149,221,370,Tuesday
2021,6,29,2200,200,240,440,Tuesday
2021,6,29,2100,281,387,668,Tuesday
2021,6,29,2000,399,520,919,Tuesday
2021,6,29,1900,490,582,1072,Tuesday
2021,6,29,1800,463,657,1120,Tuesday
2021,6,29,1700,555,640,1195,Tuesday
2021,6,29,1600,607,649,1256,Tuesday
2021,6,29,1500,670,660,1330,Tuesday
2021,6,29,1400,613,589,1202,Tuesday
2021,6,29,1300,668,532,1200,Tuesday
2021,6,29,1200,766,410,1176,Tuesday
2021,6,29,1100,772,352,1124,Tuesday
2021,6,29,1000,690,247,937,Tuesday
2021,6,29,900,551,240,791,Tuesday
2021,6,29,800,416,80,496,Tuesday
2021,6,29,700,230,60,290,Tuesday
2021,6,29,600,108,46,154,Tuesday
2021,6,29,500,58,82,140,Tuesday
2021,6,29,400,49,6,55,Tuesday
2021,6,29,300,33,31,64,Tuesday
2021,6,29,200,44,57,101,Tuesday
2021,6,29,100,56,48,104,Tuesday
2021,6,28,2400,83,231,314,Monday
2021,6,28,2300,103,121,224,Monday
2021,6,28,2200,148,240,388,Monday
2021,6,28,2100,200,388,588,Monday
2021,6,28,2000,283,503,786,Monday
2021,6,28,1900,316,652,968,Monday
2021,6,28,1800,385,658,1043,Monday
2021,6,28,1700,442,841,1283,Monday
2021,6,28,1600,517,656,1173,Monday
2021,6,28,1500,610,686,1296,Monday
2021,6,28,1400,690,590,1280,Monday
2021,6,28,1300,743,524,1267,Monday
2021,6,28,1200,805,475,1280,Monday
2021,6,28,1100,780,325,1105,Monday
2021,6,28,1000,650,227,877,Monday
2021,6,28,900,574,217,791,Monday
2021,6,28,800,433,104,537,Monday
2021,6,28,700,266,63,329,Monday
2021,6,28,600,98,35,133,Monday
2021,6,28,500,83,27,110,Monday
2021,6,28,400,35,27,62,Monday
2021,6,28,300,26,56,82,Monday
2021,6,28,200,24,61,85,Monday
2021,6,28,100,39,54,93,Monday
2021,6,27,2400,67,120,187,Sunday
2021,6,27,2300,90,266,356,Sunday
2021,6,27,2200,108,429,537,Sunday
2021,6,27,2100,170,703,873,Sunday
2021,6,27,2000,307,880,1187,Sunday
2021,6,27,1900,334,1128,1462,Sunday
2021,6,27,1800,402,1209,1611,Sunday
2021,6,27,1700,511,1262,1773,Sunday
2021,6,27,1600,578,1242,1820,Sunday
2021,6,27,1500,709,1112,1821,Sunday
2021,6,27,1400,767,990,1757,Sunday
2021,6,27,1300,874,942,1816,Sunday
2021,6,27,1200,998,825,1823,Sunday
2021,6,27,1100,928,479,1407,Sunday
2021,6,27,1000,829,301,1130,Sunday
2021,6,27,900,692,168,860,Sunday
2021,6,27,800,427,98,525,Sunday
2021,6,27,700,224,54,278,Sunday
2021,6,27,600,113,23,136,Sunday
2021,6,27,500,72,27,99,Sunday
2021,6,27,400,53,27,80,Sunday
2021,6,27,300,21,38,59,Sunday
2021,6,27,200,21,54,75,Sunday
2021,6,27,100,41,92,133,Sunday
2021,6,26,2400,51,250,301,Saturday
2021,6,26,2300,102,416,518,Saturday
2021,6,26,2200,124,496,620,Saturday
2021,6,26,2100,178,485,663,Saturday
2021,6,26,2000,254,676,930,Saturday
2021,6,26,1900,301,701,1002,Saturday
2021,6,26,1800,404,646,1050,Saturday
2021,6,26,1700,517,592,1109,Saturday
2021,6,26,1600,656,596,1252,Saturday
2021,6,26,1500,806,594,1400,Saturday
2021,6,26,1400,845,543,1388,Saturday
2021,6,26,1300,968,565,1533,Saturday
2021,6,26,1200,1164,455,1619,Saturday
2021,6,26,1100,1208,317,1525,Saturday
2021,6,26,1000,1035,233,1268,Saturday
2021,6,26,900,882,171,1053,Saturday
2021,6,26,800,597,94,691,Saturday
2021,6,26,700,293,62,355,Saturday
2021,6,26,600,117,34,151,Saturday
2021,6,26,500,91,41,132,Saturday
2021,6,26,400,38,34,72,Saturday
2021,6,26,300,41,57,98,Saturday
2021,6,26,200,28,63,91,Saturday
2021,6,26,100,52,98,150,Saturday
2021,6,25,2400,92,202,294,Friday
2021,6,25,2300,169,92,261,Friday
2021,6,25,2200,251,221,472,Friday
2021,6,25,2100,437,347,784,Friday
2021,6,25,2000,707,454,1161,Friday
2021,6,25,1900,816,537,1353,Friday
2021,6,25,1800,908,596,1504,Friday
2021,6,25,1700,936,668,1604,Friday
2021,6,25,1600,890,666,1556,Friday
2021,6,25,1500,870,583,1453,Friday
2021,6,25,1400,817,512,1329,Friday
2021,6,25,1300,780,500,1280,Friday
2021,6,25,1200,908,394,1302,Friday
2021,6,25,1100,900,297,1197,Friday
2021,6,25,1000,725,239,964,Friday
2021,6,25,900,574,220,794,Friday
2021,6,25,800,383,79,462,Friday
2021,6,25,700,208,56,264,Friday
2021,6,25,600,110,40,150,Friday
2021,6,25,500,63,33,96,Friday
2021,6,25,400,38,40,78,Friday
2021,6,25,300,26,48,74,Friday
2021,6,25,200,39,28,67,Friday
2021,6,25,100,42,52,94,Friday
2021,6,24,2400,82,74,156,Thursday
2021,6,24,2300,97,189,286,Thursday
2021,6,24,2200,169,167,336,Thursday
2021,6,24,2100,275,268,543,Thursday
2021,6,24,2000,377,373,750,Thursday
2021,6,24,1900,453,491,944,Thursday
2021,6,24,1800,450,501,951,Thursday
2021,6,24,1700,507,547,1054,Thursday
2021,6,24,1600,585,466,1051,Thursday
2021,6,24,1500,571,486,1057,Thursday
2021,6,24,1400,608,386,994,Thursday
2021,6,24,1300,564,381,945,Thursday
2021,6,24,1200,659,358,1017,Thursday
2021,6,24,1100,623,266,889,Thursday
2021,6,24,1000,473,195,668,Thursday
2021,6,24,900,370,196,566,Thursday
2021,6,24,800,281,77,358,Thursday
2021,6,24,700,159,47,206,Thursday
2021,6,24,600,67,35,102,Thursday
2021,6,24,500,33,32,65,Thursday
2021,6,24,400,33,27,60,Thursday
2021,6,24,300,24,22,46,Thursday
2021,6,24,200,35,52,87,Thursday
2021,6,24,100,41,26,67,Thursday
2021,6,23,2400,67,105,172,Wednesday
2021,6,23,2300,86,175,261,Wednesday
2021,6,23,2200,114,155,269,Wednesday
2021,6,23,2100,165,235,400,Wednesday
2021,6,23,2000,229,385,614,Wednesday
2021,6,23,1900,264,438,702,Wednesday
2021,6,23,1800,304,514,818,Wednesday
2021,6,23,1700,368,516,884,Wednesday
2021,6,23,1600,404,538,942,Wednesday
2021,6,23,1500,479,499,978,Wednesday
2021,6,23,1400,462,363,825,Wednesday
2021,6,23,1300,512,351,863,Wednesday
2021,6,23,1200,524,314,838,Wednesday
2021,6,23,1100,506,253,759,Wednesday
2021,6,23,1000,461,195,656,Wednesday
2021,6,23,900,350,228,578,Wednesday
2021,6,23,800,244,84,328,Wednesday
2021,6,23,700,153,53,206,Wednesday
2021,6,23,600,87,35,122,Wednesday
2021,6,23,500,41,39,80,Wednesday
2021,6,23,400,22,38,60,Wednesday
2021,6,23,300,32,27,59,Wednesday
2021,6,23,200,30,44,74,Wednesday
2021,6,23,100,45,41,86,Wednesday
2021,6,22,2400,64,91,155,Tuesday
2021,6,22,2300,72,198,270,Tuesday
2021,6,22,2200,98,186,284,Tuesday
2021,6,22,2100,157,307,464,Tuesday
2021,6,22,2000,206,391,597,Tuesday
2021,6,22,1900,248,482,730,Tuesday
2021,6,22,1800,280,518,798,Tuesday
2021,6,22,1700,284,590,874,Tuesday
2021,6,22,1600,363,555,918,Tuesday
2021,6,22,1500,430,483,913,Tuesday
2021,6,22,1400,444,413,857,Tuesday
2021,6,22,1300,533,352,885,Tuesday
2021,6,22,1200,532,309,841,Tuesday
2021,6,22,1100,592,238,830,Tuesday
2021,6,22,1000,499,219,718,Tuesday
2021,6,22,900,380,205,585,Tuesday
2021,6,22,800,285,65,350,Tuesday
2021,6,22,700,175,53,228,Tuesday
2021,6,22,600,74,46,120,Tuesday
2021,6,22,500,60,29,89,Tuesday
2021,6,22,400,39,43,82,Tuesday
2021,6,22,300,23,39,62,Tuesday
2021,6,22,200,30,56,86,Tuesday
2021,6,22,100,39,39,78,Tuesday
2021,6,21,2400,70,95,165,Monday
2021,6,21,2300,89,186,275,Monday
2021,6,21,2200,99,183,282,Monday
2021,6,21,2100,141,345,486,Monday
2021,6,21,2000,221,409,630,Monday
2021,6,21,1900,256,535,791,Monday
2021,6,21,1800,318,616,934,Monday
2021,6,21,1700,355,671,1026,Monday
2021,6,21,1600,414,606,1020,Monday
2021,6,21,1500,448,517,965,Monday
2021,6,21,1400,505,448,953,Monday
2021,6,21,1300,569,429,998,Monday
2021,6,21,1200,659,299,958,Monday
2021,6,21,1100,675,268,943,Monday
2021,6,21,1000,539,169,708,Monday
2021,6,21,900,375,169,544,Monday
2021,6,21,800,297,93,390,Monday
2021,6,21,700,194,50,244,Monday
2021,6,21,600,70,26,96,Monday
2021,6,21,500,43,17,60,Monday
2021,6,21,400,27,28,55,Monday
2021,6,21,300,25,36,61,Monday
2021,6,21,200,23,60,83,Monday
2021,6,21,100,23,87,110,Monday
2021,6,20,2400,50,144,194,Sunday
2021,6,20,2300,57,259,316,Sunday
2021,6,20,2200,83,408,491,Sunday
2021,6,20,2100,146,572,718,Sunday
2021,6,20,2000,216,764,980,Sunday
2021,6,20,1900,235,1041,1276,Sunday
2021,6,20,1800,317,1120,1437,Sunday
2021,6,20,1700,384,1085,1469,Sunday
2021,6,20,1600,443,1111,1554,Sunday
2021,6,20,1500,568,1007,1575,Sunday
2021,6,20,1400,627,807,1434,Sunday
2021,6,20,1300,687,812,1499,Sunday
2021,6,20,1200,734,609,1343,Sunday
2021,6,20,1100,692,344,1036,Sunday
2021,6,20,1000,586,239,825,Sunday
2021,6,20,900,455,127,582,Sunday
2021,6,20,800,270,59,329,Sunday
2021,6,20,700,135,26,161,Sunday
2021,6,20,600,72,16,88,Sunday
2021,6,20,500,41,14,55,Sunday
2021,6,20,400,28,13,41,Sunday
2021,6,20,300,23,21,44,Sunday
2021,6,20,200,17,44,61,Sunday
2021,6,20,100,17,42,59,Sunday
2021,6,19,2400,36,54,90,Saturday
2021,6,19,2300,73,125,198,Saturday
2021,6,19,2200,89,190,279,Saturday
2021,6,19,2100,132,290,422,Saturday
2021,6,19,2000,291,373,664,Saturday
2021,6,19,1900,222,495,717,Saturday
2021,6,19,1800,126,522,648,Saturday
2021,6,19,1700,320,535,855,Saturday
2021,6,19,1600,381,628,1009,Saturday
2021,6,19,1500,484,474,958,Saturday
2021,6,19,1400,570,450,1020,Saturday
2021,6,19,1300,631,387,1018,Saturday
2021,6,19,1200,647,352,999,Saturday
2021,6,19,1100,647,256,903,Saturday
2021,6,19,1000,583,145,728,Saturday
2021,6,19,900,278,146,424,Saturday
2021,6,19,800,284,81,365,Saturday
2021,6,19,700,167,52,219,Saturday
2021,6,19,600,73,32,105,Saturday
2021,6,19,500,39,33,72,Saturday
2021,6,19,400,20,42,62,Saturday
2021,6,19,300,20,33,53,Saturday
2021,6,19,200,31,40,71,Saturday
2021,6,19,100,39,67,106,Saturday
2021,6,18,2400,73,144,217,Friday
2021,6,18,2300,123,133,256,Friday
2021,6,18,2200,206,214,420,Friday
2021,6,18,2100,368,238,606,Friday
2021,6,18,2000,571,362,933,Friday
2021,6,18,1900,724,457,1181,Friday
2021,6,18,1800,770,531,1301,Friday
2021,6,18,1700,719,572,1291,Friday
2021,6,18,1600,797,527,1324,Friday
2021,6,18,1500,751,497,1248,Friday
2021,6,18,1400,713,448,1161,Friday
2021,6,18,1300,654,352,1006,Friday
2021,6,18,1200,803,362,1165,Friday
2021,6,18,1100,680,260,940,Friday
2021,6,18,1000,614,198,812,Friday
2021,6,18,900,461,181,642,Friday
2021,6,18,800,333,64,397,Friday
2021,6,18,700,154,59,213,Friday
2021,6,18,600,77,35,112,Friday
2021,6,18,500,57,37,94,Friday
2021,6,18,400,36,41,77,Friday
2021,6,18,300,34,47,81,Friday
2021,6,18,200,31,52,83,Friday
2021,6,18,100,48,35,83,Friday
2021,6,17,2400,67,104,171,Thursday
2021,6,17,2300,97,214,311,Thursday
2021,6,17,2200,158,167,325,Thursday
2021,6,17,2100,244,243,487,Thursday
2021,6,17,2000,389,335,724,Thursday
2021,6,17,1900,445,460,905,Thursday
2021,6,17,1800,482,467,949,Thursday
2021,6,17,1700,458,487,945,Thursday
2021,6,17,1600,466,467,933,Thursday
2021,6,17,1500,520,404,924,Thursday
2021,6,17,1400,532,382,914,Thursday
2021,6,17,1300,544,338,882,Thursday
2021,6,17,1200,611,288,899,Thursday
2021,6,17,1100,585,220,805,Thursday
2021,6,17,1000,544,173,717,Thursday
2021,6,17,900,378,185,563,Thursday
2021,6,17,800,289,65,354,Thursday
2021,6,17,700,179,55,234,Thursday
2021,6,17,600,53,34,87,Thursday
2021,6,17,500,44,40,84,Thursday
2021,6,17,400,33,33,66,Thursday
2021,6,17,300,25,41,66,Thursday
2021,6,17,200,38,65,103,Thursday
2021,6,17,100,45,31,76,Thursday
2021,6,16,2400,52,80,132,Wednesday
2021,6,16,2300,90,116,206,Wednesday
2021,6,16,2200,109,140,249,Wednesday
2021,6,16,2100,144,158,302,Wednesday
2021,6,16,2000,235,250,485,Wednesday
2021,6,16,1900,255,357,612,Wednesday
2021,6,16,1800,305,415,720,Wednesday
2021,6,16,1700,348,443,791,Wednesday
2021,6,16,1600,344,454,798,Wednesday
2021,6,16,1500,379,403,782,Wednesday
2021,6,16,1400,414,353,767,Wednesday
2021,6,16,1300,453,310,763,Wednesday
2021,6,16,1200,559,258,817,Wednesday
2021,6,16,1100,503,226,729,Wednesday
2021,6,16,1000,433,181,614,Wednesday
2021,6,16,900,343,185,528,Wednesday
2021,6,16,800,237,68,305,Wednesday
2021,6,16,700,142,45,187,Wednesday
2021,6,16,600,61,38,99,Wednesday
2021,6,16,500,36,43,79,Wednesday
2021,6,16,400,32,30,62,Wednesday
2021,6,16,300,26,32,58,Wednesday
2021,6,16,200,24,35,59,Wednesday
2021,6,16,100,43,34,77,Wednesday
2021,6,15,2400,66,82,148,Tuesday
2021,6,15,2300,61,139,200,Tuesday
2021,6,15,2200,79,137,216,Tuesday
2021,6,15,2100,124,218,342,Tuesday
2021,6,15,2000,170,270,440,Tuesday
2021,6,15,1900,198,352,550,Tuesday
2021,6,15,1800,240,389,629,Tuesday
2021,6,15,1700,279,382,661,Tuesday
2021,6,15,1600,297,339,636,Tuesday
2021,6,15,1500,402,363,765,Tuesday
2021,6,15,1400,410,362,772,Tuesday
2021,6,15,1300,399,284,683,Tuesday
2021,6,15,1200,419,313,732,Tuesday
2021,6,15,1100,384,245,629,Tuesday
2021,6,15,1000,256,219,475,Tuesday
2021,6,15,900,238,183,421,Tuesday
2021,6,15,800,189,57,246,Tuesday
2021,6,15,700,123,48,171,Tuesday
2021,6,15,600,63,35,98,Tuesday
2021,6,15,500,23,27,50,Tuesday
2021,6,15,400,33,24,57,Tuesday
2021,6,15,300,25,41,66,Tuesday
2021,6,15,200,25,41,66,Tuesday
2021,6,15,100,38,24,62,Tuesday
2021,6,14,2400,66,73,139,Monday
2021,6,14,2300,65,137,202,Monday
2021,6,14,2200,90,192,282,Monday
2021,6,14,2100,127,243,370,Monday
2021,6,14,2000,167,350,517,Monday
2021,6,14,1900,203,460,663,Monday
2021,6,14,1800,271,501,772,Monday
2021,6,14,1700,320,500,820,Monday
2021,6,14,1600,367,463,830,Monday
2021,6,14,1500,369,435,804,Monday
2021,6,14,1400,429,451,880,Monday
2021,6,14,1300,471,359,830,Monday
2021,6,14,1200,525,287,812,Monday
2021,6,14,1100,563,246,809,Monday
2021,6,14,1000,367,188,555,Monday
2021,6,14,900,284,149,433,Monday
2021,6,14,800,220,76,296,Monday
2021,6,14,700,135,50,185,Monday
2021,6,14,600,60,31,91,Monday
2021,6,14,500,23,21,44,Monday
2021,6,14,400,30,15,45,Monday
2021,6,14,300,15,27,42,Monday
2021,6,14,200,18,30,48,Monday
2021,6,14,100,19,17,36,Monday
2021,6,13,2400,29,82,111,Sunday
2021,6,13,2300,65,165,230,Sunday
2021,6,13,2200,72,267,339,Sunday
2021,6,13,2100,129,446,575,Sunday
2021,6,13,2000,175,641,816,Sunday
2021,6,13,1900,223,832,1055,Sunday
2021,6,13,1800,264,1037,1301,Sunday
2021,6,13,1700,298,1050,1348,Sunday
2021,6,13,1600,424,989,1413,Sunday
2021,6,13,1500,481,958,1439,Sunday
2021,6,13,1400,541,788,1329,Sunday
2021,6,13,1300,584,748,1332,Sunday
2021,6,13,1200,689,548,1237,Sunday
2021,6,13,1100,600,342,942,Sunday
2021,6,13,1000,461,193,654,Sunday
2021,6,13,900,329,138,467,Sunday
2021,6,13,800,256,61,317,Sunday
2021,6,13,700,111,24,135,Sunday
2021,6,13,600,57,33,90,Sunday
2021,6,13,500,26,19,45,Sunday
2021,6,13,400,25,22,47,Sunday
2021,6,13,300,19,24,43,Sunday
2021,6,13,200,23,35,58,Sunday
2021,6,13,100,20,64,84,Sunday
2021,6,12,2400,49,84,133,Saturday
2021,6,12,2300,63,120,183,Saturday
2021,6,12,2200,93,213,306,Saturday
2021,6,12,2100,116,296,412,Saturday
2021,6,12,2000,166,379,545,Saturday
2021,6,12,1900,231,465,696,Saturday
2021,6,12,1800,281,593,874,Saturday
2021,6,12,1700,339,544,883,Saturday
2021,6,12,1600,407,653,1060,Saturday
2021,6,12,1500,458,474,932,Saturday
2021,6,12,1400,548,383,931,Saturday
2021,6,12,1300,576,382,958,Saturday
2021,6,12,1200,621,277,898,Saturday
2021,6,12,1100,632,222,854,Saturday
2021,6,12,1000,525,204,729,Saturday
2021,6,12,900,428,118,546,Saturday
2021,6,12,800,242,72,314,Saturday
2021,6,12,700,114,48,162,Saturday
2021,6,12,600,71,40,111,Saturday
2021,6,12,500,25,25,50,Saturday
2021,6,12,400,27,33,60,Saturday
2021,6,12,300,26,31,57,Saturday
2021,6,12,200,33,52,85,Saturday
2021,6,12,100,38,83,121,Saturday
2021,6,11,2400,79,95,174,Friday
2021,6,11,2300,89,89,178,Friday
2021,6,11,2200,162,138,300,Friday
2021,6,11,2100,304,217,521,Friday
2021,6,11,2000,485,273,758,Friday
2021,6,11,1900,655,383,1038,Friday
2021,6,11,1800,680,437,1117,Friday
2021,6,11,1700,703,443,1146,Friday
2021,6,11,1600,619,445,1064,Friday
2021,6,11,1500,634,428,1062,Friday
2021,6,11,1400,614,367,981,Friday
2021,6,11,1300,535,301,836,Friday
2021,6,11,1200,571,266,837,Friday
2021,6,11,1100,558,226,784,Friday
2021,6,11,1000,423,190,613,Friday
2021,6,11,900,322,196,518,Friday
2021,6,11,800,240,82,322,Friday
2021,6,11,700,135,55,190,Friday
2021,6,11,600,70,44,114,Friday
2021,6,11,500,55,29,84,Friday
2021,6,11,400,41,28,69,Friday
2021,6,11,300,24,30,54,Friday
2021,6,11,200,34,27,61,Friday
2021,6,11,100,37,28,65,Friday
2021,6,10,2400,64,105,169,Thursday
2021,6,10,2300,90,121,211,Thursday
2021,6,10,2200,112,137,249,Thursday
2021,6,10,2100,191,216,407,Thursday
2021,6,10,2000,326,257,583,Thursday
2021,6,10,1900,391,344,735,Thursday
2021,6,10,1800,374,402,776,Thursday
2021,6,10,1700,352,347,699,Thursday
2021,6,10,1600,385,324,709,Thursday
2021,6,10,1500,386,353,739,Thursday
2021,6,10,1400,395,264,659,Thursday
2021,6,10,1300,396,223,619,Thursday
2021,6,10,1200,400,219,619,Thursday
2021,6,10,1100,445,182,627,Thursday
2021,6,10,1000,348,184,532,Thursday
2021,6,10,900,253,182,435,Thursday
2021,6,10,800,228,63,291,Thursday
2021,6,10,700,134,47,181,Thursday
2021,6,10,600,53,28,81,Thursday
2021,6,10,500,33,35,68,Thursday
2021,6,10,400,25,32,57,Thursday
2021,6,10,300,23,40,63,Thursday
2021,6,10,200,28,41,69,Thursday
2021,6,10,100,40,22,62,Thursday
2021,6,9,2400,56,71,127,Wednesday
2021,6,9,2300,67,114,181,Wednesday
2021,6,9,2200,94,129,223,Wednesday
2021,6,9,2100,122,175,297,Wednesday
2021,6,9,2000,176,210,386,Wednesday
2021,6,9,1900,199,236,435,Wednesday
2021,6,9,1800,246,344,590,Wednesday
2021,6,9,1700,267,312,579,Wednesday
2021,6,9,1600,288,328,616,Wednesday
2021,6,9,1500,344,273,617,Wednesday
2021,6,9,1400,320,280,600,Wednesday
2021,6,9,1300,372,291,663,Wednesday
2021,6,9,1200,336,257,593,Wednesday
2021,6,9,1100,279,226,505,Wednesday
2021,6,9,1000,283,167,450,Wednesday
2021,6,9,900,249,175,424,Wednesday
2021,6,9,800,169,75,244,Wednesday
2021,6,9,700,126,50,176,Wednesday
2021,6,9,600,49,37,86,Wednesday
2021,6,9,500,29,37,66,Wednesday
2021,6,9,400,26,36,62,Wednesday
2021,6,9,300,24,40,64,Wednesday
2021,6,9,200,34,35,69,Wednesday
2021,6,9,100,35,17,52,Wednesday
2021,6,8,2400,47,76,123,Tuesday
2021,6,8,2300,71,130,201,Tuesday
2021,6,8,2200,80,132,212,Tuesday
2021,6,8,2100,90,186,276,Tuesday
2021,6,8,2000,191,234,425,Tuesday
2021,6,8,1900,177,281,458,Tuesday
2021,6,8,1800,203,354,557,Tuesday
2021,6,8,1700,221,359,580,Tuesday
2021,6,8,1600,243,325,568,Tuesday
2021,6,8,1500,297,321,618,Tuesday
2021,6,8,1400,323,299,622,Tuesday
2021,6,8,1300,323,263,586,Tuesday
2021,6,8,1200,354,203,557,Tuesday
2021,6,8,1100,386,202,588,Tuesday
2021,6,8,1000,288,189,477,Tuesday
2021,6,8,900,217,159,376,Tuesday
2021,6,8,800,186,69,255,Tuesday
2021,6,8,700,109,37,146,Tuesday
2021,6,8,600,54,42,96,Tuesday
2021,6,8,500,30,22,52,Tuesday
2021,6,8,400,32,37,69,Tuesday
2021,6,8,300,15,31,46,Tuesday
2021,6,8,200,44,34,78,Tuesday
2021,6,8,100,39,17,56,Tuesday
2021,6,7,2400,62,63,125,Monday
2021,6,7,2300,53,103,156,Monday
2021,6,7,2200,85,124,209,Monday
2021,6,7,2100,119,198,317,Monday
2021,6,7,2000,140,229,369,Monday
2021,6,7,1900,197,316,513,Monday
2021,6,7,1800,212,352,564,Monday
2021,6,7,1700,254,402,656,Monday
2021,6,7,1600,258,362,620,Monday
2021,6,7,1500,334,360,694,Monday
2021,6,7,1400,334,287,621,Monday
2021,6,7,1300,324,289,613,Monday
2021,6,7,1200,364,245,609,Monday
2021,6,7,1100,306,211,517,Monday
2021,6,7,1000,240,125,365,Monday
2021,6,7,900,184,138,322,Monday
2021,6,7,800,141,56,197,Monday
2021,6,7,700,101,39,140,Monday
2021,6,7,600,47,23,70,Monday
2021,6,7,500,16,19,35,Monday
2021,6,7,400,22,16,38,Monday
2021,6,7,300,18,20,38,Monday
2021,6,7,200,16,45,61,Monday
2021,6,7,100,18,16,34,Monday
2021,6,6,2400,33,79,112,Sunday
2021,6,6,2300,57,125,182,Sunday
2021,6,6,2200,46,157,203,Sunday
2021,6,6,2100,82,317,399,Sunday
2021,6,6,2000,161,477,638,Sunday
2021,6,6,1900,180,610,790,Sunday
2021,6,6,1800,227,702,929,Sunday
2021,6,6,1700,286,798,1084,Sunday
2021,6,6,1600,339,848,1187,Sunday
2021,6,6,1500,342,845,1187,Sunday
2021,6,6,1400,403,656,1059,Sunday
2021,6,6,1300,405,543,948,Sunday
2021,6,6,1200,454,458,912,Sunday
2021,6,6,1100,392,227,619,Sunday
2021,6,6,1000,322,152,474,Sunday
2021,6,6,900,221,104,325,Sunday
2021,6,6,800,161,43,204,Sunday
2021,6,6,700,78,26,104,Sunday
2021,6,6,600,28,18,46,Sunday
2021,6,6,500,23,13,36,Sunday
2021,6,6,400,22,24,46,Sunday
2021,6,6,300,16,27,43,Sunday
2021,6,6,200,16,37,53,Sunday
2021,6,6,100,17,46,63,Sunday
2021,6,5,2400,40,63,103,Saturday
2021,6,5,2300,39,83,122,Saturday
2021,6,5,2200,68,183,251,Saturday
2021,6,5,2100,102,224,326,Saturday
2021,6,5,2000,132,297,429,Saturday
2021,6,5,1900,176,475,651,Saturday
2021,6,5,1800,171,470,641,Saturday
2021,6,5,1700,255,569,824,Saturday
2021,6,5,1600,329,541,870,Saturday
2021,6,5,1500,367,433,800,Saturday
2021,6,5,1400,415,393,808,Saturday
2021,6,5,1300,482,318,800,Saturday
2021,6,5,1200,556,277,833,Saturday
2021,6,5,1100,543,212,755,Saturday
2021,6,5,1000,441,147,588,Saturday
2021,6,5,900,307,105,412,Saturday
2021,6,5,800,198,71,269,Saturday
2021,6,5,700,110,48,158,Saturday
2021,6,5,600,54,38,92,Saturday
2021,6,5,500,28,50,78,Saturday
2021,6,5,400,32,22,54,Saturday
2021,6,5,300,18,32,50,Saturday
2021,6,5,200,29,50,79,Saturday
2021,6,5,100,31,78,109,Saturday
2021,6,4,2400,69,83,152,Friday
2021,6,4,2300,90,132,222,Friday
2021,6,4,2200,159,164,323,Friday
2021,6,4,2100,215,180,395,Friday
2021,6,4,2000,377,270,647,Friday
2021,6,4,1900,513,380,893,Friday
2021,6,4,1800,573,410,983,Friday
2021,6,4,1700,514,396,910,Friday
2021,6,4,1600,579,407,986,Friday
2021,6,4,1500,530,360,890,Friday
2021,6,4,1400,437,354,791,Friday
2021,6,4,1300,489,307,796,Friday
2021,6,4,1200,519,257,776,Friday
2021,6,4,1100,426,229,655,Friday
2021,6,4,1000,355,180,535,Friday
2021,6,4,900,309,199,508,Friday
2021,6,4,800,243,73,316,Friday
2021,6,4,700,150,44,194,Friday
2021,6,4,600,53,42,95,Friday
2021,6,4,500,35,34,69,Friday
2021,6,4,400,36,37,73,Friday
2021,6,4,300,43,27,70,Friday
2021,6,4,200,25,33,58,Friday
2021,6,4,100,46,26,72,Friday
2021,6,3,2400,57,71,128,Thursday
2021,6,3,2300,96,145,241,Thursday
2021,6,3,2200,144,163,307,Thursday
2021,6,3,2100,234,211,445,Thursday
2021,6,3,2000,313,255,568,Thursday
2021,6,3,1900,372,318,690,Thursday
2021,6,3,1800,384,394,778,Thursday
2021,6,3,1700,348,370,718,Thursday
2021,6,3,1600,356,410,766,Thursday
2021,6,3,1500,399,327,726,Thursday
2021,6,3,1400,391,343,734,Thursday
2021,6,3,1300,393,277,670,Thursday
2021,6,3,1200,418,218,636,Thursday
2021,6,3,1100,411,174,585,Thursday
2021,6,3,1000,365,128,493,Thursday
2021,6,3,900,285,159,444,Thursday
2021,6,3,800,234,73,307,Thursday
2021,6,3,700,137,55,192,Thursday
2021,6,3,600,45,37,82,Thursday
2021,6,3,500,37,30,67,Thursday
2021,6,3,400,32,31,63,Thursday
2021,6,3,300,33,32,65,Thursday
2021,6,3,200,49,36,85,Thursday
2021,6,3,100,48,32,80,Thursday
2021,6,2,2400,65,94,159,Wednesday
2021,6,2,2300,78,122,200,Wednesday
2021,6,2,2200,97,136,233,Wednesday
2021,6,2,2100,150,247,397,Wednesday
2021,6,2,2000,196,248,444,Wednesday
2021,6,2,1900,205,292,497,Wednesday
2021,6,2,1800,266,361,627,Wednesday
2021,6,2,1700,251,372,623,Wednesday
2021,6,2,1600,285,329,614,Wednesday
2021,6,2,1500,307,327,634,Wednesday
2021,6,2,1400,341,291,632,Wednesday
2021,6,2,1300,347,268,615,Wednesday
2021,6,2,1200,376,235,611,Wednesday
2021,6,2,1100,358,198,556,Wednesday
2021,6,2,1000,321,181,502,Wednesday
2021,6,2,900,244,182,426,Wednesday
2021,6,2,800,196,89,285,Wednesday
2021,6,2,700,132,42,174,Wednesday
2021,6,2,600,65,43,108,Wednesday
2021,6,2,500,29,32,61,Wednesday
2021,6,2,400,30,35,65,Wednesday
2021,6,2,300,21,29,50,Wednesday
2021,6,2,200,25,36,61,Wednesday
2021,6,2,100,34,23,57,Wednesday
2021,6,1,2400,69,51,120,Tuesday
2021,6,1,2300,72,135,207,Tuesday
2021,6,1,2200,99,159,258,Tuesday
2021,6,1,2100,117,214,331,Tuesday
2021,6,1,2000,179,246,425,Tuesday
2021,6,1,1900,200,350,550,Tuesday
2021,6,1,1800,215,360,575,Tuesday
2021,6,1,1700,236,343,579,Tuesday
2021,6,1,1600,271,323,594,Tuesday
2021,6,1,1500,302,325,627,Tuesday
2021,6,1,1400,322,278,600,Tuesday
2021,6,1,1300,342,266,608,Tuesday
2021,6,1,1200,330,213,543,Tuesday
2021,6,1,1100,330,202,532,Tuesday
2021,6,1,1000,285,170,455,Tuesday
2021,6,1,900,218,156,374,Tuesday
2021,6,1,800,190,72,262,Tuesday
2021,6,1,700,104,53,157,Tuesday
2021,6,1,600,51,36,87,Tuesday
2021,6,1,500,40,40,80,Tuesday
2021,6,1,400,24,46,70,Tuesday
2021,6,1,300,26,41,67,Tuesday
2021,6,1,200,30,49,79,Tuesday
2021,6,1,100,35,29,64,Tuesday
2021,5,31,2400,76,64,140,Monday
2021,5,31,2300,70,132,202,Monday
2021,5,31,2200,112,212,324,Monday
2021,5,31,2100,122,261,383,Monday
2021,5,31,2000,153,302,455,Monday
2021,5,31,1900,185,370,555,Monday
2021,5,31,1800,259,440,699,Monday
2021,5,31,1700,283,442,725,Monday
2021,5,31,1600,272,433,705,Monday
2021,5,31,1500,302,416,718,Monday
2021,5,31,1400,355,349,704,Monday
2021,5,31,1300,398,293,691,Monday
2021,5,31,1200,426,255,681,Monday
2021,5,31,1100,398,191,589,Monday
2021,5,31,1000,345,140,485,Monday
2021,5,31,900,260,113,373,Monday
2021,5,31,800,180,84,264,Monday
2021,5,31,700,132,44,176,Monday
2021,5,31,600,40,27,67,Monday
2021,5,31,500,23,38,61,Monday
2021,5,31,400,26,25,51,Monday
2021,5,31,300,20,37,57,Monday
2021,5,31,200,31,35,66,Monday
2021,5,31,100,30,22,52,Monday
2021,5,30,2400,28,60,88,Sunday
2021,5,30,2300,58,154,212,Sunday
2021,5,30,2200,84,277,361,Sunday
2021,5,30,2100,96,499,595,Sunday
2021,5,30,2000,141,564,705,Sunday
2021,5,30,1900,201,774,975,Sunday
2021,5,30,1800,178,862,1040,Sunday
2021,5,30,1700,284,891,1175,Sunday
2021,5,30,1600,314,835,1149,Sunday
2021,5,30,1500,429,703,1132,Sunday
2021,5,30,1400,446,543,989,Sunday
2021,5,30,1300,538,411,949,Sunday
2021,5,30,1200,531,334,865,Sunday
2021,5,30,1100,547,215,762,Sunday
2021,5,30,1000,484,165,649,Sunday
2021,5,30,900,315,107,422,Sunday
2021,5,30,800,199,49,248,Sunday
2021,5,30,700,132,17,149,Sunday
2021,5,30,600,43,21,64,Sunday
2021,5,30,500,25,16,41,Sunday
2021,5,30,400,19,27,46,Sunday
2021,5,30,300,18,19,37,Sunday
2021,5,30,200,21,31,52,Sunday
2021,5,30,100,19,33,52,Sunday
2021,5,29,2400,39,46,85,Saturday
2021,5,29,2300,60,98,158,Saturday
2021,5,29,2200,77,137,214,Saturday
2021,5,29,2100,86,195,281,Saturday
2021,5,29,2000,132,296,428,Saturday
2021,5,29,1900,155,383,538,Saturday
2021,5,29,1800,214,424,638,Saturday
2021,5,29,1700,281,529,810,Saturday
2021,5,29,1600,295,467,762,Saturday
2021,5,29,1500,383,410,793,Saturday
2021,5,29,1400,483,372,855,Saturday
2021,5,29,1300,503,296,799,Saturday
2021,5,29,1200,609,235,844,Saturday
2021,5,29,1100,522,160,682,Saturday
2021,5,29,1000,527,137,664,Saturday
2021,5,29,900,380,121,501,Saturday
2021,5,29,800,208,77,285,Saturday
2021,5,29,700,128,51,179,Saturday
2021,5,29,600,54,37,91,Saturday
2021,5,29,500,29,32,61,Saturday
2021,5,29,400,33,36,69,Saturday
2021,5,29,300,27,41,68,Saturday
2021,5,29,200,26,29,55,Saturday
2021,5,29,100,47,56,103,Saturday
2021,5,28,2400,62,85,147,Friday
2021,5,28,2300,82,93,175,Friday
2021,5,28,2200,161,132,293,Friday
2021,5,28,2100,217,149,366,Friday
2021,5,28,2000,392,195,587,Friday
2021,5,28,1900,546,275,821,Friday
2021,5,28,1800,565,305,870,Friday
2021,5,28,1700,539,344,883,Friday
2021,5,28,1600,503,358,861,Friday
2021,5,28,1500,466,348,814,Friday
2021,5,28,1400,447,344,791,Friday
2021,5,28,1300,448,211,659,Friday
2021,5,28,1200,454,186,640,Friday
2021,5,28,1100,366,166,532,Friday
2021,5,28,1000,242,144,386,Friday
2021,5,28,900,225,90,315,Friday
2021,5,28,800,170,61,231,Friday
2021,5,28,700,115,60,175,Friday
2021,5,28,600,58,31,89,Friday
2021,5,28,500,46,41,87,Friday
2021,5,28,400,31,37,68,Friday
2021,5,28,300,31,42,73,Friday
2021,5,28,200,34,44,78,Friday
2021,5,28,100,37,68,105,Friday
2021,5,27,2400,59,77,136,Thursday
2021,5,27,2300,73,96,169,Thursday
2021,5,27,2200,93,107,200,Thursday
2021,5,27,2100,172,142,314,Thursday
2021,5,27,2000,181,169,350,Thursday
2021,5,27,1900,267,236,503,Thursday
2021,5,27,1800,282,275,557,Thursday
2021,5,27,1700,283,313,596,Thursday
2021,5,27,1600,272,299,571,Thursday
2021,5,27,1500,283,278,561,Thursday
2021,5,27,1400,355,229,584,Thursday
2021,5,27,1300,341,208,549,Thursday
2021,5,27,1200,319,213,532,Thursday
2021,5,27,1100,308,164,472,Thursday
2021,5,27,1000,294,121,415,Thursday
2021,5,27,900,247,108,355,Thursday
2021,5,27,800,162,80,242,Thursday
2021,5,27,700,105,53,158,Thursday
2021,5,27,600,68,35,103,Thursday
2021,5,27,500,30,48,78,Thursday
2021,5,27,400,27,35,62,Thursday
2021,5,27,300,17,35,52,Thursday
2021,5,27,200,41,56,97,Thursday
2021,5,27,100,38,76,114,Thursday
2021,5,26,2400,64,83,147,Wednesday
2021,5,26,2300,82,98,180,Wednesday
2021,5,26,2200,87,132,219,Wednesday
2021,5,26,2100,121,190,311,Wednesday
2021,5,26,2000,164,193,357,Wednesday
2021,5,26,1900,174,244,418,Wednesday
2021,5,26,1800,222,277,499,Wednesday
2021,5,26,1700,235,316,551,Wednesday
2021,5,26,1600,266,275,541,Wednesday
2021,5,26,1500,275,295,570,Wednesday
2021,5,26,1400,312,263,575,Wednesday
2021,5,26,1300,292,247,539,Wednesday
2021,5,26,1200,328,167,495,Wednesday
2021,5,26,1100,326,142,468,Wednesday
2021,5,26,1000,260,137,397,Wednesday
2021,5,26,900,216,110,326,Wednesday
2021,5,26,800,183,84,267,Wednesday
2021,5,26,700,89,53,142,Wednesday
2021,5,26,600,71,39,110,Wednesday
2021,5,26,500,25,36,61,Wednesday
2021,5,26,400,24,29,53,Wednesday
2021,5,26,300,25,57,82,Wednesday
2021,5,26,200,28,54,82,Wednesday
2021,5,26,100,29,60,89,Wednesday
2021,5,25,2400,55,72,127,Tuesday
2021,5,25,2300,59,99,158,Tuesday
2021,5,25,2200,97,118,215,Tuesday
2021,5,25,2100,96,170,266,Tuesday
2021,5,25,2000,133,199,332,Tuesday
2021,5,25,1900,148,262,410,Tuesday
2021,5,25,1800,179,266,445,Tuesday
2021,5,25,1700,203,309,512,Tuesday
2021,5,25,1600,244,268,512,Tuesday
2021,5,25,1500,279,217,496,Tuesday
2021,5,25,1400,294,227,521,Tuesday
2021,5,25,1300,288,358,646,Tuesday
2021,5,25,1200,294,264,558,Tuesday
2021,5,25,1100,342,158,500,Tuesday
2021,5,25,1000,307,112,419,Tuesday
2021,5,25,900,247,94,341,Tuesday
2021,5,25,800,178,72,250,Tuesday
2021,5,25,700,107,51,158,Tuesday
2021,5,25,600,50,19,69,Tuesday
2021,5,25,500,24,21,45,Tuesday
2021,5,25,400,15,20,35,Tuesday
2021,5,25,300,18,27,45,Tuesday
2021,5,25,200,13,38,51,Tuesday
2021,5,25,100,32,43,75,Tuesday
2021,5,24,2400,33,89,122,Monday
2021,5,24,2300,39,105,144,Monday
2021,5,24,2200,34,159,193,Monday
2021,5,24,2100,93,267,360,Monday
2021,5,24,2000,92,440,532,Monday
2021,5,24,1900,134,589,723,Monday
2021,5,24,1800,177,717,894,Monday
2021,5,24,1700,219,849,1068,Monday
2021,5,24,1600,213,910,1123,Monday
2021,5,24,1500,322,1009,1331,Monday
2021,5,24,1400,306,907,1213,Monday
2021,5,24,1300,373,766,1139,Monday
2021,5,24,1200,359,521,880,Monday
2021,5,24,1100,294,314,608,Monday
2021,5,24,1000,221,155,376,Monday
2021,5,24,900,164,76,240,Monday
2021,5,24,800,122,32,154,Monday
2021,5,24,700,68,20,88,Monday
2021,5,24,600,29,13,42,Monday
2021,5,24,500,15,10,25,Monday
2021,5,24,400,9,27,36,Monday
2021,5,24,300,16,14,30,Monday
2021,5,24,200,14,22,36,Monday
2021,5,24,100,20,37,57,Monday
2021,5,23,2400,27,68,95,Sunday
2021,5,23,2300,38,121,159,Sunday
2021,5,23,2200,46,175,221,Sunday
2021,5,23,2100,65,278,343,Sunday
2021,5,23,2000,106,393,499,Sunday
2021,5,23,1900,117,461,578,Sunday
2021,5,23,1800,194,588,782,Sunday
2021,5,23,1700,250,611,861,Sunday
2021,5,23,1600,278,553,831,Sunday
2021,5,23,1500,334,489,823,Sunday
2021,5,23,1400,384,445,829,Sunday
2021,5,23,1300,479,365,844,Sunday
2021,5,23,1200,457,266,723,Sunday
2021,5,23,1100,433,162,595,Sunday
2021,5,23,1000,306,106,412,Sunday
2021,5,23,900,238,69,307,Sunday
2021,5,23,800,139,31,170,Sunday
2021,5,23,700,81,32,113,Sunday
2021,5,23,600,30,14,44,Sunday
2021,5,23,500,21,23,44,Sunday
2021,5,23,400,21,25,46,Sunday
2021,5,23,300,19,31,50,Sunday
2021,5,23,200,15,42,57,Sunday
2021,5,23,100,28,51,79,Sunday
2021,5,22,2400,30,68,98,Saturday
2021,5,22,2300,47,113,160,Saturday
2021,5,22,2200,58,196,254,Saturday
2021,5,22,2100,125,244,369,Saturday
2021,5,22,2000,158,347,505,Saturday
2021,5,22,1900,205,403,608,Saturday
2021,5,22,1800,238,497,735,Saturday
2021,5,22,1700,301,501,802,Saturday
2021,5,22,1600,358,466,824,Saturday
2021,5,22,1500,495,420,915,Saturday
2021,5,22,1400,529,309,838,Saturday
2021,5,22,1300,592,253,845,Saturday
2021,5,22,1200,655,195,850,Saturday
2021,5,22,1100,669,179,848,Saturday
2021,5,22,1000,502,123,625,Saturday
2021,5,22,900,358,100,458,Saturday
2021,5,22,800,241,60,301,Saturday
2021,5,22,700,107,41,148,Saturday
2021,5,22,600,62,34,96,Saturday
2021,5,22,500,36,34,70,Saturday
2021,5,22,400,38,25,63,Saturday
2021,5,22,300,24,45,69,Saturday
2021,5,22,200,31,46,77,Saturday
2021,5,22,100,51,52,103,Saturday
2021,5,21,2400,65,67,132,Friday
2021,5,21,2300,100,105,205,Friday
2021,5,21,2200,143,119,262,Friday
2021,5,21,2100,274,155,429,Friday
2021,5,21,2000,398,218,616,Friday
2021,5,21,1900,506,240,746,Friday
2021,5,21,1800,560,260,820,Friday
2021,5,21,1700,516,303,819,Friday
2021,5,21,1600,501,287,788,Friday
2021,5,21,1500,523,319,842,Friday
2021,5,21,1400,467,305,772,Friday
2021,5,21,1300,498,205,703,Friday
2021,5,21,1200,535,168,703,Friday
2021,5,21,1100,391,153,544,Friday
2021,5,21,1000,294,107,401,Friday
2021,5,21,900,236,112,348,Friday
2021,5,21,800,187,79,266,Friday
2021,5,21,700,103,53,156,Friday
2021,5,21,600,69,34,103,Friday
2021,5,21,500,40,30,70,Friday
2021,5,21,400,36,57,93,Friday
2021,5,21,300,23,43,66,Friday
2021,5,21,200,33,72,105,Friday
2021,5,21,100,48,37,85,Friday
2021,5,20,2400,62,53,115,Thursday
2021,5,20,2300,88,86,174,Thursday
2021,5,20,2200,134,127,261,Thursday
2021,5,20,2100,192,151,343,Thursday
2021,5,20,2000,336,193,529,Thursday
2021,5,20,1900,418,229,647,Thursday
2021,5,20,1800,434,272,706,Thursday
2021,5,20,1700,391,221,612,Thursday
2021,5,20,1600,380,228,608,Thursday
2021,5,20,1500,395,153,548,Thursday
2021,5,20,1400,356,198,554,Thursday
2021,5,20,1300,323,196,519,Thursday
2021,5,20,1200,289,173,462,Thursday
2021,5,20,1100,251,123,374,Thursday
2021,5,20,1000,211,117,328,Thursday
2021,5,20,900,203,81,284,Thursday
2021,5,20,800,155,60,215,Thursday
2021,5,20,700,100,56,156,Thursday
2021,5,20,600,48,33,81,Thursday
2021,5,20,500,41,38,79,Thursday
2021,5,20,400,24,32,56,Thursday
2021,5,20,300,26,45,71,Thursday
2021,5,20,200,25,56,81,Thursday
2021,5,20,100,48,78,126,Thursday
2021,5,19,2400,63,54,117,Wednesday
2021,5,19,2300,54,104,158,Wednesday
2021,5,19,2200,94,115,209,Wednesday
2021,5,19,2100,128,135,263,Wednesday
2021,5,19,2000,159,126,285,Wednesday
2021,5,19,1900,216,176,392,Wednesday
2021,5,19,1800,253,256,509,Wednesday
2021,5,19,1700,244,215,459,Wednesday
2021,5,19,1600,258,208,466,Wednesday
2021,5,19,1500,247,235,482,Wednesday
2021,5,19,1400,243,185,428,Wednesday
2021,5,19,1300,260,185,445,Wednesday
2021,5,19,1200,263,162,425,Wednesday
2021,5,19,1100,241,119,360,Wednesday
2021,5,19,1000,204,115,319,Wednesday
2021,5,19,900,191,107,298,Wednesday
2021,5,19,800,137,80,217,Wednesday
2021,5,19,700,100,52,152,Wednesday
2021,5,19,600,45,39,84,Wednesday
2021,5,19,500,25,38,63,Wednesday
2021,5,19,400,31,46,77,Wednesday
2021,5,19,300,12,51,63,Wednesday
2021,5,19,200,24,49,73,Wednesday
2021,5,19,100,44,54,98,Wednesday
2021,5,18,2400,45,57,102,Tuesday
2021,5,18,2300,68,79,147,Tuesday
2021,5,18,2200,84,129,213,Tuesday
2021,5,18,2100,107,117,224,Tuesday
2021,5,18,2000,141,153,294,Tuesday
2021,5,18,1900,182,196,378,Tuesday
2021,5,18,1800,173,279,452,Tuesday
2021,5,18,1700,205,264,469,Tuesday
2021,5,18,1600,211,186,397,Tuesday
2021,5,18,1500,217,250,467,Tuesday
2021,5,18,1400,230,229,459,Tuesday
2021,5,18,1300,237,206,443,Tuesday
2021,5,18,1200,269,181,450,Tuesday
2021,5,18,1100,214,133,347,Tuesday
2021,5,18,1000,192,126,318,Tuesday
2021,5,18,900,169,102,271,Tuesday
2021,5,18,800,139,68,207,Tuesday
2021,5,18,700,96,53,149,Tuesday
2021,5,18,600,46,36,82,Tuesday
2021,5,18,500,27,28,55,Tuesday
2021,5,18,400,21,45,66,Tuesday
2021,5,18,300,26,29,55,Tuesday
2021,5,18,200,17,45,62,Tuesday
2021,5,18,100,46,61,107,Tuesday
2021,5,17,2400,40,76,116,Monday
2021,5,17,2300,67,114,181,Monday
2021,5,17,2200,69,109,178,Monday
2021,5,17,2100,90,144,234,Monday
2021,5,17,2000,142,220,362,Monday
2021,5,17,1900,179,214,393,Monday
2021,5,17,1800,196,288,484,Monday
2021,5,17,1700,185,319,504,Monday
2021,5,17,1600,209,287,496,Monday
2021,5,17,1500,289,263,552,Monday
2021,5,17,1400,267,212,479,Monday
2021,5,17,1300,310,167,477,Monday
2021,5,17,1200,309,180,489,Monday
2021,5,17,1100,257,121,378,Monday
2021,5,17,1000,230,99,329,Monday
2021,5,17,900,172,115,287,Monday
2021,5,17,800,136,95,231,Monday
2021,5,17,700,78,54,132,Monday
2021,5,17,600,58,17,75,Monday
2021,5,17,500,33,19,52,Monday
2021,5,17,400,24,24,48,Monday
2021,5,17,300,17,27,44,Monday
2021,5,17,200,18,31,49,Monday
2021,5,17,100,25,29,54,Monday
2021,5,16,2400,38,34,72,Sunday
2021,5,16,2300,58,115,173,Sunday
2021,5,16,2200,55,177,232,Sunday
2021,5,16,2100,95,279,374,Sunday
2021,5,16,2000,112,391,503,Sunday
2021,5,16,1900,176,466,642,Sunday
2021,5,16,1800,191,498,689,Sunday
2021,5,16,1700,219,535,754,Sunday
2021,5,16,1600,259,519,778,Sunday
2021,5,16,1500,304,455,759,Sunday
2021,5,16,1400,338,358,696,Sunday
2021,5,16,1300,413,297,710,Sunday
2021,5,16,1200,391,230,621,Sunday
2021,5,16,1100,336,155,491,Sunday
2021,5,16,1000,311,122,433,Sunday
2021,5,16,900,216,74,290,Sunday
2021,5,16,800,133,30,163,Sunday
2021,5,16,700,78,26,104,Sunday
2021,5,16,600,26,13,39,Sunday
2021,5,16,500,17,16,33,Sunday
2021,5,16,400,16,24,40,Sunday
2021,5,16,300,11,16,27,Sunday
2021,5,16,200,10,28,38,Sunday
2021,5,16,100,22,23,45,Sunday
2021,5,15,2400,35,25,60,Saturday
2021,5,15,2300,35,95,130,Saturday
2021,5,15,2200,57,104,161,Saturday
2021,5,15,2100,92,204,296,Saturday
2021,5,15,2000,114,234,348,Saturday
2021,5,15,1900,167,288,455,Saturday
2021,5,15,1800,166,365,531,Saturday
2021,5,15,1700,229,422,651,Saturday
2021,5,15,1600,279,358,637,Saturday
2021,5,15,1500,328,354,682,Saturday
2021,5,15,1400,342,293,635,Saturday
2021,5,15,1300,380,221,601,Saturday
2021,5,15,1200,400,187,587,Saturday
2021,5,15,1100,418,174,592,Saturday
2021,5,15,1000,346,122,468,Saturday
2021,5,15,900,239,101,340,Saturday
2021,5,15,800,196,62,258,Saturday
2021,5,15,700,103,41,144,Saturday
2021,5,15,600,49,45,94,Saturday
2021,5,15,500,26,32,58,Saturday
2021,5,15,400,31,25,56,Saturday
2021,5,15,300,33,33,66,Saturday
2021,5,15,200,34,41,75,Saturday
2021,5,15,100,28,52,80,Saturday
2021,5,14,2400,49,65,114,Friday
2021,5,14,2300,71,66,137,Friday
2021,5,14,2200,92,114,206,Friday
2021,5,14,2100,165,163,328,Friday
2021,5,14,2000,214,178,392,Friday
2021,5,14,1900,322,229,551,Friday
2021,5,14,1800,365,318,683,Friday
2021,5,14,1700,337,307,644,Friday
2021,5,14,1600,335,297,632,Friday
2021,5,14,1500,385,288,673,Friday
2021,5,14,1400,362,240,602,Friday
2021,5,14,1300,337,157,494,Friday
2021,5,14,1200,345,155,500,Friday
2021,5,14,1100,265,144,409,Friday
2021,5,14,1000,226,136,362,Friday
2021,5,14,900,201,101,302,Friday
2021,5,14,800,137,82,219,Friday
2021,5,14,700,106,49,155,Friday
2021,5,14,600,54,27,81,Friday
2021,5,14,500,41,39,80,Friday
2021,5,14,400,33,35,68,Friday
2021,5,14,300,30,39,69,Friday
2021,5,14,200,48,43,91,Friday
2021,5,14,100,34,60,94,Friday
2021,5,13,2400,55,70,125,Thursday
2021,5,13,2300,56,82,138,Thursday
2021,5,13,2200,89,123,212,Thursday
2021,5,13,2100,158,134,292,Thursday
2021,5,13,2000,205,136,341,Thursday
2021,5,13,1900,244,213,457,Thursday
2021,5,13,1800,233,259,492,Thursday
2021,5,13,1700,227,216,443,Thursday
2021,5,13,1600,241,185,426,Thursday
2021,5,13,1500,246,202,448,Thursday
2021,5,13,1400,261,191,452,Thursday
2021,5,13,1300,258,154,412,Thursday
2021,5,13,1200,251,166,417,Thursday
2021,5,13,1100,184,126,310,Thursday
2021,5,13,1000,179,99,278,Thursday
2021,5,13,900,166,114,280,Thursday
2021,5,13,800,132,72,204,Thursday
2021,5,13,700,88,56,144,Thursday
2021,5,13,600,55,25,80,Thursday
2021,5,13,500,37,32,69,Thursday
2021,5,13,400,32,33,65,Thursday
2021,5,13,300,24,44,68,Thursday
2021,5,13,200,30,56,86,Thursday
2021,5,13,100,30,56,86,Thursday
2021,5,12,2400,51,57,108,Wednesday
2021,5,12,2300,75,77,152,Wednesday
2021,5,12,2200,79,91,170,Wednesday
2021,5,12,2100,108,112,220,Wednesday
2021,5,12,2000,156,159,315,Wednesday
2021,5,12,1900,179,185,364,Wednesday
2021,5,12,1800,196,210,406,Wednesday
2021,5,12,1700,219,256,475,Wednesday
2021,5,12,1600,226,232,458,Wednesday
2021,5,12,1500,228,224,452,Wednesday
2021,5,12,1400,223,203,426,Wednesday
2021,5,12,1300,225,150,375,Wednesday
2021,5,12,1200,230,153,383,Wednesday
2021,5,12,1100,203,147,350,Wednesday
2021,5,12,1000,152,127,279,Wednesday
2021,5,12,900,189,103,292,Wednesday
2021,5,12,800,102,79,181,Wednesday
2021,5,12,700,79,49,128,Wednesday
2021,5,12,600,47,41,88,Wednesday
2021,5,12,500,28,28,56,Wednesday
2021,5,12,400,32,41,73,Wednesday
2021,5,12,300,30,37,67,Wednesday
2021,5,12,200,30,60,90,Wednesday
2021,5,12,100,29,52,81,Wednesday
2021,5,11,2400,53,93,146,Tuesday
2021,5,11,2300,65,75,140,Tuesday
2021,5,11,2200,61,99,160,Tuesday
2021,5,11,2100,65,115,180,Tuesday
2021,5,11,2000,128,130,258,Tuesday
2021,5,11,1900,134,177,311,Tuesday
2021,5,11,1800,164,156,320,Tuesday
2021,5,11,1700,165,228,393,Tuesday
2021,5,11,1600,194,209,403,Tuesday
2021,5,11,1500,194,193,387,Tuesday
2021,5,11,1400,196,173,369,Tuesday
2021,5,11,1300,211,183,394,Tuesday
2021,5,11,1200,212,131,343,Tuesday
2021,5,11,1100,195,131,326,Tuesday
2021,5,11,1000,174,112,286,Tuesday
2021,5,11,900,167,84,251,Tuesday
2021,5,11,800,125,66,191,Tuesday
2021,5,11,700,83,43,126,Tuesday
2021,5,11,600,36,42,78,Tuesday
2021,5,11,500,43,26,69,Tuesday
2021,5,11,400,20,36,56,Tuesday
2021,5,11,300,21,37,58,Tuesday
2021,5,11,200,27,49,76,Tuesday
2021,5,11,100,39,64,103,Tuesday
2021,5,10,2400,53,50,103,Monday
2021,5,10,2300,44,89,133,Monday
2021,5,10,2200,83,103,186,Monday
2021,5,10,2100,86,125,211,Monday
2021,5,10,2000,112,150,262,Monday
2021,5,10,1900,147,165,312,Monday
2021,5,10,1800,174,217,391,Monday
2021,5,10,1700,188,228,416,Monday
2021,5,10,1600,218,224,442,Monday
2021,5,10,1500,206,188,394,Monday
2021,5,10,1400,257,174,431,Monday
2021,5,10,1300,246,154,400,Monday
2021,5,10,1200,229,128,357,Monday
2021,5,10,1100,214,106,320,Monday
2021,5,10,1000,190,87,277,Monday
2021,5,10,900,145,80,225,Monday
2021,5,10,800,122,45,167,Monday
2021,5,10,700,96,26,122,Monday
2021,5,10,600,45,14,59,Monday
2021,5,10,500,22,17,39,Monday
2021,5,10,400,21,19,40,Monday
2021,5,10,300,17,22,39,Monday
2021,5,10,200,18,34,52,Monday
2021,5,10,100,19,56,75,Monday
2021,5,9,2400,19,72,91,Sunday
2021,5,9,2300,31,86,117,Sunday
2021,5,9,2200,53,124,177,Sunday
2021,5,9,2100,68,160,228,Sunday
2021,5,9,2000,100,182,282,Sunday
2021,5,9,1900,110,195,305,Sunday
2021,5,9,1800,142,273,415,Sunday
2021,5,9,1700,180,289,469,Sunday
2021,5,9,1600,165,298,463,Sunday
2021,5,9,1500,229,261,490,Sunday
2021,5,9,1400,208,218,426,Sunday
2021,5,9,1300,203,219,422,Sunday
2021,5,9,1200,225,196,421,Sunday
2021,5,9,1100,208,123,331,Sunday
2021,5,9,1000,165,110,275,Sunday
2021,5,9,900,137,82,219,Sunday
2021,5,9,800,108,43,151,Sunday
2021,5,9,700,71,24,95,Sunday
2021,5,9,600,37,19,56,Sunday
2021,5,9,500,12,25,37,Sunday
2021,5,9,400,15,13,28,Sunday
2021,5,9,300,17,37,54,Sunday
2021,5,9,200,15,28,43,Sunday
2021,5,9,100,16,40,56,Sunday
2021,5,8,2400,20,126,146,Saturday
2021,5,8,2300,31,101,132,Saturday
2021,5,8,2200,38,266,304,Saturday
2021,5,8,2100,65,168,233,Saturday
2021,5,8,2000,87,70,157,Saturday
2021,5,8,1900,96,93,189,Saturday
2021,5,8,1800,123,130,253,Saturday
2021,5,8,1700,141,146,287,Saturday
2021,5,8,1600,170,162,332,Saturday
2021,5,8,1500,208,149,357,Saturday
2021,5,8,1400,234,101,335,Saturday
2021,5,8,1300,252,129,381,Saturday
2021,5,8,1200,232,146,378,Saturday
2021,5,8,1100,228,179,407,Saturday
2021,5,8,1000,180,92,272,Saturday
2021,5,8,900,164,73,237,Saturday
2021,5,8,800,116,43,159,Saturday
2021,5,8,700,78,42,120,Saturday
2021,5,8,600,41,35,76,Saturday
2021,5,8,500,21,37,58,Saturday
2021,5,8,400,18,25,43,Saturday
2021,5,8,300,16,28,44,Saturday
2021,5,8,200,20,40,60,Saturday
2021,5,8,100,27,51,78,Saturday
2021,5,7,2400,45,53,98,Friday
2021,5,7,2300,43,64,107,Friday
2021,5,7,2200,91,99,190,Friday
2021,5,7,2100,122,127,249,Friday
2021,5,7,2000,157,142,299,Friday
2021,5,7,1900,211,182,393,Friday
2021,5,7,1800,251,216,467,Friday
2021,5,7,1700,269,242,511,Friday
2021,5,7,1600,286,243,529,Friday
2021,5,7,1500,273,225,498,Friday
2021,5,7,1400,241,193,434,Friday
2021,5,7,1300,225,207,432,Friday
2021,5,7,1200,195,170,365,Friday
2021,5,7,1100,228,128,356,Friday
2021,5,7,1000,209,103,312,Friday
2021,5,7,900,178,97,275,Friday
2021,5,7,800,124,84,208,Friday
2021,5,7,700,79,46,125,Friday
2021,5,7,600,37,42,79,Friday
2021,5,7,500,36,38,74,Friday
2021,5,7,400,28,34,62,Friday
2021,5,7,300,30,25,55,Friday
2021,5,7,200,37,32,69,Friday
2021,5,7,100,33,47,80,Friday
2021,5,6,2400,46,69,115,Thursday
2021,5,6,2300,57,89,146,Thursday
2021,5,6,2200,100,110,210,Thursday
2021,5,6,2100,119,138,257,Thursday
2021,5,6,2000,153,151,304,Thursday
2021,5,6,1900,193,175,368,Thursday
2021,5,6,1800,207,209,416,Thursday
2021,5,6,1700,220,233,453,Thursday
2021,5,6,1600,215,251,466,Thursday
2021,5,6,1500,236,216,452,Thursday
2021,5,6,1400,203,197,400,Thursday
2021,5,6,1300,265,183,448,Thursday
2021,5,6,1200,244,154,398,Thursday
2021,5,6,1100,245,133,378,Thursday
2021,5,6,1000,199,112,311,Thursday
2021,5,6,900,163,114,277,Thursday
2021,5,6,800,130,67,197,Thursday
2021,5,6,700,77,52,129,Thursday
2021,5,6,600,48,30,78,Thursday
2021,5,6,500,41,32,73,Thursday
2021,5,6,400,24,35,59,Thursday
2021,5,6,300,28,42,70,Thursday
2021,5,6,200,35,51,86,Thursday
2021,5,6,100,30,54,84,Thursday
2021,5,5,2400,58,59,117,Wednesday
2021,5,5,2300,55,85,140,Wednesday
2021,5,5,2200,98,96,194,Wednesday
2021,5,5,2100,103,141,244,Wednesday
2021,5,5,2000,115,128,243,Wednesday
2021,5,5,1900,141,204,345,Wednesday
2021,5,5,1800,164,268,432,Wednesday
2021,5,5,1700,194,240,434,Wednesday
2021,5,5,1600,185,224,409,Wednesday
2021,5,5,1500,259,229,488,Wednesday
2021,5,5,1400,221,217,438,Wednesday
2021,5,5,1300,249,195,444,Wednesday
2021,5,5,1200,255,173,428,Wednesday
2021,5,5,1100,208,137,345,Wednesday
2021,5,5,1000,190,100,290,Wednesday
2021,5,5,900,184,97,281,Wednesday
2021,5,5,800,136,90,226,Wednesday
2021,5,5,700,81,44,125,Wednesday
2021,5,5,600,49,37,86,Wednesday
2021,5,5,500,34,27,61,Wednesday
2021,5,5,400,31,44,75,Wednesday
2021,5,5,300,30,53,83,Wednesday
2021,5,5,200,36,35,71,Wednesday
2021,5,5,100,28,61,89,Wednesday
2021,5,4,2400,48,59,107,Tuesday
2021,5,4,2300,61,78,139,Tuesday
2021,5,4,2200,76,99,175,Tuesday
2021,5,4,2100,89,119,208,Tuesday
2021,5,4,2000,106,144,250,Tuesday
2021,5,4,1900,127,177,304,Tuesday
2021,5,4,1800,162,206,368,Tuesday
2021,5,4,1700,168,231,399,Tuesday
2021,5,4,1600,184,235,419,Tuesday
2021,5,4,1500,224,196,420,Tuesday
2021,5,4,1400,242,202,444,Tuesday
2021,5,4,1300,202,212,414,Tuesday
2021,5,4,1200,200,166,366,Tuesday
2021,5,4,1100,209,121,330,Tuesday
2021,5,4,1000,182,121,303,Tuesday
2021,5,4,900,179,96,275,Tuesday
2021,5,4,800,132,71,203,Tuesday
2021,5,4,700,76,60,136,Tuesday
2021,5,4,600,39,27,66,Tuesday
2021,5,4,500,35,24,59,Tuesday
2021,5,4,400,21,51,72,Tuesday
2021,5,4,300,14,47,61,Tuesday
2021,5,4,200,30,48,78,Tuesday
2021,5,4,100,48,65,113,Tuesday
2021,5,3,2400,41,61,102,Monday
2021,5,3,2300,43,62,105,Monday
2021,5,3,2200,55,87,142,Monday
2021,5,3,2100,94,125,219,Monday
2021,5,3,2000,109,151,260,Monday
2021,5,3,1900,111,204,315,Monday
2021,5,3,1800,173,266,439,Monday
2021,5,3,1700,179,221,400,Monday
2021,5,3,1600,202,211,413,Monday
2021,5,3,1500,238,207,445,Monday
2021,5,3,1400,261,206,467,Monday
2021,5,3,1300,257,174,431,Monday
2021,5,3,1200,235,113,348,Monday
2021,5,3,1100,232,135,367,Monday
2021,5,3,1000,232,93,325,Monday
2021,5,3,900,166,82,248,Monday
2021,5,3,800,131,63,194,Monday
2021,5,3,700,94,40,134,Monday
2021,5,3,600,37,21,58,Monday
2021,5,3,500,25,21,46,Monday
2021,5,3,400,21,22,43,Monday
2021,5,3,300,15,38,53,Monday
2021,5,3,200,25,55,80,Monday
2021,5,3,100,23,57,80,Monday
2021,5,2,2400,33,101,134,Sunday
2021,5,2,2300,41,178,219,Sunday
2021,5,2,2200,61,141,202,Sunday
2021,5,2,2100,75,59,134,Sunday
2021,5,2,2000,104,236,340,Sunday
2021,5,2,1900,126,437,563,Sunday
2021,5,2,1800,170,826,996,Sunday
2021,5,2,1700,188,740,928,Sunday
2021,5,2,1600,208,579,787,Sunday
2021,5,2,1500,226,417,643,Sunday
2021,5,2,1400,278,311,589,Sunday
2021,5,2,1300,347,252,599,Sunday
2021,5,2,1200,507,241,748,Sunday
2021,5,2,1100,500,132,632,Sunday
2021,5,2,1000,530,96,626,Sunday
2021,5,2,900,415,53,468,Sunday
2021,5,2,800,247,23,270,Sunday
2021,5,2,700,84,21,105,Sunday
2021,5,2,600,52,25,77,Sunday
2021,5,2,500,28,19,47,Sunday
2021,5,2,400,21,26,47,Sunday
2021,5,2,300,26,42,68,Sunday
2021,5,2,200,20,32,52,Sunday
2021,5,2,100,21,42,63,Sunday
2021,5,1,2400,21,51,72,Saturday
2021,5,1,2300,39,96,135,Saturday
2021,5,1,2200,48,98,146,Saturday
2021,5,1,2100,67,132,199,Saturday
2021,5,1,2000,93,194,287,Saturday
2021,5,1,1900,112,235,347,Saturday
2021,5,1,1800,122,480,602,Saturday
2021,5,1,1700,182,449,631,Saturday
2021,5,1,1600,253,400,653,Saturday
2021,5,1,1500,259,365,624,Saturday
2021,5,1,1400,272,354,626,Saturday
2021,5,1,1300,342,257,599,Saturday
2021,5,1,1200,411,169,580,Saturday
2021,5,1,1100,441,157,598,Saturday
2021,5,1,1000,466,107,573,Saturday
2021,5,1,900,353,94,447,Saturday
2021,5,1,800,181,70,251,Saturday
2021,5,1,700,103,31,134,Saturday
2021,5,1,600,41,34,75,Saturday
2021,5,1,500,20,27,47,Saturday
2021,5,1,400,22,27,49,Saturday
2021,5,1,300,20,29,49,Saturday
2021,5,1,200,19,52,71,Saturday
2021,5,1,100,39,43,82,Saturday
2021,4,30,2400,44,69,113,Friday
2021,4,30,2300,69,97,166,Friday
2021,4,30,2200,152,130,282,Friday
2021,4,30,2100,114,170,284,Friday
2021,4,30,2000,112,236,348,Friday
2021,4,30,1900,235,268,503,Friday
2021,4,30,1800,270,354,624,Friday
2021,4,30,1700,325,429,754,Friday
2021,4,30,1600,271,450,721,Friday
2021,4,30,1500,296,304,600,Friday
2021,4,30,1400,313,236,549,Friday
2021,4,30,1300,341,219,560,Friday
2021,4,30,1200,376,193,569,Friday
2021,4,30,1100,391,163,554,Friday
2021,4,30,1000,352,157,509,Friday
2021,4,30,900,311,93,404,Friday
2021,4,30,800,176,64,240,Friday
2021,4,30,700,108,54,162,Friday
2021,4,30,600,50,37,87,Friday
2021,4,30,500,36,33,69,Friday
2021,4,30,400,34,36,70,Friday
2021,4,30,300,28,41,69,Friday
2021,4,30,200,34,59,93,Friday
2021,4,30,100,25,53,78,Friday
2021,4,29,2400,42,70,112,Thursday
2021,4,29,2300,69,88,157,Thursday
2021,4,29,2200,87,104,191,Thursday
2021,4,29,2100,112,163,275,Thursday
2021,4,29,2000,155,144,299,Thursday
2021,4,29,1900,176,222,398,Thursday
2021,4,29,1800,236,291,527,Thursday
2021,4,29,1700,220,391,611,Thursday
2021,4,29,1600,230,349,579,Thursday
2021,4,29,1500,228,280,508,Thursday
2021,4,29,1400,241,205,446,Thursday
2021,4,29,1300,252,193,445,Thursday
2021,4,29,1200,312,170,482,Thursday
2021,4,29,1100,294,131,425,Thursday
2021,4,29,1000,319,122,441,Thursday
2021,4,29,900,295,89,384,Thursday
2021,4,29,800,157,79,236,Thursday
2021,4,29,700,86,65,151,Thursday
2021,4,29,600,48,29,77,Thursday
2021,4,29,500,29,20,49,Thursday
2021,4,29,400,19,48,67,Thursday
2021,4,29,300,21,38,59,Thursday
2021,4,29,200,28,38,66,Thursday
2021,4,29,100,32,67,99,Thursday
2021,4,28,2400,41,63,104,Wednesday
2021,4,28,2300,73,94,167,Wednesday
2021,4,28,2200,82,102,184,Wednesday
2021,4,28,2100,91,139,230,Wednesday
2021,4,28,2000,114,184,298,Wednesday
2021,4,28,1900,163,201,364,Wednesday
2021,4,28,1800,151,303,454,Wednesday
2021,4,28,1700,192,343,535,Wednesday
2021,4,28,1600,194,277,471,Wednesday
2021,4,28,1500,230,256,486,Wednesday
2021,4,28,1400,205,249,454,Wednesday
2021,4,28,1300,286,189,475,Wednesday
2021,4,28,1200,321,167,488,Wednesday
2021,4,28,1100,319,130,449,Wednesday
2021,4,28,1000,270,105,375,Wednesday
2021,4,28,900,242,92,334,Wednesday
2021,4,28,800,148,80,228,Wednesday
2021,4,28,700,79,65,144,Wednesday
2021,4,28,600,45,37,82,Wednesday
2021,4,28,500,29,35,64,Wednesday
2021,4,28,400,35,39,74,Wednesday
2021,4,28,300,33,47,80,Wednesday
2021,4,28,200,25,60,85,Wednesday
2021,4,28,100,17,63,80,Wednesday
2021,4,27,2400,42,73,115,Tuesday
2021,4,27,2300,54,83,137,Tuesday
2021,4,27,2200,67,92,159,Tuesday
2021,4,27,2100,74,132,206,Tuesday
2021,4,27,2000,120,173,293,Tuesday
2021,4,27,1900,150,242,392,Tuesday
2021,4,27,1800,172,345,517,Tuesday
2021,4,27,1700,187,396,583,Tuesday
2021,4,27,1600,188,312,500,Tuesday
2021,4,27,1500,221,263,484,Tuesday
2021,4,27,1400,211,246,457,Tuesday
2021,4,27,1300,238,207,445,Tuesday
2021,4,27,1200,291,181,472,Tuesday
2021,4,27,1100,322,148,470,Tuesday
2021,4,27,1000,291,118,409,Tuesday
2021,4,27,900,247,94,341,Tuesday
2021,4,27,800,124,65,189,Tuesday
2021,4,27,700,86,43,129,Tuesday
2021,4,27,600,51,53,104,Tuesday
2021,4,27,500,39,24,63,Tuesday
2021,4,27,400,21,28,49,Tuesday
2021,4,27,300,23,32,55,Tuesday
2021,4,27,200,25,43,68,Tuesday
2021,4,27,100,37,59,96,Tuesday
2021,4,26,2400,51,66,117,Monday
2021,4,26,2300,60,101,161,Monday
2021,4,26,2200,78,104,182,Monday
2021,4,26,2100,83,165,248,Monday
2021,4,26,2000,106,153,259,Monday
2021,4,26,1900,149,232,381,Monday
2021,4,26,1800,171,446,617,Monday
2021,4,26,1700,179,503,682,Monday
2021,4,26,1600,233,406,639,Monday
2021,4,26,1500,238,301,539,Monday
2021,4,26,1400,224,240,464,Monday
2021,4,26,1300,268,212,480,Monday
2021,4,26,1200,342,169,511,Monday
2021,4,26,1100,369,115,484,Monday
2021,4,26,1000,442,104,546,Monday
2021,4,26,900,378,74,452,Monday
2021,4,26,800,183,45,228,Monday
2021,4,26,700,104,22,126,Monday
2021,4,26,600,38,24,62,Monday
2021,4,26,500,29,19,48,Monday
2021,4,26,400,23,29,52,Monday
2021,4,26,300,24,22,46,Monday
2021,4,26,200,16,44,60,Monday
2021,4,26,100,25,40,65,Monday
2021,4,25,2400,30,60,90,Sunday
2021,4,25,2300,45,96,141,Sunday
2021,4,25,2200,57,100,157,Sunday
2021,4,25,2100,75,160,235,Sunday
2021,4,25,2000,104,198,302,Sunday
2021,4,25,1900,111,243,354,Sunday
2021,4,25,1800,117,550,667,Sunday
2021,4,25,1700,137,747,884,Sunday
2021,4,25,1600,196,590,786,Sunday
2021,4,25,1500,183,418,601,Sunday
2021,4,25,1400,213,352,565,Sunday
2021,4,25,1300,250,228,478,Sunday
2021,4,25,1200,327,177,504,Sunday
2021,4,25,1100,385,127,512,Sunday
2021,4,25,1000,418,84,502,Sunday
2021,4,25,900,476,43,519,Sunday
2021,4,25,800,267,28,295,Sunday
2021,4,25,700,83,21,104,Sunday
2021,4,25,600,26,14,40,Sunday
2021,4,25,500,19,16,35,Sunday
2021,4,25,400,19,21,40,Sunday
2021,4,25,300,25,27,52,Sunday
2021,4,25,200,18,30,48,Sunday
2021,4,25,100,17,30,47,Sunday
2021,4,24,2400,17,41,58,Saturday
2021,4,24,2300,16,76,92,Saturday
2021,4,24,2200,36,100,136,Saturday
2021,4,24,2100,50,112,162,Saturday
2021,4,24,2000,78,179,257,Saturday
2021,4,24,1900,96,273,369,Saturday
2021,4,24,1800,129,563,692,Saturday
2021,4,24,1700,164,695,859,Saturday
2021,4,24,1600,177,426,603,Saturday
2021,4,24,1500,176,363,539,Saturday
2021,4,24,1400,225,294,519,Saturday
2021,4,24,1300,272,229,501,Saturday
2021,4,24,1200,313,153,466,Saturday
2021,4,24,1100,343,144,487,Saturday
2021,4,24,1000,479,100,579,Saturday
2021,4,24,900,547,66,613,Saturday
2021,4,24,800,312,66,378,Saturday
2021,4,24,700,87,36,123,Saturday
2021,4,24,600,35,43,78,Saturday
2021,4,24,500,26,30,56,Saturday
2021,4,24,400,24,38,62,Saturday
2021,4,24,300,17,35,52,Saturday
2021,4,24,200,26,46,72,Saturday
2021,4,24,100,30,69,99,Saturday
2021,4,23,2400,37,69,106,Friday
2021,4,23,2300,47,83,130,Friday
2021,4,23,2200,59,93,152,Friday
2021,4,23,2100,91,138,229,Friday
2021,4,23,2000,129,193,322,Friday
2021,4,23,1900,168,234,402,Friday
2021,4,23,1800,222,304,526,Friday
2021,4,23,1700,260,429,689,Friday
2021,4,23,1600,240,370,610,Friday
2021,4,23,1500,254,293,547,Friday
2021,4,23,1400,240,242,482,Friday
2021,4,23,1300,248,232,480,Friday
2021,4,23,1200,261,181,442,Friday
2021,4,23,1100,279,165,444,Friday
2021,4,23,1000,314,97,411,Friday
2021,4,23,900,297,100,397,Friday
2021,4,23,800,174,67,241,Friday
2021,4,23,700,89,55,144,Friday
2021,4,23,600,41,32,73,Friday
2021,4,23,500,38,34,72,Friday
2021,4,23,400,27,39,66,Friday
2021,4,23,300,26,68,94,Friday
2021,4,23,200,33,26,59,Friday
2021,4,23,100,38,52,90,Friday
2021,4,22,2400,39,97,136,Thursday
2021,4,22,2300,67,88,155,Thursday
2021,4,22,2200,83,90,173,Thursday
2021,4,22,2100,119,178,297,Thursday
2021,4,22,2000,164,158,322,Thursday
2021,4,22,1900,201,230,431,Thursday
2021,4,22,1800,238,292,530,Thursday
2021,4,22,1700,263,327,590,Thursday
2021,4,22,1600,273,298,571,Thursday
2021,4,22,1500,258,221,479,Thursday
2021,4,22,1400,243,239,482,Thursday
2021,4,22,1300,233,215,448,Thursday
2021,4,22,1200,266,173,439,Thursday
2021,4,22,1100,266,177,443,Thursday
2021,4,22,1000,254,106,360,Thursday
2021,4,22,900,257,93,350,Thursday
2021,4,22,800,180,66,246,Thursday
2021,4,22,700,81,46,127,Thursday
2021,4,22,600,43,29,72,Thursday
2021,4,22,500,33,36,69,Thursday
2021,4,22,400,31,39,70,Thursday
2021,4,22,300,31,32,63,Thursday
2021,4,22,200,39,53,92,Thursday
2021,4,22,100,44,55,99,Thursday
2021,4,21,2400,64,69,133,Wednesday
2021,4,21,2300,49,200,249,Wednesday
2021,4,21,2200,110,73,183,Wednesday
2021,4,21,2100,106,211,317,Wednesday
2021,4,21,2000,144,305,449,Wednesday
2021,4,21,1900,149,353,502,Wednesday
2021,4,21,1800,205,326,531,Wednesday
2021,4,21,1700,211,388,599,Wednesday
2021,4,21,1600,228,330,558,Wednesday
2021,4,21,1500,279,360,639,Wednesday
2021,4,21,1400,260,252,512,Wednesday
2021,4,21,1300,318,219,537,Wednesday
2021,4,21,1200,417,211,628,Wednesday
2021,4,21,1100,365,151,516,Wednesday
2021,4,21,1000,394,124,518,Wednesday
2021,4,21,900,290,93,383,Wednesday
2021,4,21,800,174,85,259,Wednesday
2021,4,21,700,106,49,155,Wednesday
2021,4,21,600,59,29,88,Wednesday
2021,4,21,500,37,31,68,Wednesday
2021,4,21,400,43,53,96,Wednesday
2021,4,21,300,28,56,84,Wednesday
2021,4,21,200,29,57,86,Wednesday
2021,4,21,100,34,66,100,Wednesday
2021,4,20,2400,54,85,139,Tuesday
2021,4,20,2300,56,93,149,Tuesday
2021,4,20,2200,63,103,166,Tuesday
2021,4,20,2100,102,149,251,Tuesday
2021,4,20,2000,123,206,329,Tuesday
2021,4,20,1900,162,247,409,Tuesday
2021,4,20,1800,172,379,551,Tuesday
2021,4,20,1700,195,414,609,Tuesday
2021,4,20,1600,228,370,598,Tuesday
2021,4,20,1500,211,306,517,Tuesday
2021,4,20,1400,259,235,494,Tuesday
2021,4,20,1300,275,186,461,Tuesday
2021,4,20,1200,336,206,542,Tuesday
2021,4,20,1100,348,164,512,Tuesday
2021,4,20,1000,316,117,433,Tuesday
2021,4,20,900,269,92,361,Tuesday
2021,4,20,800,186,74,260,Tuesday
2021,4,20,700,98,42,140,Tuesday
2021,4,20,600,67,30,97,Tuesday
2021,4,20,500,39,40,79,Tuesday
2021,4,20,400,23,44,67,Tuesday
2021,4,20,300,26,50,76,Tuesday
2021,4,20,200,31,49,80,Tuesday
2021,4,20,100,29,58,87,Tuesday
2021,4,19,2400,49,58,107,Monday
2021,4,19,2300,54,93,147,Monday
2021,4,19,2200,75,105,180,Monday
2021,4,19,2100,84,147,231,Monday
2021,4,19,2000,113,190,303,Monday
2021,4,19,1900,147,249,396,Monday
2021,4,19,1800,167,417,584,Monday
2021,4,19,1700,205,487,692,Monday
2021,4,19,1600,232,366,598,Monday
2021,4,19,1500,262,272,534,Monday
2021,4,19,1400,270,247,517,Monday
2021,4,19,1300,256,216,472,Monday
2021,4,19,1200,322,192,514,Monday
2021,4,19,1100,358,172,530,Monday
2021,4,19,1000,369,98,467,Monday
2021,4,19,900,316,89,405,Monday
2021,4,19,800,177,59,236,Monday
2021,4,19,700,90,37,127,Monday
2021,4,19,600,41,19,60,Monday
2021,4,19,500,19,23,42,Monday
2021,4,19,400,17,23,40,Monday
2021,4,19,300,16,35,51,Monday
2021,4,19,200,15,30,45,Monday
2021,4,19,100,24,45,69,Monday
2021,4,18,2400,30,62,92,Sunday
2021,4,18,2300,37,76,113,Sunday
2021,4,18,2200,43,114,157,Sunday
2021,4,18,2100,67,172,239,Sunday
2021,4,18,2000,74,214,288,Sunday
2021,4,18,1900,92,301,393,Sunday
2021,4,18,1800,146,412,558,Sunday
2021,4,18,1700,167,667,834,Sunday
2021,4,18,1600,184,641,825,Sunday
2021,4,18,1500,204,589,793,Sunday
2021,4,18,1400,240,530,770,Sunday
2021,4,18,1300,239,464,703,Sunday
2021,4,18,1200,286,372,658,Sunday
2021,4,18,1100,296,216,512,Sunday
2021,4,18,1000,345,127,472,Sunday
2021,4,18,900,404,76,480,Sunday
2021,4,18,800,261,29,290,Sunday
2021,4,18,700,89,15,104,Sunday
2021,4,18,600,43,12,55,Sunday
2021,4,18,500,17,17,34,Sunday
2021,4,18,400,12,36,48,Sunday
2021,4,18,300,18,29,47,Sunday
2021,4,18,200,19,43,62,Sunday
2021,4,18,100,19,51,70,Sunday
2021,4,17,2400,33,91,124,Saturday
2021,4,17,2300,38,87,125,Saturday
2021,4,17,2200,48,145,193,Saturday
2021,4,17,2100,87,258,345,Saturday
2021,4,17,2000,99,281,380,Saturday
2021,4,17,1900,180,428,608,Saturday
2021,4,17,1800,167,804,971,Saturday
2021,4,17,1700,248,895,1143,Saturday
2021,4,17,1600,291,553,844,Saturday
2021,4,17,1500,365,445,810,Saturday
2021,4,17,1400,365,348,713,Saturday
2021,4,17,1300,488,302,790,Saturday
2021,4,17,1200,572,227,799,Saturday
2021,4,17,1100,636,145,781,Saturday
2021,4,17,1000,650,146,796,Saturday
2021,4,17,900,621,87,708,Saturday
2021,4,17,800,411,46,457,Saturday
2021,4,17,700,115,43,158,Saturday
2021,4,17,600,52,39,91,Saturday
2021,4,17,500,31,38,69,Saturday
2021,4,17,400,26,40,66,Saturday
2021,4,17,300,28,37,65,Saturday
2021,4,17,200,23,63,86,Saturday
2021,4,17,100,38,73,111,Saturday
2021,4,16,2400,56,68,124,Friday
2021,4,16,2300,77,114,191,Friday
2021,4,16,2200,109,115,224,Friday
2021,4,16,2100,163,185,348,Friday
2021,4,16,2000,299,236,535,Friday
2021,4,16,1900,357,288,645,Friday
2021,4,16,1800,373,464,837,Friday
2021,4,16,1700,413,500,913,Friday
2021,4,16,1600,381,483,864,Friday
2021,4,16,1500,369,271,640,Friday
2021,4,16,1400,392,267,659,Friday
2021,4,16,1300,420,251,671,Friday
2021,4,16,1200,449,211,660,Friday
2021,4,16,1100,440,165,605,Friday
2021,4,16,1000,469,133,602,Friday
2021,4,16,900,400,95,495,Friday
2021,4,16,800,278,84,362,Friday
2021,4,16,700,105,42,147,Friday
2021,4,16,600,58,25,83,Friday
2021,4,16,500,39,41,80,Friday
2021,4,16,400,26,35,61,Friday
2021,4,16,300,33,38,71,Friday
2021,4,16,200,25,39,64,Friday
2021,4,16,100,28,66,94,Friday
2021,4,15,2400,55,69,124,Thursday
2021,4,15,2300,68,98,166,Thursday
2021,4,15,2200,107,123,230,Thursday
2021,4,15,2100,141,153,294,Thursday
2021,4,15,2000,190,173,363,Thursday
2021,4,15,1900,245,229,474,Thursday
2021,4,15,1800,297,502,799,Thursday
2021,4,15,1700,280,555,835,Thursday
2021,4,15,1600,292,372,664,Thursday
2021,4,15,1500,298,293,591,Thursday
2021,4,15,1400,270,254,524,Thursday
2021,4,15,1300,342,201,543,Thursday
2021,4,15,1200,412,162,574,Thursday
2021,4,15,1100,427,152,579,Thursday
2021,4,15,1000,442,133,575,Thursday
2021,4,15,900,444,79,523,Thursday
2021,4,15,800,236,74,310,Thursday
2021,4,15,700,100,49,149,Thursday
2021,4,15,600,59,23,82,Thursday
2021,4,15,500,30,34,64,Thursday
2021,4,15,400,43,33,76,Thursday
2021,4,15,300,47,41,88,Thursday
2021,4,15,200,40,51,91,Thursday
2021,4,15,100,57,70,127,Thursday
2021,4,14,2400,65,87,152,Wednesday
2021,4,14,2300,62,67,129,Wednesday
2021,4,14,2200,98,110,208,Wednesday
2021,4,14,2100,108,154,262,Wednesday
2021,4,14,2000,136,199,335,Wednesday
2021,4,14,1900,149,232,381,Wednesday
2021,4,14,1800,166,404,570,Wednesday
2021,4,14,1700,197,539,736,Wednesday
2021,4,14,1600,222,371,593,Wednesday
2021,4,14,1500,228,319,547,Wednesday
2021,4,14,1400,265,231,496,Wednesday
2021,4,14,1300,294,218,512,Wednesday
2021,4,14,1200,356,201,557,Wednesday
2021,4,14,1100,356,149,505,Wednesday
2021,4,14,1000,421,117,538,Wednesday
2021,4,14,900,380,102,482,Wednesday
2021,4,14,800,210,71,281,Wednesday
2021,4,14,700,100,48,148,Wednesday
2021,4,14,600,51,39,90,Wednesday
2021,4,14,500,35,36,71,Wednesday
2021,4,14,400,29,35,64,Wednesday
2021,4,14,300,24,37,61,Wednesday
2021,4,14,200,27,51,78,Wednesday
2021,4,14,100,34,51,85,Wednesday
2021,4,13,2400,63,83,146,Tuesday
2021,4,13,2300,43,93,136,Tuesday
2021,4,13,2200,69,98,167,Tuesday
2021,4,13,2100,87,130,217,Tuesday
2021,4,13,2000,109,184,293,Tuesday
2021,4,13,1900,128,288,416,Tuesday
2021,4,13,1800,150,354,504,Tuesday
2021,4,13,1700,196,503,699,Tuesday
2021,4,13,1600,196,330,526,Tuesday
2021,4,13,1500,226,296,522,Tuesday
2021,4,13,1400,236,226,462,Tuesday
2021,4,13,1300,264,218,482,Tuesday
2021,4,13,1200,315,182,497,Tuesday
2021,4,13,1100,328,165,493,Tuesday
2021,4,13,1000,410,137,547,Tuesday
2021,4,13,900,363,82,445,Tuesday
2021,4,13,800,209,62,271,Tuesday
2021,4,13,700,91,57,148,Tuesday
2021,4,13,600,55,21,76,Tuesday
2021,4,13,500,21,37,58,Tuesday
2021,4,13,400,32,38,70,Tuesday
2021,4,13,300,25,41,66,Tuesday
2021,4,13,200,28,42,70,Tuesday
2021,4,13,100,27,67,94,Tuesday
2021,4,12,2400,49,67,116,Monday
2021,4,12,2300,69,76,145,Monday
2021,4,12,2200,81,100,181,Monday
2021,4,12,2100,73,144,217,Monday
2021,4,12,2000,100,149,249,Monday
2021,4,12,1900,137,217,354,Monday
2021,4,12,1800,164,347,511,Monday
2021,4,12,1700,195,428,623,Monday
2021,4,12,1600,198,346,544,Monday
2021,4,12,1500,247,268,515,Monday
2021,4,12,1400,258,207,465,Monday
2021,4,12,1300,280,195,475,Monday
2021,4,12,1200,279,123,402,Monday
2021,4,12,1100,296,128,424,Monday
2021,4,12,1000,363,121,484,Monday
2021,4,12,900,325,77,402,Monday
2021,4,12,800,170,59,229,Monday
2021,4,12,700,106,42,148,Monday
2021,4,12,600,49,11,60,Monday
2021,4,12,500,16,25,41,Monday
2021,4,12,400,31,24,55,Monday
2021,4,12,300,8,23,31,Monday
2021,4,12,200,24,31,55,Monday
2021,4,12,100,29,48,77,Monday
2021,4,11,2400,30,64,94,Sunday
2021,4,11,2300,32,88,120,Sunday
2021,4,11,2200,56,148,204,Sunday
2021,4,11,2100,81,257,338,Sunday
2021,4,11,2000,100,354,454,Sunday
2021,4,11,1900,127,569,696,Sunday
2021,4,11,1800,177,1016,1193,Sunday
2021,4,11,1700,231,1307,1538,Sunday
2021,4,11,1600,255,1062,1317,Sunday
2021,4,11,1500,333,794,1127,Sunday
2021,4,11,1400,377,724,1101,Sunday
2021,4,11,1300,471,574,1045,Sunday
2021,4,11,1200,561,347,908,Sunday
2021,4,11,1100,562,221,783,Sunday
2021,4,11,1000,607,125,732,Sunday
2021,4,11,900,832,68,900,Sunday
2021,4,11,800,555,38,593,Sunday
2021,4,11,700,139,18,157,Sunday
2021,4,11,600,65,22,87,Sunday
2021,4,11,500,24,23,47,Sunday
2021,4,11,400,16,21,37,Sunday
2021,4,11,300,24,21,45,Sunday
2021,4,11,200,19,37,56,Sunday
2021,4,11,100,16,44,60,Sunday
2021,4,10,2400,17,52,69,Saturday
2021,4,10,2300,34,87,121,Saturday
2021,4,10,2200,50,110,160,Saturday
2021,4,10,2100,57,197,254,Saturday
2021,4,10,2000,95,223,318,Saturday
2021,4,10,1900,134,318,452,Saturday
2021,4,10,1800,159,703,862,Saturday
2021,4,10,1700,238,990,1228,Saturday
2021,4,10,1600,259,705,964,Saturday
2021,4,10,1500,311,570,881,Saturday
2021,4,10,1400,339,443,782,Saturday
2021,4,10,1300,421,413,834,Saturday
2021,4,10,1200,419,274,693,Saturday
2021,4,10,1100,517,199,716,Saturday
2021,4,10,1000,502,189,691,Saturday
2021,4,10,900,796,63,859,Saturday
2021,4,10,800,480,40,520,Saturday
2021,4,10,700,131,32,163,Saturday
2021,4,10,600,33,25,58,Saturday
2021,4,10,500,26,20,46,Saturday
2021,4,10,400,19,44,63,Saturday
2021,4,10,300,15,30,45,Saturday
2021,4,10,200,30,47,77,Saturday
2021,4,10,100,28,39,67,Saturday
2021,4,9,2400,53,60,113,Friday
2021,4,9,2300,54,79,133,Friday
2021,4,9,2200,103,144,247,Friday
2021,4,9,2100,149,201,350,Friday
2021,4,9,2000,257,263,520,Friday
2021,4,9,1900,294,307,601,Friday
2021,4,9,1800,382,512,894,Friday
2021,4,9,1700,376,711,1087,Friday
2021,4,9,1600,410,644,1054,Friday
2021,4,9,1500,386,440,826,Friday
2021,4,9,1400,400,424,824,Friday
2021,4,9,1300,403,356,759,Friday
2021,4,9,1200,459,274,733,Friday
2021,4,9,1100,461,226,687,Friday
2021,4,9,1000,530,168,698,Friday
2021,4,9,900,536,144,680,Friday
2021,4,9,800,285,111,396,Friday
2021,4,9,700,105,89,194,Friday
2021,4,9,600,55,25,80,Friday
2021,4,9,500,28,25,53,Friday
2021,4,9,400,35,29,64,Friday
2021,4,9,300,14,43,57,Friday
2021,4,9,200,31,31,62,Friday
2021,4,9,100,28,15,43,Friday
2021,4,8,2400,48,43,91,Thursday
2021,4,8,2300,48,228,276,Thursday
2021,4,8,2200,91,38,129,Thursday
2021,4,8,2100,118,124,242,Thursday
2021,4,8,2000,192,257,449,Thursday
2021,4,8,1900,175,310,485,Thursday
2021,4,8,1800,281,539,820,Thursday
2021,4,8,1700,292,610,902,Thursday
2021,4,8,1600,277,427,704,Thursday
2021,4,8,1500,299,426,725,Thursday
2021,4,8,1400,314,470,784,Thursday
2021,4,8,1300,365,281,646,Thursday
2021,4,8,1200,426,245,671,Thursday
2021,4,8,1100,442,159,601,Thursday
2021,4,8,1000,415,111,526,Thursday
2021,4,8,900,475,102,577,Thursday
2021,4,8,800,259,85,344,Thursday
2021,4,8,700,125,82,207,Thursday
2021,4,8,600,55,13,68,Thursday
2021,4,8,500,32,25,57,Thursday
2021,4,8,400,32,22,54,Thursday
2021,4,8,300,23,29,52,Thursday
2021,4,8,200,25,33,58,Thursday
2021,4,8,100,36,21,57,Thursday
2021,4,7,2400,65,44,109,Wednesday
2021,4,7,2300,55,241,296,Wednesday
2021,4,7,2200,68,39,107,Wednesday
2021,4,7,2100,110,115,225,Wednesday
2021,4,7,2000,156,226,382,Wednesday
2021,4,7,1900,175,302,477,Wednesday
2021,4,7,1800,224,496,720,Wednesday
2021,4,7,1700,287,659,946,Wednesday
2021,4,7,1600,308,563,871,Wednesday
2021,4,7,1500,357,469,826,Wednesday
2021,4,7,1400,315,460,775,Wednesday
2021,4,7,1300,382,406,788,Wednesday
2021,4,7,1200,448,279,727,Wednesday
2021,4,7,1100,427,207,634,Wednesday
2021,4,7,1000,463,191,654,Wednesday
2021,4,7,900,436,143,579,Wednesday
2021,4,7,800,258,168,426,Wednesday
2021,4,7,700,89,62,151,Wednesday
2021,4,7,600,45,26,71,Wednesday
2021,4,7,500,26,35,61,Wednesday
2021,4,7,400,32,27,59,Wednesday
2021,4,7,300,27,29,56,Wednesday
2021,4,7,200,25,35,60,Wednesday
2021,4,7,100,23,21,44,Wednesday
2021,4,6,2400,46,53,99,Tuesday
2021,4,6,2300,46,386,432,Tuesday
2021,4,6,2200,68,49,117,Tuesday
2021,4,6,2100,102,94,196,Tuesday
2021,4,6,2000,143,253,396,Tuesday
2021,4,6,1900,150,318,468,Tuesday
2021,4,6,1800,207,626,833,Tuesday
2021,4,6,1700,302,935,1237,Tuesday
2021,4,6,1600,320,656,976,Tuesday
2021,4,6,1500,355,549,904,Tuesday
2021,4,6,1400,400,430,830,Tuesday
2021,4,6,1300,434,389,823,Tuesday
2021,4,6,1200,529,298,827,Tuesday
2021,4,6,1100,558,246,804,Tuesday
2021,4,6,1000,582,178,760,Tuesday
2021,4,6,900,575,104,679,Tuesday
2021,4,6,800,326,82,408,Tuesday
2021,4,6,700,139,53,192,Tuesday
2021,4,6,600,50,28,78,Tuesday
2021,4,6,500,33,33,66,Tuesday
2021,4,6,400,29,32,61,Tuesday
2021,4,6,300,25,36,61,Tuesday
2021,4,6,200,26,55,81,Tuesday
2021,4,6,100,42,70,112,Tuesday
2021,4,5,2400,55,97,152,Monday
2021,4,5,2300,61,91,152,Monday
2021,4,5,2200,95,173,268,Monday
2021,4,5,2100,100,283,383,Monday
2021,4,5,2000,154,455,609,Monday
2021,4,5,1900,193,649,842,Monday
2021,4,5,1800,236,1016,1252,Monday
2021,4,5,1700,341,1293,1634,Monday
2021,4,5,1600,432,1120,1552,Monday
2021,4,5,1500,471,977,1448,Monday
2021,4,5,1400,561,873,1434,Monday
2021,4,5,1300,601,731,1332,Monday
2021,4,5,1200,763,511,1274,Monday
2021,4,5,1100,715,317,1032,Monday
2021,4,5,1000,703,145,848,Monday
2021,4,5,900,701,118,819,Monday
2021,4,5,800,396,47,443,Monday
2021,4,5,700,150,33,183,Monday
2021,4,5,600,62,14,76,Monday
2021,4,5,500,37,14,51,Monday
2021,4,5,400,22,23,45,Monday
2021,4,5,300,13,19,32,Monday
2021,4,5,200,16,29,45,Monday
2021,4,5,100,13,57,70,Monday
2021,4,4,2400,24,66,90,Sunday
2021,4,4,2300,40,102,142,Sunday
2021,4,4,2200,57,134,191,Sunday
2021,4,4,2100,80,311,391,Sunday
2021,4,4,2000,102,463,565,Sunday
2021,4,4,1900,144,645,789,Sunday
2021,4,4,1800,196,1032,1228,Sunday
2021,4,4,1700,278,1354,1632,Sunday
2021,4,4,1600,332,1224,1556,Sunday
2021,4,4,1500,463,1069,1532,Sunday
2021,4,4,1400,485,1047,1532,Sunday
2021,4,4,1300,550,919,1469,Sunday
2021,4,4,1200,640,642,1282,Sunday
2021,4,4,1100,500,313,813,Sunday
2021,4,4,1000,488,146,634,Sunday
2021,4,4,900,634,93,727,Sunday
2021,4,4,800,414,32,446,Sunday
2021,4,4,700,110,25,135,Sunday
2021,4,4,600,27,17,44,Sunday
2021,4,4,500,8,9,17,Sunday
2021,4,4,400,18,14,32,Sunday
2021,4,4,300,22,25,47,Sunday
2021,4,4,200,17,29,46,Sunday
2021,4,4,100,29,51,80,Sunday
2021,4,3,2400,35,61,96,Saturday
2021,4,3,2300,46,89,135,Saturday
2021,4,3,2200,62,136,198,Saturday
2021,4,3,2100,99,256,355,Saturday
2021,4,3,2000,114,404,518,Saturday
2021,4,3,1900,147,599,746,Saturday
2021,4,3,1800,267,1106,1373,Saturday
2021,4,3,1700,348,1288,1636,Saturday
2021,4,3,1600,417,1069,1486,Saturday
2021,4,3,1500,515,931,1446,Saturday
2021,4,3,1400,661,702,1363,Saturday
2021,4,3,1300,722,550,1272,Saturday
2021,4,3,1200,822,409,1231,Saturday
2021,4,3,1100,728,227,955,Saturday
2021,4,3,1000,718,123,841,Saturday
2021,4,3,900,734,84,818,Saturday
2021,4,3,800,582,47,629,Saturday
2021,4,3,700,152,24,176,Saturday
2021,4,3,600,56,13,69,Saturday
2021,4,3,500,16,24,40,Saturday
2021,4,3,400,12,24,36,Saturday
2021,4,3,300,6,22,28,Saturday
2021,4,3,200,20,41,61,Saturday
2021,4,3,100,23,37,60,Saturday
2021,4,2,2400,27,56,83,Friday
2021,4,2,2300,58,76,134,Friday
2021,4,2,2200,81,129,210,Friday
2021,4,2,2100,106,209,315,Friday
2021,4,2,2000,154,394,548,Friday
2021,4,2,1900,205,534,739,Friday
2021,4,2,1800,328,975,1303,Friday
2021,4,2,1700,496,1307,1803,Friday
2021,4,2,1600,637,1106,1743,Friday
2021,4,2,1500,896,954,1850,Friday
2021,4,2,1400,912,760,1672,Friday
2021,4,2,1300,1061,599,1660,Friday
2021,4,2,1200,1231,497,1728,Friday
2021,4,2,1100,1183,299,1482,Friday
2021,4,2,1000,1085,219,1304,Friday
2021,4,2,900,1127,107,1234,Friday
2021,4,2,800,723,83,806,Friday
2021,4,2,700,242,56,298,Friday
2021,4,2,600,106,43,149,Friday
2021,4,2,500,37,51,88,Friday
2021,4,2,400,38,33,71,Friday
2021,4,2,300,36,55,91,Friday
2021,4,2,200,37,43,80,Friday
2021,4,2,100,45,76,121,Friday
2021,4,1,2400,89,113,202,Thursday
2021,4,1,2300,115,146,261,Thursday
2021,4,1,2200,226,186,412,Thursday
2021,4,1,2100,349,237,586,Thursday
2021,4,1,2000,530,327,857,Thursday
2021,4,1,1900,663,452,1115,Thursday
2021,4,1,1800,700,676,1376,Thursday
2021,4,1,1700,703,972,1675,Thursday
2021,4,1,1600,575,830,1405,Thursday
2021,4,1,1500,679,702,1381,Thursday
2021,4,1,1400,668,663,1331,Thursday
2021,4,1,1300,669,440,1109,Thursday
2021,4,1,1200,755,386,1141,Thursday
2021,4,1,1100,738,255,993,Thursday
2021,4,1,1000,682,170,852,Thursday
2021,4,1,900,763,133,896,Thursday
2021,4,1,800,439,121,560,Thursday
2021,4,1,700,154,87,241,Thursday
2021,4,1,600,60,28,88,Thursday
2021,4,1,500,39,30,69,Thursday
2021,4,1,400,29,27,56,Thursday
2021,4,1,300,23,41,64,Thursday
2021,4,1,200,28,35,63,Thursday
2021,4,1,100,49,27,76,Thursday
2021,3,31,2400,58,53,111,Wednesday
2021,3,31,2300,68,271,339,Wednesday
2021,3,31,2200,103,52,155,Wednesday
2021,3,31,2100,155,148,303,Wednesday
2021,3,31,2000,260,300,560,Wednesday
2021,3,31,1900,262,455,717,Wednesday
2021,3,31,1800,350,781,1131,Wednesday
2021,3,31,1700,453,1080,1533,Wednesday
2021,3,31,1600,463,717,1180,Wednesday
2021,3,31,1500,512,628,1140,Wednesday
2021,3,31,1400,523,469,992,Wednesday
2021,3,31,1300,532,454,986,Wednesday
2021,3,31,1200,668,341,1009,Wednesday
2021,3,31,1100,634,245,879,Wednesday
2021,3,31,1000,635,177,812,Wednesday
2021,3,31,900,657,145,802,Wednesday
2021,3,31,800,425,109,534,Wednesday
2021,3,31,700,144,74,218,Wednesday
2021,3,31,600,60,31,91,Wednesday
2021,3,31,500,36,19,55,Wednesday
2021,3,31,400,37,23,60,Wednesday
2021,3,31,300,24,30,54,Wednesday
2021,3,31,200,32,35,67,Wednesday
2021,3,31,100,30,23,53,Wednesday
2021,3,30,2400,55,57,112,Tuesday
2021,3,30,2300,90,200,290,Tuesday
2021,3,30,2200,96,57,153,Tuesday
2021,3,30,2100,123,133,256,Tuesday
2021,3,30,2000,178,255,433,Tuesday
2021,3,30,1900,216,352,568,Tuesday
2021,3,30,1800,274,642,916,Tuesday
2021,3,30,1700,337,917,1254,Tuesday
2021,3,30,1600,368,723,1091,Tuesday
2021,3,30,1500,394,512,906,Tuesday
2021,3,30,1400,420,474,894,Tuesday
2021,3,30,1300,475,450,925,Tuesday
2021,3,30,1200,548,330,878,Tuesday
2021,3,30,1100,564,212,776,Tuesday
2021,3,30,1000,556,188,744,Tuesday
2021,3,30,900,667,131,798,Tuesday
2021,3,30,800,368,125,493,Tuesday
2021,3,30,700,118,104,222,Tuesday
2021,3,30,600,42,30,72,Tuesday
2021,3,30,500,36,28,64,Tuesday
2021,3,30,400,22,31,53,Tuesday
2021,3,30,300,20,46,66,Tuesday
2021,3,30,200,12,24,36,Tuesday
2021,3,30,100,23,20,43,Tuesday
2021,3,29,2400,40,24,64,Monday
2021,3,29,2300,46,173,219,Monday
2021,3,29,2200,72,24,96,Monday
2021,3,29,2100,96,76,172,Monday
2021,3,29,2000,127,228,355,Monday
2021,3,29,1900,161,321,482,Monday
2021,3,29,1800,221,742,963,Monday
2021,3,29,1700,329,922,1251,Monday
2021,3,29,1600,352,597,949,Monday
2021,3,29,1500,373,513,886,Monday
2021,3,29,1400,373,419,792,Monday
2021,3,29,1300,365,357,722,Monday
2021,3,29,1200,446,282,728,Monday
2021,3,29,1100,422,195,617,Monday
2021,3,29,1000,540,121,661,Monday
2021,3,29,900,934,116,1050,Monday
2021,3,29,800,378,92,470,Monday
2021,3,29,700,84,18,102,Monday
2021,3,29,600,31,16,47,Monday
2021,3,29,500,28,15,43,Monday
2021,3,29,400,35,42,77,Monday
2021,3,29,300,25,34,59,Monday
2021,3,29,200,27,78,105,Monday
2021,3,29,100,14,16,30,Monday
2021,3,28,2400,23,23,46,Sunday
2021,3,28,2300,27,64,91,Sunday
2021,3,28,2200,63,301,364,Sunday
2021,3,28,2100,67,345,412,Sunday
2021,3,28,2000,121,89,210,Sunday
2021,3,28,1900,158,207,365,Sunday
2021,3,28,1800,229,640,869,Sunday
2021,3,28,1700,382,1094,1476,Sunday
2021,3,28,1600,419,854,1273,Sunday
2021,3,28,1500,556,808,1364,Sunday
2021,3,28,1400,599,788,1387,Sunday
2021,3,28,1300,587,722,1309,Sunday
2021,3,28,1200,620,573,1193,Sunday
2021,3,28,1100,569,327,896,Sunday
2021,3,28,1000,555,163,718,Sunday
2021,3,28,900,691,93,784,Sunday
2021,3,28,800,462,46,508,Sunday
2021,3,28,700,87,28,115,Sunday
2021,3,28,600,46,18,64,Sunday
2021,3,28,500,10,18,28,Sunday
2021,3,28,400,11,19,30,Sunday
2021,3,28,300,21,35,56,Sunday
2021,3,28,200,11,24,35,Sunday
2021,3,28,100,23,49,72,Sunday
2021,3,27,2400,34,55,89,Saturday
2021,3,27,2300,50,92,142,Saturday
2021,3,27,2200,76,117,193,Saturday
2021,3,27,2100,100,215,315,Saturday
2021,3,27,2000,170,263,433,Saturday
2021,3,27,1900,210,413,623,Saturday
2021,3,27,1800,281,902,1183,Saturday
2021,3,27,1700,374,1220,1594,Saturday
2021,3,27,1600,507,859,1366,Saturday
2021,3,27,1500,666,661,1327,Saturday
2021,3,27,1400,696,551,1247,Saturday
2021,3,27,1300,772,387,1159,Saturday
2021,3,27,1200,884,345,1229,Saturday
2021,3,27,1100,875,241,1116,Saturday
2021,3,27,1000,770,146,916,Saturday
2021,3,27,900,1000,110,1110,Saturday
2021,3,27,800,833,70,903,Saturday
2021,3,27,700,200,44,244,Saturday
2021,3,27,600,68,28,96,Saturday
2021,3,27,500,31,33,64,Saturday
2021,3,27,400,28,38,66,Saturday
2021,3,27,300,23,35,58,Saturday
2021,3,27,200,34,52,86,Saturday
2021,3,27,100,37,50,87,Saturday
2021,3,26,2400,62,63,125,Friday
2021,3,26,2300,78,79,157,Friday
2021,3,26,2200,159,112,271,Friday
2021,3,26,2100,246,137,383,Friday
2021,3,26,2000,379,223,602,Friday
2021,3,26,1900,534,331,865,Friday
2021,3,26,1800,628,632,1260,Friday
2021,3,26,1700,652,812,1464,Friday
2021,3,26,1600,664,604,1268,Friday
2021,3,26,1500,662,489,1151,Friday
2021,3,26,1400,563,372,935,Friday
2021,3,26,1300,535,307,842,Friday
2021,3,26,1200,590,246,836,Friday
2021,3,26,1100,547,201,748,Friday
2021,3,26,1000,624,159,783,Friday
2021,3,26,900,789,103,892,Friday
2021,3,26,800,400,98,498,Friday
2021,3,26,700,131,49,180,Friday
2021,3,26,600,62,29,91,Friday
2021,3,26,500,36,46,82,Friday
2021,3,26,400,31,49,80,Friday
2021,3,26,300,25,41,66,Friday
2021,3,26,200,37,51,88,Friday
2021,3,26,100,39,63,102,Friday
2021,3,25,2400,65,72,137,Thursday
2021,3,25,2300,89,108,197,Thursday
2021,3,25,2200,118,105,223,Thursday
2021,3,25,2100,159,149,308,Thursday
2021,3,25,2000,256,186,442,Thursday
2021,3,25,1900,304,285,589,Thursday
2021,3,25,1800,358,479,837,Thursday
2021,3,25,1700,331,621,952,Thursday
2021,3,25,1600,366,485,851,Thursday
2021,3,25,1500,395,389,784,Thursday
2021,3,25,1400,360,270,630,Thursday
2021,3,25,1300,374,238,612,Thursday
2021,3,25,1200,382,240,622,Thursday
2021,3,25,1100,477,189,666,Thursday
2021,3,25,1000,431,123,554,Thursday
2021,3,25,900,449,106,555,Thursday
2021,3,25,800,276,65,341,Thursday
2021,3,25,700,76,55,131,Thursday
2021,3,25,600,48,33,81,Thursday
2021,3,25,500,36,44,80,Thursday
2021,3,25,400,30,36,66,Thursday
2021,3,25,300,25,60,85,Thursday
2021,3,25,200,31,38,69,Thursday
2021,3,25,100,39,67,106,Thursday
2021,3,24,2400,39,64,103,Wednesday
2021,3,24,2300,56,85,141,Wednesday
2021,3,24,2200,91,126,217,Wednesday
2021,3,24,2100,144,170,314,Wednesday
2021,3,24,2000,190,201,391,Wednesday
2021,3,24,1900,172,257,429,Wednesday
2021,3,24,1800,223,391,614,Wednesday
2021,3,24,1700,296,559,855,Wednesday
2021,3,24,1600,285,467,752,Wednesday
2021,3,24,1500,318,345,663,Wednesday
2021,3,24,1400,350,318,668,Wednesday
2021,3,24,1300,325,254,579,Wednesday
2021,3,24,1200,371,229,600,Wednesday
2021,3,24,1100,361,187,548,Wednesday
2021,3,24,1000,379,154,533,Wednesday
2021,3,24,900,417,129,546,Wednesday
2021,3,24,800,269,74,343,Wednesday
2021,3,24,700,95,51,146,Wednesday
2021,3,24,600,44,34,78,Wednesday
2021,3,24,500,35,45,80,Wednesday
2021,3,24,400,22,44,66,Wednesday
2021,3,24,300,33,34,67,Wednesday
2021,3,24,200,18,48,66,Wednesday
2021,3,24,100,45,54,99,Wednesday
2021,3,23,2400,54,81,135,Tuesday
2021,3,23,2300,60,101,161,Tuesday
2021,3,23,2200,99,125,224,Tuesday
2021,3,23,2100,103,139,242,Tuesday
2021,3,23,2000,156,187,343,Tuesday
2021,3,23,1900,164,290,454,Tuesday
2021,3,23,1800,194,466,660,Tuesday
2021,3,23,1700,257,738,995,Tuesday
2021,3,23,1600,255,523,778,Tuesday
2021,3,23,1500,275,437,712,Tuesday
2021,3,23,1400,296,373,669,Tuesday
2021,3,23,1300,348,300,648,Tuesday
2021,3,23,1200,397,245,642,Tuesday
2021,3,23,1100,444,181,625,Tuesday
2021,3,23,1000,515,135,650,Tuesday
2021,3,23,900,558,121,679,Tuesday
2021,3,23,800,256,81,337,Tuesday
2021,3,23,700,103,70,173,Tuesday
2021,3,23,600,46,40,86,Tuesday
2021,3,23,500,27,43,70,Tuesday
2021,3,23,400,33,45,78,Tuesday
2021,3,23,300,23,51,74,Tuesday
2021,3,23,200,34,68,102,Tuesday
2021,3,23,100,40,64,104,Tuesday
2021,3,22,2400,49,70,119,Monday
2021,3,22,2300,62,79,141,Monday
2021,3,22,2200,84,105,189,Monday
2021,3,22,2100,83,138,221,Monday
2021,3,22,2000,128,208,336,Monday
2021,3,22,1900,136,278,414,Monday
2021,3,22,1800,179,425,604,Monday
2021,3,22,1700,248,597,845,Monday
2021,3,22,1600,279,536,815,Monday
2021,3,22,1500,293,429,722,Monday
2021,3,22,1400,335,378,713,Monday
2021,3,22,1300,342,350,692,Monday
2021,3,22,1200,399,282,681,Monday
2021,3,22,1100,385,199,584,Monday
2021,3,22,1000,419,132,551,Monday
2021,3,22,900,452,95,547,Monday
2021,3,22,800,226,68,294,Monday
2021,3,22,700,97,27,124,Monday
2021,3,22,600,39,28,67,Monday
2021,3,22,500,27,18,45,Monday
2021,3,22,400,13,20,33,Monday
2021,3,22,300,25,34,59,Monday
2021,3,22,200,16,25,41,Monday
2021,3,22,100,25,56,81,Monday
2021,3,21,2400,27,53,80,Sunday
2021,3,21,2300,52,80,132,Sunday
2021,3,21,2200,68,141,209,Sunday
2021,3,21,2100,84,241,325,Sunday
2021,3,21,2000,126,375,501,Sunday
2021,3,21,1900,144,564,708,Sunday
2021,3,21,1800,209,1000,1209,Sunday
2021,3,21,1700,288,1427,1715,Sunday
2021,3,21,1600,338,1141,1479,Sunday
2021,3,21,1500,443,924,1367,Sunday
2021,3,21,1400,429,854,1283,Sunday
2021,3,21,1300,478,748,1226,Sunday
2021,3,21,1200,578,525,1103,Sunday
2021,3,21,1100,511,258,769,Sunday
2021,3,21,1000,493,156,649,Sunday
2021,3,21,900,744,71,815,Sunday
2021,3,21,800,600,29,629,Sunday
2021,3,21,700,132,21,153,Sunday
2021,3,21,600,44,12,56,Sunday
2021,3,21,500,18,7,25,Sunday
2021,3,21,400,20,21,41,Sunday
2021,3,21,300,20,26,46,Sunday
2021,3,21,200,12,30,42,Sunday
2021,3,21,100,27,48,75,Sunday
2021,3,20,2400,38,55,93,Saturday
2021,3,20,2300,50,68,118,Saturday
2021,3,20,2200,69,120,189,Saturday
2021,3,20,2100,92,179,271,Saturday
2021,3,20,2000,107,259,366,Saturday
2021,3,20,1900,162,462,624,Saturday
2021,3,20,1800,198,931,1129,Saturday
2021,3,20,1700,279,1149,1428,Saturday
2021,3,20,1600,366,814,1180,Saturday
2021,3,20,1500,428,621,1049,Saturday
2021,3,20,1400,494,525,1019,Saturday
2021,3,20,1300,629,466,1095,Saturday
2021,3,20,1200,649,329,978,Saturday
2021,3,20,1100,607,201,808,Saturday
2021,3,20,1000,625,156,781,Saturday
2021,3,20,900,862,122,984,Saturday
2021,3,20,800,822,60,882,Saturday
2021,3,20,700,172,27,199,Saturday
2021,3,20,600,58,40,98,Saturday
2021,3,20,500,26,36,62,Saturday
2021,3,20,400,19,36,55,Saturday
2021,3,20,300,22,29,51,Saturday
2021,3,20,200,28,48,76,Saturday
2021,3,20,100,35,60,95,Saturday
2021,3,19,2400,53,79,132,Friday
2021,3,19,2300,85,88,173,Friday
2021,3,19,2200,150,102,252,Friday
2021,3,19,2100,210,163,373,Friday
2021,3,19,2000,380,189,569,Friday
2021,3,19,1900,476,346,822,Friday
2021,3,19,1800,539,580,1119,Friday
2021,3,19,1700,607,886,1493,Friday
2021,3,19,1600,602,576,1178,Friday
2021,3,19,1500,544,477,1021,Friday
2021,3,19,1400,533,389,922,Friday
2021,3,19,1300,514,345,859,Friday
2021,3,19,1200,508,265,773,Friday
2021,3,19,1100,493,153,646,Friday
2021,3,19,1000,516,164,680,Friday
2021,3,19,900,682,124,806,Friday
2021,3,19,800,444,69,513,Friday
2021,3,19,700,116,56,172,Friday
2021,3,19,600,42,39,81,Friday
2021,3,19,500,44,40,84,Friday
2021,3,19,400,32,37,69,Friday
2021,3,19,300,30,49,79,Friday
2021,3,19,200,34,61,95,Friday
2021,3,19,100,48,74,122,Friday
2021,3,18,2400,62,71,133,Thursday
2021,3,18,2300,86,112,198,Thursday
2021,3,18,2200,115,124,239,Thursday
2021,3,18,2100,228,157,385,Thursday
2021,3,18,2000,275,221,496,Thursday
2021,3,18,1900,367,302,669,Thursday
2021,3,18,1800,359,557,916,Thursday
2021,3,18,1700,354,719,1073,Thursday
2021,3,18,1600,384,496,880,Thursday
2021,3,18,1500,385,417,802,Thursday
2021,3,18,1400,385,305,690,Thursday
2021,3,18,1300,442,261,703,Thursday
2021,3,18,1200,445,248,693,Thursday
2021,3,18,1100,450,177,627,Thursday
2021,3,18,1000,495,171,666,Thursday
2021,3,18,900,455,68,523,Thursday
2021,3,18,800,265,73,338,Thursday
2021,3,18,700,120,44,164,Thursday
2021,3,18,600,50,38,88,Thursday
2021,3,18,500,28,37,65,Thursday
2021,3,18,400,37,41,78,Thursday
2021,3,18,300,28,31,59,Thursday
2021,3,18,200,30,40,70,Thursday
2021,3,18,100,39,53,92,Thursday
2021,3,17,2400,67,58,125,Wednesday
2021,3,17,2300,76,95,171,Wednesday
2021,3,17,2200,81,113,194,Wednesday
2021,3,17,2100,134,159,293,Wednesday
2021,3,17,2000,155,189,344,Wednesday
2021,3,17,1900,186,267,453,Wednesday
2021,3,17,1800,236,576,812,Wednesday
2021,3,17,1700,244,548,792,Wednesday
2021,3,17,1600,286,418,704,Wednesday
2021,3,17,1500,300,387,687,Wednesday
2021,3,17,1400,285,302,587,Wednesday
2021,3,17,1300,361,256,617,Wednesday
2021,3,17,1200,413,238,651,Wednesday
2021,3,17,1100,384,206,590,Wednesday
2021,3,17,1000,476,135,611,Wednesday
2021,3,17,900,420,94,514,Wednesday
2021,3,17,800,246,74,320,Wednesday
2021,3,17,700,138,62,200,Wednesday
2021,3,17,600,58,41,99,Wednesday
2021,3,17,500,34,37,71,Wednesday
2021,3,17,400,25,34,59,Wednesday
2021,3,17,300,29,48,77,Wednesday
2021,3,17,200,31,52,83,Wednesday
2021,3,17,100,35,56,91,Wednesday
2021,3,16,2400,49,91,140,Tuesday
2021,3,16,2300,76,97,173,Tuesday
2021,3,16,2200,81,129,210,Tuesday
2021,3,16,2100,108,158,266,Tuesday
2021,3,16,2000,131,192,323,Tuesday
2021,3,16,1900,161,290,451,Tuesday
2021,3,16,1800,206,509,715,Tuesday
2021,3,16,1700,206,649,855,Tuesday
2021,3,16,1600,269,450,719,Tuesday
2021,3,16,1500,267,426,693,Tuesday
2021,3,16,1400,348,307,655,Tuesday
2021,3,16,1300,354,258,612,Tuesday
2021,3,16,1200,368,212,580,Tuesday
2021,3,16,1100,399,212,611,Tuesday
2021,3,16,1000,389,126,515,Tuesday
2021,3,16,900,423,98,521,Tuesday
2021,3,16,800,255,73,328,Tuesday
2021,3,16,700,112,50,162,Tuesday
2021,3,16,600,50,37,87,Tuesday
2021,3,16,500,16,37,53,Tuesday
2021,3,16,400,30,49,79,Tuesday
2021,3,16,300,31,44,75,Tuesday
2021,3,16,200,29,49,78,Tuesday
2021,3,16,100,38,60,98,Tuesday
2021,3,15,2400,49,77,126,Monday
2021,3,15,2300,55,103,158,Monday
2021,3,15,2200,102,105,207,Monday
2021,3,15,2100,99,136,235,Monday
2021,3,15,2000,152,183,335,Monday
2021,3,15,1900,178,287,465,Monday
2021,3,15,1800,188,488,676,Monday
2021,3,15,1700,202,601,803,Monday
2021,3,15,1600,261,449,710,Monday
2021,3,15,1500,310,483,793,Monday
2021,3,15,1400,324,397,721,Monday
2021,3,15,1300,339,323,662,Monday
2021,3,15,1200,411,250,661,Monday
2021,3,15,1100,366,186,552,Monday
2021,3,15,1000,389,135,524,Monday
2021,3,15,900,375,88,463,Monday
2021,3,15,800,257,66,323,Monday
2021,3,15,700,108,33,141,Monday
2021,3,15,600,42,14,56,Monday
2021,3,15,500,22,7,29,Monday
2021,3,15,400,19,21,40,Monday
2021,3,15,300,23,24,47,Monday
2021,3,15,200,21,28,49,Monday
2021,3,15,100,22,52,74,Monday
2021,3,14,2400,40,57,97,Sunday
2021,3,14,2300,46,141,187,Sunday
2021,3,14,2200,70,180,250,Sunday
2021,3,14,2100,84,262,346,Sunday
2021,3,14,2000,126,379,505,Sunday
2021,3,14,1900,153,730,883,Sunday
2021,3,14,1800,216,1234,1450,Sunday
2021,3,14,1700,282,1517,1799,Sunday
2021,3,14,1600,353,1163,1516,Sunday
2021,3,14,1500,479,1083,1562,Sunday
2021,3,14,1400,461,852,1313,Sunday
2021,3,14,1300,515,768,1283,Sunday
2021,3,14,1200,629,499,1128,Sunday
2021,3,14,1100,591,258,849,Sunday
2021,3,14,1000,569,134,703,Sunday
2021,3,14,900,693,64,757,Sunday
2021,3,14,800,533,43,576,Sunday
2021,3,14,700,113,19,132,Sunday
2021,3,14,600,36,23,59,Sunday
2021,3,14,500,23,16,39,Sunday
2021,3,14,400,16,14,30,Sunday
2021,3,14,300,0,0,0,Sunday
2021,3,14,200,20,24,44,Sunday
2021,3,14,100,24,41,65,Sunday
2021,3,13,2400,33,55,88,Saturday
2021,3,13,2300,50,74,124,Saturday
2021,3,13,2200,60,108,168,Saturday
2021,3,13,2100,69,185,254,Saturday
2021,3,13,2000,98,283,381,Saturday
2021,3,13,1900,140,557,697,Saturday
2021,3,13,1800,207,1265,1472,Saturday
2021,3,13,1700,286,1356,1642,Saturday
2021,3,13,1600,327,1023,1350,Saturday
2021,3,13,1500,463,753,1216,Saturday
2021,3,13,1400,520,625,1145,Saturday
2021,3,13,1300,669,473,1142,Saturday
2021,3,13,1200,800,353,1153,Saturday
2021,3,13,1100,845,228,1073,Saturday
2021,3,13,1000,788,177,965,Saturday
2021,3,13,900,1053,124,1177,Saturday
2021,3,13,800,958,70,1028,Saturday
2021,3,13,700,175,41,216,Saturday
2021,3,13,600,59,40,99,Saturday
2021,3,13,500,37,33,70,Saturday
2021,3,13,400,25,37,62,Saturday
2021,3,13,300,28,36,64,Saturday
2021,3,13,200,17,33,50,Saturday
2021,3,13,100,30,77,107,Saturday
2021,3,12,2400,55,67,122,Friday
2021,3,12,2300,71,97,168,Friday
2021,3,12,2200,134,124,258,Friday
2021,3,12,2100,198,145,343,Friday
2021,3,12,2000,345,209,554,Friday
2021,3,12,1900,443,343,786,Friday
2021,3,12,1800,540,853,1393,Friday
2021,3,12,1700,597,1048,1645,Friday
2021,3,12,1600,771,715,1486,Friday
2021,3,12,1500,426,529,955,Friday
2021,3,12,1400,503,392,895,Friday
2021,3,12,1300,520,287,807,Friday
2021,3,12,1200,532,285,817,Friday
2021,3,12,1100,646,176,822,Friday
2021,3,12,1000,689,158,847,Friday
2021,3,12,900,910,102,1012,Friday
2021,3,12,800,519,83,602,Friday
2021,3,12,700,119,54,173,Friday
2021,3,12,600,59,23,82,Friday
2021,3,12,500,31,35,66,Friday
2021,3,12,400,31,48,79,Friday
2021,3,12,300,31,36,67,Friday
2021,3,12,200,27,52,79,Friday
2021,3,12,100,30,55,85,Friday
2021,3,11,2400,55,76,131,Thursday
2021,3,11,2300,71,80,151,Thursday
2021,3,11,2200,122,90,212,Thursday
2021,3,11,2100,205,129,334,Thursday
2021,3,11,2000,330,191,521,Thursday
2021,3,11,1900,431,262,693,Thursday
2021,3,11,1800,386,496,882,Thursday
2021,3,11,1700,410,777,1187,Thursday
2021,3,11,1600,348,605,953,Thursday
2021,3,11,1500,393,404,797,Thursday
2021,3,11,1400,354,314,668,Thursday
2021,3,11,1300,395,276,671,Thursday
2021,3,11,1200,395,187,582,Thursday
2021,3,11,1100,412,214,626,Thursday
2021,3,11,1000,605,146,751,Thursday
2021,3,11,900,648,110,758,Thursday
2021,3,11,800,362,79,441,Thursday
2021,3,11,700,109,45,154,Thursday
2021,3,11,600,53,34,87,Thursday
2021,3,11,500,28,35,63,Thursday
2021,3,11,400,32,26,58,Thursday
2021,3,11,300,24,27,51,Thursday
2021,3,11,200,33,58,91,Thursday
2021,3,11,100,37,46,83,Thursday
2021,3,10,2400,58,84,142,Wednesday
2021,3,10,2300,65,69,134,Wednesday
2021,3,10,2200,92,93,185,Wednesday
2021,3,10,2100,113,126,239,Wednesday
2021,3,10,2000,143,148,291,Wednesday
2021,3,10,1900,171,220,391,Wednesday
2021,3,10,1800,247,319,566,Wednesday
2021,3,10,1700,208,485,693,Wednesday
2021,3,10,1600,272,489,761,Wednesday
2021,3,10,1500,280,385,665,Wednesday
2021,3,10,1400,268,272,540,Wednesday
2021,3,10,1300,282,269,551,Wednesday
2021,3,10,1200,318,225,543,Wednesday
2021,3,10,1100,341,164,505,Wednesday
2021,3,10,1000,405,158,563,Wednesday
2021,3,10,900,418,139,557,Wednesday
2021,3,10,800,308,71,379,Wednesday
2021,3,10,700,97,58,155,Wednesday
2021,3,10,600,44,38,82,Wednesday
2021,3,10,500,25,32,57,Wednesday
2021,3,10,400,27,34,61,Wednesday
2021,3,10,300,28,43,71,Wednesday
2021,3,10,200,41,55,96,Wednesday
2021,3,10,100,36,74,110,Wednesday
2021,3,9,2400,49,62,111,Tuesday
2021,3,9,2300,63,81,144,Tuesday
2021,3,9,2200,78,89,167,Tuesday
2021,3,9,2100,99,134,233,Tuesday
2021,3,9,2000,129,169,298,Tuesday
2021,3,9,1900,140,272,412,Tuesday
2021,3,9,1800,188,503,691,Tuesday
2021,3,9,1700,219,732,951,Tuesday
2021,3,9,1600,243,619,862,Tuesday
2021,3,9,1500,265,349,614,Tuesday
2021,3,9,1400,292,297,589,Tuesday
2021,3,9,1300,310,249,559,Tuesday
2021,3,9,1200,406,246,652,Tuesday
2021,3,9,1100,433,144,577,Tuesday
2021,3,9,1000,483,95,578,Tuesday
2021,3,9,900,368,67,435,Tuesday
2021,3,9,800,211,54,265,Tuesday
2021,3,9,700,92,43,135,Tuesday
2021,3,9,600,40,26,66,Tuesday
2021,3,9,500,35,29,64,Tuesday
2021,3,9,400,23,28,51,Tuesday
2021,3,9,300,20,38,58,Tuesday
2021,3,9,200,23,24,47,Tuesday
2021,3,9,100,25,8,33,Tuesday
2021,3,8,2400,44,26,70,Monday
2021,3,8,2300,65,64,129,Monday
2021,3,8,2200,63,97,160,Monday
2021,3,8,2100,103,131,234,Monday
2021,3,8,2000,127,172,299,Monday
2021,3,8,1900,141,229,370,Monday
2021,3,8,1800,195,508,703,Monday
2021,3,8,1700,234,725,959,Monday
2021,3,8,1600,230,550,780,Monday
2021,3,8,1500,290,495,785,Monday
2021,3,8,1400,293,378,671,Monday
2021,3,8,1300,348,333,681,Monday
2021,3,8,1200,381,259,640,Monday
2021,3,8,1100,427,185,612,Monday
2021,3,8,1000,524,132,656,Monday
2021,3,8,900,530,90,620,Monday
2021,3,8,800,331,55,386,Monday
2021,3,8,700,94,31,125,Monday
2021,3,8,600,42,20,62,Monday
2021,3,8,500,23,14,37,Monday
2021,3,8,400,21,15,36,Monday
2021,3,8,300,15,23,38,Monday
2021,3,8,200,20,42,62,Monday
2021,3,8,100,25,50,75,Monday
2021,3,7,2400,27,48,75,Sunday
2021,3,7,2300,35,65,100,Sunday
2021,3,7,2200,40,90,130,Sunday
2021,3,7,2100,68,152,220,Sunday
2021,3,7,2000,103,297,400,Sunday
2021,3,7,1900,116,595,711,Sunday
2021,3,7,1800,170,1188,1358,Sunday
2021,3,7,1700,218,1538,1756,Sunday
2021,3,7,1600,363,1146,1509,Sunday
2021,3,7,1500,435,989,1424,Sunday
2021,3,7,1400,597,859,1456,Sunday
2021,3,7,1300,563,771,1334,Sunday
2021,3,7,1200,487,525,1012,Sunday
2021,3,7,1100,456,317,773,Sunday
2021,3,7,1000,636,133,769,Sunday
2021,3,7,900,962,91,1053,Sunday
2021,3,7,800,695,44,739,Sunday
2021,3,7,700,110,15,125,Sunday
2021,3,7,600,25,7,32,Sunday
2021,3,7,500,19,16,35,Sunday
2021,3,7,400,15,19,34,Sunday
2021,3,7,300,14,15,29,Sunday
2021,3,7,200,12,31,43,Sunday
2021,3,7,100,16,36,52,Sunday
2021,3,6,2400,24,53,77,Saturday
2021,3,6,2300,36,50,86,Saturday
2021,3,6,2200,57,85,142,Saturday
2021,3,6,2100,67,163,230,Saturday
2021,3,6,2000,92,223,315,Saturday
2021,3,6,1900,128,457,585,Saturday
2021,3,6,1800,199,1282,1481,Saturday
2021,3,6,1700,226,1186,1412,Saturday
2021,3,6,1600,317,792,1109,Saturday
2021,3,6,1500,439,575,1014,Saturday
2021,3,6,1400,520,474,994,Saturday
2021,3,6,1300,602,434,1036,Saturday
2021,3,6,1200,669,297,966,Saturday
2021,3,6,1100,691,244,935,Saturday
2021,3,6,1000,727,149,876,Saturday
2021,3,6,900,997,137,1134,Saturday
2021,3,6,800,854,68,922,Saturday
2021,3,6,700,138,46,184,Saturday
2021,3,6,600,53,46,99,Saturday
2021,3,6,500,24,35,59,Saturday
2021,3,6,400,19,36,55,Saturday
2021,3,6,300,26,33,59,Saturday
2021,3,6,200,21,41,62,Saturday
2021,3,6,100,43,64,107,Saturday
2021,3,5,2400,48,75,123,Friday
2021,3,5,2300,68,73,141,Friday
2021,3,5,2200,150,81,231,Friday
2021,3,5,2100,221,101,322,Friday
2021,3,5,2000,324,164,488,Friday
2021,3,5,1900,532,299,831,Friday
2021,3,5,1800,561,581,1142,Friday
2021,3,5,1700,587,950,1537,Friday
2021,3,5,1600,554,683,1237,Friday
2021,3,5,1500,516,537,1053,Friday
2021,3,5,1400,468,389,857,Friday
2021,3,5,1300,481,311,792,Friday
2021,3,5,1200,561,245,806,Friday
2021,3,5,1100,525,213,738,Friday
2021,3,5,1000,617,151,768,Friday
2021,3,5,900,720,121,841,Friday
2021,3,5,800,419,100,519,Friday
2021,3,5,700,112,43,155,Friday
2021,3,5,600,51,44,95,Friday
2021,3,5,500,31,45,76,Friday
2021,3,5,400,32,43,75,Friday
2021,3,5,300,19,31,50,Friday
2021,3,5,200,25,47,72,Friday
2021,3,5,100,54,43,97,Friday
2021,3,4,2400,62,79,141,Thursday
2021,3,4,2300,78,78,156,Thursday
2021,3,4,2200,112,118,230,Thursday
2021,3,4,2100,170,147,317,Thursday
2021,3,4,2000,253,264,517,Thursday
2021,3,4,1900,299,424,723,Thursday
2021,3,4,1800,320,414,734,Thursday
2021,3,4,1700,376,664,1040,Thursday
2021,3,4,1600,316,493,809,Thursday
2021,3,4,1500,353,470,823,Thursday
2021,3,4,1400,344,360,704,Thursday
2021,3,4,1300,375,261,636,Thursday
2021,3,4,1200,441,185,626,Thursday
2021,3,4,1100,504,183,687,Thursday
2021,3,4,1000,562,121,683,Thursday
2021,3,4,900,649,112,761,Thursday
2021,3,4,800,291,84,375,Thursday
2021,3,4,700,92,37,129,Thursday
2021,3,4,600,50,34,84,Thursday
2021,3,4,500,33,37,70,Thursday
2021,3,4,400,36,40,76,Thursday
2021,3,4,300,24,33,57,Thursday
2021,3,4,200,31,41,72,Thursday
2021,3,4,100,46,56,102,Thursday
2021,3,3,2400,53,89,142,Wednesday
2021,3,3,2300,73,66,139,Wednesday
2021,3,3,2200,92,98,190,Wednesday
2021,3,3,2100,103,119,222,Wednesday
2021,3,3,2000,152,150,302,Wednesday
2021,3,3,1900,169,233,402,Wednesday
2021,3,3,1800,197,488,685,Wednesday
2021,3,3,1700,252,659,911,Wednesday
2021,3,3,1600,270,591,861,Wednesday
2021,3,3,1500,302,414,716,Wednesday
2021,3,3,1400,313,306,619,Wednesday
2021,3,3,1300,297,280,577,Wednesday
2021,3,3,1200,394,223,617,Wednesday
2021,3,3,1100,428,182,610,Wednesday
2021,3,3,1000,486,145,631,Wednesday
2021,3,3,900,573,122,695,Wednesday
2021,3,3,800,295,77,372,Wednesday
2021,3,3,700,97,58,155,Wednesday
2021,3,3,600,40,47,87,Wednesday
2021,3,3,500,38,36,74,Wednesday
2021,3,3,400,14,37,51,Wednesday
2021,3,3,300,29,37,66,Wednesday
2021,3,3,200,24,34,58,Wednesday
2021,3,3,100,43,46,89,Wednesday
2021,3,2,2400,59,69,128,Tuesday
2021,3,2,2300,71,76,147,Tuesday
2021,3,2,2200,72,83,155,Tuesday
2021,3,2,2100,92,140,232,Tuesday
2021,3,2,2000,102,167,269,Tuesday
2021,3,2,1900,136,228,364,Tuesday
2021,3,2,1800,192,346,538,Tuesday
2021,3,2,1700,227,531,758,Tuesday
2021,3,2,1600,235,529,764,Tuesday
2021,3,2,1500,255,416,671,Tuesday
2021,3,2,1400,284,332,616,Tuesday
2021,3,2,1300,306,260,566,Tuesday
2021,3,2,1200,344,195,539,Tuesday
2021,3,2,1100,366,188,554,Tuesday
2021,3,2,1000,427,154,581,Tuesday
2021,3,2,900,473,112,585,Tuesday
2021,3,2,800,263,75,338,Tuesday
2021,3,2,700,89,34,123,Tuesday
2021,3,2,600,37,38,75,Tuesday
2021,3,2,500,34,42,76,Tuesday
2021,3,2,400,21,27,48,Tuesday
2021,3,2,300,27,27,54,Tuesday
2021,3,2,200,32,55,87,Tuesday
2021,3,2,100,33,55,88,Tuesday
2021,3,1,2400,46,51,97,Monday
2021,3,1,2300,62,101,163,Monday
2021,3,1,2200,59,76,135,Monday
2021,3,1,2100,92,103,195,Monday
2021,3,1,2000,117,138,255,Monday
2021,3,1,1900,110,220,330,Monday
2021,3,1,1800,175,352,527,Monday
2021,3,1,1700,226,577,803,Monday
2021,3,1,1600,256,514,770,Monday
2021,3,1,1500,285,437,722,Monday
2021,3,1,1400,296,383,679,Monday
2021,3,1,1300,315,319,634,Monday
2021,3,1,1200,358,249,607,Monday
2021,3,1,1100,362,194,556,Monday
2021,3,1,1000,386,136,522,Monday
2021,3,1,900,196,106,302,Monday
2021,3,1,800,27,64,91,Monday
2021,3,1,700,3,26,29,Monday
2021,3,1,600,0,21,21,Monday
2021,3,1,500,65,25,90,Monday
2021,3,1,400,12,20,32,Monday
2021,3,1,300,33,17,50,Monday
2021,3,1,200,127,25,152,Monday
2021,3,1,100,16,29,45,Monday
2021,2,28,2400,26,51,77,Sunday
2021,2,28,2300,42,91,133,Sunday
2021,2,28,2200,60,132,192,Sunday
2021,2,28,2100,63,184,247,Sunday
2021,2,28,2000,81,308,389,Sunday
2021,2,28,1900,128,599,727,Sunday
2021,2,28,1800,183,1171,1354,Sunday
2021,2,28,1700,254,1571,1825,Sunday
2021,2,28,1600,274,1237,1511,Sunday
2021,2,28,1500,347,1114,1461,Sunday
2021,2,28,1400,448,938,1386,Sunday
2021,2,28,1300,417,768,1185,Sunday
2021,2,28,1200,621,534,1155,Sunday
2021,2,28,1100,634,271,905,Sunday
2021,2,28,1000,489,156,645,Sunday
2021,2,28,900,933,94,1027,Sunday
2021,2,28,800,668,37,705,Sunday
2021,2,28,700,132,17,149,Sunday
2021,2,28,600,71,15,86,Sunday
2021,2,28,500,25,14,39,Sunday
2021,2,28,400,17,12,29,Sunday
2021,2,28,300,82,20,102,Sunday
2021,2,28,200,27,31,58,Sunday
2021,2,28,100,13,34,47,Sunday
2021,2,27,2400,37,43,80,Saturday
2021,2,27,2300,47,73,120,Saturday
2021,2,27,2200,71,88,159,Saturday
2021,2,27,2100,77,169,246,Saturday
2021,2,27,2000,95,263,358,Saturday
2021,2,27,1900,115,448,563,Saturday
2021,2,27,1800,192,1319,1511,Saturday
2021,2,27,1700,233,1312,1545,Saturday
2021,2,27,1600,345,869,1214,Saturday
2021,2,27,1500,454,640,1094,Saturday
2021,2,27,1400,430,487,917,Saturday
2021,2,27,1300,585,428,1013,Saturday
2021,2,27,1200,732,306,1038,Saturday
2021,2,27,1100,703,186,889,Saturday
2021,2,27,1000,669,135,804,Saturday
2021,2,27,900,1213,95,1308,Saturday
2021,2,27,800,819,58,877,Saturday
2021,2,27,700,119,36,155,Saturday
2021,2,27,600,44,33,77,Saturday
2021,2,27,500,24,32,56,Saturday
2021,2,27,400,17,14,31,Saturday
2021,2,27,300,14,20,34,Saturday
2021,2,27,200,22,39,61,Saturday
2021,2,27,100,29,55,84,Saturday
2021,2,26,2400,61,57,118,Friday
2021,2,26,2300,82,71,153,Friday
2021,2,26,2200,143,92,235,Friday
2021,2,26,2100,188,120,308,Friday
2021,2,26,2000,290,181,471,Friday
2021,2,26,1900,413,322,735,Friday
2021,2,26,1800,508,610,1118,Friday
2021,2,26,1700,561,907,1468,Friday
2021,2,26,1600,495,616,1111,Friday
2021,2,26,1500,489,444,933,Friday
2021,2,26,1400,422,355,777,Friday
2021,2,26,1300,452,346,798,Friday
2021,2,26,1200,427,244,671,Friday
2021,2,26,1100,446,196,642,Friday
2021,2,26,1000,545,122,667,Friday
2021,2,26,900,766,119,885,Friday
2021,2,26,800,420,66,486,Friday
2021,2,26,700,89,45,134,Friday
2021,2,26,600,50,30,80,Friday
2021,2,26,500,38,40,78,Friday
2021,2,26,400,21,19,40,Friday
2021,2,26,300,33,56,89,Friday
2021,2,26,200,34,45,79,Friday
2021,2,26,100,42,42,84,Friday
2021,2,25,2400,53,51,104,Thursday
2021,2,25,2300,74,77,151,Thursday
2021,2,25,2200,101,87,188,Thursday
2021,2,25,2100,175,111,286,Thursday
2021,2,25,2000,236,151,387,Thursday
2021,2,25,1900,280,219,499,Thursday
2021,2,25,1800,332,372,704,Thursday
2021,2,25,1700,360,638,998,Thursday
2021,2,25,1600,343,445,788,Thursday
2021,2,25,1500,405,429,834,Thursday
2021,2,25,1400,348,324,672,Thursday
2021,2,25,1300,342,276,618,Thursday
2021,2,25,1200,298,227,525,Thursday
2021,2,25,1100,346,172,518,Thursday
2021,2,25,1000,384,123,507,Thursday
2021,2,25,900,533,82,615,Thursday
2021,2,25,800,293,59,352,Thursday
2021,2,25,700,71,32,103,Thursday
2021,2,25,600,36,26,62,Thursday
2021,2,25,500,37,40,77,Thursday
2021,2,25,400,28,36,64,Thursday
2021,2,25,300,31,31,62,Thursday
2021,2,25,200,35,33,68,Thursday
2021,2,25,100,45,59,104,Thursday
2021,2,24,2400,52,63,115,Wednesday
2021,2,24,2300,65,84,149,Wednesday
2021,2,24,2200,107,111,218,Wednesday
2021,2,24,2100,136,134,270,Wednesday
2021,2,24,2000,153,186,339,Wednesday
2021,2,24,1900,158,260,418,Wednesday
2021,2,24,1800,231,565,796,Wednesday
2021,2,24,1700,238,979,1217,Wednesday
2021,2,24,1600,314,478,792,Wednesday
2021,2,24,1500,297,365,662,Wednesday
2021,2,24,1400,299,349,648,Wednesday
2021,2,24,1300,330,315,645,Wednesday
2021,2,24,1200,401,123,524,Wednesday
2021,2,24,1100,448,177,625,Wednesday
2021,2,24,1000,546,160,706,Wednesday
2021,2,24,900,678,83,761,Wednesday
2021,2,24,800,321,82,403,Wednesday
2021,2,24,700,90,40,130,Wednesday
2021,2,24,600,30,30,60,Wednesday
2021,2,24,500,36,24,60,Wednesday
2021,2,24,400,25,12,37,Wednesday
2021,2,24,300,19,16,35,Wednesday
2021,2,24,200,33,34,67,Wednesday
2021,2,24,100,27,52,79,Wednesday
2021,2,23,2400,45,67,112,Tuesday
2021,2,23,2300,52,70,122,Tuesday
2021,2,23,2200,66,77,143,Tuesday
2021,2,23,2100,73,119,192,Tuesday
2021,2,23,2000,116,155,271,Tuesday
2021,2,23,1900,159,248,407,Tuesday
2021,2,23,1800,177,503,680,Tuesday
2021,2,23,1700,211,786,997,Tuesday
2021,2,23,1600,237,612,849,Tuesday
2021,2,23,1500,242,481,723,Tuesday
2021,2,23,1400,258,371,629,Tuesday
2021,2,23,1300,288,282,570,Tuesday
2021,2,23,1200,354,261,615,Tuesday
2021,2,23,1100,377,186,563,Tuesday
2021,2,23,1000,511,170,681,Tuesday
2021,2,23,900,761,103,864,Tuesday
2021,2,23,800,345,69,414,Tuesday
2021,2,23,700,85,118,203,Tuesday
2021,2,23,600,39,61,100,Tuesday
2021,2,23,500,30,4,34,Tuesday
2021,2,23,400,16,7,23,Tuesday
2021,2,23,300,20,5,25,Tuesday
2021,2,23,200,22,13,35,Tuesday
2021,2,23,100,20,27,47,Tuesday
2021,2,22,2400,43,58,101,Monday
2021,2,22,2300,43,83,126,Monday
2021,2,22,2200,44,26,70,Monday
2021,2,22,2100,67,121,188,Monday
2021,2,22,2000,123,180,303,Monday
2021,2,22,1900,132,195,327,Monday
2021,2,22,1800,171,354,525,Monday
2021,2,22,1700,198,617,815,Monday
2021,2,22,1600,270,513,783,Monday
2021,2,22,1500,257,389,646,Monday
2021,2,22,1400,294,359,653,Monday
2021,2,22,1300,293,279,572,Monday
2021,2,22,1200,336,227,563,Monday
2021,2,22,1100,317,191,508,Monday
2021,2,22,1000,453,133,586,Monday
2021,2,22,900,631,69,700,Monday
2021,2,22,800,307,64,371,Monday
2021,2,22,700,90,22,112,Monday
2021,2,22,600,30,23,53,Monday
2021,2,22,500,50,24,74,Monday
2021,2,22,400,,18,,Monday
2021,2,22,300,15,24,39,Monday
2021,2,22,200,18,40,58,Monday
2021,2,22,100,37,51,88,Monday
2021,2,21,2400,,43,,Sunday
2021,2,21,2300,,80,,Sunday
2021,2,21,2200,,126,,Sunday
2021,2,21,2100,,153,,Sunday
2021,2,21,2000,,250,,Sunday
2021,2,21,1900,,475,,Sunday
2021,2,21,1800,,1076,,Sunday
2021,2,21,1700,,1401,,Sunday
2021,2,21,1600,,1155,,Sunday
2021,2,21,1500,,1098,,Sunday
2021,2,21,1400,,862,,Sunday
2021,2,21,1300,279,752,1031,Sunday
2021,2,21,1200,,591,,Sunday
2021,2,21,1100,490,296,786,Sunday
2021,2,21,1000,592,191,783,Sunday
2021,2,21,900,925,92,1017,Sunday
2021,2,21,800,,57,,Sunday
2021,2,21,700,,25,,Sunday
2021,2,21,600,29,23,52,Sunday
2021,2,21,500,,18,,Sunday
2021,2,21,400,,22,,Sunday
2021,2,21,300,,18,,Sunday
2021,2,21,200,4,38,42,Sunday
2021,2,21,100,,47,,Sunday
2021,2,20,2400,,50,,Saturday
2021,2,20,2300,43,146,189,Saturday
2021,2,20,2200,60,465,525,Saturday
2021,2,20,2100,,394,,Saturday
2021,2,20,2000,,184,,Saturday
2021,2,20,1900,,327,,Saturday
2021,2,20,1800,,1031,,Saturday
2021,2,20,1700,,1411,,Saturday
2021,2,20,1600,,1052,,Saturday
2021,2,20,1500,,698,,Saturday
2021,2,20,1400,,598,,Saturday
2021,2,20,1300,,410,,Saturday
2021,2,20,1200,,299,,Saturday
2021,2,20,1100,,183,,Saturday
2021,2,20,1000,,138,,Saturday
2021,2,20,900,613,92,705,Saturday
2021,2,20,800,,80,,Saturday
2021,2,20,700,,41,,Saturday
2021,2,20,600,,25,,Saturday
2021,2,20,500,,37,,Saturday
2021,2,20,400,,28,,Saturday
2021,2,20,300,,41,,Saturday
2021,2,20,200,41,30,71,Saturday
2021,2,20,100,,38,,Saturday
2021,2,19,2400,,51,,Friday
2021,2,19,2300,,63,,Friday
2021,2,19,2200,,98,,Friday
2021,2,19,2100,61,125,186,Friday
2021,2,19,2000,117,186,303,Friday
2021,2,19,1900,215,338,553,Friday
2021,2,19,1800,322,738,1060,Friday
2021,2,19,1700,286,947,1233,Friday
2021,2,19,1600,,736,,Friday
2021,2,19,1500,,564,,Friday
2021,2,19,1400,,423,,Friday
2021,2,19,1300,,404,,Friday
2021,2,19,1200,,372,,Friday
2021,2,19,1100,,231,,Friday
2021,2,19,1000,,142,,Friday
2021,2,19,900,,122,,Friday
2021,2,19,800,,77,,Friday
2021,2,19,700,,49,,Friday
2021,2,19,600,,19,,Friday
2021,2,19,500,,23,,Friday
2021,2,19,400,,39,,Friday
2021,2,19,300,,70,,Friday
2021,2,19,200,,22,,Friday
2021,2,19,100,,29,,Friday
2021,2,18,2400,,34,,Thursday
2021,2,18,2300,,50,,Thursday
2021,2,18,2200,,102,,Thursday
2021,2,18,2100,,103,,Thursday
2021,2,18,2000,,165,,Thursday
2021,2,18,1900,,286,,Thursday
2021,2,18,1800,,828,,Thursday
2021,2,18,1700,,922,,Thursday
2021,2,18,1600,,627,,Thursday
2021,2,18,1500,,517,,Thursday
2021,2,18,1400,,375,,Thursday
2021,2,18,1300,,325,,Thursday
2021,2,18,1200,,261,,Thursday
2021,2,18,1100,,213,,Thursday
2021,2,18,1000,,160,,Thursday
2021,2,18,900,,97,,Thursday
2021,2,18,800,,64,,Thursday
2021,2,18,700,,49,,Thursday
2021,2,18,600,,38,,Thursday
2021,2,18,500,,41,,Thursday
2021,2,18,400,,28,,Thursday
2021,2,18,300,,46,,Thursday
2021,2,18,200,,50,,Thursday
2021,2,18,100,,53,,Thursday
2021,2,17,2400,,59,,Wednesday
2021,2,17,2300,,62,,Wednesday
2021,2,17,2200,,102,,Wednesday
2021,2,17,2100,,136,,Wednesday
2021,2,17,2000,,165,,Wednesday
2021,2,17,1900,,285,,Wednesday
2021,2,17,1800,,685,,Wednesday
2021,2,17,1700,,947,,Wednesday
2021,2,17,1600,,716,,Wednesday
2021,2,17,1500,,521,,Wednesday
2021,2,17,1400,,417,,Wednesday
2021,2,17,1300,,301,,Wednesday
2021,2,17,1200,,252,,Wednesday
2021,2,17,1100,,197,,Wednesday
2021,2,17,1000,,125,,Wednesday
2021,2,17,900,,89,,Wednesday
2021,2,17,800,,68,,Wednesday
2021,2,17,700,,50,,Wednesday
2021,2,17,600,,25,,Wednesday
2021,2,17,500,,27,,Wednesday
2021,2,17,400,,35,,Wednesday
2021,2,17,300,,43,,Wednesday
2021,2,17,200,,66,,Wednesday
2021,2,17,100,,24,,Wednesday
2021,2,16,2400,,42,,Tuesday
2021,2,16,2300,,56,,Tuesday
2021,2,16,2200,,69,,Tuesday
2021,2,16,2100,,108,,Tuesday
2021,2,16,2000,,160,,Tuesday
2021,2,16,1900,,271,,Tuesday
2021,2,16,1800,,676,,Tuesday
2021,2,16,1700,,895,,Tuesday
2021,2,16,1600,,676,,Tuesday
2021,2,16,1500,,481,,Tuesday
2021,2,16,1400,,396,,Tuesday
2021,2,16,1300,,295,,Tuesday
2021,2,16,1200,,252,,Tuesday
2021,2,16,1100,,201,,Tuesday
2021,2,16,1000,,130,,Tuesday
2021,2,16,900,,82,,Tuesday
2021,2,16,800,,54,,Tuesday
2021,2,16,700,,39,,Tuesday
2021,2,16,600,,20,,Tuesday
2021,2,16,500,,21,,Tuesday
2021,2,16,400,,19,,Tuesday
2021,2,16,300,22,34,56,Tuesday
2021,2,16,200,41,22,63,Tuesday
2021,2,16,100,79,39,118,Tuesday
2021,2,15,2400,38,56,94,Monday
2021,2,15,2300,60,86,146,Monday
2021,2,15,2200,98,143,241,Monday
2021,2,15,2100,117,163,280,Monday
2021,2,15,2000,,291,,Monday
2021,2,15,1900,125,513,638,Monday
2021,2,15,1800,150,1269,1419,Monday
2021,2,15,1700,259,1578,1837,Monday
2021,2,15,1600,336,1298,1634,Monday
2021,2,15,1500,315,1281,1596,Monday
2021,2,15,1400,420,1108,1528,Monday
2021,2,15,1300,306,998,1304,Monday
2021,2,15,1200,421,668,1089,Monday
2021,2,15,1100,450,335,785,Monday
2021,2,15,1000,416,145,561,Monday
2021,2,15,900,551,91,642,Monday
2021,2,15,800,248,39,287,Monday
2021,2,15,700,111,22,133,Monday
2021,2,15,600,35,14,49,Monday
2021,2,15,500,25,14,39,Monday
2021,2,15,400,39,15,54,Monday
2021,2,15,300,,23,,Monday
2021,2,15,200,,34,,Monday
2021,2,15,100,54,28,82,Monday
2021,2,14,2400,47,37,84,Sunday
2021,2,14,2300,53,62,115,Sunday
2021,2,14,2200,34,64,98,Sunday
2021,2,14,2100,,125,,Sunday
2021,2,14,2000,,230,,Sunday
2021,2,14,1900,,400,,Sunday
2021,2,14,1800,,841,,Sunday
2021,2,14,1700,237,1299,1536,Sunday
2021,2,14,1600,341,908,1249,Sunday
2021,2,14,1500,444,808,1252,Sunday
2021,2,14,1400,600,579,1179,Sunday
2021,2,14,1300,719,470,1189,Sunday
2021,2,14,1200,702,325,1027,Sunday
2021,2,14,1100,649,160,809,Sunday
2021,2,14,1000,584,88,672,Sunday
2021,2,14,900,590,66,656,Sunday
2021,2,14,800,402,32,434,Sunday
2021,2,14,700,83,21,104,Sunday
2021,2,14,600,29,13,42,Sunday
2021,2,14,500,18,10,28,Sunday
2021,2,14,400,22,11,33,Sunday
2021,2,14,300,27,21,48,Sunday
2021,2,14,200,24,31,55,Sunday
2021,2,14,100,11,43,54,Sunday
2021,2,13,2400,29,30,59,Saturday
2021,2,13,2300,60,50,110,Saturday
2021,2,13,2200,24,71,95,Saturday
2021,2,13,2100,109,84,193,Saturday
2021,2,13,2000,,170,,Saturday
2021,2,13,1900,,305,,Saturday
2021,2,13,1800,,828,,Saturday
2021,2,13,1700,,819,,Saturday
2021,2,13,1600,390,597,987,Saturday
2021,2,13,1500,536,456,992,Saturday
2021,2,13,1400,512,376,888,Saturday
2021,2,13,1300,720,289,1009,Saturday
2021,2,13,1200,346,235,581,Saturday
2021,2,13,1100,,161,,Saturday
2021,2,13,1000,,112,,Saturday
2021,2,13,900,,93,,Saturday
2021,2,13,800,,59,,Saturday
2021,2,13,700,,34,,Saturday
2021,2,13,600,,21,,Saturday
2021,2,13,500,,17,,Saturday
2021,2,13,400,,32,,Saturday
2021,2,13,300,,30,,Saturday
2021,2,13,200,,38,,Saturday
2021,2,13,100,35,43,78,Saturday
2021,2,12,2400,,37,,Friday
2021,2,12,2300,,74,,Friday
2021,2,12,2200,,91,,Friday
2021,2,12,2100,,116,,Friday
2021,2,12,2000,,137,,Friday
2021,2,12,1900,,239,,Friday
2021,2,12,1800,,446,,Friday
2021,2,12,1700,,531,,Friday
2021,2,12,1600,513,374,887,Friday
2021,2,12,1500,646,302,948,Friday
2021,2,12,1400,,224,,Friday
2021,2,12,1300,413,235,648,Friday
2021,2,12,1200,520,198,718,Friday
2021,2,12,1100,326,157,483,Friday
2021,2,12,1000,261,98,359,Friday
2021,2,12,900,305,94,399,Friday
2021,2,12,800,199,51,250,Friday
2021,2,12,700,82,39,121,Friday
2021,2,12,600,37,30,67,Friday
2021,2,12,500,35,29,64,Friday
2021,2,12,400,23,34,57,Friday
2021,2,12,300,77,30,107,Friday
2021,2,12,200,37,56,93,Friday
2021,2,12,100,77,50,127,Friday
2021,2,11,2400,84,60,144,Thursday
2021,2,11,2300,82,67,149,Thursday
2021,2,11,2200,120,83,203,Thursday
2021,2,11,2100,152,84,236,Thursday
2021,2,11,2000,222,123,345,Thursday
2021,2,11,1900,244,190,434,Thursday
2021,2,11,1800,286,277,563,Thursday
2021,2,11,1700,346,287,633,Thursday
2021,2,11,1600,331,245,576,Thursday
2021,2,11,1500,451,255,706,Thursday
2021,2,11,1400,430,218,648,Thursday
2021,2,11,1300,368,222,590,Thursday
2021,2,11,1200,286,177,463,Thursday
2021,2,11,1100,278,151,429,Thursday
2021,2,11,1000,271,107,378,Thursday
2021,2,11,900,203,85,288,Thursday
2021,2,11,800,126,57,183,Thursday
2021,2,11,700,71,46,117,Thursday
2021,2,11,600,39,31,70,Thursday
2021,2,11,500,25,15,40,Thursday
2021,2,11,400,30,36,66,Thursday
2021,2,11,300,25,46,71,Thursday
2021,2,11,200,39,35,74,Thursday
2021,2,11,100,36,49,85,Thursday
2021,2,10,2400,58,33,91,Wednesday
2021,2,10,2300,59,68,127,Wednesday
2021,2,10,2200,75,75,150,Wednesday
2021,2,10,2100,125,64,189,Wednesday
2021,2,10,2000,158,100,258,Wednesday
2021,2,10,1900,207,181,388,Wednesday
2021,2,10,1800,284,255,539,Wednesday
2021,2,10,1700,244,268,512,Wednesday
2021,2,10,1600,209,256,465,Wednesday
2021,2,10,1500,224,242,466,Wednesday
2021,2,10,1400,245,216,461,Wednesday
2021,2,10,1300,226,191,417,Wednesday
2021,2,10,1200,263,186,449,Wednesday
2021,2,10,1100,230,154,384,Wednesday
2021,2,10,1000,205,118,323,Wednesday
2021,2,10,900,172,80,252,Wednesday
2021,2,10,800,123,73,196,Wednesday
2021,2,10,700,54,38,92,Wednesday
2021,2,10,600,30,29,59,Wednesday
2021,2,10,500,22,29,51,Wednesday
2021,2,10,400,22,38,60,Wednesday
2021,2,10,300,20,34,54,Wednesday
2021,2,10,200,28,52,80,Wednesday
2021,2,10,100,37,48,85,Wednesday
2021,2,9,2400,51,56,107,Tuesday
2021,2,9,2300,61,61,122,Tuesday
2021,2,9,2200,70,79,149,Tuesday
2021,2,9,2100,94,81,175,Tuesday
2021,2,9,2000,98,131,229,Tuesday
2021,2,9,1900,121,176,297,Tuesday
2021,2,9,1800,145,303,448,Tuesday
2021,2,9,1700,209,280,489,Tuesday
2021,2,9,1600,186,265,451,Tuesday
2021,2,9,1500,227,225,452,Tuesday
2021,2,9,1400,212,249,461,Tuesday
2021,2,9,1300,244,210,454,Tuesday
2021,2,9,1200,231,165,396,Tuesday
2021,2,9,1100,200,153,353,Tuesday
2021,2,9,1000,204,117,321,Tuesday
2021,2,9,900,180,86,266,Tuesday
2021,2,9,800,116,63,179,Tuesday
2021,2,9,700,72,40,112,Tuesday
2021,2,9,600,29,29,58,Tuesday
2021,2,9,500,36,39,75,Tuesday
2021,2,9,400,23,39,62,Tuesday
2021,2,9,300,34,34,68,Tuesday
2021,2,9,200,21,47,68,Tuesday
2021,2,9,100,27,64,91,Tuesday
2021,2,8,2400,33,53,86,Monday
2021,2,8,2300,54,54,108,Monday
2021,2,8,2200,57,95,152,Monday
2021,2,8,2100,62,73,135,Monday
2021,2,8,2000,94,105,199,Monday
2021,2,8,1900,119,182,301,Monday
2021,2,8,1800,153,253,406,Monday
2021,2,8,1700,152,318,470,Monday
2021,2,8,1600,225,282,507,Monday
2021,2,8,1500,256,276,532,Monday
2021,2,8,1400,226,286,512,Monday
2021,2,8,1300,219,295,514,Monday
2021,2,8,1200,264,234,498,Monday
2021,2,8,1100,230,150,380,Monday
2021,2,8,1000,221,92,313,Monday
2021,2,8,900,206,90,296,Monday
2021,2,8,800,121,62,183,Monday
2021,2,8,700,51,30,81,Monday
2021,2,8,600,24,18,42,Monday
2021,2,8,500,21,15,36,Monday
2021,2,8,400,16,17,33,Monday
2021,2,8,300,19,31,50,Monday
2021,2,8,200,23,30,53,Monday
2021,2,8,100,24,33,57,Monday
2021,2,7,2400,20,34,54,Sunday
2021,2,7,2300,39,66,105,Sunday
2021,2,7,2200,50,98,148,Sunday
2021,2,7,2100,51,154,205,Sunday
2021,2,7,2000,67,195,262,Sunday
2021,2,7,1900,79,319,398,Sunday
2021,2,7,1800,119,534,653,Sunday
2021,2,7,1700,171,712,883,Sunday
2021,2,7,1600,194,698,892,Sunday
2021,2,7,1500,248,704,952,Sunday
2021,2,7,1400,319,620,939,Sunday
2021,2,7,1300,332,575,907,Sunday
2021,2,7,1200,342,390,732,Sunday
2021,2,7,1100,252,223,475,Sunday
2021,2,7,1000,262,113,375,Sunday
2021,2,7,900,458,71,529,Sunday
2021,2,7,800,325,28,353,Sunday
2021,2,7,700,56,9,65,Sunday
2021,2,7,600,18,8,26,Sunday
2021,2,7,500,12,6,18,Sunday
2021,2,7,400,17,20,37,Sunday
2021,2,7,300,12,16,28,Sunday
2021,2,7,200,18,26,44,Sunday
2021,2,7,100,17,32,49,Sunday
2021,2,6,2400,23,43,66,Saturday
2021,2,6,2300,30,67,97,Saturday
2021,2,6,2200,31,70,101,Saturday
2021,2,6,2100,48,91,139,Saturday
2021,2,6,2000,64,142,206,Saturday
2021,2,6,1900,66,232,298,Saturday
2021,2,6,1800,121,829,950,Saturday
2021,2,6,1700,179,1018,1197,Saturday
2021,2,6,1600,215,668,883,Saturday
2021,2,6,1500,235,471,706,Saturday
2021,2,6,1400,275,302,577,Saturday
2021,2,6,1300,310,260,570,Saturday
2021,2,6,1200,363,200,563,Saturday
2021,2,6,1100,396,129,525,Saturday
2021,2,6,1000,440,99,539,Saturday
2021,2,6,900,972,83,1055,Saturday
2021,2,6,800,789,47,836,Saturday
2021,2,6,700,130,37,167,Saturday
2021,2,6,600,36,34,70,Saturday
2021,2,6,500,25,24,49,Saturday
2021,2,6,400,15,23,38,Saturday
2021,2,6,300,16,31,47,Saturday
2021,2,6,200,18,37,55,Saturday
2021,2,6,100,26,60,86,Saturday
2021,2,5,2400,41,68,109,Friday
2021,2,5,2300,63,80,143,Friday
2021,2,5,2200,98,85,183,Friday
2021,2,5,2100,145,123,268,Friday
2021,2,5,2000,248,169,417,Friday
2021,2,5,1900,337,240,577,Friday
2021,2,5,1800,445,473,918,Friday
2021,2,5,1700,415,685,1100,Friday
2021,2,5,1600,365,492,857,Friday
2021,2,5,1500,385,401,786,Friday
2021,2,5,1400,305,291,596,Friday
2021,2,5,1300,337,264,601,Friday
2021,2,5,1200,359,181,540,Friday
2021,2,5,1100,340,127,467,Friday
2021,2,5,1000,414,99,513,Friday
2021,2,5,900,813,73,886,Friday
2021,2,5,800,412,65,477,Friday
2021,2,5,700,96,35,131,Friday
2021,2,5,600,47,20,67,Friday
2021,2,5,500,39,23,62,Friday
2021,2,5,400,24,28,52,Friday
2021,2,5,300,26,35,61,Friday
2021,2,5,200,36,35,71,Friday
2021,2,5,100,57,51,108,Friday
2021,2,4,2400,50,51,101,Thursday
2021,2,4,2300,80,48,128,Thursday
2021,2,4,2200,101,61,162,Thursday
2021,2,4,2100,141,81,222,Thursday
2021,2,4,2000,239,123,362,Thursday
2021,2,4,1900,235,192,427,Thursday
2021,2,4,1800,270,398,668,Thursday
2021,2,4,1700,274,666,940,Thursday
2021,2,4,1600,310,499,809,Thursday
2021,2,4,1500,301,385,686,Thursday
2021,2,4,1400,320,285,605,Thursday
2021,2,4,1300,315,225,540,Thursday
2021,2,4,1200,297,191,488,Thursday
2021,2,4,1100,334,164,498,Thursday
2021,2,4,1000,436,130,566,Thursday
2021,2,4,900,628,87,715,Thursday
2021,2,4,800,353,77,430,Thursday
2021,2,4,700,72,55,127,Thursday
2021,2,4,600,55,39,94,Thursday
2021,2,4,500,19,34,53,Thursday
2021,2,4,400,21,33,54,Thursday
2021,2,4,300,18,35,53,Thursday
2021,2,4,200,34,57,91,Thursday
2021,2,4,100,35,40,75,Thursday
2021,2,3,2400,67,52,119,Wednesday
2021,2,3,2300,78,83,161,Wednesday
2021,2,3,2200,85,97,182,Wednesday
2021,2,3,2100,120,105,225,Wednesday
2021,2,3,2000,157,134,291,Wednesday
2021,2,3,1900,187,187,374,Wednesday
2021,2,3,1800,195,468,663,Wednesday
2021,2,3,1700,224,874,1098,Wednesday
2021,2,3,1600,246,534,780,Wednesday
2021,2,3,1500,265,412,677,Wednesday
2021,2,3,1400,256,326,582,Wednesday
2021,2,3,1300,255,217,472,Wednesday
2021,2,3,1200,288,135,423,Wednesday
2021,2,3,1100,339,180,519,Wednesday
2021,2,3,1000,538,122,660,Wednesday
2021,2,3,900,743,78,821,Wednesday
2021,2,3,800,340,58,398,Wednesday
2021,2,3,700,51,43,94,Wednesday
2021,2,3,600,45,44,89,Wednesday
2021,2,3,500,13,26,39,Wednesday
2021,2,3,400,19,25,44,Wednesday
2021,2,3,300,27,42,69,Wednesday
2021,2,3,200,32,44,76,Wednesday
2021,2,3,100,34,41,75,Wednesday
2021,2,2,2400,53,74,127,Tuesday
2021,2,2,2300,49,37,86,Tuesday
2021,2,2,2200,63,66,129,Tuesday
2021,2,2,2100,86,99,185,Tuesday
2021,2,2,2000,119,111,230,Tuesday
2021,2,2,1900,122,176,298,Tuesday
2021,2,2,1800,155,348,503,Tuesday
2021,2,2,1700,166,496,662,Tuesday
2021,2,2,1600,206,417,623,Tuesday
2021,2,2,1500,181,343,524,Tuesday
2021,2,2,1400,202,342,544,Tuesday
2021,2,2,1300,270,248,518,Tuesday
2021,2,2,1200,291,185,476,Tuesday
2021,2,2,1100,272,151,423,Tuesday
2021,2,2,1000,348,71,419,Tuesday
2021,2,2,900,507,65,572,Tuesday
2021,2,2,800,313,92,405,Tuesday
2021,2,2,700,69,48,117,Tuesday
2021,2,2,600,33,10,43,Tuesday
2021,2,2,500,34,11,45,Tuesday
2021,2,2,400,23,54,77,Tuesday
2021,2,2,300,11,44,55,Tuesday
2021,2,2,200,16,44,60,Tuesday
2021,2,2,100,23,37,60,Tuesday
2021,2,1,2400,37,52,89,Monday
2021,2,1,2300,52,67,119,Monday
2021,2,1,2200,72,90,162,Monday
2021,2,1,2100,72,91,163,Monday
2021,2,1,2000,91,109,200,Monday
2021,2,1,1900,136,181,317,Monday
2021,2,1,1800,147,337,484,Monday
2021,2,1,1700,190,546,736,Monday
2021,2,1,1600,210,516,726,Monday
2021,2,1,1500,266,384,650,Monday
2021,2,1,1400,257,293,550,Monday
2021,2,1,1300,295,272,567,Monday
2021,2,1,1200,336,199,535,Monday
2021,2,1,1100,316,131,447,Monday
2021,2,1,1000,398,101,499,Monday
2021,2,1,900,420,71,491,Monday
2021,2,1,800,230,49,279,Monday
2021,2,1,700,89,28,117,Monday
2021,2,1,600,31,14,45,Monday
2021,2,1,500,22,25,47,Monday
2021,2,1,400,21,23,44,Monday
2021,2,1,300,13,21,34,Monday
2021,2,1,200,15,26,41,Monday
2021,2,1,100,20,32,52,Monday
2021,1,31,2400,21,38,59,Sunday
2021,1,31,2300,38,82,120,Sunday
2021,1,31,2200,51,103,154,Sunday
2021,1,31,2100,66,225,291,Sunday
2021,1,31,2000,96,257,353,Sunday
2021,1,31,1900,98,461,559,Sunday
2021,1,31,1800,135,1148,1283,Sunday
2021,1,31,1700,217,1503,1720,Sunday
2021,1,31,1600,301,1239,1540,Sunday
2021,1,31,1500,376,1186,1562,Sunday
2021,1,31,1400,498,825,1323,Sunday
2021,1,31,1300,499,768,1267,Sunday
2021,1,31,1200,631,470,1101,Sunday
2021,1,31,1100,563,215,778,Sunday
2021,1,31,1000,670,121,791,Sunday
2021,1,31,900,950,70,1020,Sunday
2021,1,31,800,681,28,709,Sunday
2021,1,31,700,103,18,121,Sunday
2021,1,31,600,38,12,50,Sunday
2021,1,31,500,16,16,32,Sunday
2021,1,31,400,15,23,38,Sunday
2021,1,31,300,12,18,30,Sunday
2021,1,31,200,24,21,45,Sunday
2021,1,31,100,20,33,53,Sunday
2021,1,30,2400,35,38,73,Saturday
2021,1,30,2300,41,63,104,Saturday
2021,1,30,2200,47,89,136,Saturday
2021,1,30,2100,53,127,180,Saturday
2021,1,30,2000,92,209,301,Saturday
2021,1,30,1900,105,474,579,Saturday
2021,1,30,1800,164,1306,1470,Saturday
2021,1,30,1700,217,1399,1616,Saturday
2021,1,30,1600,340,1033,1373,Saturday
2021,1,30,1500,418,750,1168,Saturday
2021,1,30,1400,553,562,1115,Saturday
2021,1,30,1300,674,355,1029,Saturday
2021,1,30,1200,730,270,1000,Saturday
2021,1,30,1100,739,159,898,Saturday
2021,1,30,1000,730,124,854,Saturday
2021,1,30,900,1159,92,1251,Saturday
2021,1,30,800,868,50,918,Saturday
2021,1,30,700,192,53,245,Saturday
2021,1,30,600,49,37,86,Saturday
2021,1,30,500,32,26,58,Saturday
2021,1,30,400,17,38,55,Saturday
2021,1,30,300,19,27,46,Saturday
2021,1,30,200,18,37,55,Saturday
2021,1,30,100,40,42,82,Saturday
2021,1,29,2400,37,51,88,Friday
2021,1,29,2300,74,68,142,Friday
2021,1,29,2200,110,93,203,Friday
2021,1,29,2100,168,128,296,Friday
2021,1,29,2000,244,142,386,Friday
2021,1,29,1900,334,304,638,Friday
2021,1,29,1800,455,813,1268,Friday
2021,1,29,1700,470,986,1456,Friday
2021,1,29,1600,505,648,1153,Friday
2021,1,29,1500,488,435,923,Friday
2021,1,29,1400,489,336,825,Friday
2021,1,29,1300,527,296,823,Friday
2021,1,29,1200,495,143,638,Friday
2021,1,29,1100,480,170,650,Friday
2021,1,29,1000,644,122,766,Friday
2021,1,29,900,828,96,924,Friday
2021,1,29,800,445,63,508,Friday
2021,1,29,700,90,50,140,Friday
2021,1,29,600,35,42,77,Friday
2021,1,29,500,42,26,68,Friday
2021,1,29,400,29,33,62,Friday
2021,1,29,300,28,37,65,Friday
2021,1,29,200,36,34,70,Friday
2021,1,29,100,47,45,92,Friday
2021,1,28,2400,45,73,118,Thursday
2021,1,28,2300,69,65,134,Thursday
2021,1,28,2200,102,83,185,Thursday
2021,1,28,2100,150,115,265,Thursday
2021,1,28,2000,244,118,362,Thursday
2021,1,28,1900,325,173,498,Thursday
2021,1,28,1800,368,364,732,Thursday
2021,1,28,1700,363,575,938,Thursday
2021,1,28,1600,351,487,838,Thursday
2021,1,28,1500,323,349,672,Thursday
2021,1,28,1400,319,257,576,Thursday
2021,1,28,1300,329,203,532,Thursday
2021,1,28,1200,325,214,539,Thursday
2021,1,28,1100,340,134,474,Thursday
2021,1,28,1000,474,112,586,Thursday
2021,1,28,900,488,88,576,Thursday
2021,1,28,800,252,76,328,Thursday
2021,1,28,700,82,51,133,Thursday
2021,1,28,600,40,75,115,Thursday
2021,1,28,500,36,39,75,Thursday
2021,1,28,400,27,23,50,Thursday
2021,1,28,300,21,7,28,Thursday
2021,1,28,200,31,19,50,Thursday
2021,1,28,100,23,25,48,Thursday
2021,1,27,2400,63,66,129,Wednesday
2021,1,27,2300,55,66,121,Wednesday
2021,1,27,2200,90,59,149,Wednesday
2021,1,27,2100,113,105,218,Wednesday
2021,1,27,2000,96,105,201,Wednesday
2021,1,27,1900,150,155,305,Wednesday
2021,1,27,1800,198,300,498,Wednesday
2021,1,27,1700,225,496,721,Wednesday
2021,1,27,1600,214,427,641,Wednesday
2021,1,27,1500,248,322,570,Wednesday
2021,1,27,1400,230,236,466,Wednesday
2021,1,27,1300,261,221,482,Wednesday
2021,1,27,1200,280,180,460,Wednesday
2021,1,27,1100,281,174,455,Wednesday
2021,1,27,1000,330,99,429,Wednesday
2021,1,27,900,404,88,492,Wednesday
2021,1,27,800,226,67,293,Wednesday
2021,1,27,700,73,63,136,Wednesday
2021,1,27,600,45,38,83,Wednesday
2021,1,27,500,30,31,61,Wednesday
2021,1,27,400,19,38,57,Wednesday
2021,1,27,300,20,38,58,Wednesday
2021,1,27,200,32,47,79,Wednesday
2021,1,27,100,37,49,86,Wednesday
2021,1,26,2400,39,59,98,Tuesday
2021,1,26,2300,49,70,119,Tuesday
2021,1,26,2200,65,79,144,Tuesday
2021,1,26,2100,79,96,175,Tuesday
2021,1,26,2000,111,123,234,Tuesday
2021,1,26,1900,130,164,294,Tuesday
2021,1,26,1800,152,340,492,Tuesday
2021,1,26,1700,166,542,708,Tuesday
2021,1,26,1600,210,416,626,Tuesday
2021,1,26,1500,224,323,547,Tuesday
2021,1,26,1400,252,264,516,Tuesday
2021,1,26,1300,274,229,503,Tuesday
2021,1,26,1200,250,194,444,Tuesday
2021,1,26,1100,280,132,412,Tuesday
2021,1,26,1000,345,117,462,Tuesday
2021,1,26,900,400,91,491,Tuesday
2021,1,26,800,262,67,329,Tuesday
2021,1,26,700,89,35,124,Tuesday
2021,1,26,600,52,41,93,Tuesday
2021,1,26,500,28,40,68,Tuesday
2021,1,26,400,25,39,64,Tuesday
2021,1,26,300,22,44,66,Tuesday
2021,1,26,200,21,44,65,Tuesday
2021,1,26,100,18,45,63,Tuesday
2021,1,25,2400,41,57,98,Monday
2021,1,25,2300,51,77,128,Monday
2021,1,25,2200,58,78,136,Monday
2021,1,25,2100,75,92,167,Monday
2021,1,25,2000,102,126,228,Monday
2021,1,25,1900,126,173,299,Monday
2021,1,25,1800,161,339,500,Monday
2021,1,25,1700,202,523,725,Monday
2021,1,25,1600,216,443,659,Monday
2021,1,25,1500,240,325,565,Monday
2021,1,25,1400,262,259,521,Monday
2021,1,25,1300,264,239,503,Monday
2021,1,25,1200,305,194,499,Monday
2021,1,25,1100,337,145,482,Monday
2021,1,25,1000,330,83,413,Monday
2021,1,25,900,374,52,426,Monday
2021,1,25,800,216,44,260,Monday
2021,1,25,700,70,34,104,Monday
2021,1,25,600,26,18,44,Monday
2021,1,25,500,21,16,37,Monday
2021,1,25,400,17,18,35,Monday
2021,1,25,300,17,20,37,Monday
2021,1,25,200,20,25,45,Monday
2021,1,25,100,15,24,39,Monday
2021,1,24,2400,31,50,81,Sunday
2021,1,24,2300,44,59,103,Sunday
2021,1,24,2200,48,100,148,Sunday
2021,1,24,2100,69,161,230,Sunday
2021,1,24,2000,92,254,346,Sunday
2021,1,24,1900,88,395,483,Sunday
2021,1,24,1800,142,868,1010,Sunday
2021,1,24,1700,188,1268,1456,Sunday
2021,1,24,1600,254,992,1246,Sunday
2021,1,24,1500,329,825,1154,Sunday
2021,1,24,1400,380,621,1001,Sunday
2021,1,24,1300,451,521,972,Sunday
2021,1,24,1200,506,357,863,Sunday
2021,1,24,1100,493,180,673,Sunday
2021,1,24,1000,451,101,552,Sunday
2021,1,24,900,660,54,714,Sunday
2021,1,24,800,550,24,574,Sunday
2021,1,24,700,99,18,117,Sunday
2021,1,24,600,29,11,40,Sunday
2021,1,24,500,19,17,36,Sunday
2021,1,24,400,17,19,36,Sunday
2021,1,24,300,15,17,32,Sunday
2021,1,24,200,16,24,40,Sunday
2021,1,24,100,10,22,32,Sunday
2021,1,23,2400,24,38,62,Saturday
2021,1,23,2300,28,50,78,Saturday
2021,1,23,2200,48,66,114,Saturday
2021,1,23,2100,46,124,170,Saturday
2021,1,23,2000,76,202,278,Saturday
2021,1,23,1900,88,394,482,Saturday
2021,1,23,1800,177,1022,1199,Saturday
2021,1,23,1700,216,1333,1549,Saturday
2021,1,23,1600,309,873,1182,Saturday
2021,1,23,1500,374,635,1009,Saturday
2021,1,23,1400,487,472,959,Saturday
2021,1,23,1300,582,331,913,Saturday
2021,1,23,1200,638,224,862,Saturday
2021,1,23,1100,571,164,735,Saturday
2021,1,23,1000,654,96,750,Saturday
2021,1,23,900,1001,94,1095,Saturday
2021,1,23,800,823,48,871,Saturday
2021,1,23,700,157,34,191,Saturday
2021,1,23,600,31,33,64,Saturday
2021,1,23,500,30,23,53,Saturday
2021,1,23,400,18,20,38,Saturday
2021,1,23,300,15,29,44,Saturday
2021,1,23,200,14,44,58,Saturday
2021,1,23,100,27,36,63,Saturday
2021,1,22,2400,45,47,92,Friday
2021,1,22,2300,63,56,119,Friday
2021,1,22,2200,106,69,175,Friday
2021,1,22,2100,176,113,289,Friday
2021,1,22,2000,265,113,378,Friday
2021,1,22,1900,343,224,567,Friday
2021,1,22,1800,425,447,872,Friday
2021,1,22,1700,417,670,1087,Friday
2021,1,22,1600,488,498,986,Friday
2021,1,22,1500,449,397,846,Friday
2021,1,22,1400,422,321,743,Friday
2021,1,22,1300,380,264,644,Friday
2021,1,22,1200,391,166,557,Friday
2021,1,22,1100,372,172,544,Friday
2021,1,22,1000,409,115,524,Friday
2021,1,22,900,548,86,634,Friday
2021,1,22,800,299,68,367,Friday
2021,1,22,700,95,61,156,Friday
2021,1,22,600,42,40,82,Friday
2021,1,22,500,26,33,59,Friday
2021,1,22,400,25,33,58,Friday
2021,1,22,300,24,46,70,Friday
2021,1,22,200,20,35,55,Friday
2021,1,22,100,30,40,70,Friday
2021,1,21,2400,52,73,125,Thursday
2021,1,21,2300,72,62,134,Thursday
2021,1,21,2200,83,83,166,Thursday
2021,1,21,2100,117,98,215,Thursday
2021,1,21,2000,167,119,286,Thursday
2021,1,21,1900,235,191,426,Thursday
2021,1,21,1800,243,405,648,Thursday
2021,1,21,1700,256,673,929,Thursday
2021,1,21,1600,295,555,850,Thursday
2021,1,21,1500,305,399,704,Thursday
2021,1,21,1400,306,250,556,Thursday
2021,1,21,1300,301,249,550,Thursday
2021,1,21,1200,344,206,550,Thursday
2021,1,21,1100,348,161,509,Thursday
2021,1,21,1000,484,97,581,Thursday
2021,1,21,900,541,67,608,Thursday
2021,1,21,800,288,81,369,Thursday
2021,1,21,700,80,49,129,Thursday
2021,1,21,600,45,31,76,Thursday
2021,1,21,500,29,33,62,Thursday
2021,1,21,400,34,43,77,Thursday
2021,1,21,300,19,38,57,Thursday
2021,1,21,200,25,56,81,Thursday
2021,1,21,100,45,41,86,Thursday
2021,1,20,2400,60,86,146,Wednesday
2021,1,20,2300,57,31,88,Wednesday
2021,1,20,2200,69,81,150,Wednesday
2021,1,20,2100,93,110,203,Wednesday
2021,1,20,2000,104,124,228,Wednesday
2021,1,20,1900,156,168,324,Wednesday
2021,1,20,1800,193,346,539,Wednesday
2021,1,20,1700,184,604,788,Wednesday
2021,1,20,1600,201,547,748,Wednesday
2021,1,20,1500,264,434,698,Wednesday
2021,1,20,1400,287,250,537,Wednesday
2021,1,20,1300,327,250,577,Wednesday
2021,1,20,1200,344,188,532,Wednesday
2021,1,20,1100,342,152,494,Wednesday
2021,1,20,1000,453,112,565,Wednesday
2021,1,20,900,534,105,639,Wednesday
2021,1,20,800,255,68,323,Wednesday
2021,1,20,700,82,55,137,Wednesday
2021,1,20,600,40,33,73,Wednesday
2021,1,20,500,32,27,59,Wednesday
2021,1,20,400,26,41,67,Wednesday
2021,1,20,300,26,45,71,Wednesday
2021,1,20,200,26,53,79,Wednesday
2021,1,20,100,30,48,78,Wednesday
2021,1,19,2400,44,61,105,Tuesday
2021,1,19,2300,48,67,115,Tuesday
2021,1,19,2200,50,66,116,Tuesday
2021,1,19,2100,85,87,172,Tuesday
2021,1,19,2000,83,109,192,Tuesday
2021,1,19,1900,104,166,270,Tuesday
2021,1,19,1800,161,307,468,Tuesday
2021,1,19,1700,171,536,707,Tuesday
2021,1,19,1600,189,455,644,Tuesday
2021,1,19,1500,203,397,600,Tuesday
2021,1,19,1400,251,299,550,Tuesday
2021,1,19,1300,252,217,469,Tuesday
2021,1,19,1200,281,189,470,Tuesday
2021,1,19,1100,312,164,476,Tuesday
2021,1,19,1000,375,107,482,Tuesday
2021,1,19,900,431,97,528,Tuesday
2021,1,19,800,243,76,319,Tuesday
2021,1,19,700,74,36,110,Tuesday
2021,1,19,600,36,32,68,Tuesday
2021,1,19,500,28,36,64,Tuesday
2021,1,19,400,18,38,56,Tuesday
2021,1,19,300,19,34,53,Tuesday
2021,1,19,200,22,50,72,Tuesday
2021,1,19,100,28,42,70,Tuesday
2021,1,18,2400,53,47,100,Monday
2021,1,18,2300,50,78,128,Monday
2021,1,18,2200,68,66,134,Monday
2021,1,18,2100,82,91,173,Monday
2021,1,18,2000,99,126,225,Monday
2021,1,18,1900,98,184,282,Monday
2021,1,18,1800,143,434,577,Monday
2021,1,18,1700,198,647,845,Monday
2021,1,18,1600,208,555,763,Monday
2021,1,18,1500,217,415,632,Monday
2021,1,18,1400,268,330,598,Monday
2021,1,18,1300,284,293,577,Monday
2021,1,18,1200,331,200,531,Monday
2021,1,18,1100,384,127,511,Monday
2021,1,18,1000,460,106,566,Monday
2021,1,18,900,521,64,585,Monday
2021,1,18,800,285,48,333,Monday
2021,1,18,700,57,30,87,Monday
2021,1,18,600,35,17,52,Monday
2021,1,18,500,28,17,45,Monday
2021,1,18,400,19,16,35,Monday
2021,1,18,300,22,25,47,Monday
2021,1,18,200,13,21,34,Monday
2021,1,18,100,10,40,50,Monday
2021,1,17,2400,19,34,53,Sunday
2021,1,17,2300,42,71,113,Sunday
2021,1,17,2200,39,128,167,Sunday
2021,1,17,2100,51,153,204,Sunday
2021,1,17,2000,76,265,341,Sunday
2021,1,17,1900,103,419,522,Sunday
2021,1,17,1800,126,1170,1296,Sunday
2021,1,17,1700,182,1592,1774,Sunday
2021,1,17,1600,252,1227,1479,Sunday
2021,1,17,1500,335,945,1280,Sunday
2021,1,17,1400,436,743,1179,Sunday
2021,1,17,1300,467,521,988,Sunday
2021,1,17,1200,565,366,931,Sunday
2021,1,17,1100,551,166,717,Sunday
2021,1,17,1000,665,97,762,Sunday
2021,1,17,900,1131,49,1180,Sunday
2021,1,17,800,745,36,781,Sunday
2021,1,17,700,124,21,145,Sunday
2021,1,17,600,33,13,46,Sunday
2021,1,17,500,8,16,24,Sunday
2021,1,17,400,8,13,21,Sunday
2021,1,17,300,10,18,28,Sunday
2021,1,17,200,21,31,52,Sunday
2021,1,17,100,24,27,51,Sunday
2021,1,16,2400,23,35,58,Saturday
2021,1,16,2300,37,61,98,Saturday
2021,1,16,2200,44,105,149,Saturday
2021,1,16,2100,53,147,200,Saturday
2021,1,16,2000,83,193,276,Saturday
2021,1,16,1900,93,474,567,Saturday
2021,1,16,1800,168,1252,1420,Saturday
2021,1,16,1700,221,1485,1706,Saturday
2021,1,16,1600,286,1154,1440,Saturday
2021,1,16,1500,415,679,1094,Saturday
2021,1,16,1400,552,523,1075,Saturday
2021,1,16,1300,693,320,1013,Saturday
2021,1,16,1200,743,261,1004,Saturday
2021,1,16,1100,748,150,898,Saturday
2021,1,16,1000,736,110,846,Saturday
2021,1,16,900,1213,92,1305,Saturday
2021,1,16,800,989,65,1054,Saturday
2021,1,16,700,158,34,192,Saturday
2021,1,16,600,46,33,79,Saturday
2021,1,16,500,19,17,36,Saturday
2021,1,16,400,14,30,44,Saturday
2021,1,16,300,24,21,45,Saturday
2021,1,16,200,18,26,44,Saturday
2021,1,16,100,40,41,81,Saturday
2021,1,15,2400,46,38,84,Friday
2021,1,15,2300,86,67,153,Friday
2021,1,15,2200,99,78,177,Friday
2021,1,15,2100,167,75,242,Friday
2021,1,15,2000,276,114,390,Friday
2021,1,15,1900,353,197,550,Friday
2021,1,15,1800,412,461,873,Friday
2021,1,15,1700,478,826,1304,Friday
2021,1,15,1600,470,570,1040,Friday
2021,1,15,1500,441,463,904,Friday
2021,1,15,1400,374,316,690,Friday
2021,1,15,1300,397,239,636,Friday
2021,1,15,1200,396,193,589,Friday
2021,1,15,1100,399,158,557,Friday
2021,1,15,1000,474,137,611,Friday
2021,1,15,900,665,102,767,Friday
2021,1,15,800,400,71,471,Friday
2021,1,15,700,90,40,130,Friday
2021,1,15,600,66,29,95,Friday
2021,1,15,500,39,28,67,Friday
2021,1,15,400,28,37,65,Friday
2021,1,15,300,27,43,70,Friday
2021,1,15,200,27,37,64,Friday
2021,1,15,100,47,49,96,Friday
2021,1,14,2400,55,68,123,Thursday
2021,1,14,2300,87,74,161,Thursday
2021,1,14,2200,93,76,169,Thursday
2021,1,14,2100,114,113,227,Thursday
2021,1,14,2000,155,125,280,Thursday
2021,1,14,1900,178,172,350,Thursday
2021,1,14,1800,254,515,769,Thursday
2021,1,14,1700,262,927,1189,Thursday
2021,1,14,1600,271,693,964,Thursday
2021,1,14,1500,297,459,756,Thursday
2021,1,14,1400,261,346,607,Thursday
2021,1,14,1300,282,289,571,Thursday
2021,1,14,1200,376,153,529,Thursday
2021,1,14,1100,395,133,528,Thursday
2021,1,14,1000,548,114,662,Thursday
2021,1,14,900,852,84,936,Thursday
2021,1,14,800,452,51,503,Thursday
2021,1,14,700,116,47,163,Thursday
2021,1,14,600,42,33,75,Thursday
2021,1,14,500,27,14,41,Thursday
2021,1,14,400,15,33,48,Thursday
2021,1,14,300,18,38,56,Thursday
2021,1,14,200,25,29,54,Thursday
2021,1,14,100,31,40,71,Thursday
2021,1,13,2400,35,67,102,Wednesday
2021,1,13,2300,51,70,121,Wednesday
2021,1,13,2200,53,76,129,Wednesday
2021,1,13,2100,90,122,212,Wednesday
2021,1,13,2000,116,166,282,Wednesday
2021,1,13,1900,104,209,313,Wednesday
2021,1,13,1800,140,264,404,Wednesday
2021,1,13,1700,149,583,732,Wednesday
2021,1,13,1600,183,522,705,Wednesday
2021,1,13,1500,200,272,472,Wednesday
2021,1,13,1400,213,278,491,Wednesday
2021,1,13,1300,219,268,487,Wednesday
2021,1,13,1200,209,156,365,Wednesday
2021,1,13,1100,242,114,356,Wednesday
2021,1,13,1000,418,58,476,Wednesday
2021,1,13,900,700,62,762,Wednesday
2021,1,13,800,391,57,448,Wednesday
2021,1,13,700,82,45,127,Wednesday
2021,1,13,600,39,57,96,Wednesday
2021,1,13,500,28,41,69,Wednesday
2021,1,13,400,25,31,56,Wednesday
2021,1,13,300,18,50,68,Wednesday
2021,1,13,200,19,50,69,Wednesday
2021,1,13,100,31,60,91,Wednesday
2021,1,12,2400,44,71,115,Tuesday
2021,1,12,2300,53,65,118,Tuesday
2021,1,12,2200,56,77,133,Tuesday
2021,1,12,2100,76,92,168,Tuesday
2021,1,12,2000,97,117,214,Tuesday
2021,1,12,1900,116,167,283,Tuesday
2021,1,12,1800,134,265,399,Tuesday
2021,1,12,1700,194,468,662,Tuesday
2021,1,12,1600,180,395,575,Tuesday
2021,1,12,1500,226,339,565,Tuesday
2021,1,12,1400,201,272,473,Tuesday
2021,1,12,1300,259,219,478,Tuesday
2021,1,12,1200,261,156,417,Tuesday
2021,1,12,1100,303,133,436,Tuesday
2021,1,12,1000,334,90,424,Tuesday
2021,1,12,900,365,81,446,Tuesday
2021,1,12,800,247,80,327,Tuesday
2021,1,12,700,68,49,117,Tuesday
2021,1,12,600,34,36,70,Tuesday
2021,1,12,500,22,35,57,Tuesday
2021,1,12,400,21,39,60,Tuesday
2021,1,12,300,22,35,57,Tuesday
2021,1,12,200,22,45,67,Tuesday
2021,1,12,100,39,44,83,Tuesday
2021,1,11,2400,41,59,100,Monday
2021,1,11,2300,49,75,124,Monday
2021,1,11,2200,58,77,135,Monday
2021,1,11,2100,68,86,154,Monday
2021,1,11,2000,88,110,198,Monday
2021,1,11,1900,121,160,281,Monday
2021,1,11,1800,132,290,422,Monday
2021,1,11,1700,177,484,661,Monday
2021,1,11,1600,201,401,602,Monday
2021,1,11,1500,242,350,592,Monday
2021,1,11,1400,268,298,566,Monday
2021,1,11,1300,284,212,496,Monday
2021,1,11,1200,316,141,457,Monday
2021,1,11,1100,296,143,439,Monday
2021,1,11,1000,354,73,427,Monday
2021,1,11,900,361,56,417,Monday
2021,1,11,800,220,46,266,Monday
2021,1,11,700,66,41,107,Monday
2021,1,11,600,34,14,48,Monday
2021,1,11,500,21,17,38,Monday
2021,1,11,400,22,28,50,Monday
2021,1,11,300,13,18,31,Monday
2021,1,11,200,21,36,57,Monday
2021,1,11,100,23,40,63,Monday
2021,1,10,2400,20,49,69,Sunday
2021,1,10,2300,39,61,100,Sunday
2021,1,10,2200,51,88,139,Sunday
2021,1,10,2100,39,155,194,Sunday
2021,1,10,2000,86,233,319,Sunday
2021,1,10,1900,102,417,519,Sunday
2021,1,10,1800,121,1062,1183,Sunday
2021,1,10,1700,204,1622,1826,Sunday
2021,1,10,1600,240,1281,1521,Sunday
2021,1,10,1500,325,925,1250,Sunday
2021,1,10,1400,394,671,1065,Sunday
2021,1,10,1300,468,508,976,Sunday
2021,1,10,1200,599,341,940,Sunday
2021,1,10,1100,569,169,738,Sunday
2021,1,10,1000,572,93,665,Sunday
2021,1,10,900,1014,60,1074,Sunday
2021,1,10,800,781,33,814,Sunday
2021,1,10,700,121,18,139,Sunday
2021,1,10,600,24,19,43,Sunday
2021,1,10,500,15,10,25,Sunday
2021,1,10,400,10,21,31,Sunday
2021,1,10,300,14,17,31,Sunday
2021,1,10,200,16,30,46,Sunday
2021,1,10,100,16,33,49,Sunday
2021,1,9,2400,24,56,80,Saturday
2021,1,9,2300,39,43,82,Saturday
2021,1,9,2200,44,93,137,Saturday
2021,1,9,2100,46,136,182,Saturday
2021,1,9,2000,78,189,267,Saturday
2021,1,9,1900,110,340,450,Saturday
2021,1,9,1800,123,1160,1283,Saturday
2021,1,9,1700,213,1443,1656,Saturday
2021,1,9,1600,295,1144,1439,Saturday
2021,1,9,1500,388,700,1088,Saturday
2021,1,9,1400,548,501,1049,Saturday
2021,1,9,1300,642,394,1036,Saturday
2021,1,9,1200,606,266,872,Saturday
2021,1,9,1100,655,152,807,Saturday
2021,1,9,1000,719,119,838,Saturday
2021,1,9,900,1098,79,1177,Saturday
2021,1,9,800,920,62,982,Saturday
2021,1,9,700,139,43,182,Saturday
2021,1,9,600,40,29,69,Saturday
2021,1,9,500,22,27,49,Saturday
2021,1,9,400,17,37,54,Saturday
2021,1,9,300,18,26,44,Saturday
2021,1,9,200,19,39,58,Saturday
2021,1,9,100,37,37,74,Saturday
2021,1,8,2400,42,43,85,Friday
2021,1,8,2300,62,56,118,Friday
2021,1,8,2200,84,74,158,Friday
2021,1,8,2100,137,123,260,Friday
2021,1,8,2000,201,165,366,Friday
2021,1,8,1900,253,217,470,Friday
2021,1,8,1800,346,541,887,Friday
2021,1,8,1700,384,919,1303,Friday
2021,1,8,1600,399,666,1065,Friday
2021,1,8,1500,409,434,843,Friday
2021,1,8,1400,406,313,719,Friday
2021,1,8,1300,389,279,668,Friday
2021,1,8,1200,407,199,606,Friday
2021,1,8,1100,398,148,546,Friday
2021,1,8,1000,459,87,546,Friday
2021,1,8,900,700,90,790,Friday
2021,1,8,800,411,55,466,Friday
2021,1,8,700,115,39,154,Friday
2021,1,8,600,41,30,71,Friday
2021,1,8,500,26,38,64,Friday
2021,1,8,400,27,34,61,Friday
2021,1,8,300,22,47,69,Friday
2021,1,8,200,28,46,74,Friday
2021,1,8,100,36,48,84,Friday
2021,1,7,2400,50,83,133,Thursday
2021,1,7,2300,56,72,128,Thursday
2021,1,7,2200,76,88,164,Thursday
2021,1,7,2100,104,94,198,Thursday
2021,1,7,2000,136,135,271,Thursday
2021,1,7,1900,187,212,399,Thursday
2021,1,7,1800,225,599,824,Thursday
2021,1,7,1700,237,975,1212,Thursday
2021,1,7,1600,270,653,923,Thursday
2021,1,7,1500,327,457,784,Thursday
2021,1,7,1400,305,405,710,Thursday
2021,1,7,1300,364,229,593,Thursday
2021,1,7,1200,401,188,589,Thursday
2021,1,7,1100,454,144,598,Thursday
2021,1,7,1000,608,104,712,Thursday
2021,1,7,900,824,98,922,Thursday
2021,1,7,800,408,44,452,Thursday
2021,1,7,700,80,37,117,Thursday
2021,1,7,600,32,42,74,Thursday
2021,1,7,500,36,35,71,Thursday
2021,1,7,400,26,47,73,Thursday
2021,1,7,300,28,33,61,Thursday
2021,1,7,200,31,45,76,Thursday
2021,1,7,100,42,48,90,Thursday
2021,1,6,2400,46,60,106,Wednesday
2021,1,6,2300,49,74,123,Wednesday
2021,1,6,2200,76,96,172,Wednesday
2021,1,6,2100,96,119,215,Wednesday
2021,1,6,2000,126,143,269,Wednesday
2021,1,6,1900,121,217,338,Wednesday
2021,1,6,1800,183,429,612,Wednesday
2021,1,6,1700,192,666,858,Wednesday
2021,1,6,1600,227,463,690,Wednesday
2021,1,6,1500,249,420,669,Wednesday
2021,1,6,1400,264,312,576,Wednesday
2021,1,6,1300,321,218,539,Wednesday
2021,1,6,1200,306,197,503,Wednesday
2021,1,6,1100,299,136,435,Wednesday
2021,1,6,1000,408,76,484,Wednesday
2021,1,6,900,539,75,614,Wednesday
2021,1,6,800,283,65,348,Wednesday
2021,1,6,700,72,39,111,Wednesday
2021,1,6,600,48,26,74,Wednesday
2021,1,6,500,22,20,42,Wednesday
2021,1,6,400,21,32,53,Wednesday
2021,1,6,300,31,32,63,Wednesday
2021,1,6,200,22,50,72,Wednesday
2021,1,6,100,39,48,87,Wednesday
2021,1,5,2400,44,50,94,Tuesday
2021,1,5,2300,52,60,112,Tuesday
2021,1,5,2200,80,86,166,Tuesday
2021,1,5,2100,83,114,197,Tuesday
2021,1,5,2000,93,118,211,Tuesday
2021,1,5,1900,130,240,370,Tuesday
2021,1,5,1800,138,518,656,Tuesday
2021,1,5,1700,165,783,948,Tuesday
2021,1,5,1600,230,634,864,Tuesday
2021,1,5,1500,242,463,705,Tuesday
2021,1,5,1400,305,315,620,Tuesday
2021,1,5,1300,300,274,574,Tuesday
2021,1,5,1200,362,197,559,Tuesday
2021,1,5,1100,394,151,545,Tuesday
2021,1,5,1000,465,124,589,Tuesday
2021,1,5,900,655,84,739,Tuesday
2021,1,5,800,325,60,385,Tuesday
2021,1,5,700,88,37,125,Tuesday
2021,1,5,600,24,30,54,Tuesday
2021,1,5,500,20,28,48,Tuesday
2021,1,5,400,23,27,50,Tuesday
2021,1,5,300,15,55,70,Tuesday
2021,1,5,200,15,36,51,Tuesday
2021,1,5,100,31,27,58,Tuesday
2021,1,4,2400,36,52,88,Monday
2021,1,4,2300,49,46,95,Monday
2021,1,4,2200,60,60,120,Monday
2021,1,4,2100,58,83,141,Monday
2021,1,4,2000,108,137,245,Monday
2021,1,4,1900,99,198,297,Monday
2021,1,4,1800,146,559,705,Monday
2021,1,4,1700,188,891,1079,Monday
2021,1,4,1600,214,735,949,Monday
2021,1,4,1500,298,524,822,Monday
2021,1,4,1400,318,341,659,Monday
2021,1,4,1300,358,305,663,Monday
2021,1,4,1200,385,204,589,Monday
2021,1,4,1100,377,122,499,Monday
2021,1,4,1000,505,114,619,Monday
2021,1,4,900,776,64,840,Monday
2021,1,4,800,398,44,442,Monday
2021,1,4,700,98,32,130,Monday
2021,1,4,600,26,21,47,Monday
2021,1,4,500,13,14,27,Monday
2021,1,4,400,14,25,39,Monday
2021,1,4,300,19,20,39,Monday
2021,1,4,200,16,16,32,Monday
2021,1,4,100,15,39,54,Monday
2021,1,3,2400,19,46,65,Sunday
2021,1,3,2300,34,50,84,Sunday
2021,1,3,2200,42,100,142,Sunday
2021,1,3,2100,55,136,191,Sunday
2021,1,3,2000,60,224,284,Sunday
2021,1,3,1900,81,365,446,Sunday
2021,1,3,1800,130,1007,1137,Sunday
2021,1,3,1700,189,1508,1697,Sunday
2021,1,3,1600,261,1324,1585,Sunday
2021,1,3,1500,389,1072,1461,Sunday
2021,1,3,1400,451,764,1215,Sunday
2021,1,3,1300,433,596,1029,Sunday
2021,1,3,1200,539,369,908,Sunday
2021,1,3,1100,477,186,663,Sunday
2021,1,3,1000,499,104,603,Sunday
2021,1,3,900,907,54,961,Sunday
2021,1,3,800,773,35,808,Sunday
2021,1,3,700,107,7,114,Sunday
2021,1,3,600,30,7,37,Sunday
2021,1,3,500,12,14,26,Sunday
2021,1,3,400,7,55,62,Sunday
2021,1,3,300,13,6,19,Sunday
2021,1,3,200,7,3,10,Sunday
2021,1,3,100,12,9,21,Sunday
2021,1,2,2400,25,29,54,Saturday
2021,1,2,2300,17,40,57,Saturday
2021,1,2,2200,29,71,100,Saturday
2021,1,2,2100,50,110,160,Saturday
2021,1,2,2000,67,204,271,Saturday
2021,1,2,1900,84,384,468,Saturday
2021,1,2,1800,128,955,1083,Saturday
2021,1,2,1700,233,1416,1649,Saturday
2021,1,2,1600,318,1175,1493,Saturday
2021,1,2,1500,491,1010,1501,Saturday
2021,1,2,1400,532,835,1367,Saturday
2021,1,2,1300,445,684,1129,Saturday
2021,1,2,1200,538,433,971,Saturday
2021,1,2,1100,585,199,784,Saturday
2021,1,2,1000,603,99,702,Saturday
2021,1,2,900,919,50,969,Saturday
2021,1,2,800,584,30,614,Saturday
2021,1,2,700,103,20,123,Saturday
2021,1,2,600,25,21,46,Saturday
2021,1,2,500,10,17,27,Saturday
2021,1,2,400,8,20,28,Saturday
2021,1,2,300,7,13,20,Saturday
2021,1,2,200,10,26,36,Saturday
2021,1,2,100,13,23,36,Saturday
2021,1,1,2400,21,34,55,Friday
2021,1,1,2300,32,38,70,Friday
2021,1,1,2200,27,57,84,Friday
2021,1,1,2100,44,100,144,Friday
2021,1,1,2000,79,176,255,Friday
2021,1,1,1900,87,405,492,Friday
2021,1,1,1800,126,1047,1173,Friday
2021,1,1,1700,239,1284,1523,Friday
2021,1,1,1600,338,935,1273,Friday
2021,1,1,1500,477,852,1329,Friday
2021,1,1,1400,555,541,1096,Friday
2021,1,1,1300,621,418,1039,Friday
2021,1,1,1200,634,228,862,Friday
2021,1,1,1100,540,148,688,Friday
2021,1,1,1000,617,68,685,Friday
2021,1,1,900,773,38,811,Friday
2021,1,1,800,481,36,517,Friday
2021,1,1,700,88,22,110,Friday
2021,1,1,600,32,19,51,Friday
2021,1,1,500,21,8,29,Friday
2021,1,1,400,11,16,27,Friday
2021,1,1,300,10,19,29,Friday
2021,1,1,200,14,35,49,Friday
2021,1,1,100,14,31,45,Friday
2020,12,31,2400,19,30,49,Thursday
2020,12,31,2300,41,54,95,Thursday
2020,12,31,2200,47,74,121,Thursday
2020,12,31,2100,67,99,166,Thursday
2020,12,31,2000,95,127,222,Thursday
2020,12,31,1900,124,270,394,Thursday
2020,12,31,1800,186,670,856,Thursday
2020,12,31,1700,286,1185,1471,Thursday
2020,12,31,1600,423,922,1345,Thursday
2020,12,31,1500,465,706,1171,Thursday
2020,12,31,1400,506,480,986,Thursday
2020,12,31,1300,513,378,891,Thursday
2020,12,31,1200,579,249,828,Thursday
2020,12,31,1100,589,137,726,Thursday
2020,12,31,1000,605,108,713,Thursday
2020,12,31,900,914,69,983,Thursday
2020,12,31,800,546,40,586,Thursday
2020,12,31,700,115,21,136,Thursday
2020,12,31,600,41,27,68,Thursday
2020,12,31,500,23,32,55,Thursday
2020,12,31,400,21,29,50,Thursday
2020,12,31,300,18,23,41,Thursday
2020,12,31,200,26,38,64,Thursday
2020,12,31,100,21,19,40,Thursday
2020,12,30,2400,39,61,100,Wednesday
2020,12,30,2300,68,128,196,Wednesday
2020,12,30,2200,69,38,107,Wednesday
2020,12,30,2100,97,88,185,Wednesday
2020,12,30,2000,126,161,287,Wednesday
2020,12,30,1900,161,273,434,Wednesday
2020,12,30,1800,224,666,890,Wednesday
2020,12,30,1700,299,1204,1503,Wednesday
2020,12,30,1600,425,985,1410,Wednesday
2020,12,30,1500,538,782,1320,Wednesday
2020,12,30,1400,568,543,1111,Wednesday
2020,12,30,1300,642,422,1064,Wednesday
2020,12,30,1200,647,270,917,Wednesday
2020,12,30,1100,642,171,813,Wednesday
2020,12,30,1000,651,142,793,Wednesday
2020,12,30,900,926,76,1002,Wednesday
2020,12,30,800,501,76,577,Wednesday
2020,12,30,700,114,36,150,Wednesday
2020,12,30,600,42,24,66,Wednesday
2020,12,30,500,26,39,65,Wednesday
2020,12,30,400,24,29,53,Wednesday
2020,12,30,300,28,40,68,Wednesday
2020,12,30,200,21,50,71,Wednesday
2020,12,30,100,26,40,66,Wednesday
2020,12,29,2400,41,66,107,Tuesday
2020,12,29,2300,56,88,144,Tuesday
2020,12,29,2200,69,81,150,Tuesday
2020,12,29,2100,114,114,228,Tuesday
2020,12,29,2000,122,179,301,Tuesday
2020,12,29,1900,152,265,417,Tuesday
2020,12,29,1800,210,680,890,Tuesday
2020,12,29,1700,277,1252,1529,Tuesday
2020,12,29,1600,392,985,1377,Tuesday
2020,12,29,1500,487,722,1209,Tuesday
2020,12,29,1400,559,535,1094,Tuesday
2020,12,29,1300,674,383,1057,Tuesday
2020,12,29,1200,726,250,976,Tuesday
2020,12,29,1100,629,187,816,Tuesday
2020,12,29,1000,730,130,860,Tuesday
2020,12,29,900,869,66,935,Tuesday
2020,12,29,800,490,70,560,Tuesday
2020,12,29,700,133,27,160,Tuesday
2020,12,29,600,44,25,69,Tuesday
2020,12,29,500,12,16,28,Tuesday
2020,12,29,400,12,30,42,Tuesday
2020,12,29,300,14,24,38,Tuesday
2020,12,29,200,12,35,47,Tuesday
2020,12,29,100,25,43,68,Tuesday
2020,12,28,2400,29,42,71,Monday
2020,12,28,2300,38,65,103,Monday
2020,12,28,2200,63,54,117,Monday
2020,12,28,2100,72,123,195,Monday
2020,12,28,2000,116,125,241,Monday
2020,12,28,1900,142,268,410,Monday
2020,12,28,1800,191,717,908,Monday
2020,12,28,1700,274,1114,1388,Monday
2020,12,28,1600,436,868,1304,Monday
2020,12,28,1500,554,617,1171,Monday
2020,12,28,1400,644,443,1087,Monday
2020,12,28,1300,719,413,1132,Monday
2020,12,28,1200,676,221,897,Monday
2020,12,28,1100,565,136,701,Monday
2020,12,28,1000,638,108,746,Monday
2020,12,28,900,815,46,861,Monday
2020,12,28,800,464,33,497,Monday
2020,12,28,700,104,18,122,Monday
2020,12,28,600,38,18,56,Monday
2020,12,28,500,16,9,25,Monday
2020,12,28,400,12,13,25,Monday
2020,12,28,300,12,10,22,Monday
2020,12,28,200,10,19,29,Monday
2020,12,28,100,12,15,27,Monday
2020,12,27,2400,21,46,67,Sunday
2020,12,27,2300,37,61,98,Sunday
2020,12,27,2200,42,74,116,Sunday
2020,12,27,2100,71,95,166,Sunday
2020,12,27,2000,94,163,257,Sunday
2020,12,27,1900,108,283,391,Sunday
2020,12,27,1800,192,676,868,Sunday
2020,12,27,1700,316,1130,1446,Sunday
2020,12,27,1600,485,890,1375,Sunday
2020,12,27,1500,617,607,1224,Sunday
2020,12,27,1400,669,411,1080,Sunday
2020,12,27,1300,651,290,941,Sunday
2020,12,27,1200,626,170,796,Sunday
2020,12,27,1100,609,122,731,Sunday
2020,12,27,1000,601,56,657,Sunday
2020,12,27,900,862,52,914,Sunday
2020,12,27,800,508,23,531,Sunday
2020,12,27,700,129,12,141,Sunday
2020,12,27,600,30,12,42,Sunday
2020,12,27,500,8,13,21,Sunday
2020,12,27,400,10,15,25,Sunday
2020,12,27,300,14,8,22,Sunday
2020,12,27,200,15,23,38,Sunday
2020,12,27,100,13,19,32,Sunday
2020,12,26,2400,19,26,45,Saturday
2020,12,26,2300,25,22,47,Saturday
2020,12,26,2200,42,47,89,Saturday
2020,12,26,2100,33,64,97,Saturday
2020,12,26,2000,79,81,160,Saturday
2020,12,26,1900,84,151,235,Saturday
2020,12,26,1800,155,453,608,Saturday
2020,12,26,1700,221,657,878,Saturday
2020,12,26,1600,434,538,972,Saturday
2020,12,26,1500,458,350,808,Saturday
2020,12,26,1400,555,283,838,Saturday
2020,12,26,1300,496,227,723,Saturday
2020,12,26,1200,477,129,606,Saturday
2020,12,26,1100,385,90,475,Saturday
2020,12,26,1000,381,49,430,Saturday
2020,12,26,900,525,42,567,Saturday
2020,12,26,800,368,14,382,Saturday
2020,12,26,700,99,12,111,Saturday
2020,12,26,600,17,7,24,Saturday
2020,12,26,500,19,7,26,Saturday
2020,12,26,400,11,5,16,Saturday
2020,12,26,300,13,8,21,Saturday
2020,12,26,200,11,6,17,Saturday
2020,12,26,100,16,14,30,Saturday
2020,12,25,2400,14,16,30,Friday
2020,12,25,2300,22,20,42,Friday
2020,12,25,2200,29,27,56,Friday
2020,12,25,2100,30,35,65,Friday
2020,12,25,2000,52,79,131,Friday
2020,12,25,1900,53,138,191,Friday
2020,12,25,1800,75,435,510,Friday
2020,12,25,1700,133,625,758,Friday
2020,12,25,1600,238,502,740,Friday
2020,12,25,1500,305,351,656,Friday
2020,12,25,1400,331,226,557,Friday
2020,12,25,1300,360,174,534,Friday
2020,12,25,1200,331,108,439,Friday
2020,12,25,1100,309,61,370,Friday
2020,12,25,1000,336,41,377,Friday
2020,12,25,900,443,31,474,Friday
2020,12,25,800,245,21,266,Friday
2020,12,25,700,41,8,49,Friday
2020,12,25,600,21,14,35,Friday
2020,12,25,500,9,17,26,Friday
2020,12,25,400,6,17,23,Friday
2020,12,25,300,9,17,26,Friday
2020,12,25,200,15,16,31,Friday
2020,12,25,100,19,18,37,Friday
2020,12,24,2400,17,30,47,Thursday
2020,12,24,2300,22,37,59,Thursday
2020,12,24,2200,38,47,85,Thursday
2020,12,24,2100,44,66,110,Thursday
2020,12,24,2000,67,91,158,Thursday
2020,12,24,1900,78,159,237,Thursday
2020,12,24,1800,135,605,740,Thursday
2020,12,24,1700,173,778,951,Thursday
2020,12,24,1600,254,565,819,Thursday
2020,12,24,1500,335,378,713,Thursday
2020,12,24,1400,310,219,529,Thursday
2020,12,24,1300,351,214,565,Thursday
2020,12,24,1200,384,191,575,Thursday
2020,12,24,1100,391,156,547,Thursday
2020,12,24,1000,420,84,504,Thursday
2020,12,24,900,629,69,698,Thursday
2020,12,24,800,381,35,416,Thursday
2020,12,24,700,90,26,116,Thursday
2020,12,24,600,33,31,64,Thursday
2020,12,24,500,17,30,47,Thursday
2020,12,24,400,26,33,59,Thursday
2020,12,24,300,25,22,47,Thursday
2020,12,24,200,24,36,60,Thursday
2020,12,24,100,51,39,90,Thursday
2020,12,23,2400,55,44,99,Wednesday
2020,12,23,2300,65,69,134,Wednesday
2020,12,23,2200,78,97,175,Wednesday
2020,12,23,2100,101,117,218,Wednesday
2020,12,23,2000,116,146,262,Wednesday
2020,12,23,1900,150,245,395,Wednesday
2020,12,23,1800,183,554,737,Wednesday
2020,12,23,1700,231,922,1153,Wednesday
2020,12,23,1600,357,624,981,Wednesday
2020,12,23,1500,438,577,1015,Wednesday
2020,12,23,1400,361,437,798,Wednesday
2020,12,23,1300,367,463,830,Wednesday
2020,12,23,1200,404,318,722,Wednesday
2020,12,23,1100,395,220,615,Wednesday
2020,12,23,1000,441,159,600,Wednesday
2020,12,23,900,812,125,937,Wednesday
2020,12,23,800,469,58,527,Wednesday
2020,12,23,700,97,47,144,Wednesday
2020,12,23,600,41,37,78,Wednesday
2020,12,23,500,23,26,49,Wednesday
2020,12,23,400,13,31,44,Wednesday
2020,12,23,300,29,23,52,Wednesday
2020,12,23,200,32,28,60,Wednesday
2020,12,23,100,44,75,119,Wednesday
2020,12,22,2400,44,68,112,Tuesday
2020,12,22,2300,45,93,138,Tuesday
2020,12,22,2200,52,135,187,Tuesday
2020,12,22,2100,74,136,210,Tuesday
2020,12,22,2000,88,161,249,Tuesday
2020,12,22,1900,106,205,311,Tuesday
2020,12,22,1800,109,422,531,Tuesday
2020,12,22,1700,172,810,982,Tuesday
2020,12,22,1600,196,701,897,Tuesday
2020,12,22,1500,181,559,740,Tuesday
2020,12,22,1400,206,224,430,Tuesday
2020,12,22,1300,175,247,422,Tuesday
2020,12,22,1200,257,180,437,Tuesday
2020,12,22,1100,233,214,447,Tuesday
2020,12,22,1000,603,111,714,Tuesday
2020,12,22,900,743,30,773,Tuesday
2020,12,22,800,326,28,354,Tuesday
2020,12,22,700,95,10,105,Tuesday
2020,12,22,600,15,3,18,Tuesday
2020,12,22,500,10,3,13,Tuesday
2020,12,22,400,7,5,12,Tuesday
2020,12,22,300,13,0,13,Tuesday
2020,12,22,200,14,3,17,Tuesday
2020,12,22,100,36,1,37,Tuesday
2020,12,21,2400,31,4,35,Monday
2020,12,21,2300,34,11,45,Monday
2020,12,21,2200,59,15,74,Monday
2020,12,21,2100,51,27,78,Monday
2020,12,21,2000,62,64,126,Monday
2020,12,21,1900,61,152,213,Monday
2020,12,21,1800,112,427,539,Monday
2020,12,21,1700,161,768,929,Monday
2020,12,21,1600,219,594,813,Monday
2020,12,21,1500,242,513,755,Monday
2020,12,21,1400,296,420,716,Monday
2020,12,21,1300,321,287,608,Monday
2020,12,21,1200,344,266,610,Monday
2020,12,21,1100,345,176,521,Monday
2020,12,21,1000,520,150,670,Monday
2020,12,21,900,894,100,994,Monday
2020,12,21,800,641,54,695,Monday
2020,12,21,700,88,30,118,Monday
2020,12,21,600,47,19,66,Monday
2020,12,21,500,16,28,44,Monday
2020,12,21,400,23,19,42,Monday
2020,12,21,300,24,18,42,Monday
2020,12,21,200,31,28,59,Monday
2020,12,21,100,18,34,52,Monday
2020,12,20,2400,32,43,75,Sunday
2020,12,20,2300,58,71,129,Sunday
2020,12,20,2200,50,101,151,Sunday
2020,12,20,2100,80,122,202,Sunday
2020,12,20,2000,103,198,301,Sunday
2020,12,20,1900,107,340,447,Sunday
2020,12,20,1800,141,807,948,Sunday
2020,12,20,1700,240,1320,1560,Sunday
2020,12,20,1600,331,1046,1377,Sunday
2020,12,20,1500,404,731,1135,Sunday
2020,12,20,1400,477,503,980,Sunday
2020,12,20,1300,488,377,865,Sunday
2020,12,20,1200,568,365,933,Sunday
2020,12,20,1100,509,155,664,Sunday
2020,12,20,1000,686,111,797,Sunday
2020,12,20,900,1139,54,1193,Sunday
2020,12,20,800,696,41,737,Sunday
2020,12,20,700,123,20,143,Sunday
2020,12,20,600,44,8,52,Sunday
2020,12,20,500,33,9,42,Sunday
2020,12,20,400,17,19,36,Sunday
2020,12,20,300,19,23,42,Sunday
2020,12,20,200,17,29,46,Sunday
2020,12,20,100,25,29,54,Sunday
2020,12,19,2400,30,32,62,Saturday
2020,12,19,2300,46,42,88,Saturday
2020,12,19,2200,62,73,135,Saturday
2020,12,19,2100,57,106,163,Saturday
2020,12,19,2000,94,151,245,Saturday
2020,12,19,1900,118,258,376,Saturday
2020,12,19,1800,158,587,745,Saturday
2020,12,19,1700,267,1158,1425,Saturday
2020,12,19,1600,359,864,1223,Saturday
2020,12,19,1500,455,588,1043,Saturday
2020,12,19,1400,487,470,957,Saturday
2020,12,19,1300,602,333,935,Saturday
2020,12,19,1200,540,225,765,Saturday
2020,12,19,1100,565,175,740,Saturday
2020,12,19,1000,534,216,750,Saturday
2020,12,19,900,776,44,820,Saturday
2020,12,19,800,701,24,725,Saturday
2020,12,19,700,109,13,122,Saturday
2020,12,19,600,46,23,69,Saturday
2020,12,19,500,21,22,43,Saturday
2020,12,19,400,21,4,25,Saturday
2020,12,19,300,20,3,23,Saturday
2020,12,19,200,24,5,29,Saturday
2020,12,19,100,29,6,35,Saturday
2020,12,18,2400,42,17,59,Friday
2020,12,18,2300,59,67,126,Friday
2020,12,18,2200,91,95,186,Friday
2020,12,18,2100,120,58,178,Friday
2020,12,18,2000,223,104,327,Friday
2020,12,18,1900,269,197,466,Friday
2020,12,18,1800,276,392,668,Friday
2020,12,18,1700,359,810,1169,Friday
2020,12,18,1600,397,665,1062,Friday
2020,12,18,1500,367,483,850,Friday
2020,12,18,1400,383,364,747,Friday
2020,12,18,1300,370,257,627,Friday
2020,12,18,1200,360,235,595,Friday
2020,12,18,1100,385,156,541,Friday
2020,12,18,1000,497,131,628,Friday
2020,12,18,900,696,98,794,Friday
2020,12,18,800,325,73,398,Friday
2020,12,18,700,101,53,154,Friday
2020,12,18,600,45,32,77,Friday
2020,12,18,500,26,35,61,Friday
2020,12,18,400,26,27,53,Friday
2020,12,18,300,25,56,81,Friday
2020,12,18,200,34,41,75,Friday
2020,12,18,100,36,60,96,Friday
2020,12,17,2400,58,50,108,Thursday
2020,12,17,2300,57,109,166,Thursday
2020,12,17,2200,73,47,120,Thursday
2020,12,17,2100,106,120,226,Thursday
2020,12,17,2000,137,113,250,Thursday
2020,12,17,1900,182,205,387,Thursday
2020,12,17,1800,200,365,565,Thursday
2020,12,17,1700,199,677,876,Thursday
2020,12,17,1600,241,568,809,Thursday
2020,12,17,1500,273,435,708,Thursday
2020,12,17,1400,288,274,562,Thursday
2020,12,17,1300,293,286,579,Thursday
2020,12,17,1200,344,180,524,Thursday
2020,12,17,1100,371,143,514,Thursday
2020,12,17,1000,504,122,626,Thursday
2020,12,17,900,603,79,682,Thursday
2020,12,17,800,256,52,308,Thursday
2020,12,17,700,79,49,128,Thursday
2020,12,17,600,42,30,72,Thursday
2020,12,17,500,33,30,63,Thursday
2020,12,17,400,35,26,61,Thursday
2020,12,17,300,27,51,78,Thursday
2020,12,17,200,28,42,70,Thursday
2020,12,17,100,36,52,88,Thursday
2020,12,16,2400,56,64,120,Wednesday
2020,12,16,2300,64,66,130,Wednesday
2020,12,16,2200,69,70,139,Wednesday
2020,12,16,2100,94,121,215,Wednesday
2020,12,16,2000,130,128,258,Wednesday
2020,12,16,1900,142,185,327,Wednesday
2020,12,16,1800,188,334,522,Wednesday
2020,12,16,1700,185,655,840,Wednesday
2020,12,16,1600,228,600,828,Wednesday
2020,12,16,1500,212,531,743,Wednesday
2020,12,16,1400,269,319,588,Wednesday
2020,12,16,1300,279,142,421,Wednesday
2020,12,16,1200,322,166,488,Wednesday
2020,12,16,1100,380,143,523,Wednesday
2020,12,16,1000,474,132,606,Wednesday
2020,12,16,900,609,90,699,Wednesday
2020,12,16,800,258,80,338,Wednesday
2020,12,16,700,81,59,140,Wednesday
2020,12,16,600,46,37,83,Wednesday
2020,12,16,500,37,30,67,Wednesday
2020,12,16,400,30,29,59,Wednesday
2020,12,16,300,19,44,63,Wednesday
2020,12,16,200,23,38,61,Wednesday
2020,12,16,100,33,53,86,Wednesday
2020,12,15,2400,41,61,102,Tuesday
2020,12,15,2300,56,63,119,Tuesday
2020,12,15,2200,56,86,142,Tuesday
2020,12,15,2100,74,82,156,Tuesday
2020,12,15,2000,113,84,197,Tuesday
2020,12,15,1900,132,144,276,Tuesday
2020,12,15,1800,140,289,429,Tuesday
2020,12,15,1700,163,448,611,Tuesday
2020,12,15,1600,194,401,595,Tuesday
2020,12,15,1500,183,345,528,Tuesday
2020,12,15,1400,209,293,502,Tuesday
2020,12,15,1300,250,224,474,Tuesday
2020,12,15,1200,268,171,439,Tuesday
2020,12,15,1100,317,154,471,Tuesday
2020,12,15,1000,371,105,476,Tuesday
2020,12,15,900,388,92,480,Tuesday
2020,12,15,800,199,66,265,Tuesday
2020,12,15,700,72,36,108,Tuesday
2020,12,15,600,40,22,62,Tuesday
2020,12,15,500,33,34,67,Tuesday
2020,12,15,400,26,28,54,Tuesday
2020,12,15,300,23,47,70,Tuesday
2020,12,15,200,23,40,63,Tuesday
2020,12,15,100,35,62,97,Tuesday
2020,12,14,2400,49,53,102,Monday
2020,12,14,2300,57,57,114,Monday
2020,12,14,2200,51,87,138,Monday
2020,12,14,2100,75,73,148,Monday
2020,12,14,2000,109,103,212,Monday
2020,12,14,1900,101,141,242,Monday
2020,12,14,1800,142,269,411,Monday
2020,12,14,1700,173,508,681,Monday
2020,12,14,1600,199,442,641,Monday
2020,12,14,1500,238,343,581,Monday
2020,12,14,1400,252,282,534,Monday
2020,12,14,1300,260,212,472,Monday
2020,12,14,1200,306,194,500,Monday
2020,12,14,1100,294,134,428,Monday
2020,12,14,1000,378,92,470,Monday
2020,12,14,900,369,88,457,Monday
2020,12,14,800,219,55,274,Monday
2020,12,14,700,89,28,117,Monday
2020,12,14,600,44,19,63,Monday
2020,12,14,500,21,9,30,Monday
2020,12,14,400,21,13,34,Monday
2020,12,14,300,17,16,33,Monday
2020,12,14,200,27,18,45,Monday
2020,12,14,100,23,33,56,Monday
2020,12,13,2400,17,42,59,Sunday
2020,12,13,2300,36,66,102,Sunday
2020,12,13,2200,46,88,134,Sunday
2020,12,13,2100,65,109,174,Sunday
2020,12,13,2000,68,156,224,Sunday
2020,12,13,1900,90,257,347,Sunday
2020,12,13,1800,129,527,656,Sunday
2020,12,13,1700,147,1005,1152,Sunday
2020,12,13,1600,210,930,1140,Sunday
2020,12,13,1500,271,593,864,Sunday
2020,12,13,1400,265,475,740,Sunday
2020,12,13,1300,285,345,630,Sunday
2020,12,13,1200,437,246,683,Sunday
2020,12,13,1100,348,159,507,Sunday
2020,12,13,1000,429,92,521,Sunday
2020,12,13,900,731,58,789,Sunday
2020,12,13,800,530,36,566,Sunday
2020,12,13,700,76,26,102,Sunday
2020,12,13,600,23,20,43,Sunday
2020,12,13,500,19,11,30,Sunday
2020,12,13,400,20,17,37,Sunday
2020,12,13,300,14,16,30,Sunday
2020,12,13,200,15,29,44,Sunday
2020,12,13,100,23,31,54,Sunday
2020,12,12,2400,27,33,60,Saturday
2020,12,12,2300,37,49,86,Saturday
2020,12,12,2200,52,62,114,Saturday
2020,12,12,2100,54,96,150,Saturday
2020,12,12,2000,80,138,218,Saturday
2020,12,12,1900,108,221,329,Saturday
2020,12,12,1800,129,573,702,Saturday
2020,12,12,1700,167,1069,1236,Saturday
2020,12,12,1600,221,798,1019,Saturday
2020,12,12,1500,288,547,835,Saturday
2020,12,12,1400,297,423,720,Saturday
2020,12,12,1300,412,288,700,Saturday
2020,12,12,1200,475,200,675,Saturday
2020,12,12,1100,449,149,598,Saturday
2020,12,12,1000,489,116,605,Saturday
2020,12,12,900,886,86,972,Saturday
2020,12,12,800,708,54,762,Saturday
2020,12,12,700,155,48,203,Saturday
2020,12,12,600,37,47,84,Saturday
2020,12,12,500,24,29,53,Saturday
2020,12,12,400,20,24,44,Saturday
2020,12,12,300,12,38,50,Saturday
2020,12,12,200,25,54,79,Saturday
2020,12,12,100,33,55,88,Saturday
2020,12,11,2400,38,53,91,Friday
2020,12,11,2300,69,62,131,Friday
2020,12,11,2200,82,71,153,Friday
2020,12,11,2100,129,102,231,Friday
2020,12,11,2000,192,116,308,Friday
2020,12,11,1900,243,154,397,Friday
2020,12,11,1800,261,416,677,Friday
2020,12,11,1700,313,662,975,Friday
2020,12,11,1600,368,590,958,Friday
2020,12,11,1500,339,361,700,Friday
2020,12,11,1400,298,313,611,Friday
2020,12,11,1300,333,249,582,Friday
2020,12,11,1200,292,193,485,Friday
2020,12,11,1100,313,172,485,Friday
2020,12,11,1000,477,104,581,Friday
2020,12,11,900,671,94,765,Friday
2020,12,11,800,312,68,380,Friday
2020,12,11,700,89,45,134,Friday
2020,12,11,600,59,33,92,Friday
2020,12,11,500,33,31,64,Friday
2020,12,11,400,32,29,61,Friday
2020,12,11,300,20,34,54,Friday
2020,12,11,200,42,52,94,Friday
2020,12,11,100,45,51,96,Friday
2020,12,10,2400,46,58,104,Thursday
2020,12,10,2300,70,67,137,Thursday
2020,12,10,2200,89,72,161,Thursday
2020,12,10,2100,133,110,243,Thursday
2020,12,10,2000,195,133,328,Thursday
2020,12,10,1900,205,206,411,Thursday
2020,12,10,1800,220,368,588,Thursday
2020,12,10,1700,234,787,1021,Thursday
2020,12,10,1600,244,646,890,Thursday
2020,12,10,1500,270,461,731,Thursday
2020,12,10,1400,238,273,511,Thursday
2020,12,10,1300,284,228,512,Thursday
2020,12,10,1200,328,162,490,Thursday
2020,12,10,1100,361,136,497,Thursday
2020,12,10,1000,569,113,682,Thursday
2020,12,10,900,719,81,800,Thursday
2020,12,10,800,312,50,362,Thursday
2020,12,10,700,90,42,132,Thursday
2020,12,10,600,40,32,72,Thursday
2020,12,10,500,30,44,74,Thursday
2020,12,10,400,26,46,72,Thursday
2020,12,10,300,18,35,53,Thursday
2020,12,10,200,42,48,90,Thursday
2020,12,10,100,32,46,78,Thursday
2020,12,9,2400,66,62,128,Wednesday
2020,12,9,2300,85,81,166,Wednesday
2020,12,9,2200,84,79,163,Wednesday
2020,12,9,2100,85,129,214,Wednesday
2020,12,9,2000,113,116,229,Wednesday
2020,12,9,1900,123,145,268,Wednesday
2020,12,9,1800,181,399,580,Wednesday
2020,12,9,1700,162,672,834,Wednesday
2020,12,9,1600,203,587,790,Wednesday
2020,12,9,1500,226,413,639,Wednesday
2020,12,9,1400,205,303,508,Wednesday
2020,12,9,1300,223,224,447,Wednesday
2020,12,9,1200,265,180,445,Wednesday
2020,12,9,1100,303,148,451,Wednesday
2020,12,9,1000,643,89,732,Wednesday
2020,12,9,900,751,65,816,Wednesday
2020,12,9,800,201,62,263,Wednesday
2020,12,9,700,43,40,83,Wednesday
2020,12,9,600,25,29,54,Wednesday
2020,12,9,500,26,30,56,Wednesday
2020,12,9,400,29,31,60,Wednesday
2020,12,9,300,24,35,59,Wednesday
2020,12,9,200,24,36,60,Wednesday
2020,12,9,100,41,57,98,Wednesday
2020,12,8,2400,46,51,97,Tuesday
2020,12,8,2300,57,59,116,Tuesday
2020,12,8,2200,54,125,179,Tuesday
2020,12,8,2100,81,134,215,Tuesday
2020,12,8,2000,89,39,128,Tuesday
2020,12,8,1900,107,71,178,Tuesday
2020,12,8,1800,152,237,389,Tuesday
2020,12,8,1700,156,477,633,Tuesday
2020,12,8,1600,195,483,678,Tuesday
2020,12,8,1500,210,435,645,Tuesday
2020,12,8,1400,193,322,515,Tuesday
2020,12,8,1300,217,244,461,Tuesday
2020,12,8,1200,253,164,417,Tuesday
2020,12,8,1100,328,135,463,Tuesday
2020,12,8,1000,407,73,480,Tuesday
2020,12,8,900,509,79,588,Tuesday
2020,12,8,800,223,51,274,Tuesday
2020,12,8,700,81,42,123,Tuesday
2020,12,8,600,46,36,82,Tuesday
2020,12,8,500,23,36,59,Tuesday
2020,12,8,400,26,45,71,Tuesday
2020,12,8,300,21,78,99,Tuesday
2020,12,8,200,29,70,99,Tuesday
2020,12,8,100,32,21,53,Tuesday
2020,12,7,2400,45,11,56,Monday
2020,12,7,2300,46,21,67,Monday
2020,12,7,2200,62,48,110,Monday
2020,12,7,2100,70,76,146,Monday
2020,12,7,2000,124,72,196,Monday
2020,12,7,1900,124,137,261,Monday
2020,12,7,1800,161,292,453,Monday
2020,12,7,1700,195,405,600,Monday
2020,12,7,1600,217,396,613,Monday
2020,12,7,1500,239,302,541,Monday
2020,12,7,1400,245,272,517,Monday
2020,12,7,1300,243,224,467,Monday
2020,12,7,1200,273,168,441,Monday
2020,12,7,1100,330,147,477,Monday
2020,12,7,1000,336,96,432,Monday
2020,12,7,900,347,75,422,Monday
2020,12,7,800,169,60,229,Monday
2020,12,7,700,64,34,98,Monday
2020,12,7,600,35,20,55,Monday
2020,12,7,500,21,22,43,Monday
2020,12,7,400,23,16,39,Monday
2020,12,7,300,14,13,27,Monday
2020,12,7,200,26,30,56,Monday
2020,12,7,100,19,23,42,Monday
2020,12,6,2400,27,37,64,Sunday
2020,12,6,2300,31,57,88,Sunday
2020,12,6,2200,52,76,128,Sunday
2020,12,6,2100,79,119,198,Sunday
2020,12,6,2000,89,196,285,Sunday
2020,12,6,1900,131,294,425,Sunday
2020,12,6,1800,116,581,697,Sunday
2020,12,6,1700,189,1111,1300,Sunday
2020,12,6,1600,207,914,1121,Sunday
2020,12,6,1500,296,682,978,Sunday
2020,12,6,1400,363,524,887,Sunday
2020,12,6,1300,385,370,755,Sunday
2020,12,6,1200,466,258,724,Sunday
2020,12,6,1100,468,185,653,Sunday
2020,12,6,1000,523,96,619,Sunday
2020,12,6,900,649,76,725,Sunday
2020,12,6,800,434,26,460,Sunday
2020,12,6,700,113,18,131,Sunday
2020,12,6,600,53,16,69,Sunday
2020,12,6,500,17,11,28,Sunday
2020,12,6,400,13,19,32,Sunday
2020,12,6,300,22,19,41,Sunday
2020,12,6,200,19,25,44,Sunday
2020,12,6,100,20,36,56,Sunday
2020,12,5,2400,20,44,64,Saturday
2020,12,5,2300,34,54,88,Saturday
2020,12,5,2200,53,63,116,Saturday
2020,12,5,2100,58,95,153,Saturday
2020,12,5,2000,92,111,203,Saturday
2020,12,5,1900,82,214,296,Saturday
2020,12,5,1800,132,621,753,Saturday
2020,12,5,1700,187,1103,1290,Saturday
2020,12,5,1600,233,745,978,Saturday
2020,12,5,1500,290,589,879,Saturday
2020,12,5,1400,374,394,768,Saturday
2020,12,5,1300,413,297,710,Saturday
2020,12,5,1200,493,226,719,Saturday
2020,12,5,1100,467,147,614,Saturday
2020,12,5,1000,594,129,723,Saturday
2020,12,5,900,857,93,950,Saturday
2020,12,5,800,610,52,662,Saturday
2020,12,5,700,125,26,151,Saturday
2020,12,5,600,42,31,73,Saturday
2020,12,5,500,22,15,37,Saturday
2020,12,5,400,19,42,61,Saturday
2020,12,5,300,9,38,47,Saturday
2020,12,5,200,24,49,73,Saturday
2020,12,5,100,29,42,71,Saturday
2020,12,4,2400,35,54,89,Friday
2020,12,4,2300,79,78,157,Friday
2020,12,4,2200,77,75,152,Friday
2020,12,4,2100,93,102,195,Friday
2020,12,4,2000,186,107,293,Friday
2020,12,4,1900,216,200,416,Friday
2020,12,4,1800,274,365,639,Friday
2020,12,4,1700,311,697,1008,Friday
2020,12,4,1600,340,566,906,Friday
2020,12,4,1500,321,424,745,Friday
2020,12,4,1400,297,346,643,Friday
2020,12,4,1300,347,265,612,Friday
2020,12,4,1200,354,180,534,Friday
2020,12,4,1100,414,127,541,Friday
2020,12,4,1000,467,119,586,Friday
2020,12,4,900,588,83,671,Friday
2020,12,4,800,244,60,304,Friday
2020,12,4,700,92,54,146,Friday
2020,12,4,600,59,39,98,Friday
2020,12,4,500,38,24,62,Friday
2020,12,4,400,32,34,66,Friday
2020,12,4,300,31,35,66,Friday
2020,12,4,200,31,53,84,Friday
2020,12,4,100,40,49,89,Friday
2020,12,3,2400,48,57,105,Thursday
2020,12,3,2300,60,83,143,Thursday
2020,12,3,2200,79,112,191,Thursday
2020,12,3,2100,128,91,219,Thursday
2020,12,3,2000,131,103,234,Thursday
2020,12,3,1900,175,181,356,Thursday
2020,12,3,1800,216,307,523,Thursday
2020,12,3,1700,239,490,729,Thursday
2020,12,3,1600,247,492,739,Thursday
2020,12,3,1500,267,386,653,Thursday
2020,12,3,1400,271,272,543,Thursday
2020,12,3,1300,276,257,533,Thursday
2020,12,3,1200,327,170,497,Thursday
2020,12,3,1100,342,134,476,Thursday
2020,12,3,1000,390,98,488,Thursday
2020,12,3,900,438,99,537,Thursday
2020,12,3,800,273,63,336,Thursday
2020,12,3,700,73,44,117,Thursday
2020,12,3,600,33,44,77,Thursday
2020,12,3,500,23,46,69,Thursday
2020,12,3,400,21,50,71,Thursday
2020,12,3,300,32,53,85,Thursday
2020,12,3,200,36,39,75,Thursday
2020,12,3,100,37,41,78,Thursday
2020,12,2,2400,51,60,111,Wednesday
2020,12,2,2300,43,64,107,Wednesday
2020,12,2,2200,59,103,162,Wednesday
2020,12,2,2100,96,80,176,Wednesday
2020,12,2,2000,96,108,204,Wednesday
2020,12,2,1900,135,143,278,Wednesday
2020,12,2,1800,149,315,464,Wednesday
2020,12,2,1700,176,527,703,Wednesday
2020,12,2,1600,204,496,700,Wednesday
2020,12,2,1500,210,363,573,Wednesday
2020,12,2,1400,264,277,541,Wednesday
2020,12,2,1300,291,220,511,Wednesday
2020,12,2,1200,297,177,474,Wednesday
2020,12,2,1100,358,129,487,Wednesday
2020,12,2,1000,450,95,545,Wednesday
2020,12,2,900,415,104,519,Wednesday
2020,12,2,800,230,63,293,Wednesday
2020,12,2,700,78,60,138,Wednesday
2020,12,2,600,48,22,70,Wednesday
2020,12,2,500,36,40,76,Wednesday
2020,12,2,400,27,50,77,Wednesday
2020,12,2,300,21,34,55,Wednesday
2020,12,2,200,38,47,85,Wednesday
2020,12,2,100,31,53,84,Wednesday
2020,12,1,2400,45,67,112,Tuesday
2020,12,1,2300,60,108,168,Tuesday
2020,12,1,2200,51,44,95,Tuesday
2020,12,1,2100,85,75,160,Tuesday
2020,12,1,2000,110,132,242,Tuesday
2020,12,1,1900,130,158,288,Tuesday
2020,12,1,1800,146,260,406,Tuesday
2020,12,1,1700,183,455,638,Tuesday
2020,12,1,1600,183,427,610,Tuesday
2020,12,1,1500,202,361,563,Tuesday
2020,12,1,1400,193,255,448,Tuesday
2020,12,1,1300,253,216,469,Tuesday
2020,12,1,1200,279,163,442,Tuesday
2020,12,1,1100,307,138,445,Tuesday
2020,12,1,1000,377,96,473,Tuesday
2020,12,1,900,378,98,476,Tuesday
2020,12,1,800,200,62,262,Tuesday
2020,12,1,700,88,49,137,Tuesday
2020,12,1,600,43,30,73,Tuesday
2020,12,1,500,18,38,56,Tuesday
2020,12,1,400,25,37,62,Tuesday
2020,12,1,300,24,49,73,Tuesday
2020,12,1,200,22,45,67,Tuesday
2020,12,1,100,42,35,77,Tuesday
2020,11,30,2400,38,56,94,Monday
2020,11,30,2300,50,56,106,Monday
2020,11,30,2200,59,72,131,Monday
2020,11,30,2100,73,93,166,Monday
2020,11,30,2000,97,108,205,Monday
2020,11,30,1900,129,145,274,Monday
2020,11,30,1800,158,263,421,Monday
2020,11,30,1700,168,441,609,Monday
2020,11,30,1600,196,366,562,Monday
2020,11,30,1500,222,294,516,Monday
2020,11,30,1400,217,253,470,Monday
2020,11,30,1300,227,210,437,Monday
2020,11,30,1200,296,173,469,Monday
2020,11,30,1100,308,118,426,Monday
2020,11,30,1000,379,106,485,Monday
2020,11,30,900,345,84,429,Monday
2020,11,30,800,177,53,230,Monday
2020,11,30,700,58,34,92,Monday
2020,11,30,600,47,22,69,Monday
2020,11,30,500,23,14,37,Monday
2020,11,30,400,24,17,41,Monday
2020,11,30,300,18,11,29,Monday
2020,11,30,200,23,28,51,Monday
2020,11,30,100,27,38,65,Monday
2020,11,29,2400,39,47,86,Sunday
2020,11,29,2300,36,61,97,Sunday
2020,11,29,2200,43,88,131,Sunday
2020,11,29,2100,56,110,166,Sunday
2020,11,29,2000,77,171,248,Sunday
2020,11,29,1900,111,283,394,Sunday
2020,11,29,1800,125,644,769,Sunday
2020,11,29,1700,171,1183,1354,Sunday
2020,11,29,1600,206,834,1040,Sunday
2020,11,29,1500,273,657,930,Sunday
2020,11,29,1400,300,437,737,Sunday
2020,11,29,1300,359,371,730,Sunday
2020,11,29,1200,433,274,707,Sunday
2020,11,29,1100,466,160,626,Sunday
2020,11,29,1000,599,79,678,Sunday
2020,11,29,900,883,46,929,Sunday
2020,11,29,800,466,34,500,Sunday
2020,11,29,700,100,20,120,Sunday
2020,11,29,600,38,14,52,Sunday
2020,11,29,500,17,20,37,Sunday
2020,11,29,400,16,21,37,Sunday
2020,11,29,300,18,27,45,Sunday
2020,11,29,200,10,42,52,Sunday
2020,11,29,100,16,37,53,Sunday
2020,11,28,2400,24,38,62,Saturday
2020,11,28,2300,50,43,93,Saturday
2020,11,28,2200,59,58,117,Saturday
2020,11,28,2100,66,84,150,Saturday
2020,11,28,2000,78,136,214,Saturday
2020,11,28,1900,107,241,348,Saturday
2020,11,28,1800,111,659,770,Saturday
2020,11,28,1700,157,1013,1170,Saturday
2020,11,28,1600,229,762,991,Saturday
2020,11,28,1500,252,529,781,Saturday
2020,11,28,1400,336,400,736,Saturday
2020,11,28,1300,424,279,703,Saturday
2020,11,28,1200,444,176,620,Saturday
2020,11,28,1100,445,137,582,Saturday
2020,11,28,1000,529,118,647,Saturday
2020,11,28,900,891,75,966,Saturday
2020,11,28,800,579,51,630,Saturday
2020,11,28,700,146,48,194,Saturday
2020,11,28,600,36,35,71,Saturday
2020,11,28,500,16,20,36,Saturday
2020,11,28,400,23,26,49,Saturday
2020,11,28,300,19,20,39,Saturday
2020,11,28,200,24,39,63,Saturday
2020,11,28,100,29,34,63,Saturday
2020,11,27,2400,48,55,103,Friday
2020,11,27,2300,47,68,115,Friday
2020,11,27,2200,83,79,162,Friday
2020,11,27,2100,134,96,230,Friday
2020,11,27,2000,186,143,329,Friday
2020,11,27,1900,220,156,376,Friday
2020,11,27,1800,273,377,650,Friday
2020,11,27,1700,269,586,855,Friday
2020,11,27,1600,308,512,820,Friday
2020,11,27,1500,320,421,741,Friday
2020,11,27,1400,274,304,578,Friday
2020,11,27,1300,326,274,600,Friday
2020,11,27,1200,323,209,532,Friday
2020,11,27,1100,383,138,521,Friday
2020,11,27,1000,421,122,543,Friday
2020,11,27,900,538,105,643,Friday
2020,11,27,800,224,54,278,Friday
2020,11,27,700,89,46,135,Friday
2020,11,27,600,38,43,81,Friday
2020,11,27,500,31,34,65,Friday
2020,11,27,400,30,49,79,Friday
2020,11,27,300,29,30,59,Friday
2020,11,27,200,33,41,74,Friday
2020,11,27,100,42,50,92,Friday
2020,11,26,2400,55,58,113,Thursday
2020,11,26,2300,60,92,152,Thursday
2020,11,26,2200,89,97,186,Thursday
2020,11,26,2100,139,99,238,Thursday
2020,11,26,2000,141,130,271,Thursday
2020,11,26,1900,184,181,365,Thursday
2020,11,26,1800,190,327,517,Thursday
2020,11,26,1700,213,445,658,Thursday
2020,11,26,1600,256,492,748,Thursday
2020,11,26,1500,261,371,632,Thursday
2020,11,26,1400,268,322,590,Thursday
2020,11,26,1300,277,225,502,Thursday
2020,11,26,1200,285,155,440,Thursday
2020,11,26,1100,331,145,476,Thursday
2020,11,26,1000,417,115,532,Thursday
2020,11,26,900,496,89,585,Thursday
2020,11,26,800,204,70,274,Thursday
2020,11,26,700,86,45,131,Thursday
2020,11,26,600,36,39,75,Thursday
2020,11,26,500,30,35,65,Thursday
2020,11,26,400,39,27,66,Thursday
2020,11,26,300,28,36,64,Thursday
2020,11,26,200,40,47,87,Thursday
2020,11,26,100,43,51,94,Thursday
2020,11,25,2400,53,55,108,Wednesday
2020,11,25,2300,78,75,153,Wednesday
2020,11,25,2200,75,82,157,Wednesday
2020,11,25,2100,93,131,224,Wednesday
2020,11,25,2000,93,113,206,Wednesday
2020,11,25,1900,115,183,298,Wednesday
2020,11,25,1800,190,285,475,Wednesday
2020,11,25,1700,186,434,620,Wednesday
2020,11,25,1600,210,430,640,Wednesday
2020,11,25,1500,207,341,548,Wednesday
2020,11,25,1400,208,264,472,Wednesday
2020,11,25,1300,220,244,464,Wednesday
2020,11,25,1200,285,184,469,Wednesday
2020,11,25,1100,314,149,463,Wednesday
2020,11,25,1000,397,116,513,Wednesday
2020,11,25,900,410,99,509,Wednesday
2020,11,25,800,145,89,234,Wednesday
2020,11,25,700,65,50,115,Wednesday
2020,11,25,600,39,30,69,Wednesday
2020,11,25,500,37,16,53,Wednesday
2020,11,25,400,28,31,59,Wednesday
2020,11,25,300,20,60,80,Wednesday
2020,11,25,200,29,25,54,Wednesday
2020,11,25,100,38,25,63,Wednesday
2020,11,24,2400,45,29,74,Tuesday
2020,11,24,2300,53,60,113,Tuesday
2020,11,24,2200,58,57,115,Tuesday
2020,11,24,2100,98,106,204,Tuesday
2020,11,24,2000,98,118,216,Tuesday
2020,11,24,1900,125,135,260,Tuesday
2020,11,24,1800,153,230,383,Tuesday
2020,11,24,1700,177,402,579,Tuesday
2020,11,24,1600,210,329,539,Tuesday
2020,11,24,1500,202,323,525,Tuesday
2020,11,24,1400,251,290,541,Tuesday
2020,11,24,1300,265,225,490,Tuesday
2020,11,24,1200,260,186,446,Tuesday
2020,11,24,1100,279,145,424,Tuesday
2020,11,24,1000,329,113,442,Tuesday
2020,11,24,900,309,90,399,Tuesday
2020,11,24,800,169,81,250,Tuesday
2020,11,24,700,82,47,129,Tuesday
2020,11,24,600,25,45,70,Tuesday
2020,11,24,500,24,28,52,Tuesday
2020,11,24,400,25,38,63,Tuesday
2020,11,24,300,28,41,69,Tuesday
2020,11,24,200,31,52,83,Tuesday
2020,11,24,100,35,48,83,Tuesday
2020,11,23,2400,60,56,116,Monday
2020,11,23,2300,61,75,136,Monday
2020,11,23,2200,63,79,142,Monday
2020,11,23,2100,64,96,160,Monday
2020,11,23,2000,97,128,225,Monday
2020,11,23,1900,123,199,322,Monday
2020,11,23,1800,150,288,438,Monday
2020,11,23,1700,178,439,617,Monday
2020,11,23,1600,232,485,717,Monday
2020,11,23,1500,230,388,618,Monday
2020,11,23,1400,281,300,581,Monday
2020,11,23,1300,279,235,514,Monday
2020,11,23,1200,323,168,491,Monday
2020,11,23,1100,354,147,501,Monday
2020,11,23,1000,437,99,536,Monday
2020,11,23,900,351,78,429,Monday
2020,11,23,800,170,51,221,Monday
2020,11,23,700,71,25,96,Monday
2020,11,23,600,35,17,52,Monday
2020,11,23,500,17,16,33,Monday
2020,11,23,400,26,23,49,Monday
2020,11,23,300,21,15,36,Monday
2020,11,23,200,23,20,43,Monday
2020,11,23,100,24,42,66,Monday
2020,11,22,2400,28,39,67,Sunday
2020,11,22,2300,43,71,114,Sunday
2020,11,22,2200,33,93,126,Sunday
2020,11,22,2100,62,148,210,Sunday
2020,11,22,2000,85,161,246,Sunday
2020,11,22,1900,112,301,413,Sunday
2020,11,22,1800,158,714,872,Sunday
2020,11,22,1700,158,1170,1328,Sunday
2020,11,22,1600,245,1031,1276,Sunday
2020,11,22,1500,255,809,1064,Sunday
2020,11,22,1400,321,621,942,Sunday
2020,11,22,1300,397,485,882,Sunday
2020,11,22,1200,476,294,770,Sunday
2020,11,22,1100,468,147,615,Sunday
2020,11,22,1000,582,131,713,Sunday
2020,11,22,900,835,60,895,Sunday
2020,11,22,800,410,35,445,Sunday
2020,11,22,700,70,21,91,Sunday
2020,11,22,600,52,20,72,Sunday
2020,11,22,500,13,13,26,Sunday
2020,11,22,400,14,16,30,Sunday
2020,11,22,300,19,26,45,Sunday
2020,11,22,200,11,36,47,Sunday
2020,11,22,100,27,34,61,Sunday
2020,11,21,2400,33,48,81,Saturday
2020,11,21,2300,32,39,71,Saturday
2020,11,21,2200,46,93,139,Saturday
2020,11,21,2100,72,100,172,Saturday
2020,11,21,2000,89,131,220,Saturday
2020,11,21,1900,105,293,398,Saturday
2020,11,21,1800,149,791,940,Saturday
2020,11,21,1700,203,1074,1277,Saturday
2020,11,21,1600,230,738,968,Saturday
2020,11,21,1500,317,600,917,Saturday
2020,11,21,1400,396,391,787,Saturday
2020,11,21,1300,439,302,741,Saturday
2020,11,21,1200,507,222,729,Saturday
2020,11,21,1100,543,203,746,Saturday
2020,11,21,1000,734,112,846,Saturday
2020,11,21,900,914,63,977,Saturday
2020,11,21,800,449,45,494,Saturday
2020,11,21,700,119,39,158,Saturday
2020,11,21,600,30,21,51,Saturday
2020,11,21,500,16,28,44,Saturday
2020,11,21,400,20,26,46,Saturday
2020,11,21,300,17,35,52,Saturday
2020,11,21,200,16,46,62,Saturday
2020,11,21,100,33,59,92,Saturday
2020,11,20,2400,38,54,92,Friday
2020,11,20,2300,57,54,111,Friday
2020,11,20,2200,99,81,180,Friday
2020,11,20,2100,142,102,244,Friday
2020,11,20,2000,199,119,318,Friday
2020,11,20,1900,210,190,400,Friday
2020,11,20,1800,315,379,694,Friday
2020,11,20,1700,363,630,993,Friday
2020,11,20,1600,339,548,887,Friday
2020,11,20,1500,353,456,809,Friday
2020,11,20,1400,349,310,659,Friday
2020,11,20,1300,374,266,640,Friday
2020,11,20,1200,352,245,597,Friday
2020,11,20,1100,404,170,574,Friday
2020,11,20,1000,499,124,623,Friday
2020,11,20,900,581,106,687,Friday
2020,11,20,800,225,76,301,Friday
2020,11,20,700,83,32,115,Friday
2020,11,20,600,38,40,78,Friday
2020,11,20,500,32,42,74,Friday
2020,11,20,400,34,73,107,Friday
2020,11,20,300,31,68,99,Friday
2020,11,20,200,35,23,58,Friday
2020,11,20,100,34,19,53,Friday
2020,11,19,2400,41,10,51,Thursday
2020,11,19,2300,52,31,83,Thursday
2020,11,19,2200,87,87,174,Thursday
2020,11,19,2100,115,122,237,Thursday
2020,11,19,2000,147,120,267,Thursday
2020,11,19,1900,214,252,466,Thursday
2020,11,19,1800,222,262,484,Thursday
2020,11,19,1700,248,356,604,Thursday
2020,11,19,1600,260,449,709,Thursday
2020,11,19,1500,246,378,624,Thursday
2020,11,19,1400,248,276,524,Thursday
2020,11,19,1300,278,260,538,Thursday
2020,11,19,1200,257,182,439,Thursday
2020,11,19,1100,306,146,452,Thursday
2020,11,19,1000,384,88,472,Thursday
2020,11,19,900,426,105,531,Thursday
2020,11,19,800,225,59,284,Thursday
2020,11,19,700,84,42,126,Thursday
2020,11,19,600,47,30,77,Thursday
2020,11,19,500,31,35,66,Thursday
2020,11,19,400,32,36,68,Thursday
2020,11,19,300,39,42,81,Thursday
2020,11,19,200,33,61,94,Thursday
2020,11,19,100,27,46,73,Thursday
2020,11,18,2400,37,64,101,Wednesday
2020,11,18,2300,58,63,121,Wednesday
2020,11,18,2200,69,89,158,Wednesday
2020,11,18,2100,89,96,185,Wednesday
2020,11,18,2000,116,122,238,Wednesday
2020,11,18,1900,113,151,264,Wednesday
2020,11,18,1800,166,279,445,Wednesday
2020,11,18,1700,212,453,665,Wednesday
2020,11,18,1600,210,413,623,Wednesday
2020,11,18,1500,245,338,583,Wednesday
2020,11,18,1400,245,267,512,Wednesday
2020,11,18,1300,270,213,483,Wednesday
2020,11,18,1200,304,242,546,Wednesday
2020,11,18,1100,312,162,474,Wednesday
2020,11,18,1000,325,100,425,Wednesday
2020,11,18,900,311,73,384,Wednesday
2020,11,18,800,198,64,262,Wednesday
2020,11,18,700,82,28,110,Wednesday
2020,11,18,600,34,39,73,Wednesday
2020,11,18,500,29,29,58,Wednesday
2020,11,18,400,23,28,51,Wednesday
2020,11,18,300,20,35,55,Wednesday
2020,11,18,200,33,30,63,Wednesday
2020,11,18,100,38,58,96,Wednesday
2020,11,17,2400,46,53,99,Tuesday
2020,11,17,2300,41,63,104,Tuesday
2020,11,17,2200,67,97,164,Tuesday
2020,11,17,2100,82,102,184,Tuesday
2020,11,17,2000,108,122,230,Tuesday
2020,11,17,1900,112,204,316,Tuesday
2020,11,17,1800,127,277,404,Tuesday
2020,11,17,1700,194,368,562,Tuesday
2020,11,17,1600,188,441,629,Tuesday
2020,11,17,1500,229,423,652,Tuesday
2020,11,17,1400,224,307,531,Tuesday
2020,11,17,1300,268,213,481,Tuesday
2020,11,17,1200,287,153,440,Tuesday
2020,11,17,1100,315,141,456,Tuesday
2020,11,17,1000,366,105,471,Tuesday
2020,11,17,900,338,78,416,Tuesday
2020,11,17,800,167,73,240,Tuesday
2020,11,17,700,68,49,117,Tuesday
2020,11,17,600,27,44,71,Tuesday
2020,11,17,500,25,30,55,Tuesday
2020,11,17,400,23,15,38,Tuesday
2020,11,17,300,19,16,35,Tuesday
2020,11,17,200,30,40,70,Tuesday
2020,11,17,100,32,39,71,Tuesday
2020,11,16,2400,35,47,82,Monday
2020,11,16,2300,72,91,163,Monday
2020,11,16,2200,54,65,119,Monday
2020,11,16,2100,74,91,165,Monday
2020,11,16,2000,107,131,238,Monday
2020,11,16,1900,130,166,296,Monday
2020,11,16,1800,176,309,485,Monday
2020,11,16,1700,196,428,624,Monday
2020,11,16,1600,225,394,619,Monday
2020,11,16,1500,275,363,638,Monday
2020,11,16,1400,283,274,557,Monday
2020,11,16,1300,316,258,574,Monday
2020,11,16,1200,295,191,486,Monday
2020,11,16,1100,312,159,471,Monday
2020,11,16,1000,334,100,434,Monday
2020,11,16,900,327,79,406,Monday
2020,11,16,800,151,62,213,Monday
2020,11,16,700,77,32,109,Monday
2020,11,16,600,44,16,60,Monday
2020,11,16,500,27,30,57,Monday
2020,11,16,400,24,23,47,Monday
2020,11,16,300,19,23,42,Monday
2020,11,16,200,15,22,37,Monday
2020,11,16,100,12,35,47,Monday
2020,11,15,2400,26,62,88,Sunday
2020,11,15,2300,39,75,114,Sunday
2020,11,15,2200,43,111,154,Sunday
2020,11,15,2100,70,125,195,Sunday
2020,11,15,2000,100,181,281,Sunday
2020,11,15,1900,111,327,438,Sunday
2020,11,15,1800,134,608,742,Sunday
2020,11,15,1700,212,1062,1274,Sunday
2020,11,15,1600,245,916,1161,Sunday
2020,11,15,1500,316,800,1116,Sunday
2020,11,15,1400,321,764,1085,Sunday
2020,11,15,1300,442,522,964,Sunday
2020,11,15,1200,504,411,915,Sunday
2020,11,15,1100,511,176,687,Sunday
2020,11,15,1000,522,142,664,Sunday
2020,11,15,900,644,59,703,Sunday
2020,11,15,800,270,24,294,Sunday
2020,11,15,700,64,12,76,Sunday
2020,11,15,600,47,11,58,Sunday
2020,11,15,500,11,12,23,Sunday
2020,11,15,400,22,24,46,Sunday
2020,11,15,300,20,21,41,Sunday
2020,11,15,200,14,29,43,Sunday
2020,11,15,100,17,24,41,Sunday
2020,11,14,2400,24,32,56,Saturday
2020,11,14,2300,34,54,88,Saturday
2020,11,14,2200,52,84,136,Saturday
2020,11,14,2100,47,110,157,Saturday
2020,11,14,2000,74,169,243,Saturday
2020,11,14,1900,112,301,413,Saturday
2020,11,14,1800,146,712,858,Saturday
2020,11,14,1700,212,1014,1226,Saturday
2020,11,14,1600,281,836,1117,Saturday
2020,11,14,1500,336,816,1152,Saturday
2020,11,14,1400,376,507,883,Saturday
2020,11,14,1300,506,340,846,Saturday
2020,11,14,1200,593,287,880,Saturday
2020,11,14,1100,579,187,766,Saturday
2020,11,14,1000,632,141,773,Saturday
2020,11,14,900,843,80,923,Saturday
2020,11,14,800,349,49,398,Saturday
2020,11,14,700,101,30,131,Saturday
2020,11,14,600,35,20,55,Saturday
2020,11,14,500,18,29,47,Saturday
2020,11,14,400,19,101,120,Saturday
2020,11,14,300,11,30,41,Saturday
2020,11,14,200,15,11,26,Saturday
2020,11,14,100,33,5,38,Saturday
2020,11,13,2400,34,8,42,Friday
2020,11,13,2300,50,22,72,Friday
2020,11,13,2200,80,50,130,Friday
2020,11,13,2100,135,100,235,Friday
2020,11,13,2000,231,136,367,Friday
2020,11,13,1900,247,224,471,Friday
2020,11,13,1800,309,530,839,Friday
2020,11,13,1700,380,670,1050,Friday
2020,11,13,1600,385,527,912,Friday
2020,11,13,1500,420,453,873,Friday
2020,11,13,1400,380,382,762,Friday
2020,11,13,1300,411,297,708,Friday
2020,11,13,1200,458,246,704,Friday
2020,11,13,1100,448,213,661,Friday
2020,11,13,1000,472,141,613,Friday
2020,11,13,900,508,97,605,Friday
2020,11,13,800,181,37,218,Friday
2020,11,13,700,105,49,154,Friday
2020,11,13,600,45,23,68,Friday
2020,11,13,500,32,29,61,Friday
2020,11,13,400,32,29,61,Friday
2020,11,13,300,28,28,56,Friday
2020,11,13,200,34,42,76,Friday
2020,11,13,100,29,50,79,Friday
2020,11,12,2400,43,58,101,Thursday
2020,11,12,2300,64,77,141,Thursday
2020,11,12,2200,67,108,175,Thursday
2020,11,12,2100,135,90,225,Thursday
2020,11,12,2000,159,164,323,Thursday
2020,11,12,1900,201,210,411,Thursday
2020,11,12,1800,224,439,663,Thursday
2020,11,12,1700,319,640,959,Thursday
2020,11,12,1600,355,607,962,Thursday
2020,11,12,1500,344,489,833,Thursday
2020,11,12,1400,345,363,708,Thursday
2020,11,12,1300,412,310,722,Thursday
2020,11,12,1200,515,225,740,Thursday
2020,11,12,1100,433,142,575,Thursday
2020,11,12,1000,510,128,638,Thursday
2020,11,12,900,465,87,552,Thursday
2020,11,12,800,180,54,234,Thursday
2020,11,12,700,82,39,121,Thursday
2020,11,12,600,32,27,59,Thursday
2020,11,12,500,25,22,47,Thursday
2020,11,12,400,25,29,54,Thursday
2020,11,12,300,21,25,46,Thursday
2020,11,12,200,18,29,47,Thursday
2020,11,12,100,23,34,57,Thursday
2020,11,11,2400,29,53,82,Wednesday
2020,11,11,2300,47,57,104,Wednesday
2020,11,11,2200,67,92,159,Wednesday
2020,11,11,2100,99,115,214,Wednesday
2020,11,11,2000,122,169,291,Wednesday
2020,11,11,1900,145,222,367,Wednesday
2020,11,11,1800,199,608,807,Wednesday
2020,11,11,1700,255,1114,1369,Wednesday
2020,11,11,1600,330,778,1108,Wednesday
2020,11,11,1500,438,737,1175,Wednesday
2020,11,11,1400,438,547,985,Wednesday
2020,11,11,1300,526,496,1022,Wednesday
2020,11,11,1200,641,376,1017,Wednesday
2020,11,11,1100,635,263,898,Wednesday
2020,11,11,1000,821,182,1003,Wednesday
2020,11,11,900,804,88,892,Wednesday
2020,11,11,800,207,50,257,Wednesday
2020,11,11,700,90,46,136,Wednesday
2020,11,11,600,33,38,71,Wednesday
2020,11,11,500,22,37,59,Wednesday
2020,11,11,400,20,159,179,Wednesday
2020,11,11,300,16,170,186,Wednesday
2020,11,11,200,28,110,138,Wednesday
2020,11,11,100,27,28,55,Wednesday
2020,11,10,2400,45,13,58,Tuesday
2020,11,10,2300,58,17,75,Tuesday
2020,11,10,2200,58,18,76,Tuesday
2020,11,10,2100,80,21,101,Tuesday
2020,11,10,2000,108,43,151,Tuesday
2020,11,10,1900,132,86,218,Tuesday
2020,11,10,1800,170,217,387,Tuesday
2020,11,10,1700,196,411,607,Tuesday
2020,11,10,1600,182,348,530,Tuesday
2020,11,10,1500,215,337,552,Tuesday
2020,11,10,1400,228,293,521,Tuesday
2020,11,10,1300,230,216,446,Tuesday
2020,11,10,1200,342,166,508,Tuesday
2020,11,10,1100,334,147,481,Tuesday
2020,11,10,1000,348,82,430,Tuesday
2020,11,10,900,337,67,404,Tuesday
2020,11,10,800,134,49,183,Tuesday
2020,11,10,700,69,22,91,Tuesday
2020,11,10,600,27,21,48,Tuesday
2020,11,10,500,25,17,42,Tuesday
2020,11,10,400,19,29,48,Tuesday
2020,11,10,300,27,26,53,Tuesday
2020,11,10,200,23,33,56,Tuesday
2020,11,10,100,39,26,65,Tuesday
2020,11,9,2400,72,29,101,Monday
2020,11,9,2300,86,49,135,Monday
2020,11,9,2200,99,65,164,Monday
2020,11,9,2100,118,125,243,Monday
2020,11,9,2000,124,136,260,Monday
2020,11,9,1900,157,242,399,Monday
2020,11,9,1800,177,342,519,Monday
2020,11,9,1700,239,573,812,Monday
2020,11,9,1600,305,543,848,Monday
2020,11,9,1500,358,420,778,Monday
2020,11,9,1400,373,319,692,Monday
2020,11,9,1300,395,277,672,Monday
2020,11,9,1200,390,229,619,Monday
2020,11,9,1100,394,158,552,Monday
2020,11,9,1000,400,124,524,Monday
2020,11,9,900,330,78,408,Monday
2020,11,9,800,153,58,211,Monday
2020,11,9,700,70,33,103,Monday
2020,11,9,600,27,21,48,Monday
2020,11,9,500,16,21,37,Monday
2020,11,9,400,12,21,33,Monday
2020,11,9,300,14,25,39,Monday
2020,11,9,200,12,23,35,Monday
2020,11,9,100,15,45,60,Monday
2020,11,8,2400,20,44,64,Sunday
2020,11,8,2300,35,66,101,Sunday
2020,11,8,2200,51,88,139,Sunday
2020,11,8,2100,47,126,173,Sunday
2020,11,8,2000,76,161,237,Sunday
2020,11,8,1900,109,307,416,Sunday
2020,11,8,1800,137,526,663,Sunday
2020,11,8,1700,224,818,1042,Sunday
2020,11,8,1600,279,779,1058,Sunday
2020,11,8,1500,296,638,934,Sunday
2020,11,8,1400,371,508,879,Sunday
2020,11,8,1300,409,419,828,Sunday
2020,11,8,1200,431,312,743,Sunday
2020,11,8,1100,466,196,662,Sunday
2020,11,8,1000,501,96,597,Sunday
2020,11,8,900,533,60,593,Sunday
2020,11,8,800,221,36,257,Sunday
2020,11,8,700,52,14,66,Sunday
2020,11,8,600,25,18,43,Sunday
2020,11,8,500,10,22,32,Sunday
2020,11,8,400,12,21,33,Sunday
2020,11,8,300,6,26,32,Sunday
2020,11,8,200,15,30,45,Sunday
2020,11,8,100,24,32,56,Sunday
2020,11,7,2400,24,34,58,Saturday
2020,11,7,2300,26,59,85,Saturday
2020,11,7,2200,46,73,119,Saturday
2020,11,7,2100,47,103,150,Saturday
2020,11,7,2000,84,133,217,Saturday
2020,11,7,1900,100,212,312,Saturday
2020,11,7,1800,143,453,596,Saturday
2020,11,7,1700,202,738,940,Saturday
2020,11,7,1600,248,687,935,Saturday
2020,11,7,1500,357,538,895,Saturday
2020,11,7,1400,369,337,706,Saturday
2020,11,7,1300,464,309,773,Saturday
2020,11,7,1200,556,208,764,Saturday
2020,11,7,1100,506,206,712,Saturday
2020,11,7,1000,523,129,652,Saturday
2020,11,7,900,728,83,811,Saturday
2020,11,7,800,286,56,342,Saturday
2020,11,7,700,90,37,127,Saturday
2020,11,7,600,28,20,48,Saturday
2020,11,7,500,27,33,60,Saturday
2020,11,7,400,14,26,40,Saturday
2020,11,7,300,24,23,47,Saturday
2020,11,7,200,23,43,66,Saturday
2020,11,7,100,37,37,74,Saturday
2020,11,6,2400,43,63,106,Friday
2020,11,6,2300,59,82,141,Friday
2020,11,6,2200,100,107,207,Friday
2020,11,6,2100,153,127,280,Friday
2020,11,6,2000,257,169,426,Friday
2020,11,6,1900,302,257,559,Friday
2020,11,6,1800,348,435,783,Friday
2020,11,6,1700,413,598,1011,Friday
2020,11,6,1600,453,462,915,Friday
2020,11,6,1500,468,401,869,Friday
2020,11,6,1400,441,332,773,Friday
2020,11,6,1300,394,317,711,Friday
2020,11,6,1200,500,240,740,Friday
2020,11,6,1100,451,205,656,Friday
2020,11,6,1000,439,126,565,Friday
2020,11,6,900,400,114,514,Friday
2020,11,6,800,208,70,278,Friday
2020,11,6,700,87,68,155,Friday
2020,11,6,600,51,31,82,Friday
2020,11,6,500,28,31,59,Friday
2020,11,6,400,37,31,68,Friday
2020,11,6,300,30,41,71,Friday
2020,11,6,200,32,50,82,Friday
2020,11,6,100,36,63,99,Friday
2020,11,5,2400,48,68,116,Thursday
2020,11,5,2300,75,81,156,Thursday
2020,11,5,2200,80,103,183,Thursday
2020,11,5,2100,119,107,226,Thursday
2020,11,5,2000,148,137,285,Thursday
2020,11,5,1900,179,208,387,Thursday
2020,11,5,1800,221,289,510,Thursday
2020,11,5,1700,243,395,638,Thursday
2020,11,5,1600,293,311,604,Thursday
2020,11,5,1500,260,298,558,Thursday
2020,11,5,1400,270,257,527,Thursday
2020,11,5,1300,289,242,531,Thursday
2020,11,5,1200,302,235,537,Thursday
2020,11,5,1100,310,175,485,Thursday
2020,11,5,1000,291,146,437,Thursday
2020,11,5,900,310,97,407,Thursday
2020,11,5,800,171,65,236,Thursday
2020,11,5,700,117,32,149,Thursday
2020,11,5,600,50,48,98,Thursday
2020,11,5,500,33,23,56,Thursday
2020,11,5,400,25,41,66,Thursday
2020,11,5,300,26,36,62,Thursday
2020,11,5,200,38,56,94,Thursday
2020,11,5,100,52,61,113,Thursday
2020,11,4,2400,45,70,115,Wednesday
2020,11,4,2300,58,48,106,Wednesday
2020,11,4,2200,78,92,170,Wednesday
2020,11,4,2100,95,103,198,Wednesday
2020,11,4,2000,111,118,229,Wednesday
2020,11,4,1900,137,172,309,Wednesday
2020,11,4,1800,174,291,465,Wednesday
2020,11,4,1700,208,349,557,Wednesday
2020,11,4,1600,235,373,608,Wednesday
2020,11,4,1500,255,338,593,Wednesday
2020,11,4,1400,267,303,570,Wednesday
2020,11,4,1300,301,263,564,Wednesday
2020,11,4,1200,337,217,554,Wednesday
2020,11,4,1100,324,163,487,Wednesday
2020,11,4,1000,277,124,401,Wednesday
2020,11,4,900,257,97,354,Wednesday
2020,11,4,800,150,84,234,Wednesday
2020,11,4,700,90,48,138,Wednesday
2020,11,4,600,45,36,81,Wednesday
2020,11,4,500,25,31,56,Wednesday
2020,11,4,400,29,38,67,Wednesday
2020,11,4,300,31,37,68,Wednesday
2020,11,4,200,29,38,67,Wednesday
2020,11,4,100,34,40,74,Wednesday
2020,11,3,2400,44,71,115,Tuesday
2020,11,3,2300,38,86,124,Tuesday
2020,11,3,2200,58,71,129,Tuesday
2020,11,3,2100,100,126,226,Tuesday
2020,11,3,2000,122,138,260,Tuesday
2020,11,3,1900,121,207,328,Tuesday
2020,11,3,1800,159,294,453,Tuesday
2020,11,3,1700,178,351,529,Tuesday
2020,11,3,1600,272,421,693,Tuesday
2020,11,3,1500,243,412,655,Tuesday
2020,11,3,1400,268,321,589,Tuesday
2020,11,3,1300,319,283,602,Tuesday
2020,11,3,1200,387,223,610,Tuesday
2020,11,3,1100,378,171,549,Tuesday
2020,11,3,1000,331,161,492,Tuesday
2020,11,3,900,272,93,365,Tuesday
2020,11,3,800,164,80,244,Tuesday
2020,11,3,700,75,45,120,Tuesday
2020,11,3,600,50,39,89,Tuesday
2020,11,3,500,25,38,63,Tuesday
2020,11,3,400,17,48,65,Tuesday
2020,11,3,300,25,41,66,Tuesday
2020,11,3,200,27,51,78,Tuesday
2020,11,3,100,38,64,102,Tuesday
2020,11,2,2400,54,79,133,Monday
2020,11,2,2300,57,49,106,Monday
2020,11,2,2200,70,95,165,Monday
2020,11,2,2100,88,126,214,Monday
2020,11,2,2000,112,159,271,Monday
2020,11,2,1900,153,204,357,Monday
2020,11,2,1800,185,404,589,Monday
2020,11,2,1700,230,449,679,Monday
2020,11,2,1600,271,441,712,Monday
2020,11,2,1500,365,307,672,Monday
2020,11,2,1400,289,339,628,Monday
2020,11,2,1300,320,251,571,Monday
2020,11,2,1200,444,203,647,Monday
2020,11,2,1100,420,179,599,Monday
2020,11,2,1000,390,115,505,Monday
2020,11,2,900,310,85,395,Monday
2020,11,2,800,162,62,224,Monday
2020,11,2,700,96,33,129,Monday
2020,11,2,600,34,18,52,Monday
2020,11,2,500,20,18,38,Monday
2020,11,2,400,22,21,43,Monday
2020,11,2,300,20,31,51,Monday
2020,11,2,200,21,29,50,Monday
2020,11,2,100,23,40,63,Monday
2020,11,1,2400,27,50,77,Sunday
2020,11,1,2300,46,72,118,Sunday
2020,11,1,2200,53,114,167,Sunday
2020,11,1,2100,84,170,254,Sunday
2020,11,1,2000,102,227,329,Sunday
2020,11,1,1900,141,346,487,Sunday
2020,11,1,1800,140,583,723,Sunday
2020,11,1,1700,222,717,939,Sunday
2020,11,1,1600,287,738,1025,Sunday
2020,11,1,1500,370,578,948,Sunday
2020,11,1,1400,436,532,968,Sunday
2020,11,1,1300,445,388,833,Sunday
2020,11,1,1200,471,282,753,Sunday
2020,11,1,1100,524,222,746,Sunday
2020,11,1,1000,478,124,602,Sunday
2020,11,1,900,468,78,546,Sunday
2020,11,1,800,212,38,250,Sunday
2020,11,1,700,92,17,109,Sunday
2020,11,1,600,43,9,52,Sunday
2020,11,1,500,18,24,42,Sunday
2020,11,1,400,22,15,37,Sunday
2020,11,1,300,11,28,39,Sunday
2020,11,1,200,14,12,26,Sunday
2020,11,1,100,17,33,50,Sunday
2020,10,31,2400,35,46,81,Saturday
2020,10,31,2300,34,44,78,Saturday
2020,10,31,2200,43,99,142,Saturday
2020,10,31,2100,77,126,203,Saturday
2020,10,31,2000,105,168,273,Saturday
2020,10,31,1900,123,265,388,Saturday
2020,10,31,1800,168,398,566,Saturday
2020,10,31,1700,218,541,759,Saturday
2020,10,31,1600,265,535,800,Saturday
2020,10,31,1500,315,538,853,Saturday
2020,10,31,1400,375,383,758,Saturday
2020,10,31,1300,446,284,730,Saturday
2020,10,31,1200,450,237,687,Saturday
2020,10,31,1100,464,158,622,Saturday
2020,10,31,1000,457,134,591,Saturday
2020,10,31,900,406,94,500,Saturday
2020,10,31,800,187,54,241,Saturday
2020,10,31,700,81,36,117,Saturday
2020,10,31,600,28,28,56,Saturday
2020,10,31,500,23,45,68,Saturday
2020,10,31,400,30,27,57,Saturday
2020,10,31,300,19,31,50,Saturday
2020,10,31,200,23,43,66,Saturday
2020,10,31,100,40,63,103,Saturday
2020,10,30,2400,47,79,126,Friday
2020,10,30,2300,58,94,152,Friday
2020,10,30,2200,88,112,200,Friday
2020,10,30,2100,107,167,274,Friday
2020,10,30,2000,229,203,432,Friday
2020,10,30,1900,240,270,510,Friday
2020,10,30,1800,293,415,708,Friday
2020,10,30,1700,351,442,793,Friday
2020,10,30,1600,369,427,796,Friday
2020,10,30,1500,386,416,802,Friday
2020,10,30,1400,369,367,736,Friday
2020,10,30,1300,409,324,733,Friday
2020,10,30,1200,364,230,594,Friday
2020,10,30,1100,412,186,598,Friday
2020,10,30,1000,318,102,420,Friday
2020,10,30,900,358,111,469,Friday
2020,10,30,800,155,68,223,Friday
2020,10,30,700,83,57,140,Friday
2020,10,30,600,36,41,77,Friday
2020,10,30,500,27,32,59,Friday
2020,10,30,400,28,33,61,Friday
2020,10,30,300,29,49,78,Friday
2020,10,30,200,40,56,96,Friday
2020,10,30,100,38,61,99,Friday
2020,10,29,2400,47,66,113,Thursday
2020,10,29,2300,57,87,144,Thursday
2020,10,29,2200,95,124,219,Thursday
2020,10,29,2100,115,136,251,Thursday
2020,10,29,2000,143,208,351,Thursday
2020,10,29,1900,184,281,465,Thursday
2020,10,29,1800,245,332,577,Thursday
2020,10,29,1700,258,414,672,Thursday
2020,10,29,1600,268,391,659,Thursday
2020,10,29,1500,291,452,743,Thursday
2020,10,29,1400,321,368,689,Thursday
2020,10,29,1300,326,321,647,Thursday
2020,10,29,1200,363,221,584,Thursday
2020,10,29,1100,372,188,560,Thursday
2020,10,29,1000,362,127,489,Thursday
2020,10,29,900,390,97,487,Thursday
2020,10,29,800,221,80,301,Thursday
2020,10,29,700,83,57,140,Thursday
2020,10,29,600,48,26,74,Thursday
2020,10,29,500,36,22,58,Thursday
2020,10,29,400,38,31,69,Thursday
2020,10,29,300,36,35,71,Thursday
2020,10,29,200,29,54,83,Thursday
2020,10,29,100,44,52,96,Thursday
2020,10,28,2400,52,66,118,Wednesday
2020,10,28,2300,67,78,145,Wednesday
2020,10,28,2200,77,107,184,Wednesday
2020,10,28,2100,101,117,218,Wednesday
2020,10,28,2000,108,145,253,Wednesday
2020,10,28,1900,155,201,356,Wednesday
2020,10,28,1800,203,319,522,Wednesday
2020,10,28,1700,218,339,557,Wednesday
2020,10,28,1600,245,327,572,Wednesday
2020,10,28,1500,249,320,569,Wednesday
2020,10,28,1400,266,331,597,Wednesday
2020,10,28,1300,314,320,634,Wednesday
2020,10,28,1200,341,176,517,Wednesday
2020,10,28,1100,304,182,486,Wednesday
2020,10,28,1000,265,104,369,Wednesday
2020,10,28,900,190,92,282,Wednesday
2020,10,28,800,163,104,267,Wednesday
2020,10,28,700,66,29,95,Wednesday
2020,10,28,600,35,11,46,Wednesday
2020,10,28,500,25,9,34,Wednesday
2020,10,28,400,28,8,36,Wednesday
2020,10,28,300,34,28,62,Wednesday
2020,10,28,200,23,33,56,Wednesday
2020,10,28,100,34,57,91,Wednesday
2020,10,27,2400,55,71,126,Tuesday
2020,10,27,2300,59,194,253,Tuesday
2020,10,27,2200,71,184,255,Tuesday
2020,10,27,2100,87,112,199,Tuesday
2020,10,27,2000,102,192,294,Tuesday
2020,10,27,1900,110,187,297,Tuesday
2020,10,27,1800,193,232,425,Tuesday
2020,10,27,1700,234,277,511,Tuesday
2020,10,27,1600,256,370,626,Tuesday
2020,10,27,1500,279,342,621,Tuesday
2020,10,27,1400,306,325,631,Tuesday
2020,10,27,1300,331,221,552,Tuesday
2020,10,27,1200,380,183,563,Tuesday
2020,10,27,1100,369,164,533,Tuesday
2020,10,27,1000,271,115,386,Tuesday
2020,10,27,900,229,98,327,Tuesday
2020,10,27,800,139,80,219,Tuesday
2020,10,27,700,73,44,117,Tuesday
2020,10,27,600,32,37,69,Tuesday
2020,10,27,500,29,40,69,Tuesday
2020,10,27,400,22,32,54,Tuesday
2020,10,27,300,22,31,53,Tuesday
2020,10,27,200,27,55,82,Tuesday
2020,10,27,100,41,53,94,Tuesday
2020,10,26,2400,51,52,103,Monday
2020,10,26,2300,64,73,137,Monday
2020,10,26,2200,62,83,145,Monday
2020,10,26,2100,86,116,202,Monday
2020,10,26,2000,114,199,313,Monday
2020,10,26,1900,162,229,391,Monday
2020,10,26,1800,180,356,536,Monday
2020,10,26,1700,213,338,551,Monday
2020,10,26,1600,248,419,667,Monday
2020,10,26,1500,290,290,580,Monday
2020,10,26,1400,342,269,611,Monday
2020,10,26,1300,317,222,539,Monday
2020,10,26,1200,354,178,532,Monday
2020,10,26,1100,301,142,443,Monday
2020,10,26,1000,256,101,357,Monday
2020,10,26,900,200,77,277,Monday
2020,10,26,800,150,57,207,Monday
2020,10,26,700,61,30,91,Monday
2020,10,26,600,31,17,48,Monday
2020,10,26,500,14,24,38,Monday
2020,10,26,400,26,19,45,Monday
2020,10,26,300,16,17,33,Monday
2020,10,26,200,22,25,47,Monday
2020,10,26,100,23,50,73,Monday
2020,10,25,2400,22,52,74,Sunday
2020,10,25,2300,33,83,116,Sunday
2020,10,25,2200,52,122,174,Sunday
2020,10,25,2100,70,139,209,Sunday
2020,10,25,2000,110,283,393,Sunday
2020,10,25,1900,126,393,519,Sunday
2020,10,25,1800,181,518,699,Sunday
2020,10,25,1700,238,615,853,Sunday
2020,10,25,1600,306,685,991,Sunday
2020,10,25,1500,362,614,976,Sunday
2020,10,25,1400,408,527,935,Sunday
2020,10,25,1300,500,498,998,Sunday
2020,10,25,1200,470,370,840,Sunday
2020,10,25,1100,388,203,591,Sunday
2020,10,25,1000,329,94,423,Sunday
2020,10,25,900,201,48,249,Sunday
2020,10,25,800,153,35,188,Sunday
2020,10,25,700,47,15,62,Sunday
2020,10,25,600,25,15,40,Sunday
2020,10,25,500,20,18,38,Sunday
2020,10,25,400,18,16,34,Sunday
2020,10,25,300,18,21,39,Sunday
2020,10,25,200,24,36,60,Sunday
2020,10,25,100,19,29,48,Sunday
2020,10,24,2400,26,45,71,Saturday
2020,10,24,2300,48,60,108,Saturday
2020,10,24,2200,36,98,134,Saturday
2020,10,24,2100,68,113,181,Saturday
2020,10,24,2000,77,204,281,Saturday
2020,10,24,1900,134,324,458,Saturday
2020,10,24,1800,150,398,548,Saturday
2020,10,24,1700,208,380,588,Saturday
2020,10,24,1600,269,443,712,Saturday
2020,10,24,1500,300,401,701,Saturday
2020,10,24,1400,399,320,719,Saturday
2020,10,24,1300,409,287,696,Saturday
2020,10,24,1200,420,236,656,Saturday
2020,10,24,1100,377,158,535,Saturday
2020,10,24,1000,266,96,362,Saturday
2020,10,24,900,203,72,275,Saturday
2020,10,24,800,99,38,137,Saturday
2020,10,24,700,51,29,80,Saturday
2020,10,24,600,24,31,55,Saturday
2020,10,24,500,20,12,32,Saturday
2020,10,24,400,13,24,37,Saturday
2020,10,24,300,22,26,48,Saturday
2020,10,24,200,10,40,50,Saturday
2020,10,24,100,28,51,79,Saturday
2020,10,23,2400,36,52,88,Friday
2020,10,23,2300,55,71,126,Friday
2020,10,23,2200,65,108,173,Friday
2020,10,23,2100,112,99,211,Friday
2020,10,23,2000,159,141,300,Friday
2020,10,23,1900,237,210,447,Friday
2020,10,23,1800,284,234,518,Friday
2020,10,23,1700,352,292,644,Friday
2020,10,23,1600,376,276,652,Friday
2020,10,23,1500,317,287,604,Friday
2020,10,23,1400,364,250,614,Friday
2020,10,23,1300,345,261,606,Friday
2020,10,23,1200,338,231,569,Friday
2020,10,23,1100,314,210,524,Friday
2020,10,23,1000,244,115,359,Friday
2020,10,23,900,189,89,278,Friday
2020,10,23,800,146,59,205,Friday
2020,10,23,700,60,47,107,Friday
2020,10,23,600,34,40,74,Friday
2020,10,23,500,19,52,71,Friday
2020,10,23,400,23,38,61,Friday
2020,10,23,300,26,44,70,Friday
2020,10,23,200,30,44,74,Friday
2020,10,23,100,43,73,116,Friday
2020,10,22,2400,61,73,134,Thursday
2020,10,22,2300,84,92,176,Thursday
2020,10,22,2200,79,112,191,Thursday
2020,10,22,2100,114,162,276,Thursday
2020,10,22,2000,151,233,384,Thursday
2020,10,22,1900,206,328,534,Thursday
2020,10,22,1800,248,334,582,Thursday
2020,10,22,1700,289,338,627,Thursday
2020,10,22,1600,305,323,628,Thursday
2020,10,22,1500,344,356,700,Thursday
2020,10,22,1400,347,293,640,Thursday
2020,10,22,1300,371,248,619,Thursday
2020,10,22,1200,374,241,615,Thursday
2020,10,22,1100,358,193,551,Thursday
2020,10,22,1000,324,116,440,Thursday
2020,10,22,900,216,90,306,Thursday
2020,10,22,800,147,68,215,Thursday
2020,10,22,700,81,36,117,Thursday
2020,10,22,600,40,43,83,Thursday
2020,10,22,500,24,34,58,Thursday
2020,10,22,400,31,27,58,Thursday
2020,10,22,300,38,35,73,Thursday
2020,10,22,200,26,49,75,Thursday
2020,10,22,100,44,53,97,Thursday
2020,10,21,2400,46,80,126,Wednesday
2020,10,21,2300,74,64,138,Wednesday
2020,10,21,2200,72,103,175,Wednesday
2020,10,21,2100,80,134,214,Wednesday
2020,10,21,2000,109,196,305,Wednesday
2020,10,21,1900,134,241,375,Wednesday
2020,10,21,1800,180,351,531,Wednesday
2020,10,21,1700,206,284,490,Wednesday
2020,10,21,1600,232,313,545,Wednesday
2020,10,21,1500,277,293,570,Wednesday
2020,10,21,1400,288,251,539,Wednesday
2020,10,21,1300,293,231,524,Wednesday
2020,10,21,1200,348,196,544,Wednesday
2020,10,21,1100,327,160,487,Wednesday
2020,10,21,1000,198,110,308,Wednesday
2020,10,21,900,184,93,277,Wednesday
2020,10,21,800,117,71,188,Wednesday
2020,10,21,700,61,50,111,Wednesday
2020,10,21,600,38,49,87,Wednesday
2020,10,21,500,23,22,45,Wednesday
2020,10,21,400,32,32,64,Wednesday
2020,10,21,300,35,55,90,Wednesday
2020,10,21,200,26,39,65,Wednesday
2020,10,21,100,45,61,106,Wednesday
2020,10,20,2400,52,75,127,Tuesday
2020,10,20,2300,47,85,132,Tuesday
2020,10,20,2200,72,112,184,Tuesday
2020,10,20,2100,111,141,252,Tuesday
2020,10,20,2000,142,208,350,Tuesday
2020,10,20,1900,156,337,493,Tuesday
2020,10,20,1800,182,385,567,Tuesday
2020,10,20,1700,199,406,605,Tuesday
2020,10,20,1600,282,455,737,Tuesday
2020,10,20,1500,348,421,769,Tuesday
2020,10,20,1400,307,338,645,Tuesday
2020,10,20,1300,388,221,609,Tuesday
2020,10,20,1200,405,180,585,Tuesday
2020,10,20,1100,393,146,539,Tuesday
2020,10,20,1000,292,123,415,Tuesday
2020,10,20,900,229,101,330,Tuesday
2020,10,20,800,155,64,219,Tuesday
2020,10,20,700,74,44,118,Tuesday
2020,10,20,600,35,50,85,Tuesday
2020,10,20,500,26,34,60,Tuesday
2020,10,20,400,21,40,61,Tuesday
2020,10,20,300,23,51,74,Tuesday
2020,10,20,200,27,34,61,Tuesday
2020,10,20,100,43,57,100,Tuesday
2020,10,19,2400,40,93,133,Monday
2020,10,19,2300,55,60,115,Monday
2020,10,19,2200,63,95,158,Monday
2020,10,19,2100,92,129,221,Monday
2020,10,19,2000,124,185,309,Monday
2020,10,19,1900,143,323,466,Monday
2020,10,19,1800,201,373,574,Monday
2020,10,19,1700,258,398,656,Monday
2020,10,19,1600,278,435,713,Monday
2020,10,19,1500,322,382,704,Monday
2020,10,19,1400,368,331,699,Monday
2020,10,19,1300,372,294,666,Monday
2020,10,19,1200,376,224,600,Monday
2020,10,19,1100,375,140,515,Monday
2020,10,19,1000,302,92,394,Monday
2020,10,19,900,181,60,241,Monday
2020,10,19,800,126,44,170,Monday
2020,10,19,700,95,25,120,Monday
2020,10,19,600,31,21,52,Monday
2020,10,19,500,13,20,33,Monday
2020,10,19,400,21,17,38,Monday
2020,10,19,300,16,25,41,Monday
2020,10,19,200,16,54,70,Monday
2020,10,19,100,19,41,60,Monday
2020,10,18,2400,21,55,76,Sunday
2020,10,18,2300,36,86,122,Sunday
2020,10,18,2200,63,89,152,Sunday
2020,10,18,2100,72,179,251,Sunday
2020,10,18,2000,93,275,368,Sunday
2020,10,18,1900,135,435,570,Sunday
2020,10,18,1800,198,547,745,Sunday
2020,10,18,1700,225,582,807,Sunday
2020,10,18,1600,298,937,1235,Sunday
2020,10,18,1500,341,489,830,Sunday
2020,10,18,1400,392,408,800,Sunday
2020,10,18,1300,419,411,830,Sunday
2020,10,18,1200,445,329,774,Sunday
2020,10,18,1100,376,168,544,Sunday
2020,10,18,1000,311,90,401,Sunday
2020,10,18,900,203,40,243,Sunday
2020,10,18,800,112,29,141,Sunday
2020,10,18,700,71,15,86,Sunday
2020,10,18,600,33,23,56,Sunday
2020,10,18,500,18,26,44,Sunday
2020,10,18,400,7,18,25,Sunday
2020,10,18,300,20,22,42,Sunday
2020,10,18,200,11,35,46,Sunday
2020,10,18,100,20,48,68,Sunday
2020,10,17,2400,31,57,88,Saturday
2020,10,17,2300,29,84,113,Saturday
2020,10,17,2200,47,103,150,Saturday
2020,10,17,2100,86,173,259,Saturday
2020,10,17,2000,97,257,354,Saturday
2020,10,17,1900,122,402,524,Saturday
2020,10,17,1800,179,461,640,Saturday
2020,10,17,1700,249,590,839,Saturday
2020,10,17,1600,294,541,835,Saturday
2020,10,17,1500,370,465,835,Saturday
2020,10,17,1400,465,417,882,Saturday
2020,10,17,1300,542,329,871,Saturday
2020,10,17,1200,559,296,855,Saturday
2020,10,17,1100,506,172,678,Saturday
2020,10,17,1000,351,129,480,Saturday
2020,10,17,900,212,91,303,Saturday
2020,10,17,800,144,56,200,Saturday
2020,10,17,700,71,35,106,Saturday
2020,10,17,600,27,46,73,Saturday
2020,10,17,500,20,42,62,Saturday
2020,10,17,400,12,26,38,Saturday
2020,10,17,300,19,39,58,Saturday
2020,10,17,200,20,34,54,Saturday
2020,10,17,100,28,67,95,Saturday
2020,10,16,2400,34,82,116,Friday
2020,10,16,2300,70,107,177,Friday
2020,10,16,2200,184,121,305,Friday
2020,10,16,2100,70,122,192,Friday
2020,10,16,2000,84,172,256,Friday
2020,10,16,1900,186,266,452,Friday
2020,10,16,1800,316,346,662,Friday
2020,10,16,1700,361,357,718,Friday
2020,10,16,1600,380,375,755,Friday
2020,10,16,1500,418,422,840,Friday
2020,10,16,1400,429,412,841,Friday
2020,10,16,1300,424,464,888,Friday
2020,10,16,1200,444,222,666,Friday
2020,10,16,1100,407,140,547,Friday
2020,10,16,1000,318,105,423,Friday
2020,10,16,900,217,79,296,Friday
2020,10,16,800,166,54,220,Friday
2020,10,16,700,100,47,147,Friday
2020,10,16,600,41,36,77,Friday
2020,10,16,500,38,41,79,Friday
2020,10,16,400,44,42,86,Friday
2020,10,16,300,41,37,78,Friday
2020,10,16,200,42,68,110,Friday
2020,10,16,100,47,72,119,Friday
2020,10,15,2400,59,72,131,Thursday
2020,10,15,2300,74,117,191,Thursday
2020,10,15,2200,111,156,267,Thursday
2020,10,15,2100,163,212,375,Thursday
2020,10,15,2000,207,340,547,Thursday
2020,10,15,1900,239,433,672,Thursday
2020,10,15,1800,329,477,806,Thursday
2020,10,15,1700,333,547,880,Thursday
2020,10,15,1600,379,560,939,Thursday
2020,10,15,1500,516,483,999,Thursday
2020,10,15,1400,469,452,921,Thursday
2020,10,15,1300,535,350,885,Thursday
2020,10,15,1200,558,267,825,Thursday
2020,10,15,1100,568,243,811,Thursday
2020,10,15,1000,423,146,569,Thursday
2020,10,15,900,293,121,414,Thursday
2020,10,15,800,224,83,307,Thursday
2020,10,15,700,115,74,189,Thursday
2020,10,15,600,42,33,75,Thursday
2020,10,15,500,33,37,70,Thursday
2020,10,15,400,28,40,68,Thursday
2020,10,15,300,28,41,69,Thursday
2020,10,15,200,40,53,93,Thursday
2020,10,15,100,70,77,147,Thursday
2020,10,14,2400,21,89,110,Wednesday
2020,10,14,2300,71,118,189,Wednesday
2020,10,14,2200,91,156,247,Wednesday
2020,10,14,2100,106,193,299,Wednesday
2020,10,14,2000,126,268,394,Wednesday
2020,10,14,1900,164,347,511,Wednesday
2020,10,14,1800,232,434,666,Wednesday
2020,10,14,1700,255,523,778,Wednesday
2020,10,14,1600,341,443,784,Wednesday
2020,10,14,1500,353,390,743,Wednesday
2020,10,14,1400,446,317,763,Wednesday
2020,10,14,1300,501,316,817,Wednesday
2020,10,14,1200,533,272,805,Wednesday
2020,10,14,1100,496,208,704,Wednesday
2020,10,14,1000,327,143,470,Wednesday
2020,10,14,900,235,115,350,Wednesday
2020,10,14,800,158,89,247,Wednesday
2020,10,14,700,70,58,128,Wednesday
2020,10,14,600,35,37,72,Wednesday
2020,10,14,500,11,55,66,Wednesday
2020,10,14,400,20,82,102,Wednesday
2020,10,14,300,19,57,76,Wednesday
2020,10,14,200,23,50,73,Wednesday
2020,10,14,100,41,55,96,Wednesday
2020,10,13,2400,62,66,128,Tuesday
2020,10,13,2300,69,91,160,Tuesday
2020,10,13,2200,75,116,191,Tuesday
2020,10,13,2100,122,215,337,Tuesday
2020,10,13,2000,154,351,505,Tuesday
2020,10,13,1900,165,466,631,Tuesday
2020,10,13,1800,202,537,739,Tuesday
2020,10,13,1700,274,604,878,Tuesday
2020,10,13,1600,385,506,891,Tuesday
2020,10,13,1500,424,530,954,Tuesday
2020,10,13,1400,508,521,1029,Tuesday
2020,10,13,1300,534,448,982,Tuesday
2020,10,13,1200,634,365,999,Tuesday
2020,10,13,1100,633,243,876,Tuesday
2020,10,13,1000,538,155,693,Tuesday
2020,10,13,900,338,88,426,Tuesday
2020,10,13,800,218,74,292,Tuesday
2020,10,13,700,120,54,174,Tuesday
2020,10,13,600,56,26,82,Tuesday
2020,10,13,500,28,23,51,Tuesday
2020,10,13,400,20,31,51,Tuesday
2020,10,13,300,20,26,46,Tuesday
2020,10,13,200,19,39,58,Tuesday
2020,10,13,100,31,50,81,Tuesday
2020,10,12,2400,33,87,120,Monday
2020,10,12,2300,49,161,210,Monday
2020,10,12,2200,49,212,261,Monday
2020,10,12,2100,94,355,449,Monday
2020,10,12,2000,143,650,793,Monday
2020,10,12,1900,180,1039,1219,Monday
2020,10,12,1800,242,1398,1640,Monday
2020,10,12,1700,359,1534,1893,Monday
2020,10,12,1600,469,1593,2062,Monday
2020,10,12,1500,610,1564,2174,Monday
2020,10,12,1400,695,1402,2097,Monday
2020,10,12,1300,827,1184,2011,Monday
2020,10,12,1200,891,808,1699,Monday
2020,10,12,1100,812,410,1222,Monday
2020,10,12,1000,611,212,823,Monday
2020,10,12,900,429,106,535,Monday
2020,10,12,800,295,45,340,Monday
2020,10,12,700,125,18,143,Monday
2020,10,12,600,47,15,62,Monday
2020,10,12,500,43,14,57,Monday
2020,10,12,400,22,26,48,Monday
2020,10,12,300,17,24,41,Monday
2020,10,12,200,24,25,49,Monday
2020,10,12,100,23,40,63,Monday
2020,10,11,2400,37,66,103,Sunday
2020,10,11,2300,57,79,136,Sunday
2020,10,11,2200,71,190,261,Sunday
2020,10,11,2100,111,317,428,Sunday
2020,10,11,2000,158,466,624,Sunday
2020,10,11,1900,179,708,887,Sunday
2020,10,11,1800,260,902,1162,Sunday
2020,10,11,1700,349,984,1333,Sunday
2020,10,11,1600,469,791,1260,Sunday
2020,10,11,1500,545,839,1384,Sunday
2020,10,11,1400,641,723,1364,Sunday
2020,10,11,1300,765,586,1351,Sunday
2020,10,11,1200,803,424,1227,Sunday
2020,10,11,1100,754,250,1004,Sunday
2020,10,11,1000,586,134,720,Sunday
2020,10,11,900,424,82,506,Sunday
2020,10,11,800,312,29,341,Sunday
2020,10,11,700,186,14,200,Sunday
2020,10,11,600,95,22,117,Sunday
2020,10,11,500,52,19,71,Sunday
2020,10,11,400,23,22,45,Sunday
2020,10,11,300,24,30,54,Sunday
2020,10,11,200,23,28,51,Sunday
2020,10,11,100,23,42,65,Sunday
2020,10,10,2400,53,66,119,Saturday
2020,10,10,2300,61,101,162,Saturday
2020,10,10,2200,86,149,235,Saturday
2020,10,10,2100,120,209,329,Saturday
2020,10,10,2000,159,385,544,Saturday
2020,10,10,1900,189,416,605,Saturday
2020,10,10,1800,258,683,941,Saturday
2020,10,10,1700,378,947,1325,Saturday
2020,10,10,1600,557,867,1424,Saturday
2020,10,10,1500,665,767,1432,Saturday
2020,10,10,1400,819,649,1468,Saturday
2020,10,10,1300,912,569,1481,Saturday
2020,10,10,1200,977,419,1396,Saturday
2020,10,10,1100,929,314,1243,Saturday
2020,10,10,1000,725,218,943,Saturday
2020,10,10,900,526,136,662,Saturday
2020,10,10,800,356,94,450,Saturday
2020,10,10,700,189,49,238,Saturday
2020,10,10,600,73,45,118,Saturday
2020,10,10,500,47,34,81,Saturday
2020,10,10,400,30,39,69,Saturday
2020,10,10,300,32,44,76,Saturday
2020,10,10,200,26,60,86,Saturday
2020,10,10,100,44,95,139,Saturday
2020,10,9,2400,77,133,210,Friday
2020,10,9,2300,126,149,275,Friday
2020,10,9,2200,181,237,418,Friday
2020,10,9,2100,342,314,656,Friday
2020,10,9,2000,555,492,1047,Friday
2020,10,9,1900,794,615,1409,Friday
2020,10,9,1800,883,725,1608,Friday
2020,10,9,1700,859,904,1763,Friday
2020,10,9,1600,946,849,1795,Friday
2020,10,9,1500,981,815,1796,Friday
2020,10,9,1400,949,560,1509,Friday
2020,10,9,1300,960,516,1476,Friday
2020,10,9,1200,1068,458,1526,Friday
2020,10,9,1100,1005,288,1293,Friday
2020,10,9,1000,726,212,938,Friday
2020,10,9,900,567,143,710,Friday
2020,10,9,800,403,90,493,Friday
2020,10,9,700,204,69,273,Friday
2020,10,9,600,84,37,121,Friday
2020,10,9,500,43,54,97,Friday
2020,10,9,400,42,60,102,Friday
2020,10,9,300,34,64,98,Friday
2020,10,9,200,40,60,100,Friday
2020,10,9,100,53,89,142,Friday
2020,10,8,2400,74,106,180,Thursday
2020,10,8,2300,122,148,270,Thursday
2020,10,8,2200,187,210,397,Thursday
2020,10,8,2100,283,255,538,Thursday
2020,10,8,2000,464,403,867,Thursday
2020,10,8,1900,553,570,1123,Thursday
2020,10,8,1800,554,662,1216,Thursday
2020,10,8,1700,542,654,1196,Thursday
2020,10,8,1600,537,645,1182,Thursday
2020,10,8,1500,643,597,1240,Thursday
2020,10,8,1400,599,521,1120,Thursday
2020,10,8,1300,564,364,928,Thursday
2020,10,8,1200,706,357,1063,Thursday
2020,10,8,1100,689,254,943,Thursday
2020,10,8,1000,572,192,764,Thursday
2020,10,8,900,482,144,626,Thursday
2020,10,8,800,272,106,378,Thursday
2020,10,8,700,156,67,223,Thursday
2020,10,8,600,77,60,137,Thursday
2020,10,8,500,45,40,85,Thursday
2020,10,8,400,28,57,85,Thursday
2020,10,8,300,38,44,82,Thursday
2020,10,8,200,40,66,106,Thursday
2020,10,8,100,49,72,121,Thursday
2020,10,7,2400,74,97,171,Wednesday
2020,10,7,2300,80,138,218,Wednesday
2020,10,7,2200,103,158,261,Wednesday
2020,10,7,2100,141,235,376,Wednesday
2020,10,7,2000,175,395,570,Wednesday
2020,10,7,1900,237,541,778,Wednesday
2020,10,7,1800,288,576,864,Wednesday
2020,10,7,1700,342,577,919,Wednesday
2020,10,7,1600,361,515,876,Wednesday
2020,10,7,1500,406,406,812,Wednesday
2020,10,7,1400,472,422,894,Wednesday
2020,10,7,1300,474,334,808,Wednesday
2020,10,7,1200,611,272,883,Wednesday
2020,10,7,1100,572,233,805,Wednesday
2020,10,7,1000,469,148,617,Wednesday
2020,10,7,900,359,117,476,Wednesday
2020,10,7,800,267,93,360,Wednesday
2020,10,7,700,131,58,189,Wednesday
2020,10,7,600,63,37,100,Wednesday
2020,10,7,500,45,47,92,Wednesday
2020,10,7,400,36,60,96,Wednesday
2020,10,7,300,37,51,88,Wednesday
2020,10,7,200,31,52,83,Wednesday
2020,10,7,100,29,57,86,Wednesday
2020,10,6,2400,54,94,148,Tuesday
2020,10,6,2300,69,76,145,Tuesday
2020,10,6,2200,100,162,262,Tuesday
2020,10,6,2100,123,203,326,Tuesday
2020,10,6,2000,158,330,488,Tuesday
2020,10,6,1900,176,436,612,Tuesday
2020,10,6,1800,257,578,835,Tuesday
2020,10,6,1700,287,545,832,Tuesday
2020,10,6,1600,318,442,760,Tuesday
2020,10,6,1500,369,468,837,Tuesday
2020,10,6,1400,408,413,821,Tuesday
2020,10,6,1300,460,333,793,Tuesday
2020,10,6,1200,498,286,784,Tuesday
2020,10,6,1100,499,202,701,Tuesday
2020,10,6,1000,459,171,630,Tuesday
2020,10,6,900,353,106,459,Tuesday
2020,10,6,800,240,109,349,Tuesday
2020,10,6,700,152,55,207,Tuesday
2020,10,6,600,72,37,109,Tuesday
2020,10,6,500,38,35,73,Tuesday
2020,10,6,400,32,42,74,Tuesday
2020,10,6,300,40,35,75,Tuesday
2020,10,6,200,31,57,88,Tuesday
2020,10,6,100,38,72,110,Tuesday
2020,10,5,2400,61,76,137,Monday
2020,10,5,2300,58,115,173,Monday
2020,10,5,2200,69,172,241,Monday
2020,10,5,2100,102,291,393,Monday
2020,10,5,2000,162,417,579,Monday
2020,10,5,1900,196,526,722,Monday
2020,10,5,1800,275,713,988,Monday
2020,10,5,1700,320,725,1045,Monday
2020,10,5,1600,371,634,1005,Monday
2020,10,5,1500,476,534,1010,Monday
2020,10,5,1400,548,511,1059,Monday
2020,10,5,1300,604,430,1034,Monday
2020,10,5,1200,599,326,925,Monday
2020,10,5,1100,718,208,926,Monday
2020,10,5,1000,521,157,678,Monday
2020,10,5,900,410,108,518,Monday
2020,10,5,800,282,82,364,Monday
2020,10,5,700,155,53,208,Monday
2020,10,5,600,83,28,111,Monday
2020,10,5,500,53,14,67,Monday
2020,10,5,400,30,18,48,Monday
2020,10,5,300,26,29,55,Monday
2020,10,5,200,22,48,70,Monday
2020,10,5,100,27,70,97,Monday
2020,10,4,2400,39,87,126,Sunday
2020,10,4,2300,53,156,209,Sunday
2020,10,4,2200,78,407,485,Sunday
2020,10,4,2100,109,474,583,Sunday
2020,10,4,2000,180,616,796,Sunday
2020,10,4,1900,199,828,1027,Sunday
2020,10,4,1800,235,1083,1318,Sunday
2020,10,4,1700,336,1286,1622,Sunday
2020,10,4,1600,447,1478,1925,Sunday
2020,10,4,1500,531,1226,1757,Sunday
2020,10,4,1400,648,1001,1649,Sunday
2020,10,4,1300,732,849,1581,Sunday
2020,10,4,1200,859,575,1434,Sunday
2020,10,4,1100,747,347,1094,Sunday
2020,10,4,1000,704,183,887,Sunday
2020,10,4,900,529,82,611,Sunday
2020,10,4,800,341,55,396,Sunday
2020,10,4,700,206,32,238,Sunday
2020,10,4,600,116,20,136,Sunday
2020,10,4,500,92,39,131,Sunday
2020,10,4,400,40,11,51,Sunday
2020,10,4,300,21,28,49,Sunday
2020,10,4,200,28,43,71,Sunday
2020,10,4,100,28,39,67,Sunday
2020,10,3,2400,43,82,125,Saturday
2020,10,3,2300,54,114,168,Saturday
2020,10,3,2200,94,215,309,Saturday
2020,10,3,2100,98,509,607,Saturday
2020,10,3,2000,147,726,873,Saturday
2020,10,3,1900,228,906,1134,Saturday
2020,10,3,1800,290,1069,1359,Saturday
2020,10,3,1700,350,970,1320,Saturday
2020,10,3,1600,480,905,1385,Saturday
2020,10,3,1500,661,797,1458,Saturday
2020,10,3,1400,762,607,1369,Saturday
2020,10,3,1300,841,570,1411,Saturday
2020,10,3,1200,1009,396,1405,Saturday
2020,10,3,1100,1092,277,1369,Saturday
2020,10,3,1000,976,203,1179,Saturday
2020,10,3,900,780,130,910,Saturday
2020,10,3,800,557,75,632,Saturday
2020,10,3,700,267,58,325,Saturday
2020,10,3,600,140,51,191,Saturday
2020,10,3,500,119,37,156,Saturday
2020,10,3,400,57,47,104,Saturday
2020,10,3,300,26,42,68,Saturday
2020,10,3,200,31,42,73,Saturday
2020,10,3,100,56,62,118,Saturday
2020,10,2,2400,57,107,164,Friday
2020,10,2,2300,119,145,264,Friday
2020,10,2,2200,153,154,307,Friday
2020,10,2,2100,264,334,598,Friday
2020,10,2,2000,463,492,955,Friday
2020,10,2,1900,598,647,1245,Friday
2020,10,2,1800,643,760,1403,Friday
2020,10,2,1700,707,802,1509,Friday
2020,10,2,1600,733,700,1433,Friday
2020,10,2,1500,689,609,1298,Friday
2020,10,2,1400,753,536,1289,Friday
2020,10,2,1300,693,429,1122,Friday
2020,10,2,1200,788,349,1137,Friday
2020,10,2,1100,806,274,1080,Friday
2020,10,2,1000,693,182,875,Friday
2020,10,2,900,505,120,625,Friday
2020,10,2,800,357,97,454,Friday
2020,10,2,700,223,46,269,Friday
2020,10,2,600,100,48,148,Friday
2020,10,2,500,74,34,108,Friday
2020,10,2,400,45,49,94,Friday
2020,10,2,300,32,49,81,Friday
2020,10,2,200,42,50,92,Friday
2020,10,2,100,55,68,123,Friday
2020,10,1,2400,67,100,167,Thursday
2020,10,1,2300,106,146,252,Thursday
2020,10,1,2200,128,147,275,Thursday
2020,10,1,2100,179,302,481,Thursday
2020,10,1,2000,285,440,725,Thursday
2020,10,1,1900,368,571,939,Thursday
2020,10,1,1800,432,631,1063,Thursday
2020,10,1,1700,430,697,1127,Thursday
2020,10,1,1600,480,588,1068,Thursday
2020,10,1,1500,507,468,975,Thursday
2020,10,1,1400,590,429,1019,Thursday
2020,10,1,1300,559,340,899,Thursday
2020,10,1,1200,700,315,1015,Thursday
2020,10,1,1100,671,256,927,Thursday
2020,10,1,1000,607,172,779,Thursday
2020,10,1,900,431,125,556,Thursday
2020,10,1,800,283,80,363,Thursday
2020,10,1,700,185,61,246,Thursday
2020,10,1,600,88,54,142,Thursday
2020,10,1,500,65,39,104,Thursday
2020,10,1,400,44,42,86,Thursday
2020,10,1,300,27,48,75,Thursday
2020,10,1,200,39,58,97,Thursday
2020,10,1,100,48,71,119,Thursday
2020,9,30,2400,69,99,168,Wednesday
2020,9,30,2300,84,116,200,Wednesday
2020,9,30,2200,105,201,306,Wednesday
2020,9,30,2100,153,260,413,Wednesday
2020,9,30,2000,167,455,622,Wednesday
2020,9,30,1900,212,582,794,Wednesday
2020,9,30,1800,332,645,977,Wednesday
2020,9,30,1700,338,676,1014,Wednesday
2020,9,30,1600,390,536,926,Wednesday
2020,9,30,1500,409,456,865,Wednesday
2020,9,30,1400,505,446,951,Wednesday
2020,9,30,1300,552,395,947,Wednesday
2020,9,30,1200,649,338,987,Wednesday
2020,9,30,1100,701,266,967,Wednesday
2020,9,30,1000,558,188,746,Wednesday
2020,9,30,900,443,148,591,Wednesday
2020,9,30,800,309,85,394,Wednesday
2020,9,30,700,174,61,235,Wednesday
2020,9,30,600,111,37,148,Wednesday
2020,9,30,500,65,38,103,Wednesday
2020,9,30,400,47,39,86,Wednesday
2020,9,30,300,23,47,70,Wednesday
2020,9,30,200,24,58,82,Wednesday
2020,9,30,100,46,67,113,Wednesday
2020,9,29,2400,69,102,171,Tuesday
2020,9,29,2300,63,113,176,Tuesday
2020,9,29,2200,98,149,247,Tuesday
2020,9,29,2100,120,305,425,Tuesday
2020,9,29,2000,176,380,556,Tuesday
2020,9,29,1900,216,586,802,Tuesday
2020,9,29,1800,284,691,975,Tuesday
2020,9,29,1700,315,647,962,Tuesday
2020,9,29,1600,396,669,1065,Tuesday
2020,9,29,1500,417,488,905,Tuesday
2020,9,29,1400,434,478,912,Tuesday
2020,9,29,1300,554,415,969,Tuesday
2020,9,29,1200,702,298,1000,Tuesday
2020,9,29,1100,718,226,944,Tuesday
2020,9,29,1000,569,179,748,Tuesday
2020,9,29,900,417,126,543,Tuesday
2020,9,29,800,307,96,403,Tuesday
2020,9,29,700,204,73,277,Tuesday
2020,9,29,600,128,41,169,Tuesday
2020,9,29,500,76,36,112,Tuesday
2020,9,29,400,39,51,90,Tuesday
2020,9,29,300,39,39,78,Tuesday
2020,9,29,200,19,48,67,Tuesday
2020,9,29,100,48,71,119,Tuesday
2020,9,28,2400,62,80,142,Monday
2020,9,28,2300,79,120,199,Monday
2020,9,28,2200,119,209,328,Monday
2020,9,28,2100,131,290,421,Monday
2020,9,28,2000,176,442,618,Monday
2020,9,28,1900,220,568,788,Monday
2020,9,28,1800,256,724,980,Monday
2020,9,28,1700,342,715,1057,Monday
2020,9,28,1600,421,756,1177,Monday
2020,9,28,1500,493,590,1083,Monday
2020,9,28,1400,589,462,1051,Monday
2020,9,28,1300,656,408,1064,Monday
2020,9,28,1200,782,324,1106,Monday
2020,9,28,1100,704,221,925,Monday
2020,9,28,1000,551,169,720,Monday
2020,9,28,900,423,124,547,Monday
2020,9,28,800,287,88,375,Monday
2020,9,28,700,180,42,222,Monday
2020,9,28,600,102,12,114,Monday
2020,9,28,500,71,25,96,Monday
2020,9,28,400,34,26,60,Monday
2020,9,28,300,29,30,59,Monday
2020,9,28,200,23,33,56,Monday
2020,9,28,100,35,82,117,Monday
2020,9,27,2400,45,99,144,Sunday
2020,9,27,2300,69,159,228,Sunday
2020,9,27,2200,77,264,341,Sunday
2020,9,27,2100,113,484,597,Sunday
2020,9,27,2000,193,875,1068,Sunday
2020,9,27,1900,260,1048,1308,Sunday
2020,9,27,1800,282,1315,1597,Sunday
2020,9,27,1700,408,1382,1790,Sunday
2020,9,27,1600,489,1292,1781,Sunday
2020,9,27,1500,666,1189,1855,Sunday
2020,9,27,1400,719,920,1639,Sunday
2020,9,27,1300,808,847,1655,Sunday
2020,9,27,1200,915,671,1586,Sunday
2020,9,27,1100,891,354,1245,Sunday
2020,9,27,1000,751,202,953,Sunday
2020,9,27,900,702,109,811,Sunday
2020,9,27,800,410,48,458,Sunday
2020,9,27,700,230,44,274,Sunday
2020,9,27,600,142,22,164,Sunday
2020,9,27,500,148,21,169,Sunday
2020,9,27,400,53,35,88,Sunday
2020,9,27,300,29,19,48,Sunday
2020,9,27,200,23,31,54,Sunday
2020,9,27,100,30,41,71,Sunday
2020,9,26,2400,38,78,116,Saturday
2020,9,26,2300,70,99,169,Saturday
2020,9,26,2200,83,192,275,Saturday
2020,9,26,2100,129,346,475,Saturday
2020,9,26,2000,160,487,647,Saturday
2020,9,26,1900,189,701,890,Saturday
2020,9,26,1800,278,882,1160,Saturday
2020,9,26,1700,354,1010,1364,Saturday
2020,9,26,1600,466,999,1465,Saturday
2020,9,26,1500,680,849,1529,Saturday
2020,9,26,1400,662,842,1504,Saturday
2020,9,26,1300,848,609,1457,Saturday
2020,9,26,1200,978,488,1466,Saturday
2020,9,26,1100,874,314,1188,Saturday
2020,9,26,1000,768,192,960,Saturday
2020,9,26,900,672,152,824,Saturday
2020,9,26,800,500,95,595,Saturday
2020,9,26,700,263,66,329,Saturday
2020,9,26,600,216,52,268,Saturday
2020,9,26,500,166,52,218,Saturday
2020,9,26,400,47,39,86,Saturday
2020,9,26,300,29,39,68,Saturday
2020,9,26,200,34,60,94,Saturday
2020,9,26,100,49,65,114,Saturday
2020,9,25,2400,58,94,152,Friday
2020,9,25,2300,121,128,249,Friday
2020,9,25,2200,147,179,326,Friday
2020,9,25,2100,243,294,537,Friday
2020,9,25,2000,436,447,883,Friday
2020,9,25,1900,538,604,1142,Friday
2020,9,25,1800,632,785,1417,Friday
2020,9,25,1700,705,796,1501,Friday
2020,9,25,1600,708,767,1475,Friday
2020,9,25,1500,797,656,1453,Friday
2020,9,25,1400,677,621,1298,Friday
2020,9,25,1300,690,477,1167,Friday
2020,9,25,1200,792,423,1215,Friday
2020,9,25,1100,790,303,1093,Friday
2020,9,25,1000,693,213,906,Friday
2020,9,25,900,460,135,595,Friday
2020,9,25,800,314,97,411,Friday
2020,9,25,700,181,50,231,Friday
2020,9,25,600,123,38,161,Friday
2020,9,25,500,67,34,101,Friday
2020,9,25,400,44,37,81,Friday
2020,9,25,300,26,53,79,Friday
2020,9,25,200,46,54,100,Friday
2020,9,25,100,49,80,129,Friday
2020,9,24,2400,51,94,145,Thursday
2020,9,24,2300,100,135,235,Thursday
2020,9,24,2200,146,210,356,Thursday
2020,9,24,2100,224,253,477,Thursday
2020,9,24,2000,305,426,731,Thursday
2020,9,24,1900,384,564,948,Thursday
2020,9,24,1800,367,668,1035,Thursday
2020,9,24,1700,375,696,1071,Thursday
2020,9,24,1600,483,679,1162,Thursday
2020,9,24,1500,514,567,1081,Thursday
2020,9,24,1400,563,539,1102,Thursday
2020,9,24,1300,575,404,979,Thursday
2020,9,24,1200,671,366,1037,Thursday
2020,9,24,1100,729,281,1010,Thursday
2020,9,24,1000,550,174,724,Thursday
2020,9,24,900,431,147,578,Thursday
2020,9,24,800,300,89,389,Thursday
2020,9,24,700,168,64,232,Thursday
2020,9,24,600,85,42,127,Thursday
2020,9,24,500,64,31,95,Thursday
2020,9,24,400,31,49,80,Thursday
2020,9,24,300,27,57,84,Thursday
2020,9,24,200,27,53,80,Thursday
2020,9,24,100,42,83,125,Thursday
2020,9,23,2400,68,75,143,Wednesday
2020,9,23,2300,94,131,225,Wednesday
2020,9,23,2200,107,191,298,Wednesday
2020,9,23,2100,145,292,437,Wednesday
2020,9,23,2000,196,421,617,Wednesday
2020,9,23,1900,206,540,746,Wednesday
2020,9,23,1800,274,714,988,Wednesday
2020,9,23,1700,346,787,1133,Wednesday
2020,9,23,1600,383,616,999,Wednesday
2020,9,23,1500,429,578,1007,Wednesday
2020,9,23,1400,475,463,938,Wednesday
2020,9,23,1300,535,499,1034,Wednesday
2020,9,23,1200,614,389,1003,Wednesday
2020,9,23,1100,698,254,952,Wednesday
2020,9,23,1000,517,201,718,Wednesday
2020,9,23,900,458,123,581,Wednesday
2020,9,23,800,303,87,390,Wednesday
2020,9,23,700,175,59,234,Wednesday
2020,9,23,600,117,56,173,Wednesday
2020,9,23,500,64,42,106,Wednesday
2020,9,23,400,27,54,81,Wednesday
2020,9,23,300,32,46,78,Wednesday
2020,9,23,200,29,55,84,Wednesday
2020,9,23,100,40,83,123,Wednesday
2020,9,22,2400,75,69,144,Tuesday
2020,9,22,2300,75,119,194,Tuesday
2020,9,22,2200,110,199,309,Tuesday
2020,9,22,2100,152,330,482,Tuesday
2020,9,22,2000,162,490,652,Tuesday
2020,9,22,1900,219,604,823,Tuesday
2020,9,22,1800,248,730,978,Tuesday
2020,9,22,1700,314,669,983,Tuesday
2020,9,22,1600,388,693,1081,Tuesday
2020,9,22,1500,453,601,1054,Tuesday
2020,9,22,1400,518,491,1009,Tuesday
2020,9,22,1300,553,414,967,Tuesday
2020,9,22,1200,623,325,948,Tuesday
2020,9,22,1100,630,273,903,Tuesday
2020,9,22,1000,567,189,756,Tuesday
2020,9,22,900,469,144,613,Tuesday
2020,9,22,800,290,101,391,Tuesday
2020,9,22,700,174,57,231,Tuesday
2020,9,22,600,125,48,173,Tuesday
2020,9,22,500,62,66,128,Tuesday
2020,9,22,400,33,54,87,Tuesday
2020,9,22,300,26,17,43,Tuesday
2020,9,22,200,37,49,86,Tuesday
2020,9,22,100,50,88,138,Tuesday
2020,9,21,2400,61,88,149,Monday
2020,9,21,2300,84,103,187,Monday
2020,9,21,2200,107,256,363,Monday
2020,9,21,2100,150,376,526,Monday
2020,9,21,2000,202,568,770,Monday
2020,9,21,1900,207,698,905,Monday
2020,9,21,1800,303,760,1063,Monday
2020,9,21,1700,327,818,1145,Monday
2020,9,21,1600,427,772,1199,Monday
2020,9,21,1500,501,685,1186,Monday
2020,9,21,1400,563,505,1068,Monday
2020,9,21,1300,607,442,1049,Monday
2020,9,21,1200,768,352,1120,Monday
2020,9,21,1100,814,266,1080,Monday
2020,9,21,1000,685,218,903,Monday
2020,9,21,900,457,123,580,Monday
2020,9,21,800,342,83,425,Monday
2020,9,21,700,177,52,229,Monday
2020,9,21,600,124,31,155,Monday
2020,9,21,500,72,24,96,Monday
2020,9,21,400,24,28,52,Monday
2020,9,21,300,23,27,50,Monday
2020,9,21,200,26,55,81,Monday
2020,9,21,100,33,82,115,Monday
2020,9,20,2400,45,100,145,Sunday
2020,9,20,2300,63,164,227,Sunday
2020,9,20,2200,100,297,397,Sunday
2020,9,20,2100,119,530,649,Sunday
2020,9,20,2000,189,762,951,Sunday
2020,9,20,1900,243,1068,1311,Sunday
2020,9,20,1800,287,1336,1623,Sunday
2020,9,20,1700,407,1360,1767,Sunday
2020,9,20,1600,478,1365,1843,Sunday
2020,9,20,1500,630,1165,1795,Sunday
2020,9,20,1400,703,1016,1719,Sunday
2020,9,20,1300,767,906,1673,Sunday
2020,9,20,1200,867,693,1560,Sunday
2020,9,20,1100,887,455,1342,Sunday
2020,9,20,1000,749,207,956,Sunday
2020,9,20,900,538,125,663,Sunday
2020,9,20,800,368,63,431,Sunday
2020,9,20,700,194,25,219,Sunday
2020,9,20,600,121,24,145,Sunday
2020,9,20,500,63,14,77,Sunday
2020,9,20,400,24,24,48,Sunday
2020,9,20,300,21,38,59,Sunday
2020,9,20,200,20,45,65,Sunday
2020,9,20,100,27,55,82,Sunday
2020,9,19,2400,45,73,118,Saturday
2020,9,19,2300,47,123,170,Saturday
2020,9,19,2200,92,219,311,Saturday
2020,9,19,2100,133,380,513,Saturday
2020,9,19,2000,188,609,797,Saturday
2020,9,19,1900,211,698,909,Saturday
2020,9,19,1800,279,975,1254,Saturday
2020,9,19,1700,336,890,1226,Saturday
2020,9,19,1600,485,888,1373,Saturday
2020,9,19,1500,610,683,1293,Saturday
2020,9,19,1400,669,603,1272,Saturday
2020,9,19,1300,784,557,1341,Saturday
2020,9,19,1200,961,461,1422,Saturday
2020,9,19,1100,880,314,1194,Saturday
2020,9,19,1000,757,242,999,Saturday
2020,9,19,900,550,160,710,Saturday
2020,9,19,800,386,74,460,Saturday
2020,9,19,700,229,53,282,Saturday
2020,9,19,600,158,43,201,Saturday
2020,9,19,500,78,39,117,Saturday
2020,9,19,400,46,40,86,Saturday
2020,9,19,300,25,39,64,Saturday
2020,9,19,200,23,41,64,Saturday
2020,9,19,100,46,92,138,Saturday
2020,9,18,2400,79,92,171,Friday
2020,9,18,2300,124,145,269,Friday
2020,9,18,2200,170,253,423,Friday
2020,9,18,2100,276,364,640,Friday
2020,9,18,2000,465,562,1027,Friday
2020,9,18,1900,565,677,1242,Friday
2020,9,18,1800,667,914,1581,Friday
2020,9,18,1700,731,874,1605,Friday
2020,9,18,1600,710,808,1518,Friday
2020,9,18,1500,771,683,1454,Friday
2020,9,18,1400,780,673,1453,Friday
2020,9,18,1300,817,545,1362,Friday
2020,9,18,1200,946,488,1434,Friday
2020,9,18,1100,899,351,1250,Friday
2020,9,18,1000,868,235,1103,Friday
2020,9,18,900,588,165,753,Friday
2020,9,18,800,430,102,532,Friday
2020,9,18,700,237,60,297,Friday
2020,9,18,600,133,51,184,Friday
2020,9,18,500,88,40,128,Friday
2020,9,18,400,47,41,88,Friday
2020,9,18,300,27,63,90,Friday
2020,9,18,200,28,53,81,Friday
2020,9,18,100,41,72,113,Friday
2020,9,17,2400,79,103,182,Thursday
2020,9,17,2300,106,129,235,Thursday
2020,9,17,2200,146,225,371,Thursday
2020,9,17,2100,208,359,567,Thursday
2020,9,17,2000,377,491,868,Thursday
2020,9,17,1900,367,701,1068,Thursday
2020,9,17,1800,427,732,1159,Thursday
2020,9,17,1700,464,760,1224,Thursday
2020,9,17,1600,578,714,1292,Thursday
2020,9,17,1500,532,623,1155,Thursday
2020,9,17,1400,630,510,1140,Thursday
2020,9,17,1300,688,459,1147,Thursday
2020,9,17,1200,808,338,1146,Thursday
2020,9,17,1100,885,297,1182,Thursday
2020,9,17,1000,672,216,888,Thursday
2020,9,17,900,565,136,701,Thursday
2020,9,17,800,338,86,424,Thursday
2020,9,17,700,216,53,269,Thursday
2020,9,17,600,126,47,173,Thursday
2020,9,17,500,36,45,81,Thursday
2020,9,17,400,38,43,81,Thursday
2020,9,17,300,36,38,74,Thursday
2020,9,17,200,23,58,81,Thursday
2020,9,17,100,56,71,127,Thursday
2020,9,16,2400,87,91,178,Wednesday
2020,9,16,2300,101,241,342,Wednesday
2020,9,16,2200,115,130,245,Wednesday
2020,9,16,2100,148,332,480,Wednesday
2020,9,16,2000,216,511,727,Wednesday
2020,9,16,1900,299,612,911,Wednesday
2020,9,16,1800,328,709,1037,Wednesday
2020,9,16,1700,395,709,1104,Wednesday
2020,9,16,1600,396,606,1002,Wednesday
2020,9,16,1500,458,553,1011,Wednesday
2020,9,16,1400,519,483,1002,Wednesday
2020,9,16,1300,626,406,1032,Wednesday
2020,9,16,1200,699,342,1041,Wednesday
2020,9,16,1100,728,246,974,Wednesday
2020,9,16,1000,587,182,769,Wednesday
2020,9,16,900,497,135,632,Wednesday
2020,9,16,800,312,87,399,Wednesday
2020,9,16,700,155,60,215,Wednesday
2020,9,16,600,94,52,146,Wednesday
2020,9,16,500,39,36,75,Wednesday
2020,9,16,400,34,40,74,Wednesday
2020,9,16,300,26,45,71,Wednesday
2020,9,16,200,28,57,85,Wednesday
2020,9,16,100,49,80,129,Wednesday
2020,9,15,2400,55,107,162,Tuesday
2020,9,15,2300,87,93,180,Tuesday
2020,9,15,2200,99,210,309,Tuesday
2020,9,15,2100,144,294,438,Tuesday
2020,9,15,2000,164,401,565,Tuesday
2020,9,15,1900,241,561,802,Tuesday
2020,9,15,1800,287,614,901,Tuesday
2020,9,15,1700,309,644,953,Tuesday
2020,9,15,1600,345,658,1003,Tuesday
2020,9,15,1500,386,567,953,Tuesday
2020,9,15,1400,481,491,972,Tuesday
2020,9,15,1300,555,453,1008,Tuesday
2020,9,15,1200,680,367,1047,Tuesday
2020,9,15,1100,635,258,893,Tuesday
2020,9,15,1000,533,185,718,Tuesday
2020,9,15,900,356,129,485,Tuesday
2020,9,15,800,231,95,326,Tuesday
2020,9,15,700,159,51,210,Tuesday
2020,9,15,600,81,41,122,Tuesday
2020,9,15,500,43,42,85,Tuesday
2020,9,15,400,31,55,86,Tuesday
2020,9,15,300,30,56,86,Tuesday
2020,9,15,200,23,53,76,Tuesday
2020,9,15,100,36,58,94,Tuesday
2020,9,14,2400,67,81,148,Monday
2020,9,14,2300,76,136,212,Monday
2020,9,14,2200,114,241,355,Monday
2020,9,14,2100,129,354,483,Monday
2020,9,14,2000,183,553,736,Monday
2020,9,14,1900,228,687,915,Monday
2020,9,14,1800,304,744,1048,Monday
2020,9,14,1700,357,904,1261,Monday
2020,9,14,1600,424,766,1190,Monday
2020,9,14,1500,524,745,1269,Monday
2020,9,14,1400,545,622,1167,Monday
2020,9,14,1300,633,580,1213,Monday
2020,9,14,1200,766,500,1266,Monday
2020,9,14,1100,791,317,1108,Monday
2020,9,14,1000,589,227,816,Monday
2020,9,14,900,439,131,570,Monday
2020,9,14,800,293,87,380,Monday
2020,9,14,700,156,55,211,Monday
2020,9,14,600,87,22,109,Monday
2020,9,14,500,43,15,58,Monday
2020,9,14,400,16,43,59,Monday
2020,9,14,300,18,34,52,Monday
2020,9,14,200,21,50,71,Monday
2020,9,14,100,20,88,108,Monday
2020,9,13,2400,35,103,138,Sunday
2020,9,13,2300,58,174,232,Sunday
2020,9,13,2200,84,338,422,Sunday
2020,9,13,2100,132,541,673,Sunday
2020,9,13,2000,175,953,1128,Sunday
2020,9,13,1900,239,1210,1449,Sunday
2020,9,13,1800,293,1527,1820,Sunday
2020,9,13,1700,359,1617,1976,Sunday
2020,9,13,1600,529,1447,1976,Sunday
2020,9,13,1500,616,1294,1910,Sunday
2020,9,13,1400,667,1175,1842,Sunday
2020,9,13,1300,818,1035,1853,Sunday
2020,9,13,1200,957,744,1701,Sunday
2020,9,13,1100,955,459,1414,Sunday
2020,9,13,1000,791,254,1045,Sunday
2020,9,13,900,656,144,800,Sunday
2020,9,13,800,424,56,480,Sunday
2020,9,13,700,221,38,259,Sunday
2020,9,13,600,127,19,146,Sunday
2020,9,13,500,76,22,98,Sunday
2020,9,13,400,30,18,48,Sunday
2020,9,13,300,17,31,48,Sunday
2020,9,13,200,29,47,76,Sunday
2020,9,13,100,30,83,113,Sunday
2020,9,12,2400,50,92,142,Saturday
2020,9,12,2300,76,179,255,Saturday
2020,9,12,2200,119,356,475,Saturday
2020,9,12,2100,141,574,715,Saturday
2020,9,12,2000,187,758,945,Saturday
2020,9,12,1900,240,1148,1388,Saturday
2020,9,12,1800,314,1090,1404,Saturday
2020,9,12,1700,472,1094,1566,Saturday
2020,9,12,1600,600,1027,1627,Saturday
2020,9,12,1500,716,863,1579,Saturday
2020,9,12,1400,815,671,1486,Saturday
2020,9,12,1300,896,637,1533,Saturday
2020,9,12,1200,1141,519,1660,Saturday
2020,9,12,1100,1071,344,1415,Saturday
2020,9,12,1000,994,258,1252,Saturday
2020,9,12,900,816,156,972,Saturday
2020,9,12,800,592,75,667,Saturday
2020,9,12,700,308,64,372,Saturday
2020,9,12,600,163,36,199,Saturday
2020,9,12,500,107,31,138,Saturday
2020,9,12,400,34,47,81,Saturday
2020,9,12,300,25,44,69,Saturday
2020,9,12,200,23,60,83,Saturday
2020,9,12,100,49,101,150,Saturday
2020,9,11,2400,78,161,239,Friday
2020,9,11,2300,139,162,301,Friday
2020,9,11,2200,241,288,529,Friday
2020,9,11,2100,350,483,833,Friday
2020,9,11,2000,567,633,1200,Friday
2020,9,11,1900,684,856,1540,Friday
2020,9,11,1800,779,1016,1795,Friday
2020,9,11,1700,896,871,1767,Friday
2020,9,11,1600,806,769,1575,Friday
2020,9,11,1500,795,660,1455,Friday
2020,9,11,1400,786,560,1346,Friday
2020,9,11,1300,897,568,1465,Friday
2020,9,11,1200,1011,447,1458,Friday
2020,9,11,1100,922,354,1276,Friday
2020,9,11,1000,783,230,1013,Friday
2020,9,11,900,541,159,700,Friday
2020,9,11,800,480,95,575,Friday
2020,9,11,700,251,62,313,Friday
2020,9,11,600,145,41,186,Friday
2020,9,11,500,75,53,128,Friday
2020,9,11,400,50,46,96,Friday
2020,9,11,300,31,54,85,Friday
2020,9,11,200,44,71,115,Friday
2020,9,11,100,57,85,142,Friday
2020,9,10,2400,86,144,230,Thursday
2020,9,10,2300,131,161,292,Thursday
2020,9,10,2200,154,285,439,Thursday
2020,9,10,2100,228,414,642,Thursday
2020,9,10,2000,377,590,967,Thursday
2020,9,10,1900,434,744,1178,Thursday
2020,9,10,1800,459,838,1297,Thursday
2020,9,10,1700,532,826,1358,Thursday
2020,9,10,1600,552,710,1262,Thursday
2020,9,10,1500,585,620,1205,Thursday
2020,9,10,1400,760,545,1305,Thursday
2020,9,10,1300,791,513,1304,Thursday
2020,9,10,1200,799,439,1238,Thursday
2020,9,10,1100,888,292,1180,Thursday
2020,9,10,1000,714,195,909,Thursday
2020,9,10,900,566,170,736,Thursday
2020,9,10,800,361,97,458,Thursday
2020,9,10,700,210,53,263,Thursday
2020,9,10,600,131,47,178,Thursday
2020,9,10,500,65,46,111,Thursday
2020,9,10,400,36,48,84,Thursday
2020,9,10,300,22,48,70,Thursday
2020,9,10,200,42,64,106,Thursday
2020,9,10,100,49,75,124,Thursday
2020,9,9,2400,74,111,185,Wednesday
2020,9,9,2300,99,178,277,Wednesday
2020,9,9,2200,135,302,437,Wednesday
2020,9,9,2100,180,445,625,Wednesday
2020,9,9,2000,218,652,870,Wednesday
2020,9,9,1900,296,727,1023,Wednesday
2020,9,9,1800,362,829,1191,Wednesday
2020,9,9,1700,418,779,1197,Wednesday
2020,9,9,1600,474,739,1213,Wednesday
2020,9,9,1500,572,602,1174,Wednesday
2020,9,9,1400,645,550,1195,Wednesday
2020,9,9,1300,699,497,1196,Wednesday
2020,9,9,1200,868,409,1277,Wednesday
2020,9,9,1100,907,291,1198,Wednesday
2020,9,9,1000,671,204,875,Wednesday
2020,9,9,900,503,161,664,Wednesday
2020,9,9,800,360,95,455,Wednesday
2020,9,9,700,198,67,265,Wednesday
2020,9,9,600,126,36,162,Wednesday
2020,9,9,500,60,49,109,Wednesday
2020,9,9,400,29,45,74,Wednesday
2020,9,9,300,30,41,71,Wednesday
2020,9,9,200,28,63,91,Wednesday
2020,9,9,100,62,89,151,Wednesday
2020,9,8,2400,63,147,210,Tuesday
2020,9,8,2300,83,167,250,Tuesday
2020,9,8,2200,140,358,498,Tuesday
2020,9,8,2100,160,493,653,Tuesday
2020,9,8,2000,230,708,938,Tuesday
2020,9,8,1900,247,924,1171,Tuesday
2020,9,8,1800,328,1026,1354,Tuesday
2020,9,8,1700,458,904,1362,Tuesday
2020,9,8,1600,446,848,1294,Tuesday
2020,9,8,1500,606,817,1423,Tuesday
2020,9,8,1400,623,677,1300,Tuesday
2020,9,8,1300,836,614,1450,Tuesday
2020,9,8,1200,924,448,1372,Tuesday
2020,9,8,1100,957,362,1319,Tuesday
2020,9,8,1000,730,253,983,Tuesday
2020,9,8,900,552,191,743,Tuesday
2020,9,8,800,371,104,475,Tuesday
2020,9,8,700,204,79,283,Tuesday
2020,9,8,600,120,29,149,Tuesday
2020,9,8,500,61,43,104,Tuesday
2020,9,8,400,22,48,70,Tuesday
2020,9,8,300,36,40,76,Tuesday
2020,9,8,200,22,82,104,Tuesday
2020,9,8,100,23,117,140,Tuesday
2020,9,7,2400,43,222,265,Monday
2020,9,7,2300,79,382,461,Monday
2020,9,7,2200,105,791,896,Monday
2020,9,7,2100,127,1194,1321,Monday
2020,9,7,2000,186,1628,1814,Monday
2020,9,7,1900,282,1608,1890,Monday
2020,9,7,1800,317,1862,2179,Monday
2020,9,7,1700,429,1954,2383,Monday
2020,9,7,1600,560,2057,2617,Monday
2020,9,7,1500,708,2082,2790,Monday
2020,9,7,1400,858,1785,2643,Monday
2020,9,7,1300,978,1574,2552,Monday
2020,9,7,1200,1070,1269,2339,Monday
2020,9,7,1100,953,788,1741,Monday
2020,9,7,1000,770,394,1164,Monday
2020,9,7,900,548,186,734,Monday
2020,9,7,800,349,69,418,Monday
2020,9,7,700,180,47,227,Monday
2020,9,7,600,102,19,121,Monday
2020,9,7,500,51,25,76,Monday
2020,9,7,400,26,46,72,Monday
2020,9,7,300,18,47,65,Monday
2020,9,7,200,25,71,96,Monday
2020,9,7,100,31,99,130,Monday
2020,9,6,2400,43,158,201,Sunday
2020,9,6,2300,67,220,287,Sunday
2020,9,6,2200,110,512,622,Sunday
2020,9,6,2100,153,828,981,Sunday
2020,9,6,2000,211,1141,1352,Sunday
2020,9,6,1900,261,1354,1615,Sunday
2020,9,6,1800,386,1483,1869,Sunday
2020,9,6,1700,502,1444,1946,Sunday
2020,9,6,1600,663,1404,2067,Sunday
2020,9,6,1500,784,1149,1933,Sunday
2020,9,6,1400,876,962,1838,Sunday
2020,9,6,1300,1038,867,1905,Sunday
2020,9,6,1200,1119,604,1723,Sunday
2020,9,6,1100,1124,430,1554,Sunday
2020,9,6,1000,1007,248,1255,Sunday
2020,9,6,900,744,156,900,Sunday
2020,9,6,800,492,68,560,Sunday
2020,9,6,700,308,35,343,Sunday
2020,9,6,600,172,29,201,Sunday
2020,9,6,500,93,16,109,Sunday
2020,9,6,400,39,25,64,Sunday
2020,9,6,300,28,48,76,Sunday
2020,9,6,200,31,60,91,Sunday
2020,9,6,100,38,81,119,Sunday
2020,9,5,2400,63,150,213,Saturday
2020,9,5,2300,91,196,287,Saturday
2020,9,5,2200,138,622,760,Saturday
2020,9,5,2100,207,962,1169,Saturday
2020,9,5,2000,294,1176,1470,Saturday
2020,9,5,1900,377,1424,1801,Saturday
2020,9,5,1800,538,1388,1926,Saturday
2020,9,5,1700,739,1370,2109,Saturday
2020,9,5,1600,1098,1246,2344,Saturday
2020,9,5,1500,1220,1154,2374,Saturday
2020,9,5,1400,1235,816,2051,Saturday
2020,9,5,1300,1423,646,2069,Saturday
2020,9,5,1200,1618,591,2209,Saturday
2020,9,5,1100,1730,431,2161,Saturday
2020,9,5,1000,1646,307,1953,Saturday
2020,9,5,900,1421,196,1617,Saturday
2020,9,5,800,1014,117,1131,Saturday
2020,9,5,700,575,74,649,Saturday
2020,9,5,600,339,57,396,Saturday
2020,9,5,500,154,42,196,Saturday
2020,9,5,400,77,60,137,Saturday
2020,9,5,300,53,46,99,Saturday
2020,9,5,200,46,79,125,Saturday
2020,9,5,100,58,125,183,Saturday
2020,9,4,2400,136,146,282,Friday
2020,9,4,2300,217,248,465,Friday
2020,9,4,2200,428,427,855,Friday
2020,9,4,2100,667,599,1266,Friday
2020,9,4,2000,1025,723,1748,Friday
2020,9,4,1900,1367,954,2321,Friday
2020,9,4,1800,1445,938,2383,Friday
2020,9,4,1700,1441,933,2374,Friday
2020,9,4,1600,1467,886,2353,Friday
2020,9,4,1500,1410,842,2252,Friday
2020,9,4,1400,1261,674,1935,Friday
2020,9,4,1300,1267,645,1912,Friday
2020,9,4,1200,1458,494,1952,Friday
2020,9,4,1100,1414,377,1791,Friday
2020,9,4,1000,1241,250,1491,Friday
2020,9,4,900,1067,183,1250,Friday
2020,9,4,800,719,115,834,Friday
2020,9,4,700,389,77,466,Friday
2020,9,4,600,241,35,276,Friday
2020,9,4,500,125,48,173,Friday
2020,9,4,400,70,58,128,Friday
2020,9,4,300,46,70,116,Friday
2020,9,4,200,42,72,114,Friday
2020,9,4,100,77,113,190,Friday
2020,9,3,2400,94,134,228,Thursday
2020,9,3,2300,177,167,344,Thursday
2020,9,3,2200,293,312,605,Thursday
2020,9,3,2100,456,408,864,Thursday
2020,9,3,2000,716,567,1283,Thursday
2020,9,3,1900,791,759,1550,Thursday
2020,9,3,1800,805,828,1633,Thursday
2020,9,3,1700,870,869,1739,Thursday
2020,9,3,1600,796,829,1625,Thursday
2020,9,3,1500,853,717,1570,Thursday
2020,9,3,1400,889,546,1435,Thursday
2020,9,3,1300,918,531,1449,Thursday
2020,9,3,1200,1061,421,1482,Thursday
2020,9,3,1100,1033,323,1356,Thursday
2020,9,3,1000,785,243,1028,Thursday
2020,9,3,900,654,157,811,Thursday
2020,9,3,800,469,102,571,Thursday
2020,9,3,700,270,60,330,Thursday
2020,9,3,600,148,52,200,Thursday
2020,9,3,500,72,36,108,Thursday
2020,9,3,400,47,59,106,Thursday
2020,9,3,300,28,48,76,Thursday
2020,9,3,200,40,60,100,Thursday
2020,9,3,100,52,74,126,Thursday
2020,9,2,2400,74,128,202,Wednesday
2020,9,2,2300,115,181,296,Wednesday
2020,9,2,2200,152,309,461,Wednesday
2020,9,2,2100,220,407,627,Wednesday
2020,9,2,2000,329,557,886,Wednesday
2020,9,2,1900,397,684,1081,Wednesday
2020,9,2,1800,436,829,1265,Wednesday
2020,9,2,1700,494,763,1257,Wednesday
2020,9,2,1600,540,709,1249,Wednesday
2020,9,2,1500,614,630,1244,Wednesday
2020,9,2,1400,696,547,1243,Wednesday
2020,9,2,1300,751,451,1202,Wednesday
2020,9,2,1200,950,392,1342,Wednesday
2020,9,2,1100,835,280,1115,Wednesday
2020,9,2,1000,655,258,913,Wednesday
2020,9,2,900,561,178,739,Wednesday
2020,9,2,800,361,106,467,Wednesday
2020,9,2,700,201,70,271,Wednesday
2020,9,2,600,103,59,162,Wednesday
2020,9,2,500,51,37,88,Wednesday
2020,9,2,400,40,38,78,Wednesday
2020,9,2,300,34,49,83,Wednesday
2020,9,2,200,37,68,105,Wednesday
2020,9,2,100,45,79,124,Wednesday
2020,9,1,2400,79,146,225,Tuesday
2020,9,1,2300,98,107,205,Tuesday
2020,9,1,2200,112,294,406,Tuesday
2020,9,1,2100,181,424,605,Tuesday
2020,9,1,2000,226,616,842,Tuesday
2020,9,1,1900,297,800,1097,Tuesday
2020,9,1,1800,352,757,1109,Tuesday
2020,9,1,1700,439,869,1308,Tuesday
2020,9,1,1600,472,785,1257,Tuesday
2020,9,1,1500,587,713,1300,Tuesday
2020,9,1,1400,622,592,1214,Tuesday
2020,9,1,1300,759,529,1288,Tuesday
2020,9,1,1200,931,412,1343,Tuesday
2020,9,1,1100,858,325,1183,Tuesday
2020,9,1,1000,776,215,991,Tuesday
2020,9,1,900,511,181,692,Tuesday
2020,9,1,800,410,115,525,Tuesday
2020,9,1,700,215,71,286,Tuesday
2020,9,1,600,125,51,176,Tuesday
2020,9,1,500,50,40,90,Tuesday
2020,9,1,400,35,56,91,Tuesday
2020,9,1,300,31,54,85,Tuesday
2020,9,1,200,36,69,105,Tuesday
2020,9,1,100,57,102,159,Tuesday
2020,8,31,2400,77,142,219,Monday
2020,8,31,2300,86,194,280,Monday
2020,8,31,2200,129,340,469,Monday
2020,8,31,2100,192,602,794,Monday
2020,8,31,2000,263,822,1085,Monday
2020,8,31,1900,340,973,1313,Monday
2020,8,31,1800,366,1088,1454,Monday
2020,8,31,1700,436,1208,1644,Monday
2020,8,31,1600,520,1062,1582,Monday
2020,8,31,1500,640,923,1563,Monday
2020,8,31,1400,773,868,1641,Monday
2020,8,31,1300,845,764,1609,Monday
2020,8,31,1200,924,553,1477,Monday
2020,8,31,1100,930,368,1298,Monday
2020,8,31,1000,777,244,1021,Monday
2020,8,31,900,640,193,833,Monday
2020,8,31,800,400,123,523,Monday
2020,8,31,700,194,69,263,Monday
2020,8,31,600,123,27,150,Monday
2020,8,31,500,76,25,101,Monday
2020,8,31,400,27,37,64,Monday
2020,8,31,300,29,28,57,Monday
2020,8,31,200,25,62,87,Monday
2020,8,31,100,24,100,124,Monday
2020,8,30,2400,53,210,263,Sunday
2020,8,30,2300,87,337,424,Sunday
2020,8,30,2200,126,635,761,Sunday
2020,8,30,2100,169,1113,1282,Sunday
2020,8,30,2000,252,1441,1693,Sunday
2020,8,30,1900,315,1727,2042,Sunday
2020,8,30,1800,338,1830,2168,Sunday
2020,8,30,1700,482,1787,2269,Sunday
2020,8,30,1600,627,1774,2401,Sunday
2020,8,30,1500,728,1547,2275,Sunday
2020,8,30,1400,843,1415,2258,Sunday
2020,8,30,1300,1047,1225,2272,Sunday
2020,8,30,1200,1205,814,2019,Sunday
2020,8,30,1100,1077,535,1612,Sunday
2020,8,30,1000,941,274,1215,Sunday
2020,8,30,900,730,156,886,Sunday
2020,8,30,800,502,79,581,Sunday
2020,8,30,700,258,33,291,Sunday
2020,8,30,600,157,18,175,Sunday
2020,8,30,500,72,25,97,Sunday
2020,8,30,400,45,25,70,Sunday
2020,8,30,300,23,47,70,Sunday
2020,8,30,200,26,67,93,Sunday
2020,8,30,100,35,92,127,Sunday
2020,8,29,2400,52,155,207,Saturday
2020,8,29,2300,58,229,287,Saturday
2020,8,29,2200,99,474,573,Saturday
2020,8,29,2100,160,757,917,Saturday
2020,8,29,2000,226,1018,1244,Saturday
2020,8,29,1900,297,1255,1552,Saturday
2020,8,29,1800,360,1317,1677,Saturday
2020,8,29,1700,450,1352,1802,Saturday
2020,8,29,1600,619,1318,1937,Saturday
2020,8,29,1500,784,1162,1946,Saturday
2020,8,29,1400,949,1185,2134,Saturday
2020,8,29,1300,1103,902,2005,Saturday
2020,8,29,1200,1202,615,1817,Saturday
2020,8,29,1100,1268,430,1698,Saturday
2020,8,29,1000,1172,316,1488,Saturday
2020,8,29,900,882,201,1083,Saturday
2020,8,29,800,671,95,766,Saturday
2020,8,29,700,371,61,432,Saturday
2020,8,29,600,190,32,222,Saturday
2020,8,29,500,92,40,132,Saturday
2020,8,29,400,46,44,90,Saturday
2020,8,29,300,35,52,87,Saturday
2020,8,29,200,34,69,103,Saturday
2020,8,29,100,69,89,158,Saturday
2020,8,28,2400,96,207,303,Friday
2020,8,28,2300,142,230,372,Friday
2020,8,28,2200,228,480,708,Friday
2020,8,28,2100,391,667,1058,Friday
2020,8,28,2000,666,953,1619,Friday
2020,8,28,1900,823,1111,1934,Friday
2020,8,28,1800,798,1258,2056,Friday
2020,8,28,1700,922,1213,2135,Friday
2020,8,28,1600,986,1074,2060,Friday
2020,8,28,1500,1024,992,2016,Friday
2020,8,28,1400,1200,783,1983,Friday
2020,8,28,1300,1069,768,1837,Friday
2020,8,28,1200,1249,610,1859,Friday
2020,8,28,1100,1254,415,1669,Friday
2020,8,28,1000,1069,273,1342,Friday
2020,8,28,900,769,180,949,Friday
2020,8,28,800,597,139,736,Friday
2020,8,28,700,315,79,394,Friday
2020,8,28,600,212,45,257,Friday
2020,8,28,500,139,50,189,Friday
2020,8,28,400,65,64,129,Friday
2020,8,28,300,40,68,108,Friday
2020,8,28,200,55,101,156,Friday
2020,8,28,100,68,128,196,Friday
2020,8,27,2400,110,158,268,Thursday
2020,8,27,2300,140,241,381,Thursday
2020,8,27,2200,189,469,658,Thursday
2020,8,27,2100,339,678,1017,Thursday
2020,8,27,2000,482,777,1259,Thursday
2020,8,27,1900,609,991,1600,Thursday
2020,8,27,1800,602,1101,1703,Thursday
2020,8,27,1700,667,1046,1713,Thursday
2020,8,27,1600,762,1005,1767,Thursday
2020,8,27,1500,834,839,1673,Thursday
2020,8,27,1400,932,809,1741,Thursday
2020,8,27,1300,971,708,1679,Thursday
2020,8,27,1200,1099,522,1621,Thursday
2020,8,27,1100,1135,372,1507,Thursday
2020,8,27,1000,958,237,1195,Thursday
2020,8,27,900,771,182,953,Thursday
2020,8,27,800,493,122,615,Thursday
2020,8,27,700,292,75,367,Thursday
2020,8,27,600,186,50,236,Thursday
2020,8,27,500,99,44,143,Thursday
2020,8,27,400,46,70,116,Thursday
2020,8,27,300,33,49,82,Thursday
2020,8,27,200,35,82,117,Thursday
2020,8,27,100,70,104,174,Thursday
2020,8,26,2400,80,367,447,Wednesday
2020,8,26,2300,137,179,316,Wednesday
2020,8,26,2200,165,551,716,Wednesday
2020,8,26,2100,229,638,867,Wednesday
2020,8,26,2000,324,786,1110,Wednesday
2020,8,26,1900,404,1020,1424,Wednesday
2020,8,26,1800,499,1056,1555,Wednesday
2020,8,26,1700,553,992,1545,Wednesday
2020,8,26,1600,646,959,1605,Wednesday
2020,8,26,1500,683,778,1461,Wednesday
2020,8,26,1400,805,718,1523,Wednesday
2020,8,26,1300,1051,688,1739,Wednesday
2020,8,26,1200,1088,526,1614,Wednesday
2020,8,26,1100,1055,360,1415,Wednesday
2020,8,26,1000,916,265,1181,Wednesday
2020,8,26,900,719,196,915,Wednesday
2020,8,26,800,489,112,601,Wednesday
2020,8,26,700,285,71,356,Wednesday
2020,8,26,600,173,59,232,Wednesday
2020,8,26,500,116,50,166,Wednesday
2020,8,26,400,43,58,101,Wednesday
2020,8,26,300,20,61,81,Wednesday
2020,8,26,200,37,84,121,Wednesday
2020,8,26,100,51,117,168,Wednesday
2020,8,25,2400,78,162,240,Tuesday
2020,8,25,2300,123,240,363,Tuesday
2020,8,25,2200,161,436,597,Tuesday
2020,8,25,2100,201,653,854,Tuesday
2020,8,25,2000,285,806,1091,Tuesday
2020,8,25,1900,338,1031,1369,Tuesday
2020,8,25,1800,392,1192,1584,Tuesday
2020,8,25,1700,512,981,1493,Tuesday
2020,8,25,1600,575,957,1532,Tuesday
2020,8,25,1500,661,891,1552,Tuesday
2020,8,25,1400,845,750,1595,Tuesday
2020,8,25,1300,911,635,1546,Tuesday
2020,8,25,1200,1029,490,1519,Tuesday
2020,8,25,1100,1026,375,1401,Tuesday
2020,8,25,1000,864,252,1116,Tuesday
2020,8,25,900,701,197,898,Tuesday
2020,8,25,800,462,117,579,Tuesday
2020,8,25,700,256,65,321,Tuesday
2020,8,25,600,161,47,208,Tuesday
2020,8,25,500,75,49,124,Tuesday
2020,8,25,400,33,64,97,Tuesday
2020,8,25,300,24,81,105,Tuesday
2020,8,25,200,33,75,108,Tuesday
2020,8,25,100,57,120,177,Tuesday
2020,8,24,2400,69,156,225,Monday
2020,8,24,2300,106,262,368,Monday
2020,8,24,2200,144,414,558,Monday
2020,8,24,2100,207,620,827,Monday
2020,8,24,2000,286,856,1142,Monday
2020,8,24,1900,349,1228,1577,Monday
2020,8,24,1800,454,1552,2006,Monday
2020,8,24,1700,523,1526,2049,Monday
2020,8,24,1600,709,1350,2059,Monday
2020,8,24,1500,762,1106,1868,Monday
2020,8,24,1400,957,916,1873,Monday
2020,8,24,1300,1097,845,1942,Monday
2020,8,24,1200,1223,609,1832,Monday
2020,8,24,1100,1196,420,1616,Monday
2020,8,24,1000,973,305,1278,Monday
2020,8,24,900,731,210,941,Monday
2020,8,24,800,509,130,639,Monday
2020,8,24,700,294,76,370,Monday
2020,8,24,600,191,28,219,Monday
2020,8,24,500,95,23,118,Monday
2020,8,24,400,31,41,72,Monday
2020,8,24,300,21,44,65,Monday
2020,8,24,200,31,65,96,Monday
2020,8,24,100,37,125,162,Monday
2020,8,23,2400,46,160,206,Sunday
2020,8,23,2300,113,392,505,Sunday
2020,8,23,2200,98,723,821,Sunday
2020,8,23,2100,194,1145,1339,Sunday
2020,8,23,2000,256,1695,1951,Sunday
2020,8,23,1900,324,1925,2249,Sunday
2020,8,23,1800,438,1918,2356,Sunday
2020,8,23,1700,593,1903,2496,Sunday
2020,8,23,1600,710,1733,2443,Sunday
2020,8,23,1500,864,1687,2551,Sunday
2020,8,23,1400,1089,1488,2577,Sunday
2020,8,23,1300,1214,1338,2552,Sunday
2020,8,23,1200,1389,866,2255,Sunday
2020,8,23,1100,1272,558,1830,Sunday
2020,8,23,1000,1145,306,1451,Sunday
2020,8,23,900,890,187,1077,Sunday
2020,8,23,800,578,73,651,Sunday
2020,8,23,700,339,32,371,Sunday
2020,8,23,600,165,27,192,Sunday
2020,8,23,500,98,23,121,Sunday
2020,8,23,400,39,38,77,Sunday
2020,8,23,300,22,42,64,Sunday
2020,8,23,200,36,63,99,Sunday
2020,8,23,100,39,99,138,Sunday
2020,8,22,2400,45,179,224,Saturday
2020,8,22,2300,77,293,370,Saturday
2020,8,22,2200,145,634,779,Saturday
2020,8,22,2100,206,813,1019,Saturday
2020,8,22,2000,276,1118,1394,Saturday
2020,8,22,1900,389,1482,1871,Saturday
2020,8,22,1800,490,1706,2196,Saturday
2020,8,22,1700,646,1291,1937,Saturday
2020,8,22,1600,804,1335,2139,Saturday
2020,8,22,1500,1031,1179,2210,Saturday
2020,8,22,1400,1134,979,2113,Saturday
2020,8,22,1300,1255,986,2241,Saturday
2020,8,22,1200,1478,687,2165,Saturday
2020,8,22,1100,1611,436,2047,Saturday
2020,8,22,1000,1295,268,1563,Saturday
2020,8,22,900,1074,184,1258,Saturday
2020,8,22,800,725,92,817,Saturday
2020,8,22,700,359,62,421,Saturday
2020,8,22,600,204,49,253,Saturday
2020,8,22,500,107,36,143,Saturday
2020,8,22,400,49,52,101,Saturday
2020,8,22,300,32,61,93,Saturday
2020,8,22,200,43,77,120,Saturday
2020,8,22,100,64,123,187,Saturday
2020,8,21,2400,105,149,254,Friday
2020,8,21,2300,187,292,479,Friday
2020,8,21,2200,256,441,697,Friday
2020,8,21,2100,414,681,1095,Friday
2020,8,21,2000,709,977,1686,Friday
2020,8,21,1900,849,989,1838,Friday
2020,8,21,1800,923,1279,2202,Friday
2020,8,21,1700,1007,1288,2295,Friday
2020,8,21,1600,1085,1196,2281,Friday
2020,8,21,1500,1203,1074,2277,Friday
2020,8,21,1400,1165,947,2112,Friday
2020,8,21,1300,1306,794,2100,Friday
2020,8,21,1200,1414,579,1993,Friday
2020,8,21,1100,1361,446,1807,Friday
2020,8,21,1000,1167,270,1437,Friday
2020,8,21,900,930,198,1128,Friday
2020,8,21,800,683,127,810,Friday
2020,8,21,700,333,76,409,Friday
2020,8,21,600,235,58,293,Friday
2020,8,21,500,135,54,189,Friday
2020,8,21,400,47,51,98,Friday
2020,8,21,300,48,58,106,Friday
2020,8,21,200,40,58,98,Friday
2020,8,21,100,54,140,194,Friday
2020,8,20,2400,89,157,246,Thursday
2020,8,20,2300,137,282,419,Thursday
2020,8,20,2200,228,420,648,Thursday
2020,8,20,2100,343,595,938,Thursday
2020,8,20,2000,510,756,1266,Thursday
2020,8,20,1900,568,1033,1601,Thursday
2020,8,20,1800,673,1205,1878,Thursday
2020,8,20,1700,669,1251,1920,Thursday
2020,8,20,1600,755,1122,1877,Thursday
2020,8,20,1500,929,895,1824,Thursday
2020,8,20,1400,890,755,1645,Thursday
2020,8,20,1300,1066,751,1817,Thursday
2020,8,20,1200,1233,609,1842,Thursday
2020,8,20,1100,1125,387,1512,Thursday
2020,8,20,1000,979,254,1233,Thursday
2020,8,20,900,801,187,988,Thursday
2020,8,20,800,517,105,622,Thursday
2020,8,20,700,298,58,356,Thursday
2020,8,20,600,183,47,230,Thursday
2020,8,20,500,88,37,125,Thursday
2020,8,20,400,53,64,117,Thursday
2020,8,20,300,37,54,91,Thursday
2020,8,20,200,33,74,107,Thursday
2020,8,20,100,58,108,166,Thursday
2020,8,19,2400,75,143,218,Wednesday
2020,8,19,2300,149,269,418,Wednesday
2020,8,19,2200,162,470,632,Wednesday
2020,8,19,2100,248,654,902,Wednesday
2020,8,19,2000,333,824,1157,Wednesday
2020,8,19,1900,422,1009,1431,Wednesday
2020,8,19,1800,481,1073,1554,Wednesday
2020,8,19,1700,606,1095,1701,Wednesday
2020,8,19,1600,729,1077,1806,Wednesday
2020,8,19,1500,750,872,1622,Wednesday
2020,8,19,1400,824,759,1583,Wednesday
2020,8,19,1300,993,700,1693,Wednesday
2020,8,19,1200,1111,525,1636,Wednesday
2020,8,19,1100,1100,421,1521,Wednesday
2020,8,19,1000,879,272,1151,Wednesday
2020,8,19,900,774,177,951,Wednesday
2020,8,19,800,524,120,644,Wednesday
2020,8,19,700,294,84,378,Wednesday
2020,8,19,600,195,40,235,Wednesday
2020,8,19,500,93,54,147,Wednesday
2020,8,19,400,44,51,95,Wednesday
2020,8,19,300,33,67,100,Wednesday
2020,8,19,200,43,76,119,Wednesday
2020,8,19,100,54,107,161,Wednesday
2020,8,18,2400,81,157,238,Tuesday
2020,8,18,2300,105,283,388,Tuesday
2020,8,18,2200,154,482,636,Tuesday
2020,8,18,2100,230,640,870,Tuesday
2020,8,18,2000,268,940,1208,Tuesday
2020,8,18,1900,360,981,1341,Tuesday
2020,8,18,1800,433,1153,1586,Tuesday
2020,8,18,1700,491,966,1457,Tuesday
2020,8,18,1600,640,1015,1655,Tuesday
2020,8,18,1500,666,967,1633,Tuesday
2020,8,18,1400,790,759,1549,Tuesday
2020,8,18,1300,933,652,1585,Tuesday
2020,8,18,1200,1063,498,1561,Tuesday
2020,8,18,1100,1130,387,1517,Tuesday
2020,8,18,1000,916,288,1204,Tuesday
2020,8,18,900,688,172,860,Tuesday
2020,8,18,800,544,129,673,Tuesday
2020,8,18,700,301,87,388,Tuesday
2020,8,18,600,185,40,225,Tuesday
2020,8,18,500,81,58,139,Tuesday
2020,8,18,400,46,60,106,Tuesday
2020,8,18,300,32,49,81,Tuesday
2020,8,18,200,23,93,116,Tuesday
2020,8,18,100,44,110,154,Tuesday
2020,8,17,2400,69,197,266,Monday
2020,8,17,2300,98,328,426,Monday
2020,8,17,2200,147,467,614,Monday
2020,8,17,2100,190,806,996,Monday
2020,8,17,2000,259,1028,1287,Monday
2020,8,17,1900,365,1170,1535,Monday
2020,8,17,1800,446,1251,1697,Monday
2020,8,17,1700,553,1304,1857,Monday
2020,8,17,1600,690,1248,1938,Monday
2020,8,17,1500,842,1070,1912,Monday
2020,8,17,1400,1006,909,1915,Monday
2020,8,17,1300,1183,807,1990,Monday
2020,8,17,1200,1294,627,1921,Monday
2020,8,17,1100,1324,451,1775,Monday
2020,8,17,1000,959,253,1212,Monday
2020,8,17,900,809,239,1048,Monday
2020,8,17,800,513,125,638,Monday
2020,8,17,700,309,71,380,Monday
2020,8,17,600,162,36,198,Monday
2020,8,17,500,81,28,109,Monday
2020,8,17,400,38,20,58,Monday
2020,8,17,300,27,34,61,Monday
2020,8,17,200,30,89,119,Monday
2020,8,17,100,49,141,190,Monday
2020,8,16,2400,65,199,264,Sunday
2020,8,16,2300,77,410,487,Sunday
2020,8,16,2200,151,742,893,Sunday
2020,8,16,2100,169,1237,1406,Sunday
2020,8,16,2000,245,1488,1733,Sunday
2020,8,16,1900,375,1864,2239,Sunday
2020,8,16,1800,508,1976,2484,Sunday
2020,8,16,1700,556,1990,2546,Sunday
2020,8,16,1600,787,1707,2494,Sunday
2020,8,16,1500,1059,1605,2664,Sunday
2020,8,16,1400,981,1398,2379,Sunday
2020,8,16,1300,1310,1260,2570,Sunday
2020,8,16,1200,1497,891,2388,Sunday
2020,8,16,1100,1311,590,1901,Sunday
2020,8,16,1000,1291,347,1638,Sunday
2020,8,16,900,850,162,1012,Sunday
2020,8,16,800,638,103,741,Sunday
2020,8,16,700,352,57,409,Sunday
2020,8,16,600,178,24,202,Sunday
2020,8,16,500,95,27,122,Sunday
2020,8,16,400,42,42,84,Sunday
2020,8,16,300,33,63,96,Sunday
2020,8,16,200,33,89,122,Sunday
2020,8,16,100,37,84,121,Sunday
2020,8,15,2400,72,196,268,Saturday
2020,8,15,2300,103,350,453,Saturday
2020,8,15,2200,171,569,740,Saturday
2020,8,15,2100,219,911,1130,Saturday
2020,8,15,2000,319,1183,1502,Saturday
2020,8,15,1900,387,1423,1810,Saturday
2020,8,15,1800,454,1468,1922,Saturday
2020,8,15,1700,677,1496,2173,Saturday
2020,8,15,1600,815,1459,2274,Saturday
2020,8,15,1500,981,1217,2198,Saturday
2020,8,15,1400,1245,971,2216,Saturday
2020,8,15,1300,1480,893,2373,Saturday
2020,8,15,1200,1676,599,2275,Saturday
2020,8,15,1100,1638,481,2119,Saturday
2020,8,15,1000,1406,315,1721,Saturday
2020,8,15,900,1270,183,1453,Saturday
2020,8,15,800,868,116,984,Saturday
2020,8,15,700,452,65,517,Saturday
2020,8,15,600,233,49,282,Saturday
2020,8,15,500,100,48,148,Saturday
2020,8,15,400,52,44,96,Saturday
2020,8,15,300,41,69,110,Saturday
2020,8,15,200,42,76,118,Saturday
2020,8,15,100,69,136,205,Saturday
2020,8,14,2400,97,159,256,Friday
2020,8,14,2300,160,220,380,Friday
2020,8,14,2200,283,384,667,Friday
2020,8,14,2100,476,539,1015,Friday
2020,8,14,2000,725,757,1482,Friday
2020,8,14,1900,866,1025,1891,Friday
2020,8,14,1800,979,1233,2212,Friday
2020,8,14,1700,993,1146,2139,Friday
2020,8,14,1600,1208,1137,2345,Friday
2020,8,14,1500,1141,1030,2171,Friday
2020,8,14,1400,1151,881,2032,Friday
2020,8,14,1300,1304,776,2080,Friday
2020,8,14,1200,1352,634,1986,Friday
2020,8,14,1100,1312,397,1709,Friday
2020,8,14,1000,1186,239,1425,Friday
2020,8,14,900,853,203,1056,Friday
2020,8,14,800,618,110,728,Friday
2020,8,14,700,329,68,397,Friday
2020,8,14,600,173,48,221,Friday
2020,8,14,500,91,47,138,Friday
2020,8,14,400,29,53,82,Friday
2020,8,14,300,60,49,109,Friday
2020,8,14,200,54,80,134,Friday
2020,8,14,100,62,103,165,Friday
2020,8,13,2400,97,159,256,Thursday
2020,8,13,2300,161,287,448,Thursday
2020,8,13,2200,214,423,637,Thursday
2020,8,13,2100,334,799,1133,Thursday
2020,8,13,2000,479,1108,1587,Thursday
2020,8,13,1900,589,1213,1802,Thursday
2020,8,13,1800,593,1005,1598,Thursday
2020,8,13,1700,676,1093,1769,Thursday
2020,8,13,1600,770,732,1502,Thursday
2020,8,13,1500,846,649,1495,Thursday
2020,8,13,1400,866,531,1397,Thursday
2020,8,13,1300,1030,574,1604,Thursday
2020,8,13,1200,1152,459,1611,Thursday
2020,8,13,1100,1165,329,1494,Thursday
2020,8,13,1000,942,230,1172,Thursday
2020,8,13,900,784,157,941,Thursday
2020,8,13,800,558,93,651,Thursday
2020,8,13,700,289,75,364,Thursday
2020,8,13,600,171,41,212,Thursday
2020,8,13,500,69,45,114,Thursday
2020,8,13,400,42,54,96,Thursday
2020,8,13,300,46,51,97,Thursday
2020,8,13,200,42,73,115,Thursday
2020,8,13,100,63,85,148,Thursday
2020,8,12,2400,86,161,247,Wednesday
2020,8,12,2300,120,206,326,Wednesday
2020,8,12,2200,184,311,495,Wednesday
2020,8,12,2100,216,560,776,Wednesday
2020,8,12,2000,301,752,1053,Wednesday
2020,8,12,1900,385,1033,1418,Wednesday
2020,8,12,1800,434,1064,1498,Wednesday
2020,8,12,1700,536,1046,1582,Wednesday
2020,8,12,1600,648,946,1594,Wednesday
2020,8,12,1500,734,851,1585,Wednesday
2020,8,12,1400,837,711,1548,Wednesday
2020,8,12,1300,923,675,1598,Wednesday
2020,8,12,1200,1131,459,1590,Wednesday
2020,8,12,1100,1047,297,1344,Wednesday
2020,8,12,1000,895,256,1151,Wednesday
2020,8,12,900,753,169,922,Wednesday
2020,8,12,800,464,118,582,Wednesday
2020,8,12,700,249,70,319,Wednesday
2020,8,12,600,138,56,194,Wednesday
2020,8,12,500,66,43,109,Wednesday
2020,8,12,400,43,44,87,Wednesday
2020,8,12,300,30,54,84,Wednesday
2020,8,12,200,41,82,123,Wednesday
2020,8,12,100,45,80,125,Wednesday
2020,8,11,2400,71,134,205,Tuesday
2020,8,11,2300,119,222,341,Tuesday
2020,8,11,2200,146,351,497,Tuesday
2020,8,11,2100,206,526,732,Tuesday
2020,8,11,2000,262,783,1045,Tuesday
2020,8,11,1900,319,995,1314,Tuesday
2020,8,11,1800,402,1069,1471,Tuesday
2020,8,11,1700,445,946,1391,Tuesday
2020,8,11,1600,586,972,1558,Tuesday
2020,8,11,1500,668,881,1549,Tuesday
2020,8,11,1400,709,677,1386,Tuesday
2020,8,11,1300,897,579,1476,Tuesday
2020,8,11,1200,1006,486,1492,Tuesday
2020,8,11,1100,961,357,1318,Tuesday
2020,8,11,1000,778,236,1014,Tuesday
2020,8,11,900,583,164,747,Tuesday
2020,8,11,800,446,99,545,Tuesday
2020,8,11,700,234,78,312,Tuesday
2020,8,11,600,141,47,188,Tuesday
2020,8,11,500,60,43,103,Tuesday
2020,8,11,400,38,56,94,Tuesday
2020,8,11,300,42,47,89,Tuesday
2020,8,11,200,28,79,107,Tuesday
2020,8,11,100,46,103,149,Tuesday
2020,8,10,2400,77,187,264,Monday
2020,8,10,2300,119,286,405,Monday
2020,8,10,2200,130,483,613,Monday
2020,8,10,2100,182,707,889,Monday
2020,8,10,2000,258,1318,1576,Monday
2020,8,10,1900,330,1133,1463,Monday
2020,8,10,1800,418,1135,1553,Monday
2020,8,10,1700,551,1144,1695,Monday
2020,8,10,1600,667,1088,1755,Monday
2020,8,10,1500,823,1013,1836,Monday
2020,8,10,1400,926,830,1756,Monday
2020,8,10,1300,1137,707,1844,Monday
2020,8,10,1200,1344,601,1945,Monday
2020,8,10,1100,1219,411,1630,Monday
2020,8,10,1000,1009,234,1243,Monday
2020,8,10,900,823,171,994,Monday
2020,8,10,800,538,139,677,Monday
2020,8,10,700,269,73,342,Monday
2020,8,10,600,165,37,202,Monday
2020,8,10,500,60,16,76,Monday
2020,8,10,400,30,28,58,Monday
2020,8,10,300,31,37,68,Monday
2020,8,10,200,25,76,101,Monday
2020,8,10,100,39,102,141,Monday
2020,8,9,2400,54,187,241,Sunday
2020,8,9,2300,84,441,525,Sunday
2020,8,9,2200,130,714,844,Sunday
2020,8,9,2100,211,1217,1428,Sunday
2020,8,9,2000,310,1573,1883,Sunday
2020,8,9,1900,379,1770,2149,Sunday
2020,8,9,1800,455,2361,2816,Sunday
2020,8,9,1700,544,1950,2494,Sunday
2020,8,9,1600,770,1491,2261,Sunday
2020,8,9,1500,897,1501,2398,Sunday
2020,8,9,1400,1018,1343,2361,Sunday
2020,8,9,1300,1335,1073,2408,Sunday
2020,8,9,1200,1447,880,2327,Sunday
2020,8,9,1100,1340,512,1852,Sunday
2020,8,9,1000,1169,283,1452,Sunday
2020,8,9,900,937,167,1104,Sunday
2020,8,9,800,643,98,741,Sunday
2020,8,9,700,327,30,357,Sunday
2020,8,9,600,200,34,234,Sunday
2020,8,9,500,93,26,119,Sunday
2020,8,9,400,37,24,61,Sunday
2020,8,9,300,30,47,77,Sunday
2020,8,9,200,31,54,85,Sunday
2020,8,9,100,45,101,146,Sunday
2020,8,8,2400,60,176,236,Saturday
2020,8,8,2300,94,268,362,Saturday
2020,8,8,2200,124,441,565,Saturday
2020,8,8,2100,190,806,996,Saturday
2020,8,8,2000,273,998,1271,Saturday
2020,8,8,1900,351,1367,1718,Saturday
2020,8,8,1800,497,1533,2030,Saturday
2020,8,8,1700,554,1446,2000,Saturday
2020,8,8,1600,801,1439,2240,Saturday
2020,8,8,1500,930,1155,2085,Saturday
2020,8,8,1400,1073,984,2057,Saturday
2020,8,8,1300,1271,913,2184,Saturday
2020,8,8,1200,1487,667,2154,Saturday
2020,8,8,1100,1432,487,1919,Saturday
2020,8,8,1000,1237,241,1478,Saturday
2020,8,8,900,962,154,1116,Saturday
2020,8,8,800,641,102,743,Saturday
2020,8,8,700,343,49,392,Saturday
2020,8,8,600,166,42,208,Saturday
2020,8,8,500,68,36,104,Saturday
2020,8,8,400,46,47,93,Saturday
2020,8,8,300,46,51,97,Saturday
2020,8,8,200,46,73,119,Saturday
2020,8,8,100,56,104,160,Saturday
2020,8,7,2400,107,178,285,Friday
2020,8,7,2300,179,249,428,Friday
2020,8,7,2200,246,364,610,Friday
2020,8,7,2100,425,555,980,Friday
2020,8,7,2000,645,802,1447,Friday
2020,8,7,1900,727,1063,1790,Friday
2020,8,7,1800,854,1203,2057,Friday
2020,8,7,1700,911,1069,1980,Friday
2020,8,7,1600,1080,1039,2119,Friday
2020,8,7,1500,1019,1068,2087,Friday
2020,8,7,1400,1133,870,2003,Friday
2020,8,7,1300,1136,761,1897,Friday
2020,8,7,1200,1284,564,1848,Friday
2020,8,7,1100,1279,405,1684,Friday
2020,8,7,1000,985,257,1242,Friday
2020,8,7,900,818,161,979,Friday
2020,8,7,800,464,120,584,Friday
2020,8,7,700,250,83,333,Friday
2020,8,7,600,136,45,181,Friday
2020,8,7,500,78,51,129,Friday
2020,8,7,400,53,32,85,Friday
2020,8,7,300,43,55,98,Friday
2020,8,7,200,41,65,106,Friday
2020,8,7,100,65,99,164,Friday
2020,8,6,2400,95,142,237,Thursday
2020,8,6,2300,157,244,401,Thursday
2020,8,6,2200,192,418,610,Thursday
2020,8,6,2100,321,598,919,Thursday
2020,8,6,2000,464,764,1228,Thursday
2020,8,6,1900,540,864,1404,Thursday
2020,8,6,1800,609,1001,1610,Thursday
2020,8,6,1700,872,989,1861,Thursday
2020,8,6,1600,860,1131,1991,Thursday
2020,8,6,1500,878,1076,1954,Thursday
2020,8,6,1400,973,914,1887,Thursday
2020,8,6,1300,908,725,1633,Thursday
2020,8,6,1200,919,604,1523,Thursday
2020,8,6,1100,939,379,1318,Thursday
2020,8,6,1000,876,269,1145,Thursday
2020,8,6,900,742,192,934,Thursday
2020,8,6,800,585,131,716,Thursday
2020,8,6,700,265,67,332,Thursday
2020,8,6,600,154,53,207,Thursday
2020,8,6,500,85,42,127,Thursday
2020,8,6,400,44,36,80,Thursday
2020,8,6,300,31,63,94,Thursday
2020,8,6,200,35,68,103,Thursday
2020,8,6,100,52,79,131,Thursday
2020,8,5,2400,82,192,274,Wednesday
2020,8,5,2300,111,300,411,Wednesday
2020,8,5,2200,153,445,598,Wednesday
2020,8,5,2100,230,609,839,Wednesday
2020,8,5,2000,305,861,1166,Wednesday
2020,8,5,1900,361,981,1342,Wednesday
2020,8,5,1800,401,1205,1606,Wednesday
2020,8,5,1700,533,1130,1663,Wednesday
2020,8,5,1600,689,1055,1744,Wednesday
2020,8,5,1500,734,946,1680,Wednesday
2020,8,5,1400,891,792,1683,Wednesday
2020,8,5,1300,922,675,1597,Wednesday
2020,8,5,1200,1174,555,1729,Wednesday
2020,8,5,1100,1103,393,1496,Wednesday
2020,8,5,1000,929,283,1212,Wednesday
2020,8,5,900,801,195,996,Wednesday
2020,8,5,800,569,142,711,Wednesday
2020,8,5,700,304,71,375,Wednesday
2020,8,5,600,208,38,246,Wednesday
2020,8,5,500,81,38,119,Wednesday
2020,8,5,400,40,45,85,Wednesday
2020,8,5,300,35,56,91,Wednesday
2020,8,5,200,33,93,126,Wednesday
2020,8,5,100,62,114,176,Wednesday
2020,8,4,2400,85,212,297,Tuesday
2020,8,4,2300,107,323,430,Tuesday
2020,8,4,2200,160,547,707,Tuesday
2020,8,4,2100,212,725,937,Tuesday
2020,8,4,2000,293,937,1230,Tuesday
2020,8,4,1900,370,1201,1571,Tuesday
2020,8,4,1800,451,1265,1716,Tuesday
2020,8,4,1700,519,1256,1775,Tuesday
2020,8,4,1600,658,1170,1828,Tuesday
2020,8,4,1500,769,1078,1847,Tuesday
2020,8,4,1400,888,948,1836,Tuesday
2020,8,4,1300,1052,846,1898,Tuesday
2020,8,4,1200,1349,647,1996,Tuesday
2020,8,4,1100,1027,472,1499,Tuesday
2020,8,4,1000,936,320,1256,Tuesday
2020,8,4,900,739,207,946,Tuesday
2020,8,4,800,514,165,679,Tuesday
2020,8,4,700,268,107,375,Tuesday
2020,8,4,600,164,42,206,Tuesday
2020,8,4,500,77,32,109,Tuesday
2020,8,4,400,33,40,73,Tuesday
2020,8,4,300,25,62,87,Tuesday
2020,8,4,200,35,98,133,Tuesday
2020,8,4,100,32,116,148,Tuesday
2020,8,3,2400,44,261,305,Monday
2020,8,3,2300,82,475,557,Monday
2020,8,3,2200,116,749,865,Monday
2020,8,3,2100,158,1163,1321,Monday
2020,8,3,2000,229,1478,1707,Monday
2020,8,3,1900,366,1610,1976,Monday
2020,8,3,1800,431,1894,2325,Monday
2020,8,3,1700,544,1855,2399,Monday
2020,8,3,1600,764,1947,2711,Monday
2020,8,3,1500,943,1961,2904,Monday
2020,8,3,1400,1035,1864,2899,Monday
2020,8,3,1300,1218,1550,2768,Monday
2020,8,3,1200,1363,1143,2506,Monday
2020,8,3,1100,1278,824,2102,Monday
2020,8,3,1000,1127,462,1589,Monday
2020,8,3,900,910,254,1164,Monday
2020,8,3,800,609,121,730,Monday
2020,8,3,700,390,47,437,Monday
2020,8,3,600,199,29,228,Monday
2020,8,3,500,105,30,135,Monday
2020,8,3,400,51,37,88,Monday
2020,8,3,300,37,52,89,Monday
2020,8,3,200,37,69,106,Monday
2020,8,3,100,41,124,165,Monday
2020,8,2,2400,55,236,291,Sunday
2020,8,2,2300,112,561,673,Sunday
2020,8,2,2200,126,877,1003,Sunday
2020,8,2,2100,203,1154,1357,Sunday
2020,8,2,2000,312,1306,1618,Sunday
2020,8,2,1900,406,1642,2048,Sunday
2020,8,2,1800,500,1697,2197,Sunday
2020,8,2,1700,631,1769,2400,Sunday
2020,8,2,1600,851,1506,2357,Sunday
2020,8,2,1500,1024,1404,2428,Sunday
2020,8,2,1400,1288,1264,2552,Sunday
2020,8,2,1300,1431,984,2415,Sunday
2020,8,2,1200,1470,778,2248,Sunday
2020,8,2,1100,1417,539,1956,Sunday
2020,8,2,1000,1357,331,1688,Sunday
2020,8,2,900,1118,198,1316,Sunday
2020,8,2,800,840,110,950,Sunday
2020,8,2,700,455,41,496,Sunday
2020,8,2,600,291,41,332,Sunday
2020,8,2,500,122,22,144,Sunday
2020,8,2,400,43,33,76,Sunday
2020,8,2,300,33,50,83,Sunday
2020,8,2,200,37,66,103,Sunday
2020,8,2,100,57,100,157,Sunday
2020,8,1,2400,63,191,254,Saturday
2020,8,1,2300,69,267,336,Saturday
2020,8,1,2200,171,740,911,Saturday
2020,8,1,2100,211,865,1076,Saturday
2020,8,1,2000,320,999,1319,Saturday
2020,8,1,1900,467,1348,1815,Saturday
2020,8,1,1800,512,1284,1796,Saturday
2020,8,1,1700,714,1312,2026,Saturday
2020,8,1,1600,887,1295,2182,Saturday
2020,8,1,1500,1122,1087,2209,Saturday
2020,8,1,1400,1381,929,2310,Saturday
2020,8,1,1300,1508,828,2336,Saturday
2020,8,1,1200,1761,696,2457,Saturday
2020,8,1,1100,1856,439,2295,Saturday
2020,8,1,1000,1809,322,2131,Saturday
2020,8,1,900,1560,187,1747,Saturday
2020,8,1,800,1181,151,1332,Saturday
2020,8,1,700,715,84,799,Saturday
2020,8,1,600,318,54,372,Saturday
2020,8,1,500,155,37,192,Saturday
2020,8,1,400,81,46,127,Saturday
2020,8,1,300,47,59,106,Saturday
2020,8,1,200,82,77,159,Saturday
2020,8,1,100,105,139,244,Saturday
2020,7,31,2400,172,239,411,Friday
2020,7,31,2300,262,277,539,Friday
2020,7,31,2200,417,413,830,Friday
2020,7,31,2100,652,712,1364,Friday
2020,7,31,2000,880,827,1707,Friday
2020,7,31,1900,1178,909,2087,Friday
2020,7,31,1800,1267,1075,2342,Friday
2020,7,31,1700,1282,1081,2363,Friday
2020,7,31,1600,1444,1070,2514,Friday
2020,7,31,1500,1399,905,2304,Friday
2020,7,31,1400,1452,873,2325,Friday
2020,7,31,1300,1476,776,2252,Friday
2020,7,31,1200,1752,663,2415,Friday
2020,7,31,1100,1634,419,2053,Friday
2020,7,31,1000,1413,297,1710,Friday
2020,7,31,900,1147,187,1334,Friday
2020,7,31,800,890,117,1007,Friday
2020,7,31,700,500,77,577,Friday
2020,7,31,600,253,46,299,Friday
2020,7,31,500,115,66,181,Friday
2020,7,31,400,60,43,103,Friday
2020,7,31,300,55,54,109,Friday
2020,7,31,200,51,116,167,Friday
2020,7,31,100,77,118,195,Friday
2020,7,30,2400,149,144,293,Thursday
2020,7,30,2300,241,310,551,Thursday
2020,7,30,2200,356,426,782,Thursday
2020,7,30,2100,545,556,1101,Thursday
2020,7,30,2000,691,711,1402,Thursday
2020,7,30,1900,792,916,1708,Thursday
2020,7,30,1800,895,1018,1913,Thursday
2020,7,30,1700,845,1014,1859,Thursday
2020,7,30,1600,941,953,1894,Thursday
2020,7,30,1500,976,835,1811,Thursday
2020,7,30,1400,993,743,1736,Thursday
2020,7,30,1300,1105,643,1748,Thursday
2020,7,30,1200,1227,544,1771,Thursday
2020,7,30,1100,1176,373,1549,Thursday
2020,7,30,1000,1134,248,1382,Thursday
2020,7,30,900,867,164,1031,Thursday
2020,7,30,800,691,119,810,Thursday
2020,7,30,700,378,72,450,Thursday
2020,7,30,600,190,58,248,Thursday
2020,7,30,500,72,56,128,Thursday
2020,7,30,400,40,41,81,Thursday
2020,7,30,300,45,57,102,Thursday
2020,7,30,200,57,71,128,Thursday
2020,7,30,100,63,102,165,Thursday
2020,7,29,2400,106,151,257,Wednesday
2020,7,29,2300,140,282,422,Wednesday
2020,7,29,2200,194,387,581,Wednesday
2020,7,29,2100,294,527,821,Wednesday
2020,7,29,2000,405,705,1110,Wednesday
2020,7,29,1900,445,890,1335,Wednesday
2020,7,29,1800,520,951,1471,Wednesday
2020,7,29,1700,583,950,1533,Wednesday
2020,7,29,1600,656,871,1527,Wednesday
2020,7,29,1500,714,836,1550,Wednesday
2020,7,29,1400,757,694,1451,Wednesday
2020,7,29,1300,954,611,1565,Wednesday
2020,7,29,1200,1088,447,1535,Wednesday
2020,7,29,1100,1049,310,1359,Wednesday
2020,7,29,1000,884,246,1130,Wednesday
2020,7,29,900,779,173,952,Wednesday
2020,7,29,800,519,132,651,Wednesday
2020,7,29,700,266,70,336,Wednesday
2020,7,29,600,130,41,171,Wednesday
2020,7,29,500,67,33,100,Wednesday
2020,7,29,400,49,59,108,Wednesday
2020,7,29,300,30,45,75,Wednesday
2020,7,29,200,34,68,102,Wednesday
2020,7,29,100,60,123,183,Wednesday
2020,7,28,2400,88,150,238,Tuesday
2020,7,28,2300,116,261,377,Tuesday
2020,7,28,2200,163,402,565,Tuesday
2020,7,28,2100,213,483,696,Tuesday
2020,7,28,2000,279,667,946,Tuesday
2020,7,28,1900,306,956,1262,Tuesday
2020,7,28,1800,432,955,1387,Tuesday
2020,7,28,1700,435,1008,1443,Tuesday
2020,7,28,1600,563,911,1474,Tuesday
2020,7,28,1500,702,773,1475,Tuesday
2020,7,28,1400,764,730,1494,Tuesday
2020,7,28,1300,904,614,1518,Tuesday
2020,7,28,1200,953,514,1467,Tuesday
2020,7,28,1100,994,309,1303,Tuesday
2020,7,28,1000,824,234,1058,Tuesday
2020,7,28,900,701,168,869,Tuesday
2020,7,28,800,510,137,647,Tuesday
2020,7,28,700,267,74,341,Tuesday
2020,7,28,600,132,57,189,Tuesday
2020,7,28,500,82,43,125,Tuesday
2020,7,28,400,45,54,99,Tuesday
2020,7,28,300,35,52,87,Tuesday
2020,7,28,200,42,78,120,Tuesday
2020,7,28,100,45,106,151,Tuesday
2020,7,27,2400,80,200,280,Monday
2020,7,27,2300,135,335,470,Monday
2020,7,27,2200,146,497,643,Monday
2020,7,27,2100,234,612,846,Monday
2020,7,27,2000,267,839,1106,Monday
2020,7,27,1900,346,1102,1448,Monday
2020,7,27,1800,427,1269,1696,Monday
2020,7,27,1700,533,1072,1605,Monday
2020,7,27,1600,635,1045,1680,Monday
2020,7,27,1500,760,910,1670,Monday
2020,7,27,1400,892,818,1710,Monday
2020,7,27,1300,992,670,1662,Monday
2020,7,27,1200,1204,551,1755,Monday
2020,7,27,1100,1218,361,1579,Monday
2020,7,27,1000,919,239,1158,Monday
2020,7,27,900,755,187,942,Monday
2020,7,27,800,512,158,670,Monday
2020,7,27,700,293,82,375,Monday
2020,7,27,600,150,34,184,Monday
2020,7,27,500,72,33,105,Monday
2020,7,27,400,23,34,57,Monday
2020,7,27,300,37,51,88,Monday
2020,7,27,200,29,71,100,Monday
2020,7,27,100,33,109,142,Monday
2020,7,26,2400,64,215,279,Sunday
2020,7,26,2300,92,481,573,Sunday
2020,7,26,2200,122,758,880,Sunday
2020,7,26,2100,196,912,1108,Sunday
2020,7,26,2000,249,1305,1554,Sunday
2020,7,26,1900,368,1599,1967,Sunday
2020,7,26,1800,455,1715,2170,Sunday
2020,7,26,1700,589,1767,2356,Sunday
2020,7,26,1600,721,1636,2357,Sunday
2020,7,26,1500,862,1324,2186,Sunday
2020,7,26,1400,1059,1280,2339,Sunday
2020,7,26,1300,1176,1096,2272,Sunday
2020,7,26,1200,1369,822,2191,Sunday
2020,7,26,1100,1322,508,1830,Sunday
2020,7,26,1000,1113,289,1402,Sunday
2020,7,26,900,876,150,1026,Sunday
2020,7,26,800,561,100,661,Sunday
2020,7,26,700,291,34,325,Sunday
2020,7,26,600,144,14,158,Sunday
2020,7,26,500,71,35,106,Sunday
2020,7,26,400,44,26,70,Sunday
2020,7,26,300,26,50,76,Sunday
2020,7,26,200,31,68,99,Sunday
2020,7,26,100,35,91,126,Sunday
2020,7,25,2400,59,163,222,Saturday
2020,7,25,2300,102,297,399,Saturday
2020,7,25,2200,133,519,652,Saturday
2020,7,25,2100,183,689,872,Saturday
2020,7,25,2000,268,996,1264,Saturday
2020,7,25,1900,350,1236,1586,Saturday
2020,7,25,1800,441,1533,1974,Saturday
2020,7,25,1700,619,1231,1850,Saturday
2020,7,25,1600,766,1210,1976,Saturday
2020,7,25,1500,1012,959,1971,Saturday
2020,7,25,1400,1144,849,1993,Saturday
2020,7,25,1300,1411,793,2204,Saturday
2020,7,25,1200,1673,537,2210,Saturday
2020,7,25,1100,1548,447,1995,Saturday
2020,7,25,1000,1424,232,1656,Saturday
2020,7,25,900,1173,151,1324,Saturday
2020,7,25,800,808,87,895,Saturday
2020,7,25,700,423,52,475,Saturday
2020,7,25,600,165,43,208,Saturday
2020,7,25,500,94,35,129,Saturday
2020,7,25,400,37,50,87,Saturday
2020,7,25,300,48,54,102,Saturday
2020,7,25,200,46,61,107,Saturday
2020,7,25,100,62,94,156,Saturday
2020,7,24,2400,95,167,262,Friday
2020,7,24,2300,178,232,410,Friday
2020,7,24,2200,247,333,580,Friday
2020,7,24,2100,417,424,841,Friday
2020,7,24,2000,769,541,1310,Friday
2020,7,24,1900,811,681,1492,Friday
2020,7,24,1800,906,1053,1959,Friday
2020,7,24,1700,1040,1043,2083,Friday
2020,7,24,1600,1030,899,1929,Friday
2020,7,24,1500,1086,870,1956,Friday
2020,7,24,1400,1152,851,2003,Friday
2020,7,24,1300,1219,685,1904,Friday
2020,7,24,1200,1365,478,1843,Friday
2020,7,24,1100,1284,353,1637,Friday
2020,7,24,1000,1080,227,1307,Friday
2020,7,24,900,868,152,1020,Friday
2020,7,24,800,562,114,676,Friday
2020,7,24,700,321,71,392,Friday
2020,7,24,600,135,51,186,Friday
2020,7,24,500,81,41,122,Friday
2020,7,24,400,46,48,94,Friday
2020,7,24,300,54,57,111,Friday
2020,7,24,200,38,63,101,Friday
2020,7,24,100,48,109,157,Friday
2020,7,23,2400,111,172,283,Thursday
2020,7,23,2300,155,215,370,Thursday
2020,7,23,2200,240,320,560,Thursday
2020,7,23,2100,384,414,798,Thursday
2020,7,23,2000,473,614,1087,Thursday
2020,7,23,1900,601,729,1330,Thursday
2020,7,23,1800,662,857,1519,Thursday
2020,7,23,1700,722,937,1659,Thursday
2020,7,23,1600,690,949,1639,Thursday
2020,7,23,1500,847,731,1578,Thursday
2020,7,23,1400,917,658,1575,Thursday
2020,7,23,1300,967,621,1588,Thursday
2020,7,23,1200,1023,579,1602,Thursday
2020,7,23,1100,1128,390,1518,Thursday
2020,7,23,1000,829,233,1062,Thursday
2020,7,23,900,688,184,872,Thursday
2020,7,23,800,430,110,540,Thursday
2020,7,23,700,233,91,324,Thursday
2020,7,23,600,114,44,158,Thursday
2020,7,23,500,53,38,91,Thursday
2020,7,23,400,42,46,88,Thursday
2020,7,23,300,45,52,97,Thursday
2020,7,23,200,49,77,126,Thursday
2020,7,23,100,48,98,146,Thursday
2020,7,22,2400,83,131,214,Wednesday
2020,7,22,2300,122,253,375,Wednesday
2020,7,22,2200,164,320,484,Wednesday
2020,7,22,2100,242,464,706,Wednesday
2020,7,22,2000,333,598,931,Wednesday
2020,7,22,1900,359,816,1175,Wednesday
2020,7,22,1800,460,925,1385,Wednesday
2020,7,22,1700,481,944,1425,Wednesday
2020,7,22,1600,583,749,1332,Wednesday
2020,7,22,1500,632,757,1389,Wednesday
2020,7,22,1400,742,604,1346,Wednesday
2020,7,22,1300,815,539,1354,Wednesday
2020,7,22,1200,1015,439,1454,Wednesday
2020,7,22,1100,917,364,1281,Wednesday
2020,7,22,1000,785,206,991,Wednesday
2020,7,22,900,626,137,763,Wednesday
2020,7,22,800,462,111,573,Wednesday
2020,7,22,700,213,59,272,Wednesday
2020,7,22,600,102,39,141,Wednesday
2020,7,22,500,53,44,97,Wednesday
2020,7,22,400,38,51,89,Wednesday
2020,7,22,300,26,43,69,Wednesday
2020,7,22,200,28,52,80,Wednesday
2020,7,22,100,62,96,158,Wednesday
2020,7,21,2400,77,118,195,Tuesday
2020,7,21,2300,117,230,347,Tuesday
2020,7,21,2200,171,388,559,Tuesday
2020,7,21,2100,218,461,679,Tuesday
2020,7,21,2000,265,716,981,Tuesday
2020,7,21,1900,301,856,1157,Tuesday
2020,7,21,1800,391,996,1387,Tuesday
2020,7,21,1700,474,847,1321,Tuesday
2020,7,21,1600,551,843,1394,Tuesday
2020,7,21,1500,591,693,1284,Tuesday
2020,7,21,1400,725,663,1388,Tuesday
2020,7,21,1300,845,548,1393,Tuesday
2020,7,21,1200,955,453,1408,Tuesday
2020,7,21,1100,891,321,1212,Tuesday
2020,7,21,1000,762,186,948,Tuesday
2020,7,21,900,599,155,754,Tuesday
2020,7,21,800,465,124,589,Tuesday
2020,7,21,700,217,58,275,Tuesday
2020,7,21,600,107,38,145,Tuesday
2020,7,21,500,81,42,123,Tuesday
2020,7,21,400,36,47,83,Tuesday
2020,7,21,300,35,58,93,Tuesday
2020,7,21,200,40,70,110,Tuesday
2020,7,21,100,43,106,149,Tuesday
2020,7,20,2400,65,177,242,Monday
2020,7,20,2300,126,291,417,Monday
2020,7,20,2200,150,380,530,Monday
2020,7,20,2100,183,627,810,Monday
2020,7,20,2000,224,753,977,Monday
2020,7,20,1900,302,969,1271,Monday
2020,7,20,1800,383,1137,1520,Monday
2020,7,20,1700,455,1069,1524,Monday
2020,7,20,1600,635,982,1617,Monday
2020,7,20,1500,757,921,1678,Monday
2020,7,20,1400,849,775,1624,Monday
2020,7,20,1300,915,639,1554,Monday
2020,7,20,1200,1138,515,1653,Monday
2020,7,20,1100,1072,357,1429,Monday
2020,7,20,1000,900,245,1145,Monday
2020,7,20,900,667,191,858,Monday
2020,7,20,800,426,153,579,Monday
2020,7,20,700,202,79,281,Monday
2020,7,20,600,99,58,157,Monday
2020,7,20,500,57,25,82,Monday
2020,7,20,400,31,28,59,Monday
2020,7,20,300,32,64,96,Monday
2020,7,20,200,29,64,93,Monday
2020,7,20,100,27,132,159,Monday
2020,7,19,2400,55,158,213,Sunday
2020,7,19,2300,90,349,439,Sunday
2020,7,19,2200,113,572,685,Sunday
2020,7,19,2100,188,880,1068,Sunday
2020,7,19,2000,243,1194,1437,Sunday
2020,7,19,1900,359,1408,1767,Sunday
2020,7,19,1800,386,1482,1868,Sunday
2020,7,19,1700,519,1540,2059,Sunday
2020,7,19,1600,659,1644,2303,Sunday
2020,7,19,1500,810,1388,2198,Sunday
2020,7,19,1400,939,1302,2241,Sunday
2020,7,19,1300,1038,1060,2098,Sunday
2020,7,19,1200,1236,845,2081,Sunday
2020,7,19,1100,1068,526,1594,Sunday
2020,7,19,1000,954,281,1235,Sunday
2020,7,19,900,746,152,898,Sunday
2020,7,19,800,489,84,573,Sunday
2020,7,19,700,216,39,255,Sunday
2020,7,19,600,110,18,128,Sunday
2020,7,19,500,66,25,91,Sunday
2020,7,19,400,36,30,66,Sunday
2020,7,19,300,32,23,55,Sunday
2020,7,19,200,43,45,88,Sunday
2020,7,19,100,23,78,101,Sunday
2020,7,18,2400,49,152,201,Saturday
2020,7,18,2300,67,256,323,Saturday
2020,7,18,2200,117,431,548,Saturday
2020,7,18,2100,183,649,832,Saturday
2020,7,18,2000,235,984,1219,Saturday
2020,7,18,1900,316,1217,1533,Saturday
2020,7,18,1800,425,1264,1689,Saturday
2020,7,18,1700,579,1313,1892,Saturday
2020,7,18,1600,790,1123,1913,Saturday
2020,7,18,1500,963,875,1838,Saturday
2020,7,18,1400,1069,853,1922,Saturday
2020,7,18,1300,1246,700,1946,Saturday
2020,7,18,1200,1430,603,2033,Saturday
2020,7,18,1100,1518,379,1897,Saturday
2020,7,18,1000,1395,246,1641,Saturday
2020,7,18,900,1218,144,1362,Saturday
2020,7,18,800,795,87,882,Saturday
2020,7,18,700,392,66,458,Saturday
2020,7,18,600,197,44,241,Saturday
2020,7,18,500,114,49,163,Saturday
2020,7,18,400,48,43,91,Saturday
2020,7,18,300,43,53,96,Saturday
2020,7,18,200,40,55,95,Saturday
2020,7,18,100,41,72,113,Saturday
2020,7,17,2400,92,114,206,Friday
2020,7,17,2300,175,211,386,Friday
2020,7,17,2200,263,313,576,Friday
2020,7,17,2100,446,406,852,Friday
2020,7,17,2000,653,615,1268,Friday
2020,7,17,1900,819,819,1638,Friday
2020,7,17,1800,899,968,1867,Friday
2020,7,17,1700,977,903,1880,Friday
2020,7,17,1600,985,848,1833,Friday
2020,7,17,1500,1118,794,1912,Friday
2020,7,17,1400,1070,664,1734,Friday
2020,7,17,1300,1095,570,1665,Friday
2020,7,17,1200,1249,450,1699,Friday
2020,7,17,1100,1252,306,1558,Friday
2020,7,17,1000,1008,203,1211,Friday
2020,7,17,900,742,153,895,Friday
2020,7,17,800,498,116,614,Friday
2020,7,17,700,303,57,360,Friday
2020,7,17,600,109,46,155,Friday
2020,7,17,500,60,50,110,Friday
2020,7,17,400,59,51,110,Friday
2020,7,17,300,36,65,101,Friday
2020,7,17,200,53,74,127,Friday
2020,7,17,100,62,99,161,Friday
2020,7,16,2400,87,132,219,Thursday
2020,7,16,2300,142,133,275,Thursday
2020,7,16,2200,245,278,523,Thursday
2020,7,16,2100,308,372,680,Thursday
2020,7,16,2000,520,548,1068,Thursday
2020,7,16,1900,586,749,1335,Thursday
2020,7,16,1800,621,780,1401,Thursday
2020,7,16,1700,608,852,1460,Thursday
2020,7,16,1600,662,858,1520,Thursday
2020,7,16,1500,747,746,1493,Thursday
2020,7,16,1400,798,632,1430,Thursday
2020,7,16,1300,1100,561,1661,Thursday
2020,7,16,1200,914,413,1327,Thursday
2020,7,16,1100,815,287,1102,Thursday
2020,7,16,1000,824,213,1037,Thursday
2020,7,16,900,637,135,772,Thursday
2020,7,16,800,376,94,470,Thursday
2020,7,16,700,224,57,281,Thursday
2020,7,16,600,90,54,144,Thursday
2020,7,16,500,62,39,101,Thursday
2020,7,16,400,37,51,88,Thursday
2020,7,16,300,33,52,85,Thursday
2020,7,16,200,37,46,83,Thursday
2020,7,16,100,57,47,104,Thursday
2020,7,15,2400,73,128,201,Wednesday
2020,7,15,2300,124,174,298,Wednesday
2020,7,15,2200,153,249,402,Wednesday
2020,7,15,2100,218,437,655,Wednesday
2020,7,15,2000,263,602,865,Wednesday
2020,7,15,1900,354,727,1081,Wednesday
2020,7,15,1800,428,775,1203,Wednesday
2020,7,15,1700,486,816,1302,Wednesday
2020,7,15,1600,539,809,1348,Wednesday
2020,7,15,1500,572,685,1257,Wednesday
2020,7,15,1400,702,601,1303,Wednesday
2020,7,15,1300,747,492,1239,Wednesday
2020,7,15,1200,857,387,1244,Wednesday
2020,7,15,1100,902,285,1187,Wednesday
2020,7,15,1000,762,185,947,Wednesday
2020,7,15,900,555,155,710,Wednesday
2020,7,15,800,395,102,497,Wednesday
2020,7,15,700,205,72,277,Wednesday
2020,7,15,600,81,43,124,Wednesday
2020,7,15,500,65,36,101,Wednesday
2020,7,15,400,38,41,79,Wednesday
2020,7,15,300,37,51,88,Wednesday
2020,7,15,200,34,64,98,Wednesday
2020,7,15,100,44,80,124,Wednesday
2020,7,14,2400,83,141,224,Tuesday
2020,7,14,2300,94,205,299,Tuesday
2020,7,14,2200,130,309,439,Tuesday
2020,7,14,2100,173,482,655,Tuesday
2020,7,14,2000,256,685,941,Tuesday
2020,7,14,1900,317,765,1082,Tuesday
2020,7,14,1800,337,813,1150,Tuesday
2020,7,14,1700,424,857,1281,Tuesday
2020,7,14,1600,504,767,1271,Tuesday
2020,7,14,1500,571,697,1268,Tuesday
2020,7,14,1400,655,645,1300,Tuesday
2020,7,14,1300,798,527,1325,Tuesday
2020,7,14,1200,939,373,1312,Tuesday
2020,7,14,1100,854,299,1153,Tuesday
2020,7,14,1000,682,190,872,Tuesday
2020,7,14,900,611,155,766,Tuesday
2020,7,14,800,410,130,540,Tuesday
2020,7,14,700,221,75,296,Tuesday
2020,7,14,600,92,39,131,Tuesday
2020,7,14,500,71,32,103,Tuesday
2020,7,14,400,41,50,91,Tuesday
2020,7,14,300,36,66,102,Tuesday
2020,7,14,200,47,57,104,Tuesday
2020,7,14,100,31,99,130,Tuesday
2020,7,13,2400,74,184,258,Monday
2020,7,13,2300,84,176,260,Monday
2020,7,13,2200,119,320,439,Monday
2020,7,13,2100,176,415,591,Monday
2020,7,13,2000,215,695,910,Monday
2020,7,13,1900,294,751,1045,Monday
2020,7,13,1800,326,874,1200,Monday
2020,7,13,1700,485,956,1441,Monday
2020,7,13,1600,540,885,1425,Monday
2020,7,13,1500,687,853,1540,Monday
2020,7,13,1400,711,719,1430,Monday
2020,7,13,1300,847,602,1449,Monday
2020,7,13,1200,995,477,1472,Monday
2020,7,13,1100,995,272,1267,Monday
2020,7,13,1000,794,199,993,Monday
2020,7,13,900,622,149,771,Monday
2020,7,13,800,378,123,501,Monday
2020,7,13,700,173,74,247,Monday
2020,7,13,600,76,42,118,Monday
2020,7,13,500,46,26,72,Monday
2020,7,13,400,28,31,59,Monday
2020,7,13,300,24,40,64,Monday
2020,7,13,200,21,43,64,Monday
2020,7,13,100,32,84,116,Monday
2020,7,12,2400,49,149,198,Sunday
2020,7,12,2300,75,234,309,Sunday
2020,7,12,2200,115,377,492,Sunday
2020,7,12,2100,195,664,859,Sunday
2020,7,12,2000,246,1002,1248,Sunday
2020,7,12,1900,310,1256,1566,Sunday
2020,7,12,1800,498,1357,1855,Sunday
2020,7,12,1700,494,1725,2219,Sunday
2020,7,12,1600,545,1570,2115,Sunday
2020,7,12,1500,637,1356,1993,Sunday
2020,7,12,1400,870,1208,2078,Sunday
2020,7,12,1300,906,1050,1956,Sunday
2020,7,12,1200,1064,772,1836,Sunday
2020,7,12,1100,919,469,1388,Sunday
2020,7,12,1000,783,264,1047,Sunday
2020,7,12,900,560,113,673,Sunday
2020,7,12,800,354,92,446,Sunday
2020,7,12,700,191,52,243,Sunday
2020,7,12,600,91,27,118,Sunday
2020,7,12,500,62,17,79,Sunday
2020,7,12,400,18,41,59,Sunday
2020,7,12,300,36,31,67,Sunday
2020,7,12,200,19,57,76,Sunday
2020,7,12,100,46,68,114,Sunday
2020,7,11,2400,49,153,202,Saturday
2020,7,11,2300,73,375,448,Saturday
2020,7,11,2200,133,496,629,Saturday
2020,7,11,2100,192,722,914,Saturday
2020,7,11,2000,209,948,1157,Saturday
2020,7,11,1900,322,1147,1469,Saturday
2020,7,11,1800,416,1225,1641,Saturday
2020,7,11,1700,586,1400,1986,Saturday
2020,7,11,1600,811,1225,2036,Saturday
2020,7,11,1500,1145,947,2092,Saturday
2020,7,11,1400,1169,806,1975,Saturday
2020,7,11,1300,1225,709,1934,Saturday
2020,7,11,1200,1301,543,1844,Saturday
2020,7,11,1100,1186,358,1544,Saturday
2020,7,11,1000,1136,220,1356,Saturday
2020,7,11,900,1078,145,1223,Saturday
2020,7,11,800,685,97,782,Saturday
2020,7,11,700,335,58,393,Saturday
2020,7,11,600,154,39,193,Saturday
2020,7,11,500,95,42,137,Saturday
2020,7,11,400,40,35,75,Saturday
2020,7,11,300,38,54,92,Saturday
2020,7,11,200,38,65,103,Saturday
2020,7,11,100,65,101,166,Saturday
2020,7,10,2400,92,149,241,Friday
2020,7,10,2300,154,222,376,Friday
2020,7,10,2200,251,316,567,Friday
2020,7,10,2100,428,476,904,Friday
2020,7,10,2000,631,645,1276,Friday
2020,7,10,1900,733,770,1503,Friday
2020,7,10,1800,876,847,1723,Friday
2020,7,10,1700,867,888,1755,Friday
2020,7,10,1600,983,951,1934,Friday
2020,7,10,1500,1040,738,1778,Friday
2020,7,10,1400,1038,651,1689,Friday
2020,7,10,1300,1155,583,1738,Friday
2020,7,10,1200,1041,417,1458,Friday
2020,7,10,1100,1113,290,1403,Friday
2020,7,10,1000,1038,214,1252,Friday
2020,7,10,900,798,149,947,Friday
2020,7,10,800,509,110,619,Friday
2020,7,10,700,267,66,333,Friday
2020,7,10,600,110,51,161,Friday
2020,7,10,500,75,34,109,Friday
2020,7,10,400,44,52,96,Friday
2020,7,10,300,46,61,107,Friday
2020,7,10,200,36,68,104,Friday
2020,7,10,100,69,83,152,Friday
2020,7,9,2400,74,146,220,Thursday
2020,7,9,2300,127,160,287,Thursday
2020,7,9,2200,214,223,437,Thursday
2020,7,9,2100,345,346,691,Thursday
2020,7,9,2000,463,477,940,Thursday
2020,7,9,1900,534,683,1217,Thursday
2020,7,9,1800,556,772,1328,Thursday
2020,7,9,1700,595,759,1354,Thursday
2020,7,9,1600,606,761,1367,Thursday
2020,7,9,1500,690,671,1361,Thursday
2020,7,9,1400,792,550,1342,Thursday
2020,7,9,1300,798,483,1281,Thursday
2020,7,9,1200,889,365,1254,Thursday
2020,7,9,1100,863,273,1136,Thursday
2020,7,9,1000,688,182,870,Thursday
2020,7,9,900,564,166,730,Thursday
2020,7,9,800,367,98,465,Thursday
2020,7,9,700,197,61,258,Thursday
2020,7,9,600,83,35,118,Thursday
2020,7,9,500,44,41,85,Thursday
2020,7,9,400,30,50,80,Thursday
2020,7,9,300,25,50,75,Thursday
2020,7,9,200,48,57,105,Thursday
2020,7,9,100,51,56,107,Thursday
2020,7,8,2400,89,122,211,Wednesday
2020,7,8,2300,101,179,280,Wednesday
2020,7,8,2200,143,270,413,Wednesday
2020,7,8,2100,218,368,586,Wednesday
2020,7,8,2000,251,459,710,Wednesday
2020,7,8,1900,318,624,942,Wednesday
2020,7,8,1800,350,660,1010,Wednesday
2020,7,8,1700,413,663,1076,Wednesday
2020,7,8,1600,439,657,1096,Wednesday
2020,7,8,1500,590,489,1079,Wednesday
2020,7,8,1400,603,452,1055,Wednesday
2020,7,8,1300,673,411,1084,Wednesday
2020,7,8,1200,796,343,1139,Wednesday
2020,7,8,1100,711,240,951,Wednesday
2020,7,8,1000,597,164,761,Wednesday
2020,7,8,900,412,131,543,Wednesday
2020,7,8,800,291,98,389,Wednesday
2020,7,8,700,140,55,195,Wednesday
2020,7,8,600,71,37,108,Wednesday
2020,7,8,500,43,33,76,Wednesday
2020,7,8,400,25,55,80,Wednesday
2020,7,8,300,25,30,55,Wednesday
2020,7,8,200,31,61,92,Wednesday
2020,7,8,100,31,67,98,Wednesday
2020,7,7,2400,84,104,188,Tuesday
2020,7,7,2300,87,167,254,Tuesday
2020,7,7,2200,140,234,374,Tuesday
2020,7,7,2100,171,356,527,Tuesday
2020,7,7,2000,236,443,679,Tuesday
2020,7,7,1900,250,526,776,Tuesday
2020,7,7,1800,351,589,940,Tuesday
2020,7,7,1700,342,657,999,Tuesday
2020,7,7,1600,440,661,1101,Tuesday
2020,7,7,1500,457,666,1123,Tuesday
2020,7,7,1400,536,696,1232,Tuesday
2020,7,7,1300,594,556,1150,Tuesday
2020,7,7,1200,602,394,996,Tuesday
2020,7,7,1100,574,260,834,Tuesday
2020,7,7,1000,492,188,680,Tuesday
2020,7,7,900,380,164,544,Tuesday
2020,7,7,800,260,104,364,Tuesday
2020,7,7,700,168,68,236,Tuesday
2020,7,7,600,67,47,114,Tuesday
2020,7,7,500,50,33,83,Tuesday
2020,7,7,400,28,31,59,Tuesday
2020,7,7,300,28,52,80,Tuesday
2020,7,7,200,37,57,94,Tuesday
2020,7,7,100,35,101,136,Tuesday
2020,7,6,2400,69,156,225,Monday
2020,7,6,2300,92,231,323,Monday
2020,7,6,2200,117,374,491,Monday
2020,7,6,2100,157,575,732,Monday
2020,7,6,2000,180,716,896,Monday
2020,7,6,1900,271,883,1154,Monday
2020,7,6,1800,317,967,1284,Monday
2020,7,6,1700,430,1006,1436,Monday
2020,7,6,1600,493,1025,1518,Monday
2020,7,6,1500,592,856,1448,Monday
2020,7,6,1400,657,721,1378,Monday
2020,7,6,1300,763,642,1405,Monday
2020,7,6,1200,855,518,1373,Monday
2020,7,6,1100,856,344,1200,Monday
2020,7,6,1000,715,265,980,Monday
2020,7,6,900,553,155,708,Monday
2020,7,6,800,394,138,532,Monday
2020,7,6,700,178,93,271,Monday
2020,7,6,600,104,43,147,Monday
2020,7,6,500,63,35,98,Monday
2020,7,6,400,32,25,57,Monday
2020,7,6,300,21,54,75,Monday
2020,7,6,200,49,237,286,Monday
2020,7,6,100,44,438,482,Monday
2020,7,5,2400,50,142,192,Sunday
2020,7,5,2300,69,171,240,Sunday
2020,7,5,2200,116,387,503,Sunday
2020,7,5,2100,164,962,1126,Sunday
2020,7,5,2000,237,1511,1748,Sunday
2020,7,5,1900,287,1854,2141,Sunday
2020,7,5,1800,353,1859,2212,Sunday
2020,7,5,1700,463,1958,2421,Sunday
2020,7,5,1600,597,1834,2431,Sunday
2020,7,5,1500,786,1653,2439,Sunday
2020,7,5,1400,841,1483,2324,Sunday
2020,7,5,1300,965,1206,2171,Sunday
2020,7,5,1200,1184,859,2043,Sunday
2020,7,5,1100,1012,520,1532,Sunday
2020,7,5,1000,948,252,1200,Sunday
2020,7,5,900,686,130,816,Sunday
2020,7,5,800,451,83,534,Sunday
2020,7,5,700,210,39,249,Sunday
2020,7,5,600,111,22,133,Sunday
2020,7,5,500,50,19,69,Sunday
2020,7,5,400,33,33,66,Sunday
2020,7,5,300,24,45,69,Sunday
2020,7,5,200,26,61,87,Sunday
2020,7,5,100,33,90,123,Sunday
2020,7,4,2400,52,156,208,Saturday
2020,7,4,2300,78,273,351,Saturday
2020,7,4,2200,134,511,645,Saturday
2020,7,4,2100,158,666,824,Saturday
2020,7,4,2000,253,897,1150,Saturday
2020,7,4,1900,297,1009,1306,Saturday
2020,7,4,1800,384,1214,1598,Saturday
2020,7,4,1700,538,1135,1673,Saturday
2020,7,4,1600,774,1184,1958,Saturday
2020,7,4,1500,997,911,1908,Saturday
2020,7,4,1400,979,954,1933,Saturday
2020,7,4,1300,910,1113,2023,Saturday
2020,7,4,1200,1113,750,1863,Saturday
2020,7,4,1100,1072,468,1540,Saturday
2020,7,4,1000,1080,309,1389,Saturday
2020,7,4,900,806,142,948,Saturday
2020,7,4,800,567,107,674,Saturday
2020,7,4,700,290,56,346,Saturday
2020,7,4,600,107,42,149,Saturday
2020,7,4,500,72,53,125,Saturday
2020,7,4,400,34,44,78,Saturday
2020,7,4,300,41,104,145,Saturday
2020,7,4,200,38,253,291,Saturday
2020,7,4,100,53,217,270,Saturday
2020,7,3,2400,66,290,356,Friday
2020,7,3,2300,110,235,345,Friday
2020,7,3,2200,220,295,515,Friday
2020,7,3,2100,295,503,798,Friday
2020,7,3,2000,509,803,1312,Friday
2020,7,3,1900,594,823,1417,Friday
2020,7,3,1800,681,822,1503,Friday
2020,7,3,1700,823,747,1570,Friday
2020,7,3,1600,927,753,1680,Friday
2020,7,3,1500,1031,741,1772,Friday
2020,7,3,1400,1022,639,1661,Friday
2020,7,3,1300,1121,527,1648,Friday
2020,7,3,1200,1323,412,1735,Friday
2020,7,3,1100,1073,229,1302,Friday
2020,7,3,1000,929,154,1083,Friday
2020,7,3,900,635,98,733,Friday
2020,7,3,800,386,66,452,Friday
2020,7,3,700,197,39,236,Friday
2020,7,3,600,110,16,126,Friday
2020,7,3,500,63,10,73,Friday
2020,7,3,400,32,17,49,Friday
2020,7,3,300,35,29,64,Friday
2020,7,3,200,20,30,50,Friday
2020,7,3,100,29,99,128,Friday
2020,7,2,2400,62,83,145,Thursday
2020,7,2,2300,95,141,236,Thursday
2020,7,2,2200,153,225,378,Thursday
2020,7,2,2100,245,297,542,Thursday
2020,7,2,2000,386,376,762,Thursday
2020,7,2,1900,452,440,892,Thursday
2020,7,2,1800,555,495,1050,Thursday
2020,7,2,1700,623,520,1143,Thursday
2020,7,2,1600,709,489,1198,Thursday
2020,7,2,1500,781,477,1258,Thursday
2020,7,2,1400,834,421,1255,Thursday
2020,7,2,1300,964,388,1352,Thursday
2020,7,2,1200,1020,299,1319,Thursday
2020,7,2,1100,933,253,1186,Thursday
2020,7,2,1000,671,172,843,Thursday
2020,7,2,900,515,123,638,Thursday
2020,7,2,800,297,80,377,Thursday
2020,7,2,700,141,41,182,Thursday
2020,7,2,600,83,21,104,Thursday
2020,7,2,500,33,31,64,Thursday
2020,7,2,400,34,19,53,Thursday
2020,7,2,300,34,33,67,Thursday
2020,7,2,200,21,38,59,Thursday
2020,7,2,100,41,61,102,Thursday
2020,7,1,2400,45,108,153,Wednesday
2020,7,1,2300,74,160,234,Wednesday
2020,7,1,2200,111,248,359,Wednesday
2020,7,1,2100,184,372,556,Wednesday
2020,7,1,2000,219,561,780,Wednesday
2020,7,1,1900,294,687,981,Wednesday
2020,7,1,1800,378,831,1209,Wednesday
2020,7,1,1700,515,834,1349,Wednesday
2020,7,1,1600,735,857,1592,Wednesday
2020,7,1,1500,882,840,1722,Wednesday
2020,7,1,1400,1081,729,1810,Wednesday
2020,7,1,1300,1129,553,1682,Wednesday
2020,7,1,1200,1211,418,1629,Wednesday
2020,7,1,1100,1086,270,1356,Wednesday
2020,7,1,1000,867,188,1055,Wednesday
2020,7,1,900,675,111,786,Wednesday
2020,7,1,800,433,71,504,Wednesday
2020,7,1,700,229,50,279,Wednesday
2020,7,1,600,90,41,131,Wednesday
2020,7,1,500,55,38,93,Wednesday
2020,7,1,400,28,48,76,Wednesday
2020,7,1,300,26,50,76,Wednesday
2020,7,1,200,41,51,92,Wednesday
2020,7,1,100,45,91,136,Wednesday
2020,6,30,2400,86,103,189,Tuesday
2020,6,30,2300,128,155,283,Tuesday
2020,6,30,2200,193,237,430,Tuesday
2020,6,30,2100,320,314,634,Tuesday
2020,6,30,2000,516,431,947,Tuesday
2020,6,30,1900,547,594,1141,Tuesday
2020,6,30,1800,606,690,1296,Tuesday
2020,6,30,1700,604,702,1306,Tuesday
2020,6,30,1600,651,662,1313,Tuesday
2020,6,30,1500,643,597,1240,Tuesday
2020,6,30,1400,714,570,1284,Tuesday
2020,6,30,1300,734,394,1128,Tuesday
2020,6,30,1200,841,337,1178,Tuesday
2020,6,30,1100,683,274,957,Tuesday
2020,6,30,1000,563,201,764,Tuesday
2020,6,30,900,455,123,578,Tuesday
2020,6,30,800,279,95,374,Tuesday
2020,6,30,700,155,53,208,Tuesday
2020,6,30,600,93,32,125,Tuesday
2020,6,30,500,38,25,63,Tuesday
2020,6,30,400,29,54,83,Tuesday
2020,6,30,300,36,41,77,Tuesday
2020,6,30,200,21,65,86,Tuesday
2020,6,30,100,38,83,121,Tuesday
2020,6,29,2400,77,133,210,Monday
2020,6,29,2300,105,224,329,Monday
2020,6,29,2200,119,309,428,Monday
2020,6,29,2100,193,466,659,Monday
2020,6,29,2000,256,557,813,Monday
2020,6,29,1900,282,665,947,Monday
2020,6,29,1800,387,841,1228,Monday
2020,6,29,1700,439,758,1197,Monday
2020,6,29,1600,540,696,1236,Monday
2020,6,29,1500,632,582,1214,Monday
2020,6,29,1400,724,506,1230,Monday
2020,6,29,1300,748,425,1173,Monday
2020,6,29,1200,899,364,1263,Monday
2020,6,29,1100,834,267,1101,Monday
2020,6,29,1000,625,170,795,Monday
2020,6,29,900,511,144,655,Monday
2020,6,29,800,347,90,437,Monday
2020,6,29,700,165,65,230,Monday
2020,6,29,600,71,25,96,Monday
2020,6,29,500,34,24,58,Monday
2020,6,29,400,23,29,52,Monday
2020,6,29,300,21,42,63,Monday
2020,6,29,200,29,57,86,Monday
2020,6,29,100,30,80,110,Monday
2020,6,28,2400,39,117,156,Sunday
2020,6,28,2300,61,214,275,Sunday
2020,6,28,2200,87,296,383,Sunday
2020,6,28,2100,142,499,641,Sunday
2020,6,28,2000,248,792,1040,Sunday
2020,6,28,1900,246,887,1133,Sunday
2020,6,28,1800,381,997,1378,Sunday
2020,6,28,1700,483,1074,1557,Sunday
2020,6,28,1600,620,1041,1661,Sunday
2020,6,28,1500,701,1052,1753,Sunday
2020,6,28,1400,782,845,1627,Sunday
2020,6,28,1300,818,705,1523,Sunday
2020,6,28,1200,951,543,1494,Sunday
2020,6,28,1100,793,312,1105,Sunday
2020,6,28,1000,572,155,727,Sunday
2020,6,28,900,429,97,526,Sunday
2020,6,28,800,257,52,309,Sunday
2020,6,28,700,138,37,175,Sunday
2020,6,28,600,55,20,75,Sunday
2020,6,28,500,39,14,53,Sunday
2020,6,28,400,21,17,38,Sunday
2020,6,28,300,18,31,49,Sunday
2020,6,28,200,30,47,77,Sunday
2020,6,28,100,27,75,102,Sunday
2020,6,27,2400,45,109,154,Saturday
2020,6,27,2300,58,153,211,Saturday
2020,6,27,2200,87,300,387,Saturday
2020,6,27,2100,173,411,584,Saturday
2020,6,27,2000,205,557,762,Saturday
2020,6,27,1900,285,832,1117,Saturday
2020,6,27,1800,351,859,1210,Saturday
2020,6,27,1700,513,894,1407,Saturday
2020,6,27,1600,673,865,1538,Saturday
2020,6,27,1500,836,739,1575,Saturday
2020,6,27,1400,943,601,1544,Saturday
2020,6,27,1300,1062,504,1566,Saturday
2020,6,27,1200,1263,386,1649,Saturday
2020,6,27,1100,1184,255,1439,Saturday
2020,6,27,1000,980,181,1161,Saturday
2020,6,27,900,775,144,919,Saturday
2020,6,27,800,505,88,593,Saturday
2020,6,27,700,240,55,295,Saturday
2020,6,27,600,108,46,154,Saturday
2020,6,27,500,64,51,115,Saturday
2020,6,27,400,42,36,78,Saturday
2020,6,27,300,23,48,71,Saturday
2020,6,27,200,52,55,107,Saturday
2020,6,27,100,51,89,140,Saturday
2020,6,26,2400,80,129,209,Friday
2020,6,26,2300,129,161,290,Friday
2020,6,26,2200,257,242,499,Friday
2020,6,26,2100,369,287,656,Friday
2020,6,26,2000,585,492,1077,Friday
2020,6,26,1900,740,573,1313,Friday
2020,6,26,1800,835,709,1544,Friday
2020,6,26,1700,855,685,1540,Friday
2020,6,26,1600,878,795,1673,Friday
2020,6,26,1500,946,700,1646,Friday
2020,6,26,1400,1104,576,1680,Friday
2020,6,26,1300,830,486,1316,Friday
2020,6,26,1200,900,370,1270,Friday
2020,6,26,1100,1018,225,1243,Friday
2020,6,26,1000,907,166,1073,Friday
2020,6,26,900,637,132,769,Friday
2020,6,26,800,440,111,551,Friday
2020,6,26,700,230,76,306,Friday
2020,6,26,600,113,46,159,Friday
2020,6,26,500,79,36,115,Friday
2020,6,26,400,42,47,89,Friday
2020,6,26,300,35,40,75,Friday
2020,6,26,200,44,58,102,Friday
2020,6,26,100,58,103,161,Friday
2020,6,25,2400,79,117,196,Thursday
2020,6,25,2300,150,229,379,Thursday
2020,6,25,2200,214,285,499,Thursday
2020,6,25,2100,302,337,639,Thursday
2020,6,25,2000,465,552,1017,Thursday
2020,6,25,1900,528,581,1109,Thursday
2020,6,25,1800,568,685,1253,Thursday
2020,6,25,1700,620,650,1270,Thursday
2020,6,25,1600,598,608,1206,Thursday
2020,6,25,1500,668,481,1149,Thursday
2020,6,25,1400,639,463,1102,Thursday
2020,6,25,1300,759,399,1158,Thursday
2020,6,25,1200,909,320,1229,Thursday
2020,6,25,1100,783,261,1044,Thursday
2020,6,25,1000,619,175,794,Thursday
2020,6,25,900,536,113,649,Thursday
2020,6,25,800,385,95,480,Thursday
2020,6,25,700,206,69,275,Thursday
2020,6,25,600,75,44,119,Thursday
2020,6,25,500,51,42,93,Thursday
2020,6,25,400,36,50,86,Thursday
2020,6,25,300,32,50,82,Thursday
2020,6,25,200,30,69,99,Thursday
2020,6,25,100,52,77,129,Thursday
2020,6,24,2400,69,98,167,Wednesday
2020,6,24,2300,94,139,233,Wednesday
2020,6,24,2200,129,191,320,Wednesday
2020,6,24,2100,203,272,475,Wednesday
2020,6,24,2000,255,323,578,Wednesday
2020,6,24,1900,335,449,784,Wednesday
2020,6,24,1800,340,469,809,Wednesday
2020,6,24,1700,364,548,912,Wednesday
2020,6,24,1600,449,501,950,Wednesday
2020,6,24,1500,481,430,911,Wednesday
2020,6,24,1400,475,405,880,Wednesday
2020,6,24,1300,525,397,922,Wednesday
2020,6,24,1200,549,286,835,Wednesday
2020,6,24,1100,513,243,756,Wednesday
2020,6,24,1000,465,160,625,Wednesday
2020,6,24,900,361,137,498,Wednesday
2020,6,24,800,282,127,409,Wednesday
2020,6,24,700,147,75,222,Wednesday
2020,6,24,600,65,38,103,Wednesday
2020,6,24,500,37,34,71,Wednesday
2020,6,24,400,25,47,72,Wednesday
2020,6,24,300,28,49,77,Wednesday
2020,6,24,200,35,63,98,Wednesday
2020,6,24,100,43,70,113,Wednesday
2020,6,23,2400,76,96,172,Tuesday
2020,6,23,2300,85,164,249,Tuesday
2020,6,23,2200,134,232,366,Tuesday
2020,6,23,2100,159,349,508,Tuesday
2020,6,23,2000,210,467,677,Tuesday
2020,6,23,1900,258,571,829,Tuesday
2020,6,23,1800,325,638,963,Tuesday
2020,6,23,1700,400,690,1090,Tuesday
2020,6,23,1600,414,658,1072,Tuesday
2020,6,23,1500,441,565,1006,Tuesday
2020,6,23,1400,529,470,999,Tuesday
2020,6,23,1300,591,368,959,Tuesday
2020,6,23,1200,645,320,965,Tuesday
2020,6,23,1100,649,232,881,Tuesday
2020,6,23,1000,505,179,684,Tuesday
2020,6,23,900,448,116,564,Tuesday
2020,6,23,800,267,92,359,Tuesday
2020,6,23,700,127,83,210,Tuesday
2020,6,23,600,64,39,103,Tuesday
2020,6,23,500,46,35,81,Tuesday
2020,6,23,400,32,30,62,Tuesday
2020,6,23,300,28,50,78,Tuesday
2020,6,23,200,31,46,77,Tuesday
2020,6,23,100,39,82,121,Tuesday
2020,6,22,2400,70,129,199,Monday
2020,6,22,2300,81,183,264,Monday
2020,6,22,2200,115,249,364,Monday
2020,6,22,2100,129,387,516,Monday
2020,6,22,2000,179,532,711,Monday
2020,6,22,1900,234,667,901,Monday
2020,6,22,1800,320,693,1013,Monday
2020,6,22,1700,396,808,1204,Monday
2020,6,22,1600,476,746,1222,Monday
2020,6,22,1500,497,609,1106,Monday
2020,6,22,1400,642,511,1153,Monday
2020,6,22,1300,694,408,1102,Monday
2020,6,22,1200,752,295,1047,Monday
2020,6,22,1100,761,217,978,Monday
2020,6,22,1000,630,172,802,Monday
2020,6,22,900,445,113,558,Monday
2020,6,22,800,307,113,420,Monday
2020,6,22,700,150,47,197,Monday
2020,6,22,600,70,23,93,Monday
2020,6,22,500,41,24,65,Monday
2020,6,22,400,22,16,38,Monday
2020,6,22,300,15,24,39,Monday
2020,6,22,200,16,41,57,Monday
2020,6,22,100,26,66,92,Monday
2020,6,21,2400,38,129,167,Sunday
2020,6,21,2300,63,229,292,Sunday
2020,6,21,2200,67,365,432,Sunday
2020,6,21,2100,141,590,731,Sunday
2020,6,21,2000,174,792,966,Sunday
2020,6,21,1900,250,854,1104,Sunday
2020,6,21,1800,288,1082,1370,Sunday
2020,6,21,1700,402,1133,1535,Sunday
2020,6,21,1600,461,1106,1567,Sunday
2020,6,21,1500,595,989,1584,Sunday
2020,6,21,1400,709,871,1580,Sunday
2020,6,21,1300,744,712,1456,Sunday
2020,6,21,1200,793,484,1277,Sunday
2020,6,21,1100,773,266,1039,Sunday
2020,6,21,1000,564,149,713,Sunday
2020,6,21,900,364,85,449,Sunday
2020,6,21,800,260,64,324,Sunday
2020,6,21,700,100,24,124,Sunday
2020,6,21,600,44,18,62,Sunday
2020,6,21,500,42,24,66,Sunday
2020,6,21,400,19,25,44,Sunday
2020,6,21,300,25,39,64,Sunday
2020,6,21,200,16,36,52,Sunday
2020,6,21,100,31,59,90,Sunday
2020,6,20,2400,35,97,132,Saturday
2020,6,20,2300,60,158,218,Saturday
2020,6,20,2200,87,218,305,Saturday
2020,6,20,2100,118,436,554,Saturday
2020,6,20,2000,166,529,695,Saturday
2020,6,20,1900,230,613,843,Saturday
2020,6,20,1800,278,786,1064,Saturday
2020,6,20,1700,372,804,1176,Saturday
2020,6,20,1600,460,811,1271,Saturday
2020,6,20,1500,558,726,1284,Saturday
2020,6,20,1400,677,717,1394,Saturday
2020,6,20,1300,750,521,1271,Saturday
2020,6,20,1200,805,407,1212,Saturday
2020,6,20,1100,911,238,1149,Saturday
2020,6,20,1000,767,173,940,Saturday
2020,6,20,900,549,104,653,Saturday
2020,6,20,800,380,71,451,Saturday
2020,6,20,700,169,45,214,Saturday
2020,6,20,600,65,42,107,Saturday
2020,6,20,500,36,33,69,Saturday
2020,6,20,400,34,35,69,Saturday
2020,6,20,300,24,34,58,Saturday
2020,6,20,200,36,70,106,Saturday
2020,6,20,100,55,79,134,Saturday
2020,6,19,2400,61,82,143,Friday
2020,6,19,2300,96,164,260,Friday
2020,6,19,2200,174,228,402,Friday
2020,6,19,2100,262,312,574,Friday
2020,6,19,2000,451,420,871,Friday
2020,6,19,1900,573,551,1124,Friday
2020,6,19,1800,611,613,1224,Friday
2020,6,19,1700,691,671,1362,Friday
2020,6,19,1600,786,583,1369,Friday
2020,6,19,1500,633,519,1152,Friday
2020,6,19,1400,744,428,1172,Friday
2020,6,19,1300,750,361,1111,Friday
2020,6,19,1200,801,295,1096,Friday
2020,6,19,1100,752,235,987,Friday
2020,6,19,1000,667,148,815,Friday
2020,6,19,900,499,123,622,Friday
2020,6,19,800,329,73,402,Friday
2020,6,19,700,193,63,256,Friday
2020,6,19,600,86,31,117,Friday
2020,6,19,500,42,35,77,Friday
2020,6,19,400,42,40,82,Friday
2020,6,19,300,37,37,74,Friday
2020,6,19,200,35,44,79,Friday
2020,6,19,100,36,74,110,Friday
2020,6,18,2400,68,120,188,Thursday
2020,6,18,2300,110,150,260,Thursday
2020,6,18,2200,173,203,376,Thursday
2020,6,18,2100,296,291,587,Thursday
2020,6,18,2000,372,347,719,Thursday
2020,6,18,1900,454,449,903,Thursday
2020,6,18,1800,521,511,1032,Thursday
2020,6,18,1700,469,458,927,Thursday
2020,6,18,1600,500,389,889,Thursday
2020,6,18,1500,551,367,918,Thursday
2020,6,18,1400,539,316,855,Thursday
2020,6,18,1300,563,282,845,Thursday
2020,6,18,1200,617,252,869,Thursday
2020,6,18,1100,536,183,719,Thursday
2020,6,18,1000,449,139,588,Thursday
2020,6,18,900,360,113,473,Thursday
2020,6,18,800,265,77,342,Thursday
2020,6,18,700,170,54,224,Thursday
2020,6,18,600,55,45,100,Thursday
2020,6,18,500,36,28,64,Thursday
2020,6,18,400,29,40,69,Thursday
2020,6,18,300,35,49,84,Thursday
2020,6,18,200,35,52,87,Thursday
2020,6,18,100,50,76,126,Thursday
2020,6,17,2400,62,90,152,Wednesday
2020,6,17,2300,92,140,232,Wednesday
2020,6,17,2200,102,150,252,Wednesday
2020,6,17,2100,159,239,398,Wednesday
2020,6,17,2000,201,301,502,Wednesday
2020,6,17,1900,288,369,657,Wednesday
2020,6,17,1800,320,449,769,Wednesday
2020,6,17,1700,324,411,735,Wednesday
2020,6,17,1600,383,375,758,Wednesday
2020,6,17,1500,381,329,710,Wednesday
2020,6,17,1400,433,285,718,Wednesday
2020,6,17,1300,440,285,725,Wednesday
2020,6,17,1200,483,225,708,Wednesday
2020,6,17,1100,436,184,620,Wednesday
2020,6,17,1000,380,116,496,Wednesday
2020,6,17,900,299,103,402,Wednesday
2020,6,17,800,229,68,297,Wednesday
2020,6,17,700,113,59,172,Wednesday
2020,6,17,600,58,29,87,Wednesday
2020,6,17,500,36,28,64,Wednesday
2020,6,17,400,21,37,58,Wednesday
2020,6,17,300,32,38,70,Wednesday
2020,6,17,200,23,43,66,Wednesday
2020,6,17,100,47,71,118,Wednesday
2020,6,16,2400,48,92,140,Tuesday
2020,6,16,2300,68,115,183,Tuesday
2020,6,16,2200,97,156,253,Tuesday
2020,6,16,2100,129,249,378,Tuesday
2020,6,16,2000,162,267,429,Tuesday
2020,6,16,1900,207,381,588,Tuesday
2020,6,16,1800,247,432,679,Tuesday
2020,6,16,1700,291,385,676,Tuesday
2020,6,16,1600,331,416,747,Tuesday
2020,6,16,1500,358,352,710,Tuesday
2020,6,16,1400,381,345,726,Tuesday
2020,6,16,1300,427,279,706,Tuesday
2020,6,16,1200,411,234,645,Tuesday
2020,6,16,1100,440,194,634,Tuesday
2020,6,16,1000,330,110,440,Tuesday
2020,6,16,900,247,128,375,Tuesday
2020,6,16,800,213,74,287,Tuesday
2020,6,16,700,131,60,191,Tuesday
2020,6,16,600,58,41,99,Tuesday
2020,6,16,500,34,42,76,Tuesday
2020,6,16,400,34,36,70,Tuesday
2020,6,16,300,25,58,83,Tuesday
2020,6,16,200,31,41,72,Tuesday
2020,6,16,100,48,68,116,Tuesday
2020,6,15,2400,51,77,128,Monday
2020,6,15,2300,56,121,177,Monday
2020,6,15,2200,87,159,246,Monday
2020,6,15,2100,145,289,434,Monday
2020,6,15,2000,157,365,522,Monday
2020,6,15,1900,216,594,810,Monday
2020,6,15,1800,251,583,834,Monday
2020,6,15,1700,309,543,852,Monday
2020,6,15,1600,352,508,860,Monday
2020,6,15,1500,371,419,790,Monday
2020,6,15,1400,428,373,801,Monday
2020,6,15,1300,507,322,829,Monday
2020,6,15,1200,514,260,774,Monday
2020,6,15,1100,459,201,660,Monday
2020,6,15,1000,377,143,520,Monday
2020,6,15,900,302,99,401,Monday
2020,6,15,800,174,85,259,Monday
2020,6,15,700,144,47,191,Monday
2020,6,15,600,59,17,76,Monday
2020,6,15,500,23,18,41,Monday
2020,6,15,400,21,23,44,Monday
2020,6,15,300,15,27,42,Monday
2020,6,15,200,28,45,73,Monday
2020,6,15,100,33,50,83,Monday
2020,6,14,2400,25,94,119,Sunday
2020,6,14,2300,62,151,213,Sunday
2020,6,14,2200,108,175,283,Sunday
2020,6,14,2100,126,320,446,Sunday
2020,6,14,2000,166,494,660,Sunday
2020,6,14,1900,212,685,897,Sunday
2020,6,14,1800,249,763,1012,Sunday
2020,6,14,1700,351,910,1261,Sunday
2020,6,14,1600,385,863,1248,Sunday
2020,6,14,1500,448,836,1284,Sunday
2020,6,14,1400,505,738,1243,Sunday
2020,6,14,1300,546,619,1165,Sunday
2020,6,14,1200,536,429,965,Sunday
2020,6,14,1100,530,264,794,Sunday
2020,6,14,1000,353,146,499,Sunday
2020,6,14,900,240,93,333,Sunday
2020,6,14,800,158,46,204,Sunday
2020,6,14,700,86,19,105,Sunday
2020,6,14,600,37,26,63,Sunday
2020,6,14,500,17,18,35,Sunday
2020,6,14,400,22,14,36,Sunday
2020,6,14,300,25,27,52,Sunday
2020,6,14,200,18,42,60,Sunday
2020,6,14,100,17,49,66,Sunday
2020,6,13,2400,32,72,104,Saturday
2020,6,13,2300,45,112,157,Saturday
2020,6,13,2200,71,135,206,Saturday
2020,6,13,2100,108,230,338,Saturday
2020,6,13,2000,139,362,501,Saturday
2020,6,13,1900,189,526,715,Saturday
2020,6,13,1800,250,615,865,Saturday
2020,6,13,1700,293,535,828,Saturday
2020,6,13,1600,365,506,871,Saturday
2020,6,13,1500,392,485,877,Saturday
2020,6,13,1400,458,437,895,Saturday
2020,6,13,1300,571,378,949,Saturday
2020,6,13,1200,571,276,847,Saturday
2020,6,13,1100,499,212,711,Saturday
2020,6,13,1000,492,133,625,Saturday
2020,6,13,900,283,115,398,Saturday
2020,6,13,800,200,75,275,Saturday
2020,6,13,700,121,56,177,Saturday
2020,6,13,600,47,54,101,Saturday
2020,6,13,500,28,41,69,Saturday
2020,6,13,400,26,29,55,Saturday
2020,6,13,300,27,34,61,Saturday
2020,6,13,200,21,27,48,Saturday
2020,6,13,100,37,42,79,Saturday
2020,6,12,2400,50,93,143,Friday
2020,6,12,2300,85,127,212,Friday
2020,6,12,2200,124,178,302,Friday
2020,6,12,2100,204,319,523,Friday
2020,6,12,2000,340,391,731,Friday
2020,6,12,1900,426,404,830,Friday
2020,6,12,1800,510,550,1060,Friday
2020,6,12,1700,524,507,1031,Friday
2020,6,12,1600,648,576,1224,Friday
2020,6,12,1500,601,473,1074,Friday
2020,6,12,1400,559,406,965,Friday
2020,6,12,1300,513,347,860,Friday
2020,6,12,1200,595,291,886,Friday
2020,6,12,1100,580,195,775,Friday
2020,6,12,1000,470,146,616,Friday
2020,6,12,900,396,96,492,Friday
2020,6,12,800,253,85,338,Friday
2020,6,12,700,141,80,221,Friday
2020,6,12,600,65,49,114,Friday
2020,6,12,500,31,29,60,Friday
2020,6,12,400,16,34,50,Friday
2020,6,12,300,31,41,72,Friday
2020,6,12,200,33,61,94,Friday
2020,6,12,100,37,69,106,Friday
2020,6,11,2400,62,110,172,Thursday
2020,6,11,2300,108,120,228,Thursday
2020,6,11,2200,159,204,363,Thursday
2020,6,11,2100,234,272,506,Thursday
2020,6,11,2000,308,326,634,Thursday
2020,6,11,1900,402,416,818,Thursday
2020,6,11,1800,420,552,972,Thursday
2020,6,11,1700,453,498,951,Thursday
2020,6,11,1600,432,471,903,Thursday
2020,6,11,1500,504,401,905,Thursday
2020,6,11,1400,504,315,819,Thursday
2020,6,11,1300,529,298,827,Thursday
2020,6,11,1200,540,257,797,Thursday
2020,6,11,1100,533,191,724,Thursday
2020,6,11,1000,431,151,582,Thursday
2020,6,11,900,342,94,436,Thursday
2020,6,11,800,231,88,319,Thursday
2020,6,11,700,132,66,198,Thursday
2020,6,11,600,58,44,102,Thursday
2020,6,11,500,39,21,60,Thursday
2020,6,11,400,32,47,79,Thursday
2020,6,11,300,28,31,59,Thursday
2020,6,11,200,34,58,92,Thursday
2020,6,11,100,41,85,126,Thursday
2020,6,10,2400,61,115,176,Wednesday
2020,6,10,2300,72,134,206,Wednesday
2020,6,10,2200,100,199,299,Wednesday
2020,6,10,2100,180,219,399,Wednesday
2020,6,10,2000,214,317,531,Wednesday
2020,6,10,1900,257,392,649,Wednesday
2020,6,10,1800,281,439,720,Wednesday
2020,6,10,1700,321,438,759,Wednesday
2020,6,10,1600,368,363,731,Wednesday
2020,6,10,1500,379,338,717,Wednesday
2020,6,10,1400,467,299,766,Wednesday
2020,6,10,1300,460,289,749,Wednesday
2020,6,10,1200,494,248,742,Wednesday
2020,6,10,1100,413,189,602,Wednesday
2020,6,10,1000,344,143,487,Wednesday
2020,6,10,900,297,94,391,Wednesday
2020,6,10,800,230,79,309,Wednesday
2020,6,10,700,103,69,172,Wednesday
2020,6,10,600,58,37,95,Wednesday
2020,6,10,500,28,31,59,Wednesday
2020,6,10,400,27,29,56,Wednesday
2020,6,10,300,29,43,72,Wednesday
2020,6,10,200,28,44,72,Wednesday
2020,6,10,100,33,70,103,Wednesday
2020,6,9,2400,58,85,143,Tuesday
2020,6,9,2300,85,118,203,Tuesday
2020,6,9,2200,99,182,281,Tuesday
2020,6,9,2100,143,245,388,Tuesday
2020,6,9,2000,166,308,474,Tuesday
2020,6,9,1900,209,371,580,Tuesday
2020,6,9,1800,255,394,649,Tuesday
2020,6,9,1700,268,421,689,Tuesday
2020,6,9,1600,309,401,710,Tuesday
2020,6,9,1500,354,386,740,Tuesday
2020,6,9,1400,391,332,723,Tuesday
2020,6,9,1300,428,261,689,Tuesday
2020,6,9,1200,440,222,662,Tuesday
2020,6,9,1100,419,197,616,Tuesday
2020,6,9,1000,323,164,487,Tuesday
2020,6,9,900,266,105,371,Tuesday
2020,6,9,800,183,83,266,Tuesday
2020,6,9,700,110,72,182,Tuesday
2020,6,9,600,51,38,89,Tuesday
2020,6,9,500,33,39,72,Tuesday
2020,6,9,400,33,39,72,Tuesday
2020,6,9,300,19,36,55,Tuesday
2020,6,9,200,27,44,71,Tuesday
2020,6,9,100,36,68,104,Tuesday
2020,6,8,2400,41,106,147,Monday
2020,6,8,2300,66,137,203,Monday
2020,6,8,2200,90,178,268,Monday
2020,6,8,2100,133,258,391,Monday
2020,6,8,2000,164,326,490,Monday
2020,6,8,1900,206,414,620,Monday
2020,6,8,1800,245,460,705,Monday
2020,6,8,1700,291,430,721,Monday
2020,6,8,1600,327,467,794,Monday
2020,6,8,1500,399,370,769,Monday
2020,6,8,1400,401,314,715,Monday
2020,6,8,1300,417,254,671,Monday
2020,6,8,1200,441,243,684,Monday
2020,6,8,1100,372,166,538,Monday
2020,6,8,1000,344,120,464,Monday
2020,6,8,900,266,92,358,Monday
2020,6,8,800,193,74,267,Monday
2020,6,8,700,98,55,153,Monday
2020,6,8,600,55,16,71,Monday
2020,6,8,500,25,21,46,Monday
2020,6,8,400,15,25,40,Monday
2020,6,8,300,24,34,58,Monday
2020,6,8,200,29,45,74,Monday
2020,6,8,100,21,57,78,Monday
2020,6,7,2400,21,62,83,Sunday
2020,6,7,2300,42,117,159,Sunday
2020,6,7,2200,64,218,282,Sunday
2020,6,7,2100,86,230,316,Sunday
2020,6,7,2000,131,340,471,Sunday
2020,6,7,1900,133,537,670,Sunday
2020,6,7,1800,195,554,749,Sunday
2020,6,7,1700,239,623,862,Sunday
2020,6,7,1600,333,682,1015,Sunday
2020,6,7,1500,332,616,948,Sunday
2020,6,7,1400,374,618,992,Sunday
2020,6,7,1300,440,471,911,Sunday
2020,6,7,1200,410,338,748,Sunday
2020,6,7,1100,332,180,512,Sunday
2020,6,7,1000,235,102,337,Sunday
2020,6,7,900,180,60,240,Sunday
2020,6,7,800,125,36,161,Sunday
2020,6,7,700,71,20,91,Sunday
2020,6,7,600,36,17,53,Sunday
2020,6,7,500,18,14,32,Sunday
2020,6,7,400,17,17,34,Sunday
2020,6,7,300,12,18,30,Sunday
2020,6,7,200,24,42,66,Sunday
2020,6,7,100,21,38,59,Sunday
2020,6,6,2400,37,83,120,Saturday
2020,6,6,2300,40,116,156,Saturday
2020,6,6,2200,68,184,252,Saturday
2020,6,6,2100,100,267,367,Saturday
2020,6,6,2000,128,362,490,Saturday
2020,6,6,1900,172,476,648,Saturday
2020,6,6,1800,244,527,771,Saturday
2020,6,6,1700,282,555,837,Saturday
2020,6,6,1600,361,462,823,Saturday
2020,6,6,1500,442,507,949,Saturday
2020,6,6,1400,528,407,935,Saturday
2020,6,6,1300,526,352,878,Saturday
2020,6,6,1200,564,281,845,Saturday
2020,6,6,1100,475,207,682,Saturday
2020,6,6,1000,399,158,557,Saturday
2020,6,6,900,278,75,353,Saturday
2020,6,6,800,198,69,267,Saturday
2020,6,6,700,111,39,150,Saturday
2020,6,6,600,50,34,84,Saturday
2020,6,6,500,22,32,54,Saturday
2020,6,6,400,23,23,46,Saturday
2020,6,6,300,20,45,65,Saturday
2020,6,6,200,29,38,67,Saturday
2020,6,6,100,37,72,109,Saturday
2020,6,5,2400,46,92,138,Friday
2020,6,5,2300,81,122,203,Friday
2020,6,5,2200,103,172,275,Friday
2020,6,5,2100,170,245,415,Friday
2020,6,5,2000,326,317,643,Friday
2020,6,5,1900,394,380,774,Friday
2020,6,5,1800,443,442,885,Friday
2020,6,5,1700,508,543,1051,Friday
2020,6,5,1600,493,480,973,Friday
2020,6,5,1500,527,438,965,Friday
2020,6,5,1400,528,308,836,Friday
2020,6,5,1300,512,311,823,Friday
2020,6,5,1200,484,256,740,Friday
2020,6,5,1100,488,202,690,Friday
2020,6,5,1000,407,166,573,Friday
2020,6,5,900,297,101,398,Friday
2020,6,5,800,231,90,321,Friday
2020,6,5,700,116,47,163,Friday
2020,6,5,600,70,41,111,Friday
2020,6,5,500,43,28,71,Friday
2020,6,5,400,36,40,76,Friday
2020,6,5,300,28,43,71,Friday
2020,6,5,200,33,63,96,Friday
2020,6,5,100,46,74,120,Friday
2020,6,4,2400,56,92,148,Thursday
2020,6,4,2300,75,123,198,Thursday
2020,6,4,2200,113,169,282,Thursday
2020,6,4,2100,189,215,404,Thursday
2020,6,4,2000,290,271,561,Thursday
2020,6,4,1900,335,353,688,Thursday
2020,6,4,1800,370,401,771,Thursday
2020,6,4,1700,368,413,781,Thursday
2020,6,4,1600,373,382,755,Thursday
2020,6,4,1500,412,313,725,Thursday
2020,6,4,1400,434,269,703,Thursday
2020,6,4,1300,417,254,671,Thursday
2020,6,4,1200,413,216,629,Thursday
2020,6,4,1100,397,174,571,Thursday
2020,6,4,1000,321,135,456,Thursday
2020,6,4,900,249,121,370,Thursday
2020,6,4,800,215,69,284,Thursday
2020,6,4,700,99,47,146,Thursday
2020,6,4,600,54,43,97,Thursday
2020,6,4,500,31,40,71,Thursday
2020,6,4,400,28,40,68,Thursday
2020,6,4,300,21,33,54,Thursday
2020,6,4,200,39,70,109,Thursday
2020,6,4,100,48,72,120,Thursday
2020,6,3,2400,58,84,142,Wednesday
2020,6,3,2300,76,84,160,Wednesday
2020,6,3,2200,93,145,238,Wednesday
2020,6,3,2100,113,230,343,Wednesday
2020,6,3,2000,187,267,454,Wednesday
2020,6,3,1900,223,394,617,Wednesday
2020,6,3,1800,268,370,638,Wednesday
2020,6,3,1700,322,393,715,Wednesday
2020,6,3,1600,341,384,725,Wednesday
2020,6,3,1500,346,306,652,Wednesday
2020,6,3,1400,336,301,637,Wednesday
2020,6,3,1300,391,236,627,Wednesday
2020,6,3,1200,400,222,622,Wednesday
2020,6,3,1100,391,194,585,Wednesday
2020,6,3,1000,312,121,433,Wednesday
2020,6,3,900,259,94,353,Wednesday
2020,6,3,800,184,76,260,Wednesday
2020,6,3,700,107,58,165,Wednesday
2020,6,3,600,50,30,80,Wednesday
2020,6,3,500,25,32,57,Wednesday
2020,6,3,400,20,38,58,Wednesday
2020,6,3,300,26,44,70,Wednesday
2020,6,3,200,31,57,88,Wednesday
2020,6,3,100,42,92,134,Wednesday
2020,6,2,2400,62,113,175,Tuesday
2020,6,2,2300,75,118,193,Tuesday
2020,6,2,2200,89,156,245,Tuesday
2020,6,2,2100,106,215,321,Tuesday
2020,6,2,2000,150,305,455,Tuesday
2020,6,2,1900,198,384,582,Tuesday
2020,6,2,1800,236,477,713,Tuesday
2020,6,2,1700,275,413,688,Tuesday
2020,6,2,1600,290,381,671,Tuesday
2020,6,2,1500,346,330,676,Tuesday
2020,6,2,1400,381,309,690,Tuesday
2020,6,2,1300,356,276,632,Tuesday
2020,6,2,1200,455,197,652,Tuesday
2020,6,2,1100,336,168,504,Tuesday
2020,6,2,1000,302,127,429,Tuesday
2020,6,2,900,254,99,353,Tuesday
2020,6,2,800,172,94,266,Tuesday
2020,6,2,700,106,46,152,Tuesday
2020,6,2,600,43,36,79,Tuesday
2020,6,2,500,25,42,67,Tuesday
2020,6,2,400,31,46,77,Tuesday
2020,6,2,300,24,47,71,Tuesday
2020,6,2,200,39,60,99,Tuesday
2020,6,2,100,40,63,103,Tuesday
2020,6,1,2400,56,101,157,Monday
2020,6,1,2300,74,132,206,Monday
2020,6,1,2200,88,181,269,Monday
2020,6,1,2100,135,261,396,Monday
2020,6,1,2000,178,320,498,Monday
2020,6,1,1900,183,416,599,Monday
2020,6,1,1800,223,391,614,Monday
2020,6,1,1700,275,489,764,Monday
2020,6,1,1600,313,445,758,Monday
2020,6,1,1500,349,364,713,Monday
2020,6,1,1400,381,315,696,Monday
2020,6,1,1300,381,309,690,Monday
2020,6,1,1200,422,236,658,Monday
2020,6,1,1100,392,187,579,Monday
2020,6,1,1000,353,132,485,Monday
2020,6,1,900,238,95,333,Monday
2020,6,1,800,175,81,256,Monday
2020,6,1,700,120,28,148,Monday
2020,6,1,600,56,16,72,Monday
2020,6,1,500,33,24,57,Monday
2020,6,1,400,26,25,51,Monday
2020,6,1,300,22,21,43,Monday
2020,6,1,200,17,38,55,Monday
2020,6,1,100,25,57,82,Monday
2020,5,31,2400,24,74,98,Sunday
2020,5,31,2300,52,116,168,Sunday
2020,5,31,2200,60,167,227,Sunday
2020,5,31,2100,100,249,349,Sunday
2020,5,31,2000,121,349,470,Sunday
2020,5,31,1900,153,517,670,Sunday
2020,5,31,1800,196,602,798,Sunday
2020,5,31,1700,235,755,990,Sunday
2020,5,31,1600,298,870,1168,Sunday
2020,5,31,1500,324,782,1106,Sunday
2020,5,31,1400,355,821,1176,Sunday
2020,5,31,1300,379,659,1038,Sunday
2020,5,31,1200,347,453,800,Sunday
2020,5,31,1100,356,239,595,Sunday
2020,5,31,1000,265,124,389,Sunday
2020,5,31,900,178,73,251,Sunday
2020,5,31,800,128,39,167,Sunday
2020,5,31,700,62,22,84,Sunday
2020,5,31,600,34,14,48,Sunday
2020,5,31,500,16,12,28,Sunday
2020,5,31,400,13,13,26,Sunday
2020,5,31,300,15,23,38,Sunday
2020,5,31,200,18,44,62,Sunday
2020,5,31,100,28,54,82,Sunday
2020,5,30,2400,44,72,116,Saturday
2020,5,30,2300,47,131,178,Saturday
2020,5,30,2200,48,171,219,Saturday
2020,5,30,2100,98,249,347,Saturday
2020,5,30,2000,141,338,479,Saturday
2020,5,30,1900,166,391,557,Saturday
2020,5,30,1800,191,448,639,Saturday
2020,5,30,1700,240,480,720,Saturday
2020,5,30,1600,284,446,730,Saturday
2020,5,30,1500,363,371,734,Saturday
2020,5,30,1400,424,322,746,Saturday
2020,5,30,1300,435,280,715,Saturday
2020,5,30,1200,534,203,737,Saturday
2020,5,30,1100,454,179,633,Saturday
2020,5,30,1000,367,144,511,Saturday
2020,5,30,900,300,79,379,Saturday
2020,5,30,800,218,85,303,Saturday
2020,5,30,700,110,45,155,Saturday
2020,5,30,600,57,49,106,Saturday
2020,5,30,500,25,26,51,Saturday
2020,5,30,400,22,32,54,Saturday
2020,5,30,300,25,42,67,Saturday
2020,5,30,200,23,40,63,Saturday
2020,5,30,100,35,50,85,Saturday
2020,5,29,2400,47,92,139,Friday
2020,5,29,2300,89,118,207,Friday
2020,5,29,2200,144,127,271,Friday
2020,5,29,2100,229,217,446,Friday
2020,5,29,2000,373,247,620,Friday
2020,5,29,1900,472,329,801,Friday
2020,5,29,1800,534,318,852,Friday
2020,5,29,1700,532,339,871,Friday
2020,5,29,1600,548,337,885,Friday
2020,5,29,1500,517,313,830,Friday
2020,5,29,1400,504,293,797,Friday
2020,5,29,1300,467,256,723,Friday
2020,5,29,1200,438,193,631,Friday
2020,5,29,1100,431,184,615,Friday
2020,5,29,1000,367,132,499,Friday
2020,5,29,900,295,96,391,Friday
2020,5,29,800,229,88,317,Friday
2020,5,29,700,131,50,181,Friday
2020,5,29,600,55,32,87,Friday
2020,5,29,500,36,54,90,Friday
2020,5,29,400,28,33,61,Friday
2020,5,29,300,21,38,59,Friday
2020,5,29,200,39,41,80,Friday
2020,5,29,100,50,64,114,Friday
2020,5,28,2400,52,72,124,Thursday
2020,5,28,2300,80,151,231,Thursday
2020,5,28,2200,133,149,282,Thursday
2020,5,28,2100,225,188,413,Thursday
2020,5,28,2000,331,249,580,Thursday
2020,5,28,1900,400,268,668,Thursday
2020,5,28,1800,465,346,811,Thursday
2020,5,28,1700,416,359,775,Thursday
2020,5,28,1600,406,319,725,Thursday
2020,5,28,1500,420,300,720,Thursday
2020,5,28,1400,387,265,652,Thursday
2020,5,28,1300,423,239,662,Thursday
2020,5,28,1200,393,196,589,Thursday
2020,5,28,1100,384,168,552,Thursday
2020,5,28,1000,320,130,450,Thursday
2020,5,28,900,263,100,363,Thursday
2020,5,28,800,211,61,272,Thursday
2020,5,28,700,105,59,164,Thursday
2020,5,28,600,50,27,77,Thursday
2020,5,28,500,25,37,62,Thursday
2020,5,28,400,34,47,81,Thursday
2020,5,28,300,31,41,72,Thursday
2020,5,28,200,28,44,72,Thursday
2020,5,28,100,54,58,112,Thursday
2020,5,27,2400,62,80,142,Wednesday
2020,5,27,2300,97,115,212,Wednesday
2020,5,27,2200,84,131,215,Wednesday
2020,5,27,2100,128,198,326,Wednesday
2020,5,27,2000,183,262,445,Wednesday
2020,5,27,1900,224,281,505,Wednesday
2020,5,27,1800,269,334,603,Wednesday
2020,5,27,1700,309,286,595,Wednesday
2020,5,27,1600,332,308,640,Wednesday
2020,5,27,1500,324,255,579,Wednesday
2020,5,27,1400,367,239,606,Wednesday
2020,5,27,1300,315,238,553,Wednesday
2020,5,27,1200,406,165,571,Wednesday
2020,5,27,1100,295,155,450,Wednesday
2020,5,27,1000,278,114,392,Wednesday
2020,5,27,900,235,106,341,Wednesday
2020,5,27,800,197,70,267,Wednesday
2020,5,27,700,108,55,163,Wednesday
2020,5,27,600,44,35,79,Wednesday
2020,5,27,500,32,33,65,Wednesday
2020,5,27,400,18,33,51,Wednesday
2020,5,27,300,21,39,60,Wednesday
2020,5,27,200,26,47,73,Wednesday
2020,5,27,100,32,71,103,Wednesday
2020,5,26,2400,55,72,127,Tuesday
2020,5,26,2300,78,115,193,Tuesday
2020,5,26,2200,92,130,222,Tuesday
2020,5,26,2100,120,158,278,Tuesday
2020,5,26,2000,153,196,349,Tuesday
2020,5,26,1900,163,249,412,Tuesday
2020,5,26,1800,231,274,505,Tuesday
2020,5,26,1700,223,300,523,Tuesday
2020,5,26,1600,259,272,531,Tuesday
2020,5,26,1500,275,287,562,Tuesday
2020,5,26,1400,300,262,562,Tuesday
2020,5,26,1300,290,234,524,Tuesday
2020,5,26,1200,319,182,501,Tuesday
2020,5,26,1100,266,178,444,Tuesday
2020,5,26,1000,228,112,340,Tuesday
2020,5,26,900,211,101,312,Tuesday
2020,5,26,800,173,71,244,Tuesday
2020,5,26,700,76,48,124,Tuesday
2020,5,26,600,48,38,86,Tuesday
2020,5,26,500,28,24,52,Tuesday
2020,5,26,400,22,43,65,Tuesday
2020,5,26,300,20,43,63,Tuesday
2020,5,26,200,28,33,61,Tuesday
2020,5,26,100,31,72,103,Tuesday
2020,5,25,2400,53,66,119,Monday
2020,5,25,2300,54,94,148,Monday
2020,5,25,2200,83,151,234,Monday
2020,5,25,2100,124,224,348,Monday
2020,5,25,2000,136,264,400,Monday
2020,5,25,1900,156,352,508,Monday
2020,5,25,1800,216,304,520,Monday
2020,5,25,1700,241,337,578,Monday
2020,5,25,1600,287,323,610,Monday
2020,5,25,1500,299,307,606,Monday
2020,5,25,1400,312,310,622,Monday
2020,5,25,1300,341,238,579,Monday
2020,5,25,1200,303,196,499,Monday
2020,5,25,1100,297,164,461,Monday
2020,5,25,1000,222,119,341,Monday
2020,5,25,900,193,86,279,Monday
2020,5,25,800,188,58,246,Monday
2020,5,25,700,105,36,141,Monday
2020,5,25,600,47,21,68,Monday
2020,5,25,500,22,18,40,Monday
2020,5,25,400,15,25,40,Monday
2020,5,25,300,20,22,42,Monday
2020,5,25,200,19,28,47,Monday
2020,5,25,100,18,46,64,Monday
2020,5,24,2400,36,64,100,Sunday
2020,5,24,2300,47,123,170,Sunday
2020,5,24,2200,61,182,243,Sunday
2020,5,24,2100,81,325,406,Sunday
2020,5,24,2000,102,401,503,Sunday
2020,5,24,1900,129,537,666,Sunday
2020,5,24,1800,177,578,755,Sunday
2020,5,24,1700,246,599,845,Sunday
2020,5,24,1600,302,638,940,Sunday
2020,5,24,1500,314,471,785,Sunday
2020,5,24,1400,334,376,710,Sunday
2020,5,24,1300,363,348,711,Sunday
2020,5,24,1200,361,196,557,Sunday
2020,5,24,1100,335,174,509,Sunday
2020,5,24,1000,273,92,365,Sunday
2020,5,24,900,182,56,238,Sunday
2020,5,24,800,150,33,183,Sunday
2020,5,24,700,69,25,94,Sunday
2020,5,24,600,32,12,44,Sunday
2020,5,24,500,18,13,31,Sunday
2020,5,24,400,18,22,40,Sunday
2020,5,24,300,10,22,32,Sunday
2020,5,24,200,12,34,46,Sunday
2020,5,24,100,25,39,64,Sunday
2020,5,23,2400,37,54,91,Saturday
2020,5,23,2300,39,100,139,Saturday
2020,5,23,2200,50,121,171,Saturday
2020,5,23,2100,91,196,287,Saturday
2020,5,23,2000,102,194,296,Saturday
2020,5,23,1900,118,256,374,Saturday
2020,5,23,1800,170,297,467,Saturday
2020,5,23,1700,210,377,587,Saturday
2020,5,23,1600,251,294,545,Saturday
2020,5,23,1500,314,295,609,Saturday
2020,5,23,1400,348,236,584,Saturday
2020,5,23,1300,349,206,555,Saturday
2020,5,23,1200,384,171,555,Saturday
2020,5,23,1100,345,173,518,Saturday
2020,5,23,1000,265,113,378,Saturday
2020,5,23,900,216,82,298,Saturday
2020,5,23,800,150,56,206,Saturday
2020,5,23,700,93,47,140,Saturday
2020,5,23,600,35,23,58,Saturday
2020,5,23,500,16,24,40,Saturday
2020,5,23,400,12,36,48,Saturday
2020,5,23,300,23,36,59,Saturday
2020,5,23,200,24,45,69,Saturday
2020,5,23,100,47,60,107,Saturday
2020,5,22,2400,38,84,122,Friday
2020,5,22,2300,60,75,135,Friday
2020,5,22,2200,92,123,215,Friday
2020,5,22,2100,168,138,306,Friday
2020,5,22,2000,270,188,458,Friday
2020,5,22,1900,364,193,557,Friday
2020,5,22,1800,440,278,718,Friday
2020,5,22,1700,385,283,668,Friday
2020,5,22,1600,384,276,660,Friday
2020,5,22,1500,432,256,688,Friday
2020,5,22,1400,375,218,593,Friday
2020,5,22,1300,331,249,580,Friday
2020,5,22,1200,304,207,511,Friday
2020,5,22,1100,312,170,482,Friday
2020,5,22,1000,272,98,370,Friday
2020,5,22,900,177,100,277,Friday
2020,5,22,800,156,83,239,Friday
2020,5,22,700,95,45,140,Friday
2020,5,22,600,41,35,76,Friday
2020,5,22,500,25,38,63,Friday
2020,5,22,400,18,29,47,Friday
2020,5,22,300,25,38,63,Friday
2020,5,22,200,25,45,70,Friday
2020,5,22,100,41,53,94,Friday
2020,5,21,2400,57,86,143,Thursday
2020,5,21,2300,56,89,145,Thursday
2020,5,21,2200,75,142,217,Thursday
2020,5,21,2100,100,132,232,Thursday
2020,5,21,2000,169,198,367,Thursday
2020,5,21,1900,197,246,443,Thursday
2020,5,21,1800,260,231,491,Thursday
2020,5,21,1700,266,264,530,Thursday
2020,5,21,1600,291,255,546,Thursday
2020,5,21,1500,267,249,516,Thursday
2020,5,21,1400,272,259,531,Thursday
2020,5,21,1300,269,224,493,Thursday
2020,5,21,1200,291,156,447,Thursday
2020,5,21,1100,244,144,388,Thursday
2020,5,21,1000,173,133,306,Thursday
2020,5,21,900,174,83,257,Thursday
2020,5,21,800,137,69,206,Thursday
2020,5,21,700,85,44,129,Thursday
2020,5,21,600,36,47,83,Thursday
2020,5,21,500,22,30,52,Thursday
2020,5,21,400,20,31,51,Thursday
2020,5,21,300,32,32,64,Thursday
2020,5,21,200,24,38,62,Thursday
2020,5,21,100,30,51,81,Thursday
2020,5,20,2400,37,71,108,Wednesday
2020,5,20,2300,66,97,163,Wednesday
2020,5,20,2200,69,132,201,Wednesday
2020,5,20,2100,112,190,302,Wednesday
2020,5,20,2000,159,245,404,Wednesday
2020,5,20,1900,160,284,444,Wednesday
2020,5,20,1800,186,314,500,Wednesday
2020,5,20,1700,189,334,523,Wednesday
2020,5,20,1600,241,265,506,Wednesday
2020,5,20,1500,259,268,527,Wednesday
2020,5,20,1400,276,213,489,Wednesday
2020,5,20,1300,264,228,492,Wednesday
2020,5,20,1200,262,195,457,Wednesday
2020,5,20,1100,202,155,357,Wednesday
2020,5,20,1000,207,122,329,Wednesday
2020,5,20,900,176,101,277,Wednesday
2020,5,20,800,140,75,215,Wednesday
2020,5,20,700,107,58,165,Wednesday
2020,5,20,600,36,28,64,Wednesday
2020,5,20,500,29,34,63,Wednesday
2020,5,20,400,17,44,61,Wednesday
2020,5,20,300,21,27,48,Wednesday
2020,5,20,200,35,48,83,Wednesday
2020,5,20,100,35,58,93,Wednesday
2020,5,19,2400,62,74,136,Tuesday
2020,5,19,2300,77,120,197,Tuesday
2020,5,19,2200,67,148,215,Tuesday
2020,5,19,2100,100,176,276,Tuesday
2020,5,19,2000,109,321,430,Tuesday
2020,5,19,1900,175,337,512,Tuesday
2020,5,19,1800,168,390,558,Tuesday
2020,5,19,1700,226,387,613,Tuesday
2020,5,19,1600,242,388,630,Tuesday
2020,5,19,1500,241,276,517,Tuesday
2020,5,19,1400,264,314,578,Tuesday
2020,5,19,1300,293,244,537,Tuesday
2020,5,19,1200,285,205,490,Tuesday
2020,5,19,1100,280,144,424,Tuesday
2020,5,19,1000,241,127,368,Tuesday
2020,5,19,900,202,85,287,Tuesday
2020,5,19,800,151,98,249,Tuesday
2020,5,19,700,88,49,137,Tuesday
2020,5,19,600,45,17,62,Tuesday
2020,5,19,500,15,14,29,Tuesday
2020,5,19,400,12,29,41,Tuesday
2020,5,19,300,23,40,63,Tuesday
2020,5,19,200,20,33,53,Tuesday
2020,5,19,100,25,43,68,Tuesday
2020,5,18,2400,39,86,125,Monday
2020,5,18,2300,45,131,176,Monday
2020,5,18,2200,48,230,278,Monday
2020,5,18,2100,95,353,448,Monday
2020,5,18,2000,98,539,637,Monday
2020,5,18,1900,136,652,788,Monday
2020,5,18,1800,188,752,940,Monday
2020,5,18,1700,208,908,1116,Monday
2020,5,18,1600,289,885,1174,Monday
2020,5,18,1500,353,814,1167,Monday
2020,5,18,1400,336,728,1064,Monday
2020,5,18,1300,397,578,975,Monday
2020,5,18,1200,378,339,717,Monday
2020,5,18,1100,300,217,517,Monday
2020,5,18,1000,243,112,355,Monday
2020,5,18,900,207,69,276,Monday
2020,5,18,800,113,45,158,Monday
2020,5,18,700,58,20,78,Monday
2020,5,18,600,37,8,45,Monday
2020,5,18,500,25,4,29,Monday
2020,5,18,400,11,22,33,Monday
2020,5,18,300,15,28,43,Monday
2020,5,18,200,14,29,43,Monday
2020,5,18,100,16,48,64,Monday
2020,5,17,2400,29,62,91,Sunday
2020,5,17,2300,35,114,149,Sunday
2020,5,17,2200,62,139,201,Sunday
2020,5,17,2100,91,229,320,Sunday
2020,5,17,2000,115,231,346,Sunday
2020,5,17,1900,120,393,513,Sunday
2020,5,17,1800,127,410,537,Sunday
2020,5,17,1700,197,492,689,Sunday
2020,5,17,1600,264,547,811,Sunday
2020,5,17,1500,274,402,676,Sunday
2020,5,17,1400,288,345,633,Sunday
2020,5,17,1300,341,260,601,Sunday
2020,5,17,1200,335,203,538,Sunday
2020,5,17,1100,247,127,374,Sunday
2020,5,17,1000,202,75,277,Sunday
2020,5,17,900,166,43,209,Sunday
2020,5,17,800,103,31,134,Sunday
2020,5,17,700,54,17,71,Sunday
2020,5,17,600,24,15,39,Sunday
2020,5,17,500,15,4,19,Sunday
2020,5,17,400,18,12,30,Sunday
2020,5,17,300,14,27,41,Sunday
2020,5,17,200,13,27,40,Sunday
2020,5,17,100,19,55,74,Sunday
2020,5,16,2400,33,61,94,Saturday
2020,5,16,2300,40,97,137,Saturday
2020,5,16,2200,59,156,215,Saturday
2020,5,16,2100,85,170,255,Saturday
2020,5,16,2000,124,226,350,Saturday
2020,5,16,1900,151,297,448,Saturday
2020,5,16,1800,174,311,485,Saturday
2020,5,16,1700,210,340,550,Saturday
2020,5,16,1600,266,319,585,Saturday
2020,5,16,1500,372,253,625,Saturday
2020,5,16,1400,444,255,699,Saturday
2020,5,16,1300,405,213,618,Saturday
2020,5,16,1200,400,190,590,Saturday
2020,5,16,1100,454,130,584,Saturday
2020,5,16,1000,356,109,465,Saturday
2020,5,16,900,256,85,341,Saturday
2020,5,16,800,187,69,256,Saturday
2020,5,16,700,95,36,131,Saturday
2020,5,16,600,46,37,83,Saturday
2020,5,16,500,25,22,47,Saturday
2020,5,16,400,21,37,58,Saturday
2020,5,16,300,27,38,65,Saturday
2020,5,16,200,23,40,63,Saturday
2020,5,16,100,40,34,74,Saturday
2020,5,15,2400,64,88,152,Friday
2020,5,15,2300,82,114,196,Friday
2020,5,15,2200,139,135,274,Friday
2020,5,15,2100,242,171,413,Friday
2020,5,15,2000,356,232,588,Friday
2020,5,15,1900,473,243,716,Friday
2020,5,15,1800,569,267,836,Friday
2020,5,15,1700,582,305,887,Friday
2020,5,15,1600,586,277,863,Friday
2020,5,15,1500,574,276,850,Friday
2020,5,15,1400,585,238,823,Friday
2020,5,15,1300,439,251,690,Friday
2020,5,15,1200,433,196,629,Friday
2020,5,15,1100,431,119,550,Friday
2020,5,15,1000,413,115,528,Friday
2020,5,15,900,278,98,376,Friday
2020,5,15,800,210,80,290,Friday
2020,5,15,700,107,55,162,Friday
2020,5,15,600,55,32,87,Friday
2020,5,15,500,37,38,75,Friday
2020,5,15,400,34,38,72,Friday
2020,5,15,300,23,28,51,Friday
2020,5,15,200,24,52,76,Friday
2020,5,15,100,43,64,107,Friday
2020,5,14,2400,54,99,153,Thursday
2020,5,14,2300,103,101,204,Thursday
2020,5,14,2200,110,120,230,Thursday
2020,5,14,2100,226,185,411,Thursday
2020,5,14,2000,374,207,581,Thursday
2020,5,14,1900,461,246,707,Thursday
2020,5,14,1800,518,289,807,Thursday
2020,5,14,1700,462,251,713,Thursday
2020,5,14,1600,444,309,753,Thursday
2020,5,14,1500,437,246,683,Thursday
2020,5,14,1400,405,254,659,Thursday
2020,5,14,1300,418,220,638,Thursday
2020,5,14,1200,407,164,571,Thursday
2020,5,14,1100,322,152,474,Thursday
2020,5,14,1000,268,122,390,Thursday
2020,5,14,900,217,85,302,Thursday
2020,5,14,800,206,61,267,Thursday
2020,5,14,700,80,49,129,Thursday
2020,5,14,600,51,36,87,Thursday
2020,5,14,500,34,24,58,Thursday
2020,5,14,400,22,33,55,Thursday
2020,5,14,300,28,40,68,Thursday
2020,5,14,200,30,49,79,Thursday
2020,5,14,100,39,55,94,Thursday
2020,5,13,2400,54,72,126,Wednesday
2020,5,13,2300,83,79,162,Wednesday
2020,5,13,2200,83,151,234,Wednesday
2020,5,13,2100,137,168,305,Wednesday
2020,5,13,2000,183,206,389,Wednesday
2020,5,13,1900,225,264,489,Wednesday
2020,5,13,1800,254,289,543,Wednesday
2020,5,13,1700,269,279,548,Wednesday
2020,5,13,1600,272,256,528,Wednesday
2020,5,13,1500,295,235,530,Wednesday
2020,5,13,1400,277,207,484,Wednesday
2020,5,13,1300,305,195,500,Wednesday
2020,5,13,1200,299,151,450,Wednesday
2020,5,13,1100,301,129,430,Wednesday
2020,5,13,1000,224,122,346,Wednesday
2020,5,13,900,215,73,288,Wednesday
2020,5,13,800,143,66,209,Wednesday
2020,5,13,700,84,52,136,Wednesday
2020,5,13,600,46,39,85,Wednesday
2020,5,13,500,20,22,42,Wednesday
2020,5,13,400,17,36,53,Wednesday
2020,5,13,300,20,47,67,Wednesday
2020,5,13,200,29,48,77,Wednesday
2020,5,13,100,35,47,82,Wednesday
2020,5,12,2400,47,71,118,Tuesday
2020,5,12,2300,61,89,150,Tuesday
2020,5,12,2200,70,111,181,Tuesday
2020,5,12,2100,99,160,259,Tuesday
2020,5,12,2000,104,212,316,Tuesday
2020,5,12,1900,151,230,381,Tuesday
2020,5,12,1800,172,266,438,Tuesday
2020,5,12,1700,214,237,451,Tuesday
2020,5,12,1600,245,256,501,Tuesday
2020,5,12,1500,263,226,489,Tuesday
2020,5,12,1400,232,223,455,Tuesday
2020,5,12,1300,240,188,428,Tuesday
2020,5,12,1200,278,190,468,Tuesday
2020,5,12,1100,208,158,366,Tuesday
2020,5,12,1000,209,127,336,Tuesday
2020,5,12,900,142,100,242,Tuesday
2020,5,12,800,124,63,187,Tuesday
2020,5,12,700,82,47,129,Tuesday
2020,5,12,600,46,24,70,Tuesday
2020,5,12,500,23,40,63,Tuesday
2020,5,12,400,15,37,52,Tuesday
2020,5,12,300,16,35,51,Tuesday
2020,5,12,200,25,52,77,Tuesday
2020,5,12,100,30,51,81,Tuesday
2020,5,11,2400,40,62,102,Monday
2020,5,11,2300,58,92,150,Monday
2020,5,11,2200,67,135,202,Monday
2020,5,11,2100,90,161,251,Monday
2020,5,11,2000,107,192,299,Monday
2020,5,11,1900,161,235,396,Monday
2020,5,11,1800,166,296,462,Monday
2020,5,11,1700,196,330,526,Monday
2020,5,11,1600,214,309,523,Monday
2020,5,11,1500,265,246,511,Monday
2020,5,11,1400,250,231,481,Monday
2020,5,11,1300,273,190,463,Monday
2020,5,11,1200,236,172,408,Monday
2020,5,11,1100,261,125,386,Monday
2020,5,11,1000,226,98,324,Monday
2020,5,11,900,176,62,238,Monday
2020,5,11,800,142,47,189,Monday
2020,5,11,700,91,33,124,Monday
2020,5,11,600,40,21,61,Monday
2020,5,11,500,19,17,36,Monday
2020,5,11,400,14,23,37,Monday
2020,5,11,300,19,15,34,Monday
2020,5,11,200,17,27,44,Monday
2020,5,11,100,22,52,74,Monday
2020,5,10,2400,36,61,97,Sunday
2020,5,10,2300,36,109,145,Sunday
2020,5,10,2200,51,107,158,Sunday
2020,5,10,2100,52,202,254,Sunday
2020,5,10,2000,109,270,379,Sunday
2020,5,10,1900,99,343,442,Sunday
2020,5,10,1800,130,393,523,Sunday
2020,5,10,1700,174,390,564,Sunday
2020,5,10,1600,167,487,654,Sunday
2020,5,10,1500,215,424,639,Sunday
2020,5,10,1400,234,369,603,Sunday
2020,5,10,1300,204,317,521,Sunday
2020,5,10,1200,217,221,438,Sunday
2020,5,10,1100,204,114,318,Sunday
2020,5,10,1000,171,90,261,Sunday
2020,5,10,900,125,41,166,Sunday
2020,5,10,800,98,32,130,Sunday
2020,5,10,700,60,16,76,Sunday
2020,5,10,600,28,14,42,Sunday
2020,5,10,500,9,28,37,Sunday
2020,5,10,400,13,14,27,Sunday
2020,5,10,300,18,21,39,Sunday
2020,5,10,200,16,31,47,Sunday
2020,5,10,100,17,39,56,Sunday
2020,5,9,2400,28,47,75,Saturday
2020,5,9,2300,32,75,107,Saturday
2020,5,9,2200,42,115,157,Saturday
2020,5,9,2100,58,155,213,Saturday
2020,5,9,2000,87,188,275,Saturday
2020,5,9,1900,115,236,351,Saturday
2020,5,9,1800,143,287,430,Saturday
2020,5,9,1700,146,289,435,Saturday
2020,5,9,1600,225,274,499,Saturday
2020,5,9,1500,244,226,470,Saturday
2020,5,9,1400,276,227,503,Saturday
2020,5,9,1300,306,180,486,Saturday
2020,5,9,1200,311,175,486,Saturday
2020,5,9,1100,323,111,434,Saturday
2020,5,9,1000,244,100,344,Saturday
2020,5,9,900,224,69,293,Saturday
2020,5,9,800,146,57,203,Saturday
2020,5,9,700,80,28,108,Saturday
2020,5,9,600,34,28,62,Saturday
2020,5,9,500,15,24,39,Saturday
2020,5,9,400,11,31,42,Saturday
2020,5,9,300,18,28,46,Saturday
2020,5,9,200,35,44,79,Saturday
2020,5,9,100,42,41,83,Saturday
2020,5,8,2400,38,61,99,Friday
2020,5,8,2300,52,88,140,Friday
2020,5,8,2200,84,133,217,Friday
2020,5,8,2100,136,150,286,Friday
2020,5,8,2000,222,152,374,Friday
2020,5,8,1900,285,211,496,Friday
2020,5,8,1800,387,229,616,Friday
2020,5,8,1700,368,224,592,Friday
2020,5,8,1600,406,247,653,Friday
2020,5,8,1500,441,201,642,Friday
2020,5,8,1400,395,171,566,Friday
2020,5,8,1300,358,165,523,Friday
2020,5,8,1200,317,175,492,Friday
2020,5,8,1100,336,132,468,Friday
2020,5,8,1000,280,88,368,Friday
2020,5,8,900,213,85,298,Friday
2020,5,8,800,171,78,249,Friday
2020,5,8,700,78,46,124,Friday
2020,5,8,600,43,22,65,Friday
2020,5,8,500,27,32,59,Friday
2020,5,8,400,30,28,58,Friday
2020,5,8,300,21,47,68,Friday
2020,5,8,200,27,42,69,Friday
2020,5,8,100,46,51,97,Friday
2020,5,7,2400,53,53,106,Thursday
2020,5,7,2300,56,82,138,Thursday
2020,5,7,2200,80,113,193,Thursday
2020,5,7,2100,118,140,258,Thursday
2020,5,7,2000,187,160,347,Thursday
2020,5,7,1900,260,209,469,Thursday
2020,5,7,1800,273,167,440,Thursday
2020,5,7,1700,335,211,546,Thursday
2020,5,7,1600,310,223,533,Thursday
2020,5,7,1500,299,209,508,Thursday
2020,5,7,1400,280,165,445,Thursday
2020,5,7,1300,317,190,507,Thursday
2020,5,7,1200,244,144,388,Thursday
2020,5,7,1100,256,134,390,Thursday
2020,5,7,1000,213,99,312,Thursday
2020,5,7,900,169,82,251,Thursday
2020,5,7,800,152,62,214,Thursday
2020,5,7,700,60,42,102,Thursday
2020,5,7,600,32,38,70,Thursday
2020,5,7,500,30,28,58,Thursday
2020,5,7,400,26,28,54,Thursday
2020,5,7,300,31,49,80,Thursday
2020,5,7,200,31,40,71,Thursday
2020,5,7,100,40,50,90,Thursday
2020,5,6,2400,50,60,110,Wednesday
2020,5,6,2300,47,85,132,Wednesday
2020,5,6,2200,70,89,159,Wednesday
2020,5,6,2100,104,131,235,Wednesday
2020,5,6,2000,128,142,270,Wednesday
2020,5,6,1900,127,200,327,Wednesday
2020,5,6,1800,187,206,393,Wednesday
2020,5,6,1700,200,243,443,Wednesday
2020,5,6,1600,228,209,437,Wednesday
2020,5,6,1500,247,225,472,Wednesday
2020,5,6,1400,219,205,424,Wednesday
2020,5,6,1300,226,201,427,Wednesday
2020,5,6,1200,240,176,416,Wednesday
2020,5,6,1100,230,114,344,Wednesday
2020,5,6,1000,201,129,330,Wednesday
2020,5,6,900,156,78,234,Wednesday
2020,5,6,800,133,74,207,Wednesday
2020,5,6,700,64,56,120,Wednesday
2020,5,6,600,38,30,68,Wednesday
2020,5,6,500,29,28,57,Wednesday
2020,5,6,400,18,22,40,Wednesday
2020,5,6,300,29,36,65,Wednesday
2020,5,6,200,37,39,76,Wednesday
2020,5,6,100,46,67,113,Wednesday
2020,5,5,2400,50,58,108,Tuesday
2020,5,5,2300,59,100,159,Tuesday
2020,5,5,2200,69,105,174,Tuesday
2020,5,5,2100,99,143,242,Tuesday
2020,5,5,2000,122,156,278,Tuesday
2020,5,5,1900,158,223,381,Tuesday
2020,5,5,1800,204,234,438,Tuesday
2020,5,5,1700,191,261,452,Tuesday
2020,5,5,1600,173,171,344,Tuesday
2020,5,5,1500,208,192,400,Tuesday
2020,5,5,1400,235,183,418,Tuesday
2020,5,5,1300,261,181,442,Tuesday
2020,5,5,1200,200,184,384,Tuesday
2020,5,5,1100,226,120,346,Tuesday
2020,5,5,1000,189,94,283,Tuesday
2020,5,5,900,162,81,243,Tuesday
2020,5,5,800,152,57,209,Tuesday
2020,5,5,700,74,55,129,Tuesday
2020,5,5,600,25,31,56,Tuesday
2020,5,5,500,29,27,56,Tuesday
2020,5,5,400,24,35,59,Tuesday
2020,5,5,300,23,31,54,Tuesday
2020,5,5,200,25,43,68,Tuesday
2020,5,5,100,24,36,60,Tuesday
2020,5,4,2400,44,69,113,Monday
2020,5,4,2300,45,75,120,Monday
2020,5,4,2200,70,113,183,Monday
2020,5,4,2100,93,159,252,Monday
2020,5,4,2000,119,144,263,Monday
2020,5,4,1900,130,223,353,Monday
2020,5,4,1800,154,223,377,Monday
2020,5,4,1700,181,239,420,Monday
2020,5,4,1600,192,221,413,Monday
2020,5,4,1500,254,181,435,Monday
2020,5,4,1400,224,167,391,Monday
2020,5,4,1300,245,173,418,Monday
2020,5,4,1200,232,116,348,Monday
2020,5,4,1100,196,102,298,Monday
2020,5,4,1000,184,98,282,Monday
2020,5,4,900,150,76,226,Monday
2020,5,4,800,114,56,170,Monday
2020,5,4,700,81,32,113,Monday
2020,5,4,600,40,17,57,Monday
2020,5,4,500,22,8,30,Monday
2020,5,4,400,14,27,41,Monday
2020,5,4,300,20,18,38,Monday
2020,5,4,200,20,31,51,Monday
2020,5,4,100,15,45,60,Monday
2020,5,3,2400,19,44,63,Sunday
2020,5,3,2300,28,83,111,Sunday
2020,5,3,2200,58,106,164,Sunday
2020,5,3,2100,66,185,251,Sunday
2020,5,3,2000,84,190,274,Sunday
2020,5,3,1900,105,287,392,Sunday
2020,5,3,1800,153,324,477,Sunday
2020,5,3,1700,156,388,544,Sunday
2020,5,3,1600,225,375,600,Sunday
2020,5,3,1500,215,369,584,Sunday
2020,5,3,1400,200,404,604,Sunday
2020,5,3,1300,221,199,420,Sunday
2020,5,3,1200,237,177,414,Sunday
2020,5,3,1100,202,107,309,Sunday
2020,5,3,1000,160,73,233,Sunday
2020,5,3,900,133,38,171,Sunday
2020,5,3,800,79,28,107,Sunday
2020,5,3,700,44,20,64,Sunday
2020,5,3,600,24,11,35,Sunday
2020,5,3,500,5,21,26,Sunday
2020,5,3,400,16,9,25,Sunday
2020,5,3,300,16,23,39,Sunday
2020,5,3,200,22,23,45,Sunday
2020,5,3,100,12,38,50,Sunday
2020,5,2,2400,19,46,65,Saturday
2020,5,2,2300,27,65,92,Saturday
2020,5,2,2200,45,206,251,Saturday
2020,5,2,2100,70,109,179,Saturday
2020,5,2,2000,97,161,258,Saturday
2020,5,2,1900,88,307,395,Saturday
2020,5,2,1800,109,213,322,Saturday
2020,5,2,1700,163,239,402,Saturday
2020,5,2,1600,191,242,433,Saturday
2020,5,2,1500,206,205,411,Saturday
2020,5,2,1400,248,201,449,Saturday
2020,5,2,1300,272,169,441,Saturday
2020,5,2,1200,277,167,444,Saturday
2020,5,2,1100,310,117,427,Saturday
2020,5,2,1000,222,98,320,Saturday
2020,5,2,900,165,62,227,Saturday
2020,5,2,800,127,49,176,Saturday
2020,5,2,700,70,33,103,Saturday
2020,5,2,600,34,21,55,Saturday
2020,5,2,500,23,25,48,Saturday
2020,5,2,400,21,26,47,Saturday
2020,5,2,300,16,40,56,Saturday
2020,5,2,200,22,42,64,Saturday
2020,5,2,100,25,51,76,Saturday
2020,5,1,2400,39,57,96,Friday
2020,5,1,2300,54,78,132,Friday
2020,5,1,2200,68,104,172,Friday
2020,5,1,2100,124,154,278,Friday
2020,5,1,2000,201,165,366,Friday
2020,5,1,1900,235,219,454,Friday
2020,5,1,1800,272,262,534,Friday
2020,5,1,1700,307,212,519,Friday
2020,5,1,1600,260,226,486,Friday
2020,5,1,1500,312,215,527,Friday
2020,5,1,1400,289,187,476,Friday
2020,5,1,1300,285,187,472,Friday
2020,5,1,1200,272,163,435,Friday
2020,5,1,1100,252,116,368,Friday
2020,5,1,1000,226,100,326,Friday
2020,5,1,900,205,79,284,Friday
2020,5,1,800,144,68,212,Friday
2020,5,1,700,83,46,129,Friday
2020,5,1,600,35,35,70,Friday
2020,5,1,500,19,24,43,Friday
2020,5,1,400,28,30,58,Friday
2020,5,1,300,20,53,73,Friday
2020,5,1,200,32,40,72,Friday
2020,5,1,100,38,52,90,Friday
2020,4,30,2400,47,65,112,Thursday
2020,4,30,2300,62,63,125,Thursday
2020,4,30,2200,81,103,184,Thursday
2020,4,30,2100,108,140,248,Thursday
2020,4,30,2000,157,157,314,Thursday
2020,4,30,1900,187,215,402,Thursday
2020,4,30,1800,232,212,444,Thursday
2020,4,30,1700,274,201,475,Thursday
2020,4,30,1600,239,211,450,Thursday
2020,4,30,1500,261,210,471,Thursday
2020,4,30,1400,225,209,434,Thursday
2020,4,30,1300,225,156,381,Thursday
2020,4,30,1200,212,144,356,Thursday
2020,4,30,1100,196,135,331,Thursday
2020,4,30,1000,181,122,303,Thursday
2020,4,30,900,160,97,257,Thursday
2020,4,30,800,152,62,214,Thursday
2020,4,30,700,82,48,130,Thursday
2020,4,30,600,36,21,57,Thursday
2020,4,30,500,31,36,67,Thursday
2020,4,30,400,27,30,57,Thursday
2020,4,30,300,16,18,34,Thursday
2020,4,30,200,37,28,65,Thursday
2020,4,30,100,36,54,90,Thursday
2020,4,29,2400,57,303,360,Wednesday
2020,4,29,2300,50,33,83,Wednesday
2020,4,29,2200,70,107,177,Wednesday
2020,4,29,2100,83,16,99,Wednesday
2020,4,29,2000,125,24,149,Wednesday
2020,4,29,1900,129,164,293,Wednesday
2020,4,29,1800,150,203,353,Wednesday
2020,4,29,1700,191,222,413,Wednesday
2020,4,29,1600,223,192,415,Wednesday
2020,4,29,1500,220,197,417,Wednesday
2020,4,29,1400,218,157,375,Wednesday
2020,4,29,1300,213,173,386,Wednesday
2020,4,29,1200,216,128,344,Wednesday
2020,4,29,1100,184,133,317,Wednesday
2020,4,29,1000,148,104,252,Wednesday
2020,4,29,900,157,96,253,Wednesday
2020,4,29,800,114,59,173,Wednesday
2020,4,29,700,52,47,99,Wednesday
2020,4,29,600,37,29,66,Wednesday
2020,4,29,500,20,35,55,Wednesday
2020,4,29,400,33,33,66,Wednesday
2020,4,29,300,24,32,56,Wednesday
2020,4,29,200,25,45,70,Wednesday
2020,4,29,100,36,37,73,Wednesday
2020,4,28,2400,36,44,80,Tuesday
2020,4,28,2300,43,76,119,Tuesday
2020,4,28,2200,62,109,171,Tuesday
2020,4,28,2100,74,144,218,Tuesday
2020,4,28,2000,109,143,252,Tuesday
2020,4,28,1900,134,161,295,Tuesday
2020,4,28,1800,146,219,365,Tuesday
2020,4,28,1700,165,205,370,Tuesday
2020,4,28,1600,196,194,390,Tuesday
2020,4,28,1500,208,190,398,Tuesday
2020,4,28,1400,202,216,418,Tuesday
2020,4,28,1300,220,133,353,Tuesday
2020,4,28,1200,221,137,358,Tuesday
2020,4,28,1100,194,139,333,Tuesday
2020,4,28,1000,166,95,261,Tuesday
2020,4,28,900,169,85,254,Tuesday
2020,4,28,800,106,44,150,Tuesday
2020,4,28,700,57,34,91,Tuesday
2020,4,28,600,40,41,81,Tuesday
2020,4,28,500,19,50,69,Tuesday
2020,4,28,400,20,39,59,Tuesday
2020,4,28,300,13,25,38,Tuesday
2020,4,28,200,28,34,62,Tuesday
2020,4,28,100,31,57,88,Tuesday
2020,4,27,2400,37,56,93,Monday
2020,4,27,2300,44,81,125,Monday
2020,4,27,2200,56,96,152,Monday
2020,4,27,2100,85,124,209,Monday
2020,4,27,2000,100,149,249,Monday
2020,4,27,1900,159,143,302,Monday
2020,4,27,1800,140,205,345,Monday
2020,4,27,1700,157,215,372,Monday
2020,4,27,1600,191,206,397,Monday
2020,4,27,1500,220,229,449,Monday
2020,4,27,1400,209,159,368,Monday
2020,4,27,1300,191,122,313,Monday
2020,4,27,1200,185,123,308,Monday
2020,4,27,1100,173,93,266,Monday
2020,4,27,1000,166,105,271,Monday
2020,4,27,900,135,54,189,Monday
2020,4,27,800,103,57,160,Monday
2020,4,27,700,65,30,95,Monday
2020,4,27,600,27,13,40,Monday
2020,4,27,500,21,15,36,Monday
2020,4,27,400,17,14,31,Monday
2020,4,27,300,14,12,26,Monday
2020,4,27,200,19,34,53,Monday
2020,4,27,100,14,35,49,Monday
2020,4,26,2400,23,44,67,Sunday
2020,4,26,2300,32,64,96,Sunday
2020,4,26,2200,40,112,152,Sunday
2020,4,26,2100,58,150,208,Sunday
2020,4,26,2000,81,192,273,Sunday
2020,4,26,1900,114,251,365,Sunday
2020,4,26,1800,108,325,433,Sunday
2020,4,26,1700,140,320,460,Sunday
2020,4,26,1600,166,288,454,Sunday
2020,4,26,1500,203,273,476,Sunday
2020,4,26,1400,220,195,415,Sunday
2020,4,26,1300,222,173,395,Sunday
2020,4,26,1200,184,111,295,Sunday
2020,4,26,1100,180,85,265,Sunday
2020,4,26,1000,148,62,210,Sunday
2020,4,26,900,118,36,154,Sunday
2020,4,26,800,82,32,114,Sunday
2020,4,26,700,37,23,60,Sunday
2020,4,26,600,23,15,38,Sunday
2020,4,26,500,15,9,24,Sunday
2020,4,26,400,8,17,25,Sunday
2020,4,26,300,11,15,26,Sunday
2020,4,26,200,14,22,36,Sunday
2020,4,26,100,27,38,65,Sunday
2020,4,25,2400,20,56,76,Saturday
2020,4,25,2300,22,36,58,Saturday
2020,4,25,2200,32,75,107,Saturday
2020,4,25,2100,47,75,122,Saturday
2020,4,25,2000,74,109,183,Saturday
2020,4,25,1900,127,160,287,Saturday
2020,4,25,1800,107,228,335,Saturday
2020,4,25,1700,172,223,395,Saturday
2020,4,25,1600,174,221,395,Saturday
2020,4,25,1500,202,230,432,Saturday
2020,4,25,1400,198,185,383,Saturday
2020,4,25,1300,236,155,391,Saturday
2020,4,25,1200,216,122,338,Saturday
2020,4,25,1100,217,93,310,Saturday
2020,4,25,1000,164,77,241,Saturday
2020,4,25,900,120,84,204,Saturday
2020,4,25,800,77,42,119,Saturday
2020,4,25,700,47,55,102,Saturday
2020,4,25,600,20,25,45,Saturday
2020,4,25,500,19,31,50,Saturday
2020,4,25,400,15,17,32,Saturday
2020,4,25,300,15,25,40,Saturday
2020,4,25,200,28,38,66,Saturday
2020,4,25,100,23,51,74,Saturday
2020,4,24,2400,25,54,79,Friday
2020,4,24,2300,49,84,133,Friday
2020,4,24,2200,61,91,152,Friday
2020,4,24,2100,103,127,230,Friday
2020,4,24,2000,162,134,296,Friday
2020,4,24,1900,204,179,383,Friday
2020,4,24,1800,240,208,448,Friday
2020,4,24,1700,243,202,445,Friday
2020,4,24,1600,230,205,435,Friday
2020,4,24,1500,255,185,440,Friday
2020,4,24,1400,254,147,401,Friday
2020,4,24,1300,228,143,371,Friday
2020,4,24,1200,192,110,302,Friday
2020,4,24,1100,197,122,319,Friday
2020,4,24,1000,176,96,272,Friday
2020,4,24,900,134,78,212,Friday
2020,4,24,800,107,83,190,Friday
2020,4,24,700,71,56,127,Friday
2020,4,24,600,33,33,66,Friday
2020,4,24,500,27,22,49,Friday
2020,4,24,400,22,31,53,Friday
2020,4,24,300,16,36,52,Friday
2020,4,24,200,37,30,67,Friday
2020,4,24,100,30,48,78,Friday
2020,4,23,2400,32,58,90,Thursday
2020,4,23,2300,44,71,115,Thursday
2020,4,23,2200,68,92,160,Thursday
2020,4,23,2100,115,126,241,Thursday
2020,4,23,2000,122,111,233,Thursday
2020,4,23,1900,184,146,330,Thursday
2020,4,23,1800,185,160,345,Thursday
2020,4,23,1700,197,189,386,Thursday
2020,4,23,1600,175,173,348,Thursday
2020,4,23,1500,207,167,374,Thursday
2020,4,23,1400,180,167,347,Thursday
2020,4,23,1300,187,154,341,Thursday
2020,4,23,1200,185,152,337,Thursday
2020,4,23,1100,171,109,280,Thursday
2020,4,23,1000,135,80,215,Thursday
2020,4,23,900,132,65,197,Thursday
2020,4,23,800,115,81,196,Thursday
2020,4,23,700,71,41,112,Thursday
2020,4,23,600,27,37,64,Thursday
2020,4,23,500,17,30,47,Thursday
2020,4,23,400,21,30,51,Thursday
2020,4,23,300,21,28,49,Thursday
2020,4,23,200,32,34,66,Thursday
2020,4,23,100,39,53,92,Thursday
2020,4,22,2400,56,62,118,Wednesday
2020,4,22,2300,46,80,126,Wednesday
2020,4,22,2200,63,91,154,Wednesday
2020,4,22,2100,91,118,209,Wednesday
2020,4,22,2000,120,127,247,Wednesday
2020,4,22,1900,136,151,287,Wednesday
2020,4,22,1800,122,222,344,Wednesday
2020,4,22,1700,154,210,364,Wednesday
2020,4,22,1600,182,194,376,Wednesday
2020,4,22,1500,204,169,373,Wednesday
2020,4,22,1400,189,180,369,Wednesday
2020,4,22,1300,166,148,314,Wednesday
2020,4,22,1200,166,151,317,Wednesday
2020,4,22,1100,153,99,252,Wednesday
2020,4,22,1000,125,103,228,Wednesday
2020,4,22,900,128,84,212,Wednesday
2020,4,22,800,107,74,181,Wednesday
2020,4,22,700,59,41,100,Wednesday
2020,4,22,600,25,38,63,Wednesday
2020,4,22,500,17,33,50,Wednesday
2020,4,22,400,29,31,60,Wednesday
2020,4,22,300,16,36,52,Wednesday
2020,4,22,200,26,46,72,Wednesday
2020,4,22,100,26,40,66,Wednesday
2020,4,21,2400,48,64,112,Tuesday
2020,4,21,2300,52,79,131,Tuesday
2020,4,21,2200,40,80,120,Tuesday
2020,4,21,2100,76,131,207,Tuesday
2020,4,21,2000,109,151,260,Tuesday
2020,4,21,1900,125,174,299,Tuesday
2020,4,21,1800,147,181,328,Tuesday
2020,4,21,1700,170,190,360,Tuesday
2020,4,21,1600,158,191,349,Tuesday
2020,4,21,1500,193,181,374,Tuesday
2020,4,21,1400,206,157,363,Tuesday
2020,4,21,1300,189,145,334,Tuesday
2020,4,21,1200,182,128,310,Tuesday
2020,4,21,1100,147,143,290,Tuesday
2020,4,21,1000,149,96,245,Tuesday
2020,4,21,900,133,84,217,Tuesday
2020,4,21,800,99,76,175,Tuesday
2020,4,21,700,51,30,81,Tuesday
2020,4,21,600,30,29,59,Tuesday
2020,4,21,500,17,34,51,Tuesday
2020,4,21,400,23,37,60,Tuesday
2020,4,21,300,19,32,51,Tuesday
2020,4,21,200,20,31,51,Tuesday
2020,4,21,100,27,42,69,Tuesday
2020,4,20,2400,39,51,90,Monday
2020,4,20,2300,48,79,127,Monday
2020,4,20,2200,55,101,156,Monday
2020,4,20,2100,69,202,271,Monday
2020,4,20,2000,132,70,202,Monday
2020,4,20,1900,118,200,318,Monday
2020,4,20,1800,144,272,416,Monday
2020,4,20,1700,144,84,228,Monday
2020,4,20,1600,182,148,330,Monday
2020,4,20,1500,199,164,363,Monday
2020,4,20,1400,196,133,329,Monday
2020,4,20,1300,201,139,340,Monday
2020,4,20,1200,164,111,275,Monday
2020,4,20,1100,164,104,268,Monday
2020,4,20,1000,137,70,207,Monday
2020,4,20,900,141,58,199,Monday
2020,4,20,800,105,55,160,Monday
2020,4,20,700,38,17,55,Monday
2020,4,20,600,43,11,54,Monday
2020,4,20,500,13,7,20,Monday
2020,4,20,400,16,15,31,Monday
2020,4,20,300,9,16,25,Monday
2020,4,20,200,18,16,34,Monday
2020,4,20,100,21,22,43,Monday
2020,4,19,2400,18,50,68,Sunday
2020,4,19,2300,29,63,92,Sunday
2020,4,19,2200,33,88,121,Sunday
2020,4,19,2100,50,132,182,Sunday
2020,4,19,2000,78,171,249,Sunday
2020,4,19,1900,94,244,338,Sunday
2020,4,19,1800,123,259,382,Sunday
2020,4,19,1700,161,257,418,Sunday
2020,4,19,1600,158,274,432,Sunday
2020,4,19,1500,200,219,419,Sunday
2020,4,19,1400,197,173,370,Sunday
2020,4,19,1300,239,125,364,Sunday
2020,4,19,1200,203,130,333,Sunday
2020,4,19,1100,151,84,235,Sunday
2020,4,19,1000,155,61,216,Sunday
2020,4,19,900,112,42,154,Sunday
2020,4,19,800,89,35,124,Sunday
2020,4,19,700,65,15,80,Sunday
2020,4,19,600,13,11,24,Sunday
2020,4,19,500,15,12,27,Sunday
2020,4,19,400,14,8,22,Sunday
2020,4,19,300,6,20,26,Sunday
2020,4,19,200,16,19,35,Sunday
2020,4,19,100,19,35,54,Sunday
2020,4,18,2400,21,42,63,Saturday
2020,4,18,2300,20,59,79,Saturday
2020,4,18,2200,24,75,99,Saturday
2020,4,18,2100,31,95,126,Saturday
2020,4,18,2000,56,105,161,Saturday
2020,4,18,1900,80,120,200,Saturday
2020,4,18,1800,91,171,262,Saturday
2020,4,18,1700,132,170,302,Saturday
2020,4,18,1600,156,159,315,Saturday
2020,4,18,1500,165,145,310,Saturday
2020,4,18,1400,180,137,317,Saturday
2020,4,18,1300,174,131,305,Saturday
2020,4,18,1200,183,145,328,Saturday
2020,4,18,1100,163,110,273,Saturday
2020,4,18,1000,131,98,229,Saturday
2020,4,18,900,143,45,188,Saturday
2020,4,18,800,92,44,136,Saturday
2020,4,18,700,54,27,81,Saturday
2020,4,18,600,27,30,57,Saturday
2020,4,18,500,15,22,37,Saturday
2020,4,18,400,12,30,42,Saturday
2020,4,18,300,17,31,48,Saturday
2020,4,18,200,17,40,57,Saturday
2020,4,18,100,25,42,67,Saturday
2020,4,17,2400,37,52,89,Friday
2020,4,17,2300,33,48,81,Friday
2020,4,17,2200,50,65,115,Friday
2020,4,17,2100,71,104,175,Friday
2020,4,17,2000,117,89,206,Friday
2020,4,17,1900,137,132,269,Friday
2020,4,17,1800,229,175,404,Friday
2020,4,17,1700,218,152,370,Friday
2020,4,17,1600,208,166,374,Friday
2020,4,17,1500,217,140,357,Friday
2020,4,17,1400,194,151,345,Friday
2020,4,17,1300,170,156,326,Friday
2020,4,17,1200,179,145,324,Friday
2020,4,17,1100,162,105,267,Friday
2020,4,17,1000,161,103,264,Friday
2020,4,17,900,154,78,232,Friday
2020,4,17,800,98,44,142,Friday
2020,4,17,700,57,35,92,Friday
2020,4,17,600,25,29,54,Friday
2020,4,17,500,15,27,42,Friday
2020,4,17,400,24,29,53,Friday
2020,4,17,300,18,30,48,Friday
2020,4,17,200,22,34,56,Friday
2020,4,17,100,32,41,73,Friday
2020,4,16,2400,38,44,82,Thursday
2020,4,16,2300,53,70,123,Thursday
2020,4,16,2200,59,65,124,Thursday
2020,4,16,2100,72,112,184,Thursday
2020,4,16,2000,108,109,217,Thursday
2020,4,16,1900,169,164,333,Thursday
2020,4,16,1800,158,179,337,Thursday
2020,4,16,1700,192,180,372,Thursday
2020,4,16,1600,180,144,324,Thursday
2020,4,16,1500,200,159,359,Thursday
2020,4,16,1400,220,145,365,Thursday
2020,4,16,1300,194,140,334,Thursday
2020,4,16,1200,208,135,343,Thursday
2020,4,16,1100,179,115,294,Thursday
2020,4,16,1000,158,104,262,Thursday
2020,4,16,900,136,70,206,Thursday
2020,4,16,800,129,64,193,Thursday
2020,4,16,700,61,30,91,Thursday
2020,4,16,600,36,21,57,Thursday
2020,4,16,500,16,28,44,Thursday
2020,4,16,400,21,29,50,Thursday
2020,4,16,300,25,38,63,Thursday
2020,4,16,200,20,38,58,Thursday
2020,4,16,100,25,48,73,Thursday
2020,4,15,2400,38,47,85,Wednesday
2020,4,15,2300,40,79,119,Wednesday
2020,4,15,2200,52,64,116,Wednesday
2020,4,15,2100,73,81,154,Wednesday
2020,4,15,2000,101,107,208,Wednesday
2020,4,15,1900,94,122,216,Wednesday
2020,4,15,1800,125,172,297,Wednesday
2020,4,15,1700,176,135,311,Wednesday
2020,4,15,1600,152,138,290,Wednesday
2020,4,15,1500,187,128,315,Wednesday
2020,4,15,1400,180,147,327,Wednesday
2020,4,15,1300,168,148,316,Wednesday
2020,4,15,1200,167,124,291,Wednesday
2020,4,15,1100,146,114,260,Wednesday
2020,4,15,1000,115,90,205,Wednesday
2020,4,15,900,127,78,205,Wednesday
2020,4,15,800,112,55,167,Wednesday
2020,4,15,700,36,36,72,Wednesday
2020,4,15,600,23,33,56,Wednesday
2020,4,15,500,13,26,39,Wednesday
2020,4,15,400,13,31,44,Wednesday
2020,4,15,300,21,23,44,Wednesday
2020,4,15,200,33,41,74,Wednesday
2020,4,15,100,30,50,80,Wednesday
2020,4,14,2400,47,35,82,Tuesday
2020,4,14,2300,60,73,133,Tuesday
2020,4,14,2200,38,64,102,Tuesday
2020,4,14,2100,73,77,150,Tuesday
2020,4,14,2000,102,114,216,Tuesday
2020,4,14,1900,100,140,240,Tuesday
2020,4,14,1800,114,144,258,Tuesday
2020,4,14,1700,144,174,318,Tuesday
2020,4,14,1600,155,171,326,Tuesday
2020,4,14,1500,194,127,321,Tuesday
2020,4,14,1400,151,149,300,Tuesday
2020,4,14,1300,185,135,320,Tuesday
2020,4,14,1200,176,135,311,Tuesday
2020,4,14,1100,137,106,243,Tuesday
2020,4,14,1000,118,99,217,Tuesday
2020,4,14,900,129,59,188,Tuesday
2020,4,14,800,98,47,145,Tuesday
2020,4,14,700,51,35,86,Tuesday
2020,4,14,600,13,23,36,Tuesday
2020,4,14,500,17,22,39,Tuesday
2020,4,14,400,13,28,41,Tuesday
2020,4,14,300,15,41,56,Tuesday
2020,4,14,200,21,26,47,Tuesday
2020,4,14,100,23,37,60,Tuesday
2020,4,13,2400,32,55,87,Monday
2020,4,13,2300,33,60,93,Monday
2020,4,13,2200,52,71,123,Monday
2020,4,13,2100,50,102,152,Monday
2020,4,13,2000,76,123,199,Monday
2020,4,13,1900,87,154,241,Monday
2020,4,13,1800,104,206,310,Monday
2020,4,13,1700,135,215,350,Monday
2020,4,13,1600,128,156,284,Monday
2020,4,13,1500,194,182,376,Monday
2020,4,13,1400,161,140,301,Monday
2020,4,13,1300,176,119,295,Monday
2020,4,13,1200,174,97,271,Monday
2020,4,13,1100,169,56,225,Monday
2020,4,13,1000,135,46,181,Monday
2020,4,13,900,130,45,175,Monday
2020,4,13,800,68,18,86,Monday
2020,4,13,700,48,10,58,Monday
2020,4,13,600,29,12,41,Monday
2020,4,13,500,15,13,28,Monday
2020,4,13,400,14,14,28,Monday
2020,4,13,300,11,18,29,Monday
2020,4,13,200,11,15,26,Monday
2020,4,13,100,15,20,35,Monday
2020,4,12,2400,16,28,44,Sunday
2020,4,12,2300,19,42,61,Sunday
2020,4,12,2200,22,74,96,Sunday
2020,4,12,2100,42,104,146,Sunday
2020,4,12,2000,51,146,197,Sunday
2020,4,12,1900,72,152,224,Sunday
2020,4,12,1800,74,181,255,Sunday
2020,4,12,1700,82,149,231,Sunday
2020,4,12,1600,96,193,289,Sunday
2020,4,12,1500,133,168,301,Sunday
2020,4,12,1400,156,150,306,Sunday
2020,4,12,1300,160,112,272,Sunday
2020,4,12,1200,116,69,185,Sunday
2020,4,12,1100,95,52,147,Sunday
2020,4,12,1000,93,18,111,Sunday
2020,4,12,900,59,18,77,Sunday
2020,4,12,800,49,10,59,Sunday
2020,4,12,700,39,10,49,Sunday
2020,4,12,600,20,12,32,Sunday
2020,4,12,500,8,11,19,Sunday
2020,4,12,400,8,13,21,Sunday
2020,4,12,300,18,15,33,Sunday
2020,4,12,200,12,16,28,Sunday
2020,4,12,100,17,23,40,Sunday
2020,4,11,2400,11,34,45,Saturday
2020,4,11,2300,23,39,62,Saturday
2020,4,11,2200,19,46,65,Saturday
2020,4,11,2100,33,67,100,Saturday
2020,4,11,2000,38,70,108,Saturday
2020,4,11,1900,52,99,151,Saturday
2020,4,11,1800,86,113,199,Saturday
2020,4,11,1700,98,111,209,Saturday
2020,4,11,1600,106,115,221,Saturday
2020,4,11,1500,108,110,218,Saturday
2020,4,11,1400,90,93,183,Saturday
2020,4,11,1300,91,100,191,Saturday
2020,4,11,1200,87,62,149,Saturday
2020,4,11,1100,83,62,145,Saturday
2020,4,11,1000,69,44,113,Saturday
2020,4,11,900,60,26,86,Saturday
2020,4,11,800,32,33,65,Saturday
2020,4,11,700,25,16,41,Saturday
2020,4,11,600,5,9,14,Saturday
2020,4,11,500,11,8,19,Saturday
2020,4,11,400,9,34,43,Saturday
2020,4,11,300,10,19,29,Saturday
2020,4,11,200,5,26,31,Saturday
2020,4,11,100,15,34,49,Saturday
2020,4,10,2400,22,32,54,Friday
2020,4,10,2300,15,43,58,Friday
2020,4,10,2200,30,65,95,Friday
2020,4,10,2100,30,90,120,Friday
2020,4,10,2000,59,104,163,Friday
2020,4,10,1900,68,120,188,Friday
2020,4,10,1800,89,164,253,Friday
2020,4,10,1700,111,161,272,Friday
2020,4,10,1600,131,171,302,Friday
2020,4,10,1500,170,165,335,Friday
2020,4,10,1400,173,171,344,Friday
2020,4,10,1300,215,134,349,Friday
2020,4,10,1200,205,132,337,Friday
2020,4,10,1100,201,89,290,Friday
2020,4,10,1000,189,63,252,Friday
2020,4,10,900,146,60,206,Friday
2020,4,10,800,113,47,160,Friday
2020,4,10,700,62,24,86,Friday
2020,4,10,600,35,18,53,Friday
2020,4,10,500,18,25,43,Friday
2020,4,10,400,20,21,41,Friday
2020,4,10,300,24,34,58,Friday
2020,4,10,200,19,49,68,Friday
2020,4,10,100,33,49,82,Friday
2020,4,9,2400,49,48,97,Thursday
2020,4,9,2300,45,81,126,Thursday
2020,4,9,2200,59,89,148,Thursday
2020,4,9,2100,110,112,222,Thursday
2020,4,9,2000,148,194,342,Thursday
2020,4,9,1900,201,109,310,Thursday
2020,4,9,1800,227,201,428,Thursday
2020,4,9,1700,223,137,360,Thursday
2020,4,9,1600,220,172,392,Thursday
2020,4,9,1500,200,168,368,Thursday
2020,4,9,1400,213,133,346,Thursday
2020,4,9,1300,172,134,306,Thursday
2020,4,9,1200,175,120,295,Thursday
2020,4,9,1100,169,122,291,Thursday
2020,4,9,1000,159,95,254,Thursday
2020,4,9,900,144,74,218,Thursday
2020,4,9,800,123,67,190,Thursday
2020,4,9,700,48,35,83,Thursday
2020,4,9,600,25,29,54,Thursday
2020,4,9,500,22,28,50,Thursday
2020,4,9,400,24,28,52,Thursday
2020,4,9,300,20,31,51,Thursday
2020,4,9,200,21,35,56,Thursday
2020,4,9,100,38,46,84,Thursday
2020,4,8,2400,44,55,99,Wednesday
2020,4,8,2300,53,61,114,Wednesday
2020,4,8,2200,61,94,155,Wednesday
2020,4,8,2100,85,107,192,Wednesday
2020,4,8,2000,127,115,242,Wednesday
2020,4,8,1900,147,156,303,Wednesday
2020,4,8,1800,175,189,364,Wednesday
2020,4,8,1700,156,172,328,Wednesday
2020,4,8,1600,184,153,337,Wednesday
2020,4,8,1500,201,172,373,Wednesday
2020,4,8,1400,197,149,346,Wednesday
2020,4,8,1300,175,145,320,Wednesday
2020,4,8,1200,171,115,286,Wednesday
2020,4,8,1100,170,119,289,Wednesday
2020,4,8,1000,154,87,241,Wednesday
2020,4,8,900,144,85,229,Wednesday
2020,4,8,800,109,64,173,Wednesday
2020,4,8,700,46,36,82,Wednesday
2020,4,8,600,34,32,66,Wednesday
2020,4,8,500,20,26,46,Wednesday
2020,4,8,400,19,26,45,Wednesday
2020,4,8,300,32,35,67,Wednesday
2020,4,8,200,24,48,72,Wednesday
2020,4,8,100,26,54,80,Wednesday
2020,4,7,2400,41,47,88,Tuesday
2020,4,7,2300,47,64,111,Tuesday
2020,4,7,2200,56,86,142,Tuesday
2020,4,7,2100,64,104,168,Tuesday
2020,4,7,2000,69,94,163,Tuesday
2020,4,7,1900,99,137,236,Tuesday
2020,4,7,1800,116,164,280,Tuesday
2020,4,7,1700,154,164,318,Tuesday
2020,4,7,1600,142,159,301,Tuesday
2020,4,7,1500,182,164,346,Tuesday
2020,4,7,1400,183,142,325,Tuesday
2020,4,7,1300,171,144,315,Tuesday
2020,4,7,1200,192,122,314,Tuesday
2020,4,7,1100,156,96,252,Tuesday
2020,4,7,1000,155,100,255,Tuesday
2020,4,7,900,116,71,187,Tuesday
2020,4,7,800,85,61,146,Tuesday
2020,4,7,700,45,35,80,Tuesday
2020,4,7,600,14,33,47,Tuesday
2020,4,7,500,20,36,56,Tuesday
2020,4,7,400,22,26,48,Tuesday
2020,4,7,300,30,31,61,Tuesday
2020,4,7,200,17,25,42,Tuesday
2020,4,7,100,24,39,63,Tuesday
2020,4,6,2400,44,49,93,Monday
2020,4,6,2300,57,52,109,Monday
2020,4,6,2200,60,94,154,Monday
2020,4,6,2100,69,90,159,Monday
2020,4,6,2000,92,124,216,Monday
2020,4,6,1900,119,154,273,Monday
2020,4,6,1800,132,191,323,Monday
2020,4,6,1700,167,169,336,Monday
2020,4,6,1600,173,166,339,Monday
2020,4,6,1500,180,129,309,Monday
2020,4,6,1400,192,122,314,Monday
2020,4,6,1300,175,108,283,Monday
2020,4,6,1200,169,102,271,Monday
2020,4,6,1100,158,85,243,Monday
2020,4,6,1000,136,64,200,Monday
2020,4,6,900,111,40,151,Monday
2020,4,6,800,83,42,125,Monday
2020,4,6,700,40,27,67,Monday
2020,4,6,600,26,28,54,Monday
2020,4,6,500,8,15,23,Monday
2020,4,6,400,16,20,36,Monday
2020,4,6,300,14,20,34,Monday
2020,4,6,200,15,15,30,Monday
2020,4,6,100,14,20,34,Monday
2020,4,5,2400,20,49,69,Sunday
2020,4,5,2300,32,56,88,Sunday
2020,4,5,2200,25,58,83,Sunday
2020,4,5,2100,43,94,137,Sunday
2020,4,5,2000,65,130,195,Sunday
2020,4,5,1900,91,175,266,Sunday
2020,4,5,1800,105,181,286,Sunday
2020,4,5,1700,101,206,307,Sunday
2020,4,5,1600,130,220,350,Sunday
2020,4,5,1500,169,182,351,Sunday
2020,4,5,1400,164,150,314,Sunday
2020,4,5,1300,174,98,272,Sunday
2020,4,5,1200,152,86,238,Sunday
2020,4,5,1100,127,69,196,Sunday
2020,4,5,1000,133,47,180,Sunday
2020,4,5,900,96,34,130,Sunday
2020,4,5,800,84,17,101,Sunday
2020,4,5,700,33,14,47,Sunday
2020,4,5,600,13,7,20,Sunday
2020,4,5,500,13,12,25,Sunday
2020,4,5,400,12,10,22,Sunday
2020,4,5,300,7,7,14,Sunday
2020,4,5,200,17,23,40,Sunday
2020,4,5,100,13,17,30,Sunday
2020,4,4,2400,28,35,63,Saturday
2020,4,4,2300,31,40,71,Saturday
2020,4,4,2200,25,92,117,Saturday
2020,4,4,2100,54,83,137,Saturday
2020,4,4,2000,76,132,208,Saturday
2020,4,4,1900,66,146,212,Saturday
2020,4,4,1800,117,202,319,Saturday
2020,4,4,1700,115,179,294,Saturday
2020,4,4,1600,166,196,362,Saturday
2020,4,4,1500,160,164,324,Saturday
2020,4,4,1400,190,158,348,Saturday
2020,4,4,1300,194,128,322,Saturday
2020,4,4,1200,171,138,309,Saturday
2020,4,4,1100,185,96,281,Saturday
2020,4,4,1000,141,79,220,Saturday
2020,4,4,900,93,80,173,Saturday
2020,4,4,800,104,55,159,Saturday
2020,4,4,700,38,28,66,Saturday
2020,4,4,600,27,22,49,Saturday
2020,4,4,500,9,28,37,Saturday
2020,4,4,400,10,33,43,Saturday
2020,4,4,300,17,22,39,Saturday
2020,4,4,200,14,31,45,Saturday
2020,4,4,100,18,39,57,Saturday
2020,4,3,2400,37,54,91,Friday
2020,4,3,2300,25,48,73,Friday
2020,4,3,2200,37,71,108,Friday
2020,4,3,2100,72,76,148,Friday
2020,4,3,2000,82,78,160,Friday
2020,4,3,1900,112,117,229,Friday
2020,4,3,1800,144,134,278,Friday
2020,4,3,1700,147,139,286,Friday
2020,4,3,1600,154,119,273,Friday
2020,4,3,1500,143,179,322,Friday
2020,4,3,1400,144,171,315,Friday
2020,4,3,1300,135,75,210,Friday
2020,4,3,1200,130,76,206,Friday
2020,4,3,1100,99,76,175,Friday
2020,4,3,1000,89,84,173,Friday
2020,4,3,900,97,48,145,Friday
2020,4,3,800,80,52,132,Friday
2020,4,3,700,36,34,70,Friday
2020,4,3,600,23,28,51,Friday
2020,4,3,500,17,24,41,Friday
2020,4,3,400,24,25,49,Friday
2020,4,3,300,22,43,65,Friday
2020,4,3,200,29,31,60,Friday
2020,4,3,100,38,48,86,Friday
2020,4,2,2400,40,54,94,Thursday
2020,4,2,2300,55,63,118,Thursday
2020,4,2,2200,58,70,128,Thursday
2020,4,2,2100,78,115,193,Thursday
2020,4,2,2000,98,126,224,Thursday
2020,4,2,1900,116,121,237,Thursday
2020,4,2,1800,157,161,318,Thursday
2020,4,2,1700,156,162,318,Thursday
2020,4,2,1600,159,154,313,Thursday
2020,4,2,1500,162,150,312,Thursday
2020,4,2,1400,152,164,316,Thursday
2020,4,2,1300,173,140,313,Thursday
2020,4,2,1200,139,108,247,Thursday
2020,4,2,1100,146,82,228,Thursday
2020,4,2,1000,126,92,218,Thursday
2020,4,2,900,126,66,192,Thursday
2020,4,2,800,97,48,145,Thursday
2020,4,2,700,47,28,75,Thursday
2020,4,2,600,29,36,65,Thursday
2020,4,2,500,23,28,51,Thursday
2020,4,2,400,17,34,51,Thursday
2020,4,2,300,27,30,57,Thursday
2020,4,2,200,26,41,67,Thursday
2020,4,2,100,31,42,73,Thursday
2020,4,1,2400,39,40,79,Wednesday
2020,4,1,2300,44,52,96,Wednesday
2020,4,1,2200,50,80,130,Wednesday
2020,4,1,2100,76,109,185,Wednesday
2020,4,1,2000,90,122,212,Wednesday
2020,4,1,1900,86,140,226,Wednesday
2020,4,1,1800,132,159,291,Wednesday
2020,4,1,1700,140,150,290,Wednesday
2020,4,1,1600,182,135,317,Wednesday
2020,4,1,1500,150,145,295,Wednesday
2020,4,1,1400,162,134,296,Wednesday
2020,4,1,1300,134,136,270,Wednesday
2020,4,1,1200,138,140,278,Wednesday
2020,4,1,1100,116,72,188,Wednesday
2020,4,1,1000,133,76,209,Wednesday
2020,4,1,900,127,48,175,Wednesday
2020,4,1,800,98,46,144,Wednesday
2020,4,1,700,41,27,68,Wednesday
2020,4,1,600,27,28,55,Wednesday
2020,4,1,500,25,26,51,Wednesday
2020,4,1,400,16,22,38,Wednesday
2020,4,1,300,16,37,53,Wednesday
2020,4,1,200,32,35,67,Wednesday
2020,4,1,100,42,58,100,Wednesday
2020,3,31,2400,37,60,97,Tuesday
2020,3,31,2300,41,69,110,Tuesday
2020,3,31,2200,49,72,121,Tuesday
2020,3,31,2100,54,85,139,Tuesday
2020,3,31,2000,72,119,191,Tuesday
2020,3,31,1900,97,152,249,Tuesday
2020,3,31,1800,127,168,295,Tuesday
2020,3,31,1700,120,135,255,Tuesday
2020,3,31,1600,134,147,281,Tuesday
2020,3,31,1500,159,150,309,Tuesday
2020,3,31,1400,145,132,277,Tuesday
2020,3,31,1300,162,133,295,Tuesday
2020,3,31,1200,143,117,260,Tuesday
2020,3,31,1100,126,119,245,Tuesday
2020,3,31,1000,122,86,208,Tuesday
2020,3,31,900,109,65,174,Tuesday
2020,3,31,800,76,46,122,Tuesday
2020,3,31,700,27,27,54,Tuesday
2020,3,31,600,31,27,58,Tuesday
2020,3,31,500,17,35,52,Tuesday
2020,3,31,400,26,25,51,Tuesday
2020,3,31,300,13,24,37,Tuesday
2020,3,31,200,23,31,54,Tuesday
2020,3,31,100,26,32,58,Tuesday
2020,3,30,2400,45,43,88,Monday
2020,3,30,2300,31,56,87,Monday
2020,3,30,2200,43,59,102,Monday
2020,3,30,2100,56,91,147,Monday
2020,3,30,2000,77,88,165,Monday
2020,3,30,1900,94,143,237,Monday
2020,3,30,1800,97,145,242,Monday
2020,3,30,1700,120,110,230,Monday
2020,3,30,1600,149,129,278,Monday
2020,3,30,1500,151,165,316,Monday
2020,3,30,1400,163,158,321,Monday
2020,3,30,1300,151,153,304,Monday
2020,3,30,1200,157,144,301,Monday
2020,3,30,1100,140,115,255,Monday
2020,3,30,1000,106,94,200,Monday
2020,3,30,900,109,57,166,Monday
2020,3,30,800,74,46,120,Monday
2020,3,30,700,32,39,71,Monday
2020,3,30,600,18,35,53,Monday
2020,3,30,500,17,138,155,Monday
2020,3,30,400,15,117,132,Monday
2020,3,30,300,15,2,17,Monday
2020,3,30,200,21,1,22,Monday
2020,3,30,100,15,6,21,Monday
2020,3,29,2400,22,6,28,Sunday
2020,3,29,2300,27,6,33,Sunday
2020,3,29,2200,37,20,57,Sunday
2020,3,29,2100,63,32,95,Sunday
2020,3,29,2000,61,56,117,Sunday
2020,3,29,1900,70,91,161,Sunday
2020,3,29,1800,115,124,239,Sunday
2020,3,29,1700,124,206,330,Sunday
2020,3,29,1600,158,279,437,Sunday
2020,3,29,1500,133,216,349,Sunday
2020,3,29,1400,158,170,328,Sunday
2020,3,29,1300,175,141,316,Sunday
2020,3,29,1200,159,132,291,Sunday
2020,3,29,1100,157,62,219,Sunday
2020,3,29,1000,121,43,164,Sunday
2020,3,29,900,83,30,113,Sunday
2020,3,29,800,53,27,80,Sunday
2020,3,29,700,17,11,28,Sunday
2020,3,29,600,18,12,30,Sunday
2020,3,29,500,13,8,21,Sunday
2020,3,29,400,9,12,21,Sunday
2020,3,29,300,9,19,28,Sunday
2020,3,29,200,13,19,32,Sunday
2020,3,29,100,14,20,34,Sunday
2020,3,28,2400,24,37,61,Saturday
2020,3,28,2300,24,58,82,Saturday
2020,3,28,2200,29,68,97,Saturday
2020,3,28,2100,54,106,160,Saturday
2020,3,28,2000,64,115,179,Saturday
2020,3,28,1900,78,171,249,Saturday
2020,3,28,1800,118,173,291,Saturday
2020,3,28,1700,116,208,324,Saturday
2020,3,28,1600,154,247,401,Saturday
2020,3,28,1500,168,218,386,Saturday
2020,3,28,1400,171,170,341,Saturday
2020,3,28,1300,179,144,323,Saturday
2020,3,28,1200,191,135,326,Saturday
2020,3,28,1100,134,102,236,Saturday
2020,3,28,1000,148,87,235,Saturday
2020,3,28,900,107,58,165,Saturday
2020,3,28,800,84,31,115,Saturday
2020,3,28,700,59,42,101,Saturday
2020,3,28,600,29,32,61,Saturday
2020,3,28,500,15,20,35,Saturday
2020,3,28,400,18,21,39,Saturday
2020,3,28,300,21,33,54,Saturday
2020,3,28,200,21,39,60,Saturday
2020,3,28,100,19,51,70,Saturday
2020,3,27,2400,27,53,80,Friday
2020,3,27,2300,32,69,101,Friday
2020,3,27,2200,62,91,153,Friday
2020,3,27,2100,110,107,217,Friday
2020,3,27,2000,124,120,244,Friday
2020,3,27,1900,152,172,324,Friday
2020,3,27,1800,172,175,347,Friday
2020,3,27,1700,206,217,423,Friday
2020,3,27,1600,196,166,362,Friday
2020,3,27,1500,207,189,396,Friday
2020,3,27,1400,196,144,340,Friday
2020,3,27,1300,178,163,341,Friday
2020,3,27,1200,184,153,337,Friday
2020,3,27,1100,185,137,322,Friday
2020,3,27,1000,168,73,241,Friday
2020,3,27,900,144,65,209,Friday
2020,3,27,800,114,62,176,Friday
2020,3,27,700,39,36,75,Friday
2020,3,27,600,28,23,51,Friday
2020,3,27,500,27,35,62,Friday
2020,3,27,400,21,25,46,Friday
2020,3,27,300,25,38,63,Friday
2020,3,27,200,25,41,66,Friday
2020,3,27,100,30,44,74,Friday
2020,3,26,2400,51,48,99,Thursday
2020,3,26,2300,52,78,130,Thursday
2020,3,26,2200,67,114,181,Thursday
2020,3,26,2100,82,107,189,Thursday
2020,3,26,2000,112,134,246,Thursday
2020,3,26,1900,128,164,292,Thursday
2020,3,26,1800,167,198,365,Thursday
2020,3,26,1700,196,209,405,Thursday
2020,3,26,1600,191,188,379,Thursday
2020,3,26,1500,185,221,406,Thursday
2020,3,26,1400,183,190,373,Thursday
2020,3,26,1300,206,165,371,Thursday
2020,3,26,1200,194,115,309,Thursday
2020,3,26,1100,154,135,289,Thursday
2020,3,26,1000,179,84,263,Thursday
2020,3,26,900,143,82,225,Thursday
2020,3,26,800,130,47,177,Thursday
2020,3,26,700,39,46,85,Thursday
2020,3,26,600,29,30,59,Thursday
2020,3,26,500,31,30,61,Thursday
2020,3,26,400,17,32,49,Thursday
2020,3,26,300,28,29,57,Thursday
2020,3,26,200,32,45,77,Thursday
2020,3,26,100,43,52,95,Thursday
2020,3,25,2400,45,62,107,Wednesday
2020,3,25,2300,50,77,127,Wednesday
2020,3,25,2200,58,88,146,Wednesday
2020,3,25,2100,78,125,203,Wednesday
2020,3,25,2000,90,147,237,Wednesday
2020,3,25,1900,131,194,325,Wednesday
2020,3,25,1800,147,230,377,Wednesday
2020,3,25,1700,195,220,415,Wednesday
2020,3,25,1600,172,197,369,Wednesday
2020,3,25,1500,204,171,375,Wednesday
2020,3,25,1400,192,187,379,Wednesday
2020,3,25,1300,213,181,394,Wednesday
2020,3,25,1200,205,142,347,Wednesday
2020,3,25,1100,188,131,319,Wednesday
2020,3,25,1000,142,107,249,Wednesday
2020,3,25,900,149,80,229,Wednesday
2020,3,25,800,126,56,182,Wednesday
2020,3,25,700,42,50,92,Wednesday
2020,3,25,600,37,36,73,Wednesday
2020,3,25,500,25,37,62,Wednesday
2020,3,25,400,21,33,54,Wednesday
2020,3,25,300,18,35,53,Wednesday
2020,3,25,200,30,37,67,Wednesday
2020,3,25,100,29,60,89,Wednesday
2020,3,24,2400,56,59,115,Tuesday
2020,3,24,2300,51,81,132,Tuesday
2020,3,24,2200,63,107,170,Tuesday
2020,3,24,2100,67,108,175,Tuesday
2020,3,24,2000,92,127,219,Tuesday
2020,3,24,1900,107,198,305,Tuesday
2020,3,24,1800,150,228,378,Tuesday
2020,3,24,1700,160,214,374,Tuesday
2020,3,24,1600,178,225,403,Tuesday
2020,3,24,1500,195,212,407,Tuesday
2020,3,24,1400,191,213,404,Tuesday
2020,3,24,1300,170,164,334,Tuesday
2020,3,24,1200,177,150,327,Tuesday
2020,3,24,1100,157,133,290,Tuesday
2020,3,24,1000,160,109,269,Tuesday
2020,3,24,900,129,54,183,Tuesday
2020,3,24,800,134,54,188,Tuesday
2020,3,24,700,52,45,97,Tuesday
2020,3,24,600,23,52,75,Tuesday
2020,3,24,500,26,24,50,Tuesday
2020,3,24,400,21,26,47,Tuesday
2020,3,24,300,36,29,65,Tuesday
2020,3,24,200,32,53,85,Tuesday
2020,3,24,100,36,56,92,Tuesday
2020,3,23,2400,26,60,86,Monday
2020,3,23,2300,53,67,120,Monday
2020,3,23,2200,54,82,136,Monday
2020,3,23,2100,80,130,210,Monday
2020,3,23,2000,96,144,240,Monday
2020,3,23,1900,133,185,318,Monday
2020,3,23,1800,149,217,366,Monday
2020,3,23,1700,161,250,411,Monday
2020,3,23,1600,185,245,430,Monday
2020,3,23,1500,229,194,423,Monday
2020,3,23,1400,248,200,448,Monday
2020,3,23,1300,239,198,437,Monday
2020,3,23,1200,256,148,404,Monday
2020,3,23,1100,216,118,334,Monday
2020,3,23,1000,166,85,251,Monday
2020,3,23,900,182,45,227,Monday
2020,3,23,800,108,36,144,Monday
2020,3,23,700,63,23,86,Monday
2020,3,23,600,32,21,53,Monday
2020,3,23,500,19,15,34,Monday
2020,3,23,400,18,30,48,Monday
2020,3,23,300,21,21,42,Monday
2020,3,23,200,32,21,53,Monday
2020,3,23,100,21,52,73,Monday
2020,3,22,2400,26,57,83,Sunday
2020,3,22,2300,29,72,101,Sunday
2020,3,22,2200,64,107,171,Sunday
2020,3,22,2100,71,175,246,Sunday
2020,3,22,2000,102,256,358,Sunday
2020,3,22,1900,122,347,469,Sunday
2020,3,22,1800,123,417,540,Sunday
2020,3,22,1700,187,587,774,Sunday
2020,3,22,1600,225,481,706,Sunday
2020,3,22,1500,281,395,676,Sunday
2020,3,22,1400,329,320,649,Sunday
2020,3,22,1300,355,184,539,Sunday
2020,3,22,1200,310,159,469,Sunday
2020,3,22,1100,290,125,415,Sunday
2020,3,22,1000,230,76,306,Sunday
2020,3,22,900,213,48,261,Sunday
2020,3,22,800,142,32,174,Sunday
2020,3,22,700,51,17,68,Sunday
2020,3,22,600,31,20,51,Sunday
2020,3,22,500,12,16,28,Sunday
2020,3,22,400,12,26,38,Sunday
2020,3,22,300,25,19,44,Sunday
2020,3,22,200,13,28,41,Sunday
2020,3,22,100,31,39,70,Sunday
2020,3,21,2400,29,53,82,Saturday
2020,3,21,2300,37,78,115,Saturday
2020,3,21,2200,61,103,164,Saturday
2020,3,21,2100,42,146,188,Saturday
2020,3,21,2000,78,201,279,Saturday
2020,3,21,1900,112,290,402,Saturday
2020,3,21,1800,176,445,621,Saturday
2020,3,21,1700,198,441,639,Saturday
2020,3,21,1600,243,397,640,Saturday
2020,3,21,1500,334,337,671,Saturday
2020,3,21,1400,338,265,603,Saturday
2020,3,21,1300,395,203,598,Saturday
2020,3,21,1200,373,170,543,Saturday
2020,3,21,1100,371,134,505,Saturday
2020,3,21,1000,263,124,387,Saturday
2020,3,21,900,262,59,321,Saturday
2020,3,21,800,200,61,261,Saturday
2020,3,21,700,77,47,124,Saturday
2020,3,21,600,36,29,65,Saturday
2020,3,21,500,26,35,61,Saturday
2020,3,21,400,16,34,50,Saturday
2020,3,21,300,20,27,47,Saturday
2020,3,21,200,23,67,90,Saturday
2020,3,21,100,44,42,86,Saturday
2020,3,20,2400,51,75,126,Friday
2020,3,20,2300,67,75,142,Friday
2020,3,20,2200,88,121,209,Friday
2020,3,20,2100,122,171,293,Friday
2020,3,20,2000,233,222,455,Friday
2020,3,20,1900,258,240,498,Friday
2020,3,20,1800,277,372,649,Friday
2020,3,20,1700,282,434,716,Friday
2020,3,20,1600,312,297,609,Friday
2020,3,20,1500,362,279,641,Friday
2020,3,20,1400,335,257,592,Friday
2020,3,20,1300,346,219,565,Friday
2020,3,20,1200,367,200,567,Friday
2020,3,20,1100,339,168,507,Friday
2020,3,20,1000,264,127,391,Friday
2020,3,20,900,255,78,333,Friday
2020,3,20,800,197,55,252,Friday
2020,3,20,700,69,57,126,Friday
2020,3,20,600,39,29,68,Friday
2020,3,20,500,34,32,66,Friday
2020,3,20,400,26,34,60,Friday
2020,3,20,300,33,31,64,Friday
2020,3,20,200,21,44,65,Friday
2020,3,20,100,42,62,104,Friday
2020,3,19,2400,49,77,126,Thursday
2020,3,19,2300,64,92,156,Thursday
2020,3,19,2200,104,130,234,Thursday
2020,3,19,2100,100,165,265,Thursday
2020,3,19,2000,147,193,340,Thursday
2020,3,19,1900,183,233,416,Thursday
2020,3,19,1800,187,289,476,Thursday
2020,3,19,1700,232,328,560,Thursday
2020,3,19,1600,266,271,537,Thursday
2020,3,19,1500,279,291,570,Thursday
2020,3,19,1400,284,247,531,Thursday
2020,3,19,1300,313,199,512,Thursday
2020,3,19,1200,332,206,538,Thursday
2020,3,19,1100,309,149,458,Thursday
2020,3,19,1000,216,113,329,Thursday
2020,3,19,900,190,91,281,Thursday
2020,3,19,800,179,59,238,Thursday
2020,3,19,700,80,38,118,Thursday
2020,3,19,600,50,47,97,Thursday
2020,3,19,500,31,32,63,Thursday
2020,3,19,400,30,49,79,Thursday
2020,3,19,300,27,34,61,Thursday
2020,3,19,200,35,37,72,Thursday
2020,3,19,100,40,50,90,Thursday
2020,3,18,2400,69,63,132,Wednesday
2020,3,18,2300,53,92,145,Wednesday
2020,3,18,2200,75,103,178,Wednesday
2020,3,18,2100,120,145,265,Wednesday
2020,3,18,2000,128,336,464,Wednesday
2020,3,18,1900,154,147,301,Wednesday
2020,3,18,1800,197,283,480,Wednesday
2020,3,18,1700,237,353,590,Wednesday
2020,3,18,1600,259,333,592,Wednesday
2020,3,18,1500,257,273,530,Wednesday
2020,3,18,1400,336,287,623,Wednesday
2020,3,18,1300,300,278,578,Wednesday
2020,3,18,1200,366,227,593,Wednesday
2020,3,18,1100,295,182,477,Wednesday
2020,3,18,1000,220,139,359,Wednesday
2020,3,18,900,173,104,277,Wednesday
2020,3,18,800,172,70,242,Wednesday
2020,3,18,700,88,51,139,Wednesday
2020,3,18,600,42,33,75,Wednesday
2020,3,18,500,28,61,89,Wednesday
2020,3,18,400,28,30,58,Wednesday
2020,3,18,300,24,35,59,Wednesday
2020,3,18,200,27,45,72,Wednesday
2020,3,18,100,29,60,89,Wednesday
2020,3,17,2400,47,72,119,Tuesday
2020,3,17,2300,64,89,153,Tuesday
2020,3,17,2200,71,84,155,Tuesday
2020,3,17,2100,104,147,251,Tuesday
2020,3,17,2000,142,181,323,Tuesday
2020,3,17,1900,156,303,459,Tuesday
2020,3,17,1800,198,522,720,Tuesday
2020,3,17,1700,238,609,847,Tuesday
2020,3,17,1600,251,427,678,Tuesday
2020,3,17,1500,273,405,678,Tuesday
2020,3,17,1400,294,342,636,Tuesday
2020,3,17,1300,331,263,594,Tuesday
2020,3,17,1200,405,255,660,Tuesday
2020,3,17,1100,464,190,654,Tuesday
2020,3,17,1000,436,145,581,Tuesday
2020,3,17,900,369,120,489,Tuesday
2020,3,17,800,226,65,291,Tuesday
2020,3,17,700,92,33,125,Tuesday
2020,3,17,600,49,47,96,Tuesday
2020,3,17,500,22,32,54,Tuesday
2020,3,17,400,35,32,67,Tuesday
2020,3,17,300,15,47,62,Tuesday
2020,3,17,200,38,33,71,Tuesday
2020,3,17,100,47,61,108,Tuesday
2020,3,16,2400,55,70,125,Monday
2020,3,16,2300,66,68,134,Monday
2020,3,16,2200,81,115,196,Monday
2020,3,16,2100,128,170,298,Monday
2020,3,16,2000,138,238,376,Monday
2020,3,16,1900,174,335,509,Monday
2020,3,16,1800,192,564,756,Monday
2020,3,16,1700,263,647,910,Monday
2020,3,16,1600,281,471,752,Monday
2020,3,16,1500,319,368,687,Monday
2020,3,16,1400,327,298,625,Monday
2020,3,16,1300,320,298,618,Monday
2020,3,16,1200,410,220,630,Monday
2020,3,16,1100,462,184,646,Monday
2020,3,16,1000,458,134,592,Monday
2020,3,16,900,402,75,477,Monday
2020,3,16,800,208,47,255,Monday
2020,3,16,700,89,45,134,Monday
2020,3,16,600,63,17,80,Monday
2020,3,16,500,20,26,46,Monday
2020,3,16,400,12,19,31,Monday
2020,3,16,300,17,16,33,Monday
2020,3,16,200,16,34,50,Monday
2020,3,16,100,22,41,63,Monday
2020,3,15,2400,43,74,117,Sunday
2020,3,15,2300,49,98,147,Sunday
2020,3,15,2200,59,130,189,Sunday
2020,3,15,2100,78,216,294,Sunday
2020,3,15,2000,132,307,439,Sunday
2020,3,15,1900,142,558,700,Sunday
2020,3,15,1800,180,1036,1216,Sunday
2020,3,15,1700,232,995,1227,Sunday
2020,3,15,1600,283,591,874,Sunday
2020,3,15,1500,325,490,815,Sunday
2020,3,15,1400,387,413,800,Sunday
2020,3,15,1300,393,407,800,Sunday
2020,3,15,1200,486,276,762,Sunday
2020,3,15,1100,466,164,630,Sunday
2020,3,15,1000,556,122,678,Sunday
2020,3,15,900,563,52,615,Sunday
2020,3,15,800,213,27,240,Sunday
2020,3,15,700,73,32,105,Sunday
2020,3,15,600,30,12,42,Sunday
2020,3,15,500,10,14,24,Sunday
2020,3,15,400,14,19,33,Sunday
2020,3,15,300,9,19,28,Sunday
2020,3,15,200,17,22,39,Sunday
2020,3,15,100,29,22,51,Sunday
2020,3,14,2400,31,31,62,Saturday
2020,3,14,2300,44,56,100,Saturday
2020,3,14,2200,73,67,140,Saturday
2020,3,14,2100,72,124,196,Saturday
2020,3,14,2000,95,148,243,Saturday
2020,3,14,1900,101,264,365,Saturday
2020,3,14,1800,135,388,523,Saturday
2020,3,14,1700,189,453,642,Saturday
2020,3,14,1600,193,352,545,Saturday
2020,3,14,1500,233,294,527,Saturday
2020,3,14,1400,264,238,502,Saturday
2020,3,14,1300,275,221,496,Saturday
2020,3,14,1200,278,225,503,Saturday
2020,3,14,1100,278,158,436,Saturday
2020,3,14,1000,258,128,386,Saturday
2020,3,14,900,291,91,382,Saturday
2020,3,14,800,175,55,230,Saturday
2020,3,14,700,69,31,100,Saturday
2020,3,14,600,37,31,68,Saturday
2020,3,14,500,12,27,39,Saturday
2020,3,14,400,24,32,56,Saturday
2020,3,14,300,17,31,48,Saturday
2020,3,14,200,24,41,65,Saturday
2020,3,14,100,42,52,94,Saturday
2020,3,13,2400,40,56,96,Friday
2020,3,13,2300,66,80,146,Friday
2020,3,13,2200,101,98,199,Friday
2020,3,13,2100,138,121,259,Friday
2020,3,13,2000,218,152,370,Friday
2020,3,13,1900,289,198,487,Friday
2020,3,13,1800,356,324,680,Friday
2020,3,13,1700,363,428,791,Friday
2020,3,13,1600,341,340,681,Friday
2020,3,13,1500,345,318,663,Friday
2020,3,13,1400,274,292,566,Friday
2020,3,13,1300,254,240,494,Friday
2020,3,13,1200,289,218,507,Friday
2020,3,13,1100,313,184,497,Friday
2020,3,13,1000,328,143,471,Friday
2020,3,13,900,286,92,378,Friday
2020,3,13,800,169,60,229,Friday
2020,3,13,700,64,54,118,Friday
2020,3,13,600,33,35,68,Friday
2020,3,13,500,33,27,60,Friday
2020,3,13,400,32,36,68,Friday
2020,3,13,300,26,46,72,Friday
2020,3,13,200,32,62,94,Friday
2020,3,13,100,38,73,111,Friday
2020,3,12,2400,69,63,132,Thursday
2020,3,12,2300,82,89,171,Thursday
2020,3,12,2200,96,99,195,Thursday
2020,3,12,2100,153,155,308,Thursday
2020,3,12,2000,198,203,401,Thursday
2020,3,12,1900,254,268,522,Thursday
2020,3,12,1800,281,434,715,Thursday
2020,3,12,1700,318,539,857,Thursday
2020,3,12,1600,334,385,719,Thursday
2020,3,12,1500,298,327,625,Thursday
2020,3,12,1400,290,354,644,Thursday
2020,3,12,1300,289,292,581,Thursday
2020,3,12,1200,353,215,568,Thursday
2020,3,12,1100,340,173,513,Thursday
2020,3,12,1000,395,144,539,Thursday
2020,3,12,900,369,105,474,Thursday
2020,3,12,800,227,66,293,Thursday
2020,3,12,700,72,44,116,Thursday
2020,3,12,600,48,23,71,Thursday
2020,3,12,500,29,21,50,Thursday
2020,3,12,400,41,34,75,Thursday
2020,3,12,300,28,51,79,Thursday
2020,3,12,200,30,60,90,Thursday
2020,3,12,100,34,45,79,Thursday
2020,3,11,2400,69,62,131,Wednesday
2020,3,11,2300,65,69,134,Wednesday
2020,3,11,2200,97,104,201,Wednesday
2020,3,11,2100,98,139,237,Wednesday
2020,3,11,2000,137,190,327,Wednesday
2020,3,11,1900,156,272,428,Wednesday
2020,3,11,1800,192,533,725,Wednesday
2020,3,11,1700,236,469,705,Wednesday
2020,3,11,1600,242,462,704,Wednesday
2020,3,11,1500,242,212,454,Wednesday
2020,3,11,1400,252,189,441,Wednesday
2020,3,11,1300,277,310,587,Wednesday
2020,3,11,1200,316,167,483,Wednesday
2020,3,11,1100,331,111,442,Wednesday
2020,3,11,1000,409,129,538,Wednesday
2020,3,11,900,371,96,467,Wednesday
2020,3,11,800,238,65,303,Wednesday
2020,3,11,700,95,40,135,Wednesday
2020,3,11,600,43,41,84,Wednesday
2020,3,11,500,27,31,58,Wednesday
2020,3,11,400,25,54,79,Wednesday
2020,3,11,300,28,105,133,Wednesday
2020,3,11,200,37,65,102,Wednesday
2020,3,11,100,43,76,119,Wednesday
2020,3,10,2400,53,15,68,Tuesday
2020,3,10,2300,58,23,81,Tuesday
2020,3,10,2200,76,31,107,Tuesday
2020,3,10,2100,96,87,183,Tuesday
2020,3,10,2000,108,157,265,Tuesday
2020,3,10,1900,137,233,370,Tuesday
2020,3,10,1800,160,426,586,Tuesday
2020,3,10,1700,212,449,661,Tuesday
2020,3,10,1600,214,379,593,Tuesday
2020,3,10,1500,256,282,538,Tuesday
2020,3,10,1400,242,277,519,Tuesday
2020,3,10,1300,269,238,507,Tuesday
2020,3,10,1200,307,199,506,Tuesday
2020,3,10,1100,302,185,487,Tuesday
2020,3,10,1000,363,142,505,Tuesday
2020,3,10,900,360,101,461,Tuesday
2020,3,10,800,233,71,304,Tuesday
2020,3,10,700,77,54,131,Tuesday
2020,3,10,600,40,35,75,Tuesday
2020,3,10,500,25,37,62,Tuesday
2020,3,10,400,19,34,53,Tuesday
2020,3,10,300,27,48,75,Tuesday
2020,3,10,200,29,48,77,Tuesday
2020,3,10,100,35,51,86,Tuesday
2020,3,9,2400,64,54,118,Monday
2020,3,9,2300,54,71,125,Monday
2020,3,9,2200,72,110,182,Monday
2020,3,9,2100,102,174,276,Monday
2020,3,9,2000,129,212,341,Monday
2020,3,9,1900,155,287,442,Monday
2020,3,9,1800,210,540,750,Monday
2020,3,9,1700,202,683,885,Monday
2020,3,9,1600,271,449,720,Monday
2020,3,9,1500,308,345,653,Monday
2020,3,9,1400,328,266,594,Monday
2020,3,9,1300,340,281,621,Monday
2020,3,9,1200,382,213,595,Monday
2020,3,9,1100,411,181,592,Monday
2020,3,9,1000,443,147,590,Monday
2020,3,9,900,434,94,528,Monday
2020,3,9,800,237,72,309,Monday
2020,3,9,700,70,37,107,Monday
2020,3,9,600,36,16,52,Monday
2020,3,9,500,20,28,48,Monday
2020,3,9,400,23,20,43,Monday
2020,3,9,300,27,21,48,Monday
2020,3,9,200,21,28,49,Monday
2020,3,9,100,25,44,69,Monday
2020,3,8,2400,41,66,107,Sunday
2020,3,8,2300,55,85,140,Sunday
2020,3,8,2200,83,145,228,Sunday
2020,3,8,2100,93,211,304,Sunday
2020,3,8,2000,112,339,451,Sunday
2020,3,8,1900,145,594,739,Sunday
2020,3,8,1800,202,1068,1270,Sunday
2020,3,8,1700,266,1235,1501,Sunday
2020,3,8,1600,261,958,1219,Sunday
2020,3,8,1500,307,788,1095,Sunday
2020,3,8,1400,350,748,1098,Sunday
2020,3,8,1300,384,457,841,Sunday
2020,3,8,1200,409,329,738,Sunday
2020,3,8,1100,390,205,595,Sunday
2020,3,8,1000,579,111,690,Sunday
2020,3,8,900,790,63,853,Sunday
2020,3,8,800,306,46,352,Sunday
2020,3,8,700,54,29,83,Sunday
2020,3,8,600,24,14,38,Sunday
2020,3,8,500,20,18,38,Sunday
2020,3,8,400,25,17,42,Sunday
2020,3,8,300,0,0,0,Sunday
2020,3,8,200,22,23,45,Sunday
2020,3,8,100,19,28,47,Sunday
2020,3,7,2400,25,45,70,Saturday
2020,3,7,2300,37,49,86,Saturday
2020,3,7,2200,57,77,134,Saturday
2020,3,7,2100,67,122,189,Saturday
2020,3,7,2000,73,129,202,Saturday
2020,3,7,1900,102,276,378,Saturday
2020,3,7,1800,161,898,1059,Saturday
2020,3,7,1700,183,816,999,Saturday
2020,3,7,1600,216,552,768,Saturday
2020,3,7,1500,238,371,609,Saturday
2020,3,7,1400,248,276,524,Saturday
2020,3,7,1300,249,278,527,Saturday
2020,3,7,1200,329,248,577,Saturday
2020,3,7,1100,346,151,497,Saturday
2020,3,7,1000,599,154,753,Saturday
2020,3,7,900,1082,102,1184,Saturday
2020,3,7,800,484,55,539,Saturday
2020,3,7,700,81,26,107,Saturday
2020,3,7,600,36,22,58,Saturday
2020,3,7,500,11,22,33,Saturday
2020,3,7,400,18,23,41,Saturday
2020,3,7,300,20,23,43,Saturday
2020,3,7,200,30,160,190,Saturday
2020,3,7,100,35,9,44,Saturday
2020,3,6,2400,68,6,74,Friday
2020,3,6,2300,88,41,129,Friday
2020,3,6,2200,103,74,177,Friday
2020,3,6,2100,236,106,342,Friday
2020,3,6,2000,286,187,473,Friday
2020,3,6,1900,430,293,723,Friday
2020,3,6,1800,452,500,952,Friday
2020,3,6,1700,532,623,1155,Friday
2020,3,6,1600,458,452,910,Friday
2020,3,6,1500,457,356,813,Friday
2020,3,6,1400,360,315,675,Friday
2020,3,6,1300,356,306,662,Friday
2020,3,6,1200,361,240,601,Friday
2020,3,6,1100,370,199,569,Friday
2020,3,6,1000,487,144,631,Friday
2020,3,6,900,599,124,723,Friday
2020,3,6,800,314,80,394,Friday
2020,3,6,700,97,36,133,Friday
2020,3,6,600,62,30,92,Friday
2020,3,6,500,39,17,56,Friday
2020,3,6,400,30,34,64,Friday
2020,3,6,300,27,21,48,Friday
2020,3,6,200,32,38,70,Friday
2020,3,6,100,35,51,86,Friday
2020,3,5,2400,67,54,121,Thursday
2020,3,5,2300,99,69,168,Thursday
2020,3,5,2200,124,84,208,Thursday
2020,3,5,2100,171,135,306,Thursday
2020,3,5,2000,200,167,367,Thursday
2020,3,5,1900,264,256,520,Thursday
2020,3,5,1800,312,467,779,Thursday
2020,3,5,1700,321,607,928,Thursday
2020,3,5,1600,322,448,770,Thursday
2020,3,5,1500,328,302,630,Thursday
2020,3,5,1400,323,268,591,Thursday
2020,3,5,1300,309,269,578,Thursday
2020,3,5,1200,355,200,555,Thursday
2020,3,5,1100,354,179,533,Thursday
2020,3,5,1000,449,147,596,Thursday
2020,3,5,900,465,118,583,Thursday
2020,3,5,800,279,64,343,Thursday
2020,3,5,700,78,53,131,Thursday
2020,3,5,600,61,33,94,Thursday
2020,3,5,500,28,38,66,Thursday
2020,3,5,400,37,37,74,Thursday
2020,3,5,300,19,32,51,Thursday
2020,3,5,200,24,41,65,Thursday
2020,3,5,100,36,48,84,Thursday
2020,3,4,2400,66,57,123,Wednesday
2020,3,4,2300,86,77,163,Wednesday
2020,3,4,2200,82,80,162,Wednesday
2020,3,4,2100,116,104,220,Wednesday
2020,3,4,2000,131,156,287,Wednesday
2020,3,4,1900,161,223,384,Wednesday
2020,3,4,1800,191,410,601,Wednesday
2020,3,4,1700,265,503,768,Wednesday
2020,3,4,1600,223,391,614,Wednesday
2020,3,4,1500,230,367,597,Wednesday
2020,3,4,1400,274,320,594,Wednesday
2020,3,4,1300,283,265,548,Wednesday
2020,3,4,1200,271,191,462,Wednesday
2020,3,4,1100,314,165,479,Wednesday
2020,3,4,1000,406,132,538,Wednesday
2020,3,4,900,489,110,599,Wednesday
2020,3,4,800,192,61,253,Wednesday
2020,3,4,700,65,35,100,Wednesday
2020,3,4,600,46,31,77,Wednesday
2020,3,4,500,21,30,51,Wednesday
2020,3,4,400,25,16,41,Wednesday
2020,3,4,300,25,39,64,Wednesday
2020,3,4,200,34,40,74,Wednesday
2020,3,4,100,35,57,92,Wednesday
2020,3,3,2400,49,44,93,Tuesday
2020,3,3,2300,65,73,138,Tuesday
2020,3,3,2200,67,84,151,Tuesday
2020,3,3,2100,119,94,213,Tuesday
2020,3,3,2000,121,144,265,Tuesday
2020,3,3,1900,123,263,386,Tuesday
2020,3,3,1800,202,365,567,Tuesday
2020,3,3,1700,211,500,711,Tuesday
2020,3,3,1600,226,368,594,Tuesday
2020,3,3,1500,230,324,554,Tuesday
2020,3,3,1400,235,296,531,Tuesday
2020,3,3,1300,254,268,522,Tuesday
2020,3,3,1200,297,185,482,Tuesday
2020,3,3,1100,347,167,514,Tuesday
2020,3,3,1000,416,133,549,Tuesday
2020,3,3,900,423,109,532,Tuesday
2020,3,3,800,237,85,322,Tuesday
2020,3,3,700,77,35,112,Tuesday
2020,3,3,600,50,24,74,Tuesday
2020,3,3,500,25,22,47,Tuesday
2020,3,3,400,28,23,51,Tuesday
2020,3,3,300,15,33,48,Tuesday
2020,3,3,200,21,26,47,Tuesday
2020,3,3,100,37,43,80,Tuesday
2020,3,2,2400,57,67,124,Monday
2020,3,2,2300,72,65,137,Monday
2020,3,2,2200,60,75,135,Monday
2020,3,2,2100,83,107,190,Monday
2020,3,2,2000,120,169,289,Monday
2020,3,2,1900,136,382,518,Monday
2020,3,2,1800,165,311,476,Monday
2020,3,2,1700,225,485,710,Monday
2020,3,2,1600,260,448,708,Monday
2020,3,2,1500,253,244,497,Monday
2020,3,2,1400,249,406,655,Monday
2020,3,2,1300,279,225,504,Monday
2020,3,2,1200,311,227,538,Monday
2020,3,2,1100,344,225,569,Monday
2020,3,2,1000,373,101,474,Monday
2020,3,2,900,429,110,539,Monday
2020,3,2,800,179,81,260,Monday
2020,3,2,700,71,43,114,Monday
2020,3,2,600,38,24,62,Monday
2020,3,2,500,26,24,50,Monday
2020,3,2,400,18,21,39,Monday
2020,3,2,300,19,25,44,Monday
2020,3,2,200,36,22,58,Monday
2020,3,2,100,28,44,72,Monday
2020,3,1,2400,27,64,91,Sunday
2020,3,1,2300,47,161,208,Sunday
2020,3,1,2200,64,171,235,Sunday
2020,3,1,2100,68,237,305,Sunday
2020,3,1,2000,115,309,424,Sunday
2020,3,1,1900,121,493,614,Sunday
2020,3,1,1800,191,900,1091,Sunday
2020,3,1,1700,260,1334,1594,Sunday
2020,3,1,1600,273,948,1221,Sunday
2020,3,1,1500,337,754,1091,Sunday
2020,3,1,1400,361,629,990,Sunday
2020,3,1,1300,383,531,914,Sunday
2020,3,1,1200,448,389,837,Sunday
2020,3,1,1100,430,242,672,Sunday
2020,3,1,1000,645,114,759,Sunday
2020,3,1,900,854,80,934,Sunday
2020,3,1,800,389,27,416,Sunday
2020,3,1,700,71,9,80,Sunday
2020,3,1,600,29,4,33,Sunday
2020,3,1,500,18,19,37,Sunday
2020,3,1,400,18,15,33,Sunday
2020,3,1,300,22,16,38,Sunday
2020,3,1,200,17,25,42,Sunday
2020,3,1,100,22,35,57,Sunday
2020,2,29,2400,21,45,66,Saturday
2020,2,29,2300,45,65,110,Saturday
2020,2,29,2200,53,80,133,Saturday
2020,2,29,2100,86,129,215,Saturday
2020,2,29,2000,113,154,267,Saturday
2020,2,29,1900,118,332,450,Saturday
2020,2,29,1800,182,793,975,Saturday
2020,2,29,1700,209,996,1205,Saturday
2020,2,29,1600,262,677,939,Saturday
2020,2,29,1500,284,522,806,Saturday
2020,2,29,1400,319,379,698,Saturday
2020,2,29,1300,367,357,724,Saturday
2020,2,29,1200,465,290,755,Saturday
2020,2,29,1100,512,186,698,Saturday
2020,2,29,1000,720,179,899,Saturday
2020,2,29,900,1019,94,1113,Saturday
2020,2,29,800,516,78,594,Saturday
2020,2,29,700,99,29,128,Saturday
2020,2,29,600,30,7,37,Saturday
2020,2,29,500,32,17,49,Saturday
2020,2,29,400,38,16,54,Saturday
2020,2,29,300,23,21,44,Saturday
2020,2,29,200,29,32,61,Saturday
2020,2,29,100,31,53,84,Saturday
2020,2,28,2400,46,55,101,Friday
2020,2,28,2300,79,81,160,Friday
2020,2,28,2200,140,100,240,Friday
2020,2,28,2100,229,130,359,Friday
2020,2,28,2000,335,197,532,Friday
2020,2,28,1900,426,290,716,Friday
2020,2,28,1800,471,567,1038,Friday
2020,2,28,1700,492,658,1150,Friday
2020,2,28,1600,480,561,1041,Friday
2020,2,28,1500,435,396,831,Friday
2020,2,28,1400,393,334,727,Friday
2020,2,28,1300,375,320,695,Friday
2020,2,28,1200,431,267,698,Friday
2020,2,28,1100,448,225,673,Friday
2020,2,28,1000,503,170,673,Friday
2020,2,28,900,558,122,680,Friday
2020,2,28,800,286,71,357,Friday
2020,2,28,700,123,37,160,Friday
2020,2,28,600,46,48,94,Friday
2020,2,28,500,23,45,68,Friday
2020,2,28,400,27,31,58,Friday
2020,2,28,300,23,44,67,Friday
2020,2,28,200,26,43,69,Friday
2020,2,28,100,39,50,89,Friday
2020,2,27,2400,54,64,118,Thursday
2020,2,27,2300,85,76,161,Thursday
2020,2,27,2200,88,86,174,Thursday
2020,2,27,2100,152,114,266,Thursday
2020,2,27,2000,207,152,359,Thursday
2020,2,27,1900,245,242,487,Thursday
2020,2,27,1800,308,452,760,Thursday
2020,2,27,1700,302,557,859,Thursday
2020,2,27,1600,314,477,791,Thursday
2020,2,27,1500,370,302,672,Thursday
2020,2,27,1400,336,317,653,Thursday
2020,2,27,1300,295,228,523,Thursday
2020,2,27,1200,325,211,536,Thursday
2020,2,27,1100,349,168,517,Thursday
2020,2,27,1000,433,113,546,Thursday
2020,2,27,900,425,106,531,Thursday
2020,2,27,800,234,82,316,Thursday
2020,2,27,700,77,44,121,Thursday
2020,2,27,600,40,31,71,Thursday
2020,2,27,500,24,36,60,Thursday
2020,2,27,400,32,24,56,Thursday
2020,2,27,300,26,31,57,Thursday
2020,2,27,200,28,25,53,Thursday
2020,2,27,100,39,43,82,Thursday
2020,2,26,2400,48,56,104,Wednesday
2020,2,26,2300,61,67,128,Wednesday
2020,2,26,2200,95,79,174,Wednesday
2020,2,26,2100,118,119,237,Wednesday
2020,2,26,2000,155,135,290,Wednesday
2020,2,26,1900,142,209,351,Wednesday
2020,2,26,1800,209,338,547,Wednesday
2020,2,26,1700,235,480,715,Wednesday
2020,2,26,1600,266,357,623,Wednesday
2020,2,26,1500,242,355,597,Wednesday
2020,2,26,1400,296,257,553,Wednesday
2020,2,26,1300,261,284,545,Wednesday
2020,2,26,1200,280,218,498,Wednesday
2020,2,26,1100,293,163,456,Wednesday
2020,2,26,1000,362,147,509,Wednesday
2020,2,26,900,372,101,473,Wednesday
2020,2,26,800,179,66,245,Wednesday
2020,2,26,700,68,49,117,Wednesday
2020,2,26,600,33,31,64,Wednesday
2020,2,26,500,21,30,51,Wednesday
2020,2,26,400,22,30,52,Wednesday
2020,2,26,300,25,28,53,Wednesday
2020,2,26,200,30,33,63,Wednesday
2020,2,26,100,30,48,78,Wednesday
2020,2,25,2400,41,40,81,Tuesday
2020,2,25,2300,73,61,134,Tuesday
2020,2,25,2200,72,81,153,Tuesday
2020,2,25,2100,101,110,211,Tuesday
2020,2,25,2000,116,157,273,Tuesday
2020,2,25,1900,124,199,323,Tuesday
2020,2,25,1800,151,367,518,Tuesday
2020,2,25,1700,201,506,707,Tuesday
2020,2,25,1600,239,388,627,Tuesday
2020,2,25,1500,267,281,548,Tuesday
2020,2,25,1400,231,254,485,Tuesday
2020,2,25,1300,271,242,513,Tuesday
2020,2,25,1200,274,192,466,Tuesday
2020,2,25,1100,308,170,478,Tuesday
2020,2,25,1000,354,161,515,Tuesday
2020,2,25,900,372,111,483,Tuesday
2020,2,25,800,219,80,299,Tuesday
2020,2,25,700,69,47,116,Tuesday
2020,2,25,600,44,43,87,Tuesday
2020,2,25,500,17,33,50,Tuesday
2020,2,25,400,25,27,52,Tuesday
2020,2,25,300,26,32,58,Tuesday
2020,2,25,200,29,56,85,Tuesday
2020,2,25,100,38,51,89,Tuesday
2020,2,24,2400,42,57,99,Monday
2020,2,24,2300,50,76,126,Monday
2020,2,24,2200,80,94,174,Monday
2020,2,24,2100,89,99,188,Monday
2020,2,24,2000,129,161,290,Monday
2020,2,24,1900,125,239,364,Monday
2020,2,24,1800,153,391,544,Monday
2020,2,24,1700,221,461,682,Monday
2020,2,24,1600,239,378,617,Monday
2020,2,24,1500,256,309,565,Monday
2020,2,24,1400,287,299,586,Monday
2020,2,24,1300,250,276,526,Monday
2020,2,24,1200,309,197,506,Monday
2020,2,24,1100,292,215,507,Monday
2020,2,24,1000,369,143,512,Monday
2020,2,24,900,395,90,485,Monday
2020,2,24,800,182,48,230,Monday
2020,2,24,700,67,35,102,Monday
2020,2,24,600,41,18,59,Monday
2020,2,24,500,19,22,41,Monday
2020,2,24,400,25,24,49,Monday
2020,2,24,300,14,24,38,Monday
2020,2,24,200,19,30,49,Monday
2020,2,24,100,21,49,70,Monday
2020,2,23,2400,22,74,96,Sunday
2020,2,23,2300,35,57,92,Sunday
2020,2,23,2200,55,98,153,Sunday
2020,2,23,2100,66,177,243,Sunday
2020,2,23,2000,83,254,337,Sunday
2020,2,23,1900,130,428,558,Sunday
2020,2,23,1800,147,798,945,Sunday
2020,2,23,1700,237,1112,1349,Sunday
2020,2,23,1600,312,868,1180,Sunday
2020,2,23,1500,369,799,1168,Sunday
2020,2,23,1400,364,787,1151,Sunday
2020,2,23,1300,399,689,1088,Sunday
2020,2,23,1200,462,534,996,Sunday
2020,2,23,1100,430,334,764,Sunday
2020,2,23,1000,555,183,738,Sunday
2020,2,23,900,712,88,800,Sunday
2020,2,23,800,353,49,402,Sunday
2020,2,23,700,93,28,121,Sunday
2020,2,23,600,29,19,48,Sunday
2020,2,23,500,9,12,21,Sunday
2020,2,23,400,8,17,25,Sunday
2020,2,23,300,13,26,39,Sunday
2020,2,23,200,31,35,66,Sunday
2020,2,23,100,20,39,59,Sunday
2020,2,22,2400,31,41,72,Saturday
2020,2,22,2300,47,62,109,Saturday
2020,2,22,2200,71,109,180,Saturday
2020,2,22,2100,72,200,272,Saturday
2020,2,22,2000,94,474,568,Saturday
2020,2,22,1900,130,365,495,Saturday
2020,2,22,1800,198,903,1101,Saturday
2020,2,22,1700,252,997,1249,Saturday
2020,2,22,1600,299,543,842,Saturday
2020,2,22,1500,374,516,890,Saturday
2020,2,22,1400,357,402,759,Saturday
2020,2,22,1300,471,411,882,Saturday
2020,2,22,1200,519,365,884,Saturday
2020,2,22,1100,534,241,775,Saturday
2020,2,22,1000,693,170,863,Saturday
2020,2,22,900,916,118,1034,Saturday
2020,2,22,800,486,72,558,Saturday
2020,2,22,700,94,51,145,Saturday
2020,2,22,600,40,24,64,Saturday
2020,2,22,500,24,24,48,Saturday
2020,2,22,400,12,20,32,Saturday
2020,2,22,300,18,30,48,Saturday
2020,2,22,200,19,16,35,Saturday
2020,2,22,100,33,45,78,Saturday
2020,2,21,2400,47,50,97,Friday
2020,2,21,2300,88,62,150,Friday
2020,2,21,2200,145,92,237,Friday
2020,2,21,2100,195,129,324,Friday
2020,2,21,2000,303,230,533,Friday
2020,2,21,1900,354,376,730,Friday
2020,2,21,1800,405,780,1185,Friday
2020,2,21,1700,458,869,1327,Friday
2020,2,21,1600,497,641,1138,Friday
2020,2,21,1500,509,490,999,Friday
2020,2,21,1400,421,402,823,Friday
2020,2,21,1300,475,401,876,Friday
2020,2,21,1200,477,386,863,Friday
2020,2,21,1100,521,270,791,Friday
2020,2,21,1000,564,222,786,Friday
2020,2,21,900,661,128,789,Friday
2020,2,21,800,290,91,381,Friday
2020,2,21,700,95,66,161,Friday
2020,2,21,600,54,44,98,Friday
2020,2,21,500,33,28,61,Friday
2020,2,21,400,26,39,65,Friday
2020,2,21,300,26,38,64,Friday
2020,2,21,200,30,45,75,Friday
2020,2,21,100,37,56,93,Friday
2020,2,20,2400,56,174,230,Thursday
2020,2,20,2300,92,123,215,Thursday
2020,2,20,2200,119,23,142,Thursday
2020,2,20,2100,161,188,349,Thursday
2020,2,20,2000,203,131,334,Thursday
2020,2,20,1900,218,239,457,Thursday
2020,2,20,1800,302,690,992,Thursday
2020,2,20,1700,340,848,1188,Thursday
2020,2,20,1600,319,568,887,Thursday
2020,2,20,1500,367,451,818,Thursday
2020,2,20,1400,378,445,823,Thursday
2020,2,20,1300,383,312,695,Thursday
2020,2,20,1200,427,287,714,Thursday
2020,2,20,1100,460,234,694,Thursday
2020,2,20,1000,594,148,742,Thursday
2020,2,20,900,618,132,750,Thursday
2020,2,20,800,251,78,329,Thursday
2020,2,20,700,69,43,112,Thursday
2020,2,20,600,47,43,90,Thursday
2020,2,20,500,33,40,73,Thursday
2020,2,20,400,26,25,51,Thursday
2020,2,20,300,31,31,62,Thursday
2020,2,20,200,34,29,63,Thursday
2020,2,20,100,36,57,93,Thursday
2020,2,19,2400,57,46,103,Wednesday
2020,2,19,2300,74,83,157,Wednesday
2020,2,19,2200,113,98,211,Wednesday
2020,2,19,2100,118,139,257,Wednesday
2020,2,19,2000,150,208,358,Wednesday
2020,2,19,1900,174,318,492,Wednesday
2020,2,19,1800,208,683,891,Wednesday
2020,2,19,1700,292,751,1043,Wednesday
2020,2,19,1600,312,551,863,Wednesday
2020,2,19,1500,315,443,758,Wednesday
2020,2,19,1400,348,338,686,Wednesday
2020,2,19,1300,366,357,723,Wednesday
2020,2,19,1200,442,290,732,Wednesday
2020,2,19,1100,463,188,651,Wednesday
2020,2,19,1000,510,173,683,Wednesday
2020,2,19,900,494,114,608,Wednesday
2020,2,19,800,263,97,360,Wednesday
2020,2,19,700,71,47,118,Wednesday
2020,2,19,600,41,38,79,Wednesday
2020,2,19,500,28,35,63,Wednesday
2020,2,19,400,30,39,69,Wednesday
2020,2,19,300,17,35,52,Wednesday
2020,2,19,200,36,27,63,Wednesday
2020,2,19,100,41,38,79,Wednesday
2020,2,18,2400,50,51,101,Tuesday
2020,2,18,2300,61,70,131,Tuesday
2020,2,18,2200,80,88,168,Tuesday
2020,2,18,2100,118,114,232,Tuesday
2020,2,18,2000,132,196,328,Tuesday
2020,2,18,1900,138,352,490,Tuesday
2020,2,18,1800,221,662,883,Tuesday
2020,2,18,1700,265,756,1021,Tuesday
2020,2,18,1600,317,557,874,Tuesday
2020,2,18,1500,335,450,785,Tuesday
2020,2,18,1400,368,388,756,Tuesday
2020,2,18,1300,372,330,702,Tuesday
2020,2,18,1200,403,267,670,Tuesday
2020,2,18,1100,466,203,669,Tuesday
2020,2,18,1000,526,164,690,Tuesday
2020,2,18,900,552,99,651,Tuesday
2020,2,18,800,251,74,325,Tuesday
2020,2,18,700,71,40,111,Tuesday
2020,2,18,600,38,28,66,Tuesday
2020,2,18,500,15,21,36,Tuesday
2020,2,18,400,17,20,37,Tuesday
2020,2,18,300,18,15,33,Tuesday
2020,2,18,200,19,42,61,Tuesday
2020,2,18,100,26,39,65,Tuesday
2020,2,17,2400,28,37,65,Monday
2020,2,17,2300,47,59,106,Monday
2020,2,17,2200,60,131,191,Monday
2020,2,17,2100,78,200,278,Monday
2020,2,17,2000,102,354,456,Monday
2020,2,17,1900,123,627,750,Monday
2020,2,17,1800,201,1125,1326,Monday
2020,2,17,1700,270,1478,1748,Monday
2020,2,17,1600,379,1379,1758,Monday
2020,2,17,1500,465,1363,1828,Monday
2020,2,17,1400,548,1165,1713,Monday
2020,2,17,1300,576,1214,1790,Monday
2020,2,17,1200,671,844,1515,Monday
2020,2,17,1100,636,481,1117,Monday
2020,2,17,1000,610,214,824,Monday
2020,2,17,900,738,107,845,Monday
2020,2,17,800,332,47,379,Monday
2020,2,17,700,89,36,125,Monday
2020,2,17,600,31,23,54,Monday
2020,2,17,500,15,14,29,Monday
2020,2,17,400,20,11,31,Monday
2020,2,17,300,9,8,17,Monday
2020,2,17,200,7,21,28,Monday
2020,2,17,100,24,34,58,Monday
2020,2,16,2400,28,49,77,Sunday
2020,2,16,2300,43,58,101,Sunday
2020,2,16,2200,57,103,160,Sunday
2020,2,16,2100,84,159,243,Sunday
2020,2,16,2000,122,280,402,Sunday
2020,2,16,1900,158,573,731,Sunday
2020,2,16,1800,216,1177,1393,Sunday
2020,2,16,1700,311,1428,1739,Sunday
2020,2,16,1600,447,1020,1467,Sunday
2020,2,16,1500,497,752,1249,Sunday
2020,2,16,1400,612,620,1232,Sunday
2020,2,16,1300,636,478,1114,Sunday
2020,2,16,1200,759,389,1148,Sunday
2020,2,16,1100,746,215,961,Sunday
2020,2,16,1000,817,129,946,Sunday
2020,2,16,900,921,77,998,Sunday
2020,2,16,800,411,34,445,Sunday
2020,2,16,700,77,24,101,Sunday
2020,2,16,600,26,8,34,Sunday
2020,2,16,500,26,8,34,Sunday
2020,2,16,400,15,11,26,Sunday
2020,2,16,300,11,17,28,Sunday
2020,2,16,200,17,28,45,Sunday
2020,2,16,100,27,36,63,Sunday
2020,2,15,2400,35,30,65,Saturday
2020,2,15,2300,54,65,119,Saturday
2020,2,15,2200,61,74,135,Saturday
2020,2,15,2100,84,116,200,Saturday
2020,2,15,2000,137,197,334,Saturday
2020,2,15,1900,180,458,638,Saturday
2020,2,15,1800,293,865,1158,Saturday
2020,2,15,1700,406,1052,1458,Saturday
2020,2,15,1600,488,724,1212,Saturday
2020,2,15,1500,642,618,1260,Saturday
2020,2,15,1400,685,485,1170,Saturday
2020,2,15,1300,793,433,1226,Saturday
2020,2,15,1200,778,295,1073,Saturday
2020,2,15,1100,764,215,979,Saturday
2020,2,15,1000,770,142,912,Saturday
2020,2,15,900,908,84,992,Saturday
2020,2,15,800,457,59,516,Saturday
2020,2,15,700,127,29,156,Saturday
2020,2,15,600,53,29,82,Saturday
2020,2,15,500,22,22,44,Saturday
2020,2,15,400,21,21,42,Saturday
2020,2,15,300,21,14,35,Saturday
2020,2,15,200,28,31,59,Saturday
2020,2,15,100,46,47,93,Saturday
2020,2,14,2400,86,66,152,Friday
2020,2,14,2300,165,86,251,Friday
2020,2,14,2200,222,82,304,Friday
2020,2,14,2100,304,123,427,Friday
2020,2,14,2000,464,172,636,Friday
2020,2,14,1900,570,281,851,Friday
2020,2,14,1800,717,523,1240,Friday
2020,2,14,1700,839,768,1607,Friday
2020,2,14,1600,780,647,1427,Friday
2020,2,14,1500,714,481,1195,Friday
2020,2,14,1400,616,391,1007,Friday
2020,2,14,1300,554,299,853,Friday
2020,2,14,1200,573,234,807,Friday
2020,2,14,1100,573,205,778,Friday
2020,2,14,1000,624,205,829,Friday
2020,2,14,900,594,136,730,Friday
2020,2,14,800,346,57,403,Friday
2020,2,14,700,96,38,134,Friday
2020,2,14,600,35,13,48,Friday
2020,2,14,500,28,6,34,Friday
2020,2,14,400,30,8,38,Friday
2020,2,14,300,24,4,28,Friday
2020,2,14,200,33,52,85,Friday
2020,2,14,100,52,64,116,Friday
2020,2,13,2400,76,49,125,Thursday
2020,2,13,2300,78,73,151,Thursday
2020,2,13,2200,145,89,234,Thursday
2020,2,13,2100,193,116,309,Thursday
2020,2,13,2000,255,149,404,Thursday
2020,2,13,1900,252,209,461,Thursday
2020,2,13,1800,351,411,762,Thursday
2020,2,13,1700,413,578,991,Thursday
2020,2,13,1600,425,410,835,Thursday
2020,2,13,1500,398,322,720,Thursday
2020,2,13,1400,376,269,645,Thursday
2020,2,13,1300,429,261,690,Thursday
2020,2,13,1200,440,200,640,Thursday
2020,2,13,1100,389,173,562,Thursday
2020,2,13,1000,469,129,598,Thursday
2020,2,13,900,428,93,521,Thursday
2020,2,13,800,232,69,301,Thursday
2020,2,13,700,74,55,129,Thursday
2020,2,13,600,41,36,77,Thursday
2020,2,13,500,27,20,47,Thursday
2020,2,13,400,26,25,51,Thursday
2020,2,13,300,33,31,64,Thursday
2020,2,13,200,31,45,76,Thursday
2020,2,13,100,43,34,77,Thursday
2020,2,12,2400,59,60,119,Wednesday
2020,2,12,2300,66,69,135,Wednesday
2020,2,12,2200,117,86,203,Wednesday
2020,2,12,2100,111,96,207,Wednesday
2020,2,12,2000,159,127,286,Wednesday
2020,2,12,1900,207,199,406,Wednesday
2020,2,12,1800,239,396,635,Wednesday
2020,2,12,1700,268,497,765,Wednesday
2020,2,12,1600,262,368,630,Wednesday
2020,2,12,1500,259,250,509,Wednesday
2020,2,12,1400,297,276,573,Wednesday
2020,2,12,1300,244,190,434,Wednesday
2020,2,12,1200,254,155,409,Wednesday
2020,2,12,1100,310,182,492,Wednesday
2020,2,12,1000,335,147,482,Wednesday
2020,2,12,900,370,119,489,Wednesday
2020,2,12,800,210,74,284,Wednesday
2020,2,12,700,60,40,100,Wednesday
2020,2,12,600,53,28,81,Wednesday
2020,2,12,500,22,36,58,Wednesday
2020,2,12,400,15,27,42,Wednesday
2020,2,12,300,15,41,56,Wednesday
2020,2,12,200,30,43,73,Wednesday
2020,2,12,100,43,53,96,Wednesday
2020,2,11,2400,55,36,91,Tuesday
2020,2,11,2300,42,43,85,Tuesday
2020,2,11,2200,69,74,143,Tuesday
2020,2,11,2100,86,108,194,Tuesday
2020,2,11,2000,98,210,308,Tuesday
2020,2,11,1900,84,254,338,Tuesday
2020,2,11,1800,156,275,431,Tuesday
2020,2,11,1700,183,345,528,Tuesday
2020,2,11,1600,185,250,435,Tuesday
2020,2,11,1500,218,201,419,Tuesday
2020,2,11,1400,231,212,443,Tuesday
2020,2,11,1300,220,242,462,Tuesday
2020,2,11,1200,266,191,457,Tuesday
2020,2,11,1100,260,160,420,Tuesday
2020,2,11,1000,306,121,427,Tuesday
2020,2,11,900,314,91,405,Tuesday
2020,2,11,800,172,69,241,Tuesday
2020,2,11,700,55,50,105,Tuesday
2020,2,11,600,38,39,77,Tuesday
2020,2,11,500,29,26,55,Tuesday
2020,2,11,400,24,32,56,Tuesday
2020,2,11,300,13,29,42,Tuesday
2020,2,11,200,20,35,55,Tuesday
2020,2,11,100,23,57,80,Tuesday
2020,2,10,2400,50,48,98,Monday
2020,2,10,2300,58,61,119,Monday
2020,2,10,2200,78,103,181,Monday
2020,2,10,2100,86,102,188,Monday
2020,2,10,2000,100,120,220,Monday
2020,2,10,1900,97,205,302,Monday
2020,2,10,1800,160,402,562,Monday
2020,2,10,1700,215,539,754,Monday
2020,2,10,1600,288,410,698,Monday
2020,2,10,1500,281,351,632,Monday
2020,2,10,1400,276,265,541,Monday
2020,2,10,1300,304,281,585,Monday
2020,2,10,1200,297,217,514,Monday
2020,2,10,1100,327,172,499,Monday
2020,2,10,1000,357,150,507,Monday
2020,2,10,900,347,99,446,Monday
2020,2,10,800,214,72,286,Monday
2020,2,10,700,80,26,106,Monday
2020,2,10,600,33,23,56,Monday
2020,2,10,500,21,20,41,Monday
2020,2,10,400,10,29,39,Monday
2020,2,10,300,23,15,38,Monday
2020,2,10,200,19,30,49,Monday
2020,2,10,100,27,36,63,Monday
2020,2,9,2400,15,59,74,Sunday
2020,2,9,2300,42,84,126,Sunday
2020,2,9,2200,49,86,135,Sunday
2020,2,9,2100,85,150,235,Sunday
2020,2,9,2000,116,227,343,Sunday
2020,2,9,1900,134,384,518,Sunday
2020,2,9,1800,153,817,970,Sunday
2020,2,9,1700,215,1079,1294,Sunday
2020,2,9,1600,261,939,1200,Sunday
2020,2,9,1500,299,763,1062,Sunday
2020,2,9,1400,319,689,1008,Sunday
2020,2,9,1300,380,640,1020,Sunday
2020,2,9,1200,433,468,901,Sunday
2020,2,9,1100,411,290,701,Sunday
2020,2,9,1000,570,144,714,Sunday
2020,2,9,900,702,101,803,Sunday
2020,2,9,800,291,51,342,Sunday
2020,2,9,700,60,42,102,Sunday
2020,2,9,600,17,16,33,Sunday
2020,2,9,500,20,11,31,Sunday
2020,2,9,400,13,35,48,Sunday
2020,2,9,300,18,25,43,Sunday
2020,2,9,200,16,28,44,Sunday
2020,2,9,100,23,36,59,Sunday
2020,2,8,2400,20,36,56,Saturday
2020,2,8,2300,40,51,91,Saturday
2020,2,8,2200,70,87,157,Saturday
2020,2,8,2100,83,114,197,Saturday
2020,2,8,2000,89,191,280,Saturday
2020,2,8,1900,131,263,394,Saturday
2020,2,8,1800,141,689,830,Saturday
2020,2,8,1700,197,992,1189,Saturday
2020,2,8,1600,256,600,856,Saturday
2020,2,8,1500,286,414,700,Saturday
2020,2,8,1400,285,297,582,Saturday
2020,2,8,1300,367,252,619,Saturday
2020,2,8,1200,359,214,573,Saturday
2020,2,8,1100,416,164,580,Saturday
2020,2,8,1000,721,122,843,Saturday
2020,2,8,900,794,77,871,Saturday
2020,2,8,800,330,40,370,Saturday
2020,2,8,700,71,31,102,Saturday
2020,2,8,600,19,21,40,Saturday
2020,2,8,500,21,11,32,Saturday
2020,2,8,400,22,22,44,Saturday
2020,2,8,300,18,27,45,Saturday
2020,2,8,200,18,25,43,Saturday
2020,2,8,100,29,43,72,Saturday
2020,2,7,2400,53,44,97,Friday
2020,2,7,2300,68,57,125,Friday
2020,2,7,2200,133,78,211,Friday
2020,2,7,2100,211,90,301,Friday
2020,2,7,2000,320,158,478,Friday
2020,2,7,1900,414,236,650,Friday
2020,2,7,1800,429,477,906,Friday
2020,2,7,1700,490,674,1164,Friday
2020,2,7,1600,459,528,987,Friday
2020,2,7,1500,402,408,810,Friday
2020,2,7,1400,382,246,628,Friday
2020,2,7,1300,382,287,669,Friday
2020,2,7,1200,378,220,598,Friday
2020,2,7,1100,446,171,617,Friday
2020,2,7,1000,455,161,616,Friday
2020,2,7,900,485,90,575,Friday
2020,2,7,800,272,82,354,Friday
2020,2,7,700,84,38,122,Friday
2020,2,7,600,50,40,90,Friday
2020,2,7,500,26,22,48,Friday
2020,2,7,400,25,20,45,Friday
2020,2,7,300,33,27,60,Friday
2020,2,7,200,25,20,45,Friday
2020,2,7,100,31,48,79,Friday
2020,2,6,2400,58,46,104,Thursday
2020,2,6,2300,67,65,132,Thursday
2020,2,6,2200,109,97,206,Thursday
2020,2,6,2100,138,117,255,Thursday
2020,2,6,2000,200,128,328,Thursday
2020,2,6,1900,222,202,424,Thursday
2020,2,6,1800,238,365,603,Thursday
2020,2,6,1700,264,515,779,Thursday
2020,2,6,1600,282,388,670,Thursday
2020,2,6,1500,298,290,588,Thursday
2020,2,6,1400,281,274,555,Thursday
2020,2,6,1300,271,221,492,Thursday
2020,2,6,1200,299,203,502,Thursday
2020,2,6,1100,302,138,440,Thursday
2020,2,6,1000,382,128,510,Thursday
2020,2,6,900,396,115,511,Thursday
2020,2,6,800,224,103,327,Thursday
2020,2,6,700,84,35,119,Thursday
2020,2,6,600,32,26,58,Thursday
2020,2,6,500,39,2,41,Thursday
2020,2,6,400,35,6,41,Thursday
2020,2,6,300,26,16,42,Thursday
2020,2,6,200,36,29,65,Thursday
2020,2,6,100,32,40,72,Thursday
2020,2,5,2400,43,40,83,Wednesday
2020,2,5,2300,77,55,132,Wednesday
2020,2,5,2200,76,69,145,Wednesday
2020,2,5,2100,94,113,207,Wednesday
2020,2,5,2000,105,119,224,Wednesday
2020,2,5,1900,133,199,332,Wednesday
2020,2,5,1800,165,333,498,Wednesday
2020,2,5,1700,198,449,647,Wednesday
2020,2,5,1600,238,358,596,Wednesday
2020,2,5,1500,248,277,525,Wednesday
2020,2,5,1400,240,173,413,Wednesday
2020,2,5,1300,235,123,358,Wednesday
2020,2,5,1200,235,140,375,Wednesday
2020,2,5,1100,283,176,459,Wednesday
2020,2,5,1000,331,124,455,Wednesday
2020,2,5,900,280,63,343,Wednesday
2020,2,5,800,190,67,257,Wednesday
2020,2,5,700,61,43,104,Wednesday
2020,2,5,600,41,36,77,Wednesday
2020,2,5,500,21,25,46,Wednesday
2020,2,5,400,21,38,59,Wednesday
2020,2,5,300,23,16,39,Wednesday
2020,2,5,200,28,27,55,Wednesday
2020,2,5,100,42,54,96,Wednesday
2020,2,4,2400,47,65,112,Tuesday
2020,2,4,2300,75,62,137,Tuesday
2020,2,4,2200,74,62,136,Tuesday
2020,2,4,2100,91,81,172,Tuesday
2020,2,4,2000,108,116,224,Tuesday
2020,2,4,1900,127,197,324,Tuesday
2020,2,4,1800,153,301,454,Tuesday
2020,2,4,1700,199,395,594,Tuesday
2020,2,4,1600,191,315,506,Tuesday
2020,2,4,1500,201,279,480,Tuesday
2020,2,4,1400,201,254,455,Tuesday
2020,2,4,1300,251,171,422,Tuesday
2020,2,4,1200,277,171,448,Tuesday
2020,2,4,1100,288,180,468,Tuesday
2020,2,4,1000,314,132,446,Tuesday
2020,2,4,900,326,102,428,Tuesday
2020,2,4,800,205,62,267,Tuesday
2020,2,4,700,54,49,103,Tuesday
2020,2,4,600,34,31,65,Tuesday
2020,2,4,500,24,35,59,Tuesday
2020,2,4,400,17,31,48,Tuesday
2020,2,4,300,16,42,58,Tuesday
2020,2,4,200,30,32,62,Tuesday
2020,2,4,100,50,36,86,Tuesday
2020,2,3,2400,40,55,95,Monday
2020,2,3,2300,60,59,119,Monday
2020,2,3,2200,70,81,151,Monday
2020,2,3,2100,67,97,164,Monday
2020,2,3,2000,99,108,207,Monday
2020,2,3,1900,108,209,317,Monday
2020,2,3,1800,157,393,550,Monday
2020,2,3,1700,175,501,676,Monday
2020,2,3,1600,249,408,657,Monday
2020,2,3,1500,287,345,632,Monday
2020,2,3,1400,272,284,556,Monday
2020,2,3,1300,288,250,538,Monday
2020,2,3,1200,288,191,479,Monday
2020,2,3,1100,324,172,496,Monday
2020,2,3,1000,362,127,489,Monday
2020,2,3,900,361,81,442,Monday
2020,2,3,800,199,71,270,Monday
2020,2,3,700,68,28,96,Monday
2020,2,3,600,23,23,46,Monday
2020,2,3,500,22,17,39,Monday
2020,2,3,400,13,9,22,Monday
2020,2,3,300,17,20,37,Monday
2020,2,3,200,12,28,40,Monday
2020,2,3,100,32,38,70,Monday
2020,2,2,2400,21,50,71,Sunday
2020,2,2,2300,42,81,123,Sunday
2020,2,2,2200,46,107,153,Sunday
2020,2,2,2100,75,151,226,Sunday
2020,2,2,2000,104,226,330,Sunday
2020,2,2,1900,105,385,490,Sunday
2020,2,2,1800,138,1009,1147,Sunday
2020,2,2,1700,167,1076,1243,Sunday
2020,2,2,1600,252,921,1173,Sunday
2020,2,2,1500,267,988,1255,Sunday
2020,2,2,1400,302,394,696,Sunday
2020,2,2,1300,301,296,597,Sunday
2020,2,2,1200,320,392,712,Sunday
2020,2,2,1100,352,225,577,Sunday
2020,2,2,1000,589,126,715,Sunday
2020,2,2,900,817,62,879,Sunday
2020,2,2,800,415,35,450,Sunday
2020,2,2,700,63,29,92,Sunday
2020,2,2,600,24,13,37,Sunday
2020,2,2,500,17,43,60,Sunday
2020,2,2,400,9,18,27,Sunday
2020,2,2,300,11,16,27,Sunday
2020,2,2,200,18,29,47,Sunday
2020,2,2,100,9,83,92,Sunday
2020,2,1,2400,20,10,30,Saturday
2020,2,1,2300,33,24,57,Saturday
2020,2,1,2200,35,72,107,Saturday
2020,2,1,2100,44,105,149,Saturday
2020,2,1,2000,93,224,317,Saturday
2020,2,1,1900,72,421,493,Saturday
2020,2,1,1800,114,602,716,Saturday
2020,2,1,1700,168,815,983,Saturday
2020,2,1,1600,211,462,673,Saturday
2020,2,1,1500,269,438,707,Saturday
2020,2,1,1400,313,421,734,Saturday
2020,2,1,1300,319,343,662,Saturday
2020,2,1,1200,365,293,658,Saturday
2020,2,1,1100,329,141,470,Saturday
2020,2,1,1000,486,108,594,Saturday
2020,2,1,900,1039,61,1100,Saturday
2020,2,1,800,600,53,653,Saturday
2020,2,1,700,82,6,88,Saturday
2020,2,1,600,30,2,32,Saturday
2020,2,1,500,10,4,14,Saturday
2020,2,1,400,11,5,16,Saturday
2020,2,1,300,16,6,22,Saturday
2020,2,1,200,16,24,40,Saturday
2020,2,1,100,31,32,63,Saturday
2020,1,31,2400,37,28,65,Friday
2020,1,31,2300,69,133,202,Friday
2020,1,31,2200,123,128,251,Friday
2020,1,31,2100,188,102,290,Friday
2020,1,31,2000,296,77,373,Friday
2020,1,31,1900,326,183,509,Friday
2020,1,31,1800,400,432,832,Friday
2020,1,31,1700,437,734,1171,Friday
2020,1,31,1600,422,535,957,Friday
2020,1,31,1500,381,403,784,Friday
2020,1,31,1400,408,299,707,Friday
2020,1,31,1300,398,283,681,Friday
2020,1,31,1200,440,243,683,Friday
2020,1,31,1100,427,192,619,Friday
2020,1,31,1000,566,128,694,Friday
2020,1,31,900,576,89,665,Friday
2020,1,31,800,284,79,363,Friday
2020,1,31,700,95,39,134,Friday
2020,1,31,600,37,36,73,Friday
2020,1,31,500,27,31,58,Friday
2020,1,31,400,21,34,55,Friday
2020,1,31,300,24,25,49,Friday
2020,1,31,200,35,28,63,Friday
2020,1,31,100,44,48,92,Friday
2020,1,30,2400,63,62,125,Thursday
2020,1,30,2300,92,66,158,Thursday
2020,1,30,2200,123,106,229,Thursday
2020,1,30,2100,167,138,305,Thursday
2020,1,30,2000,212,142,354,Thursday
2020,1,30,1900,250,229,479,Thursday
2020,1,30,1800,284,381,665,Thursday
2020,1,30,1700,304,488,792,Thursday
2020,1,30,1600,335,442,777,Thursday
2020,1,30,1500,336,386,722,Thursday
2020,1,30,1400,308,304,612,Thursday
2020,1,30,1300,312,246,558,Thursday
2020,1,30,1200,347,205,552,Thursday
2020,1,30,1100,362,134,496,Thursday
2020,1,30,1000,433,130,563,Thursday
2020,1,30,900,352,115,467,Thursday
2020,1,30,800,253,61,314,Thursday
2020,1,30,700,77,40,117,Thursday
2020,1,30,600,34,29,63,Thursday
2020,1,30,500,26,30,56,Thursday
2020,1,30,400,23,26,49,Thursday
2020,1,30,300,30,29,59,Thursday
2020,1,30,200,41,61,102,Thursday
2020,1,30,100,37,45,82,Thursday
2020,1,29,2400,41,46,87,Wednesday
2020,1,29,2300,53,37,90,Wednesday
2020,1,29,2200,89,67,156,Wednesday
2020,1,29,2100,119,114,233,Wednesday
2020,1,29,2000,126,104,230,Wednesday
2020,1,29,1900,140,169,309,Wednesday
2020,1,29,1800,183,312,495,Wednesday
2020,1,29,1700,222,447,669,Wednesday
2020,1,29,1600,265,367,632,Wednesday
2020,1,29,1500,277,347,624,Wednesday
2020,1,29,1400,284,233,517,Wednesday
2020,1,29,1300,288,202,490,Wednesday
2020,1,29,1200,234,177,411,Wednesday
2020,1,29,1100,328,187,515,Wednesday
2020,1,29,1000,345,138,483,Wednesday
2020,1,29,900,304,106,410,Wednesday
2020,1,29,800,203,63,266,Wednesday
2020,1,29,700,76,48,124,Wednesday
2020,1,29,600,39,33,72,Wednesday
2020,1,29,500,36,25,61,Wednesday
2020,1,29,400,19,25,44,Wednesday
2020,1,29,300,26,21,47,Wednesday
2020,1,29,200,30,37,67,Wednesday
2020,1,29,100,31,32,63,Wednesday
2020,1,28,2400,51,44,95,Tuesday
2020,1,28,2300,58,59,117,Tuesday
2020,1,28,2200,97,87,184,Tuesday
2020,1,28,2100,73,106,179,Tuesday
2020,1,28,2000,110,108,218,Tuesday
2020,1,28,1900,119,217,336,Tuesday
2020,1,28,1800,153,350,503,Tuesday
2020,1,28,1700,175,433,608,Tuesday
2020,1,28,1600,206,362,568,Tuesday
2020,1,28,1500,240,306,546,Tuesday
2020,1,28,1400,204,255,459,Tuesday
2020,1,28,1300,255,218,473,Tuesday
2020,1,28,1200,291,180,471,Tuesday
2020,1,28,1100,333,165,498,Tuesday
2020,1,28,1000,376,146,522,Tuesday
2020,1,28,900,301,103,404,Tuesday
2020,1,28,800,191,77,268,Tuesday
2020,1,28,700,52,43,95,Tuesday
2020,1,28,600,29,39,68,Tuesday
2020,1,28,500,19,26,45,Tuesday
2020,1,28,400,11,20,31,Tuesday
2020,1,28,300,21,27,48,Tuesday
2020,1,28,200,27,36,63,Tuesday
2020,1,28,100,39,44,83,Tuesday
2020,1,27,2400,43,55,98,Monday
2020,1,27,2300,48,62,110,Monday
2020,1,27,2200,60,91,151,Monday
2020,1,27,2100,91,126,217,Monday
2020,1,27,2000,111,214,325,Monday
2020,1,27,1900,142,155,297,Monday
2020,1,27,1800,147,336,483,Monday
2020,1,27,1700,182,545,727,Monday
2020,1,27,1600,229,436,665,Monday
2020,1,27,1500,290,384,674,Monday
2020,1,27,1400,307,316,623,Monday
2020,1,27,1300,323,278,601,Monday
2020,1,27,1200,369,211,580,Monday
2020,1,27,1100,363,211,574,Monday
2020,1,27,1000,397,140,537,Monday
2020,1,27,900,338,92,430,Monday
2020,1,27,800,183,44,227,Monday
2020,1,27,700,80,29,109,Monday
2020,1,27,600,34,23,57,Monday
2020,1,27,500,15,16,31,Monday
2020,1,27,400,14,15,29,Monday
2020,1,27,300,19,25,44,Monday
2020,1,27,200,21,28,49,Monday
2020,1,27,100,20,41,61,Monday
2020,1,26,2400,27,33,60,Sunday
2020,1,26,2300,39,52,91,Sunday
2020,1,26,2200,61,125,186,Sunday
2020,1,26,2100,67,158,225,Sunday
2020,1,26,2000,90,302,392,Sunday
2020,1,26,1900,128,544,672,Sunday
2020,1,26,1800,128,952,1080,Sunday
2020,1,26,1700,246,1499,1745,Sunday
2020,1,26,1600,308,1198,1506,Sunday
2020,1,26,1500,407,1012,1419,Sunday
2020,1,26,1400,501,876,1377,Sunday
2020,1,26,1300,628,728,1356,Sunday
2020,1,26,1200,657,525,1182,Sunday
2020,1,26,1100,583,298,881,Sunday
2020,1,26,1000,697,159,856,Sunday
2020,1,26,900,858,85,943,Sunday
2020,1,26,800,416,51,467,Sunday
2020,1,26,700,73,20,93,Sunday
2020,1,26,600,39,19,58,Sunday
2020,1,26,500,18,20,38,Sunday
2020,1,26,400,7,15,22,Sunday
2020,1,26,300,16,23,39,Sunday
2020,1,26,200,27,29,56,Sunday
2020,1,26,100,14,36,50,Sunday
2020,1,25,2400,36,68,104,Saturday
2020,1,25,2300,52,192,244,Saturday
2020,1,25,2200,62,136,198,Saturday
2020,1,25,2100,86,175,261,Saturday
2020,1,25,2000,108,257,365,Saturday
2020,1,25,1900,130,613,743,Saturday
2020,1,25,1800,219,1222,1441,Saturday
2020,1,25,1700,314,1275,1589,Saturday
2020,1,25,1600,377,891,1268,Saturday
2020,1,25,1500,462,612,1074,Saturday
2020,1,25,1400,618,484,1102,Saturday
2020,1,25,1300,643,443,1086,Saturday
2020,1,25,1200,767,316,1083,Saturday
2020,1,25,1100,699,210,909,Saturday
2020,1,25,1000,982,135,1117,Saturday
2020,1,25,900,1192,70,1262,Saturday
2020,1,25,800,512,63,575,Saturday
2020,1,25,700,121,26,147,Saturday
2020,1,25,600,44,25,69,Saturday
2020,1,25,500,9,49,58,Saturday
2020,1,25,400,18,24,42,Saturday
2020,1,25,300,15,10,25,Saturday
2020,1,25,200,24,9,33,Saturday
2020,1,25,100,30,16,46,Saturday
2020,1,24,2400,55,61,116,Friday
2020,1,24,2300,81,82,163,Friday
2020,1,24,2200,128,96,224,Friday
2020,1,24,2100,190,112,302,Friday
2020,1,24,2000,298,208,506,Friday
2020,1,24,1900,410,627,1037,Friday
2020,1,24,1800,432,516,948,Friday
2020,1,24,1700,488,574,1062,Friday
2020,1,24,1600,573,467,1040,Friday
2020,1,24,1500,506,367,873,Friday
2020,1,24,1400,465,236,701,Friday
2020,1,24,1300,406,205,611,Friday
2020,1,24,1200,456,177,633,Friday
2020,1,24,1100,442,152,594,Friday
2020,1,24,1000,493,115,608,Friday
2020,1,24,900,481,88,569,Friday
2020,1,24,800,281,62,343,Friday
2020,1,24,700,89,35,124,Friday
2020,1,24,600,39,27,66,Friday
2020,1,24,500,37,34,71,Friday
2020,1,24,400,27,37,64,Friday
2020,1,24,300,24,46,70,Friday
2020,1,24,200,40,42,82,Friday
2020,1,24,100,44,48,92,Friday
2020,1,23,2400,63,56,119,Thursday
2020,1,23,2300,60,65,125,Thursday
2020,1,23,2200,98,96,194,Thursday
2020,1,23,2100,141,116,257,Thursday
2020,1,23,2000,169,181,350,Thursday
2020,1,23,1900,219,202,421,Thursday
2020,1,23,1800,245,381,626,Thursday
2020,1,23,1700,274,504,778,Thursday
2020,1,23,1600,319,421,740,Thursday
2020,1,23,1500,312,389,701,Thursday
2020,1,23,1400,324,301,625,Thursday
2020,1,23,1300,317,216,533,Thursday
2020,1,23,1200,356,173,529,Thursday
2020,1,23,1100,421,151,572,Thursday
2020,1,23,1000,412,125,537,Thursday
2020,1,23,900,371,105,476,Thursday
2020,1,23,800,207,69,276,Thursday
2020,1,23,700,66,43,109,Thursday
2020,1,23,600,54,31,85,Thursday
2020,1,23,500,18,23,41,Thursday
2020,1,23,400,20,27,47,Thursday
2020,1,23,300,23,36,59,Thursday
2020,1,23,200,29,38,67,Thursday
2020,1,23,100,30,48,78,Thursday
2020,1,22,2400,47,51,98,Wednesday
2020,1,22,2300,66,62,128,Wednesday
2020,1,22,2200,69,89,158,Wednesday
2020,1,22,2100,105,107,212,Wednesday
2020,1,22,2000,132,119,251,Wednesday
2020,1,22,1900,129,214,343,Wednesday
2020,1,22,1800,171,381,552,Wednesday
2020,1,22,1700,229,503,732,Wednesday
2020,1,22,1600,260,466,726,Wednesday
2020,1,22,1500,271,340,611,Wednesday
2020,1,22,1400,258,232,490,Wednesday
2020,1,22,1300,292,178,470,Wednesday
2020,1,22,1200,320,173,493,Wednesday
2020,1,22,1100,323,152,475,Wednesday
2020,1,22,1000,352,154,506,Wednesday
2020,1,22,900,337,110,447,Wednesday
2020,1,22,800,199,60,259,Wednesday
2020,1,22,700,76,49,125,Wednesday
2020,1,22,600,47,26,73,Wednesday
2020,1,22,500,23,43,66,Wednesday
2020,1,22,400,31,33,64,Wednesday
2020,1,22,300,28,35,63,Wednesday
2020,1,22,200,30,29,59,Wednesday
2020,1,22,100,43,43,86,Wednesday
2020,1,21,2400,63,75,138,Tuesday
2020,1,21,2300,49,67,116,Tuesday
2020,1,21,2200,53,81,134,Tuesday
2020,1,21,2100,106,102,208,Tuesday
2020,1,21,2000,97,114,211,Tuesday
2020,1,21,1900,147,190,337,Tuesday
2020,1,21,1800,184,325,509,Tuesday
2020,1,21,1700,195,504,699,Tuesday
2020,1,21,1600,202,374,576,Tuesday
2020,1,21,1500,260,322,582,Tuesday
2020,1,21,1400,243,294,537,Tuesday
2020,1,21,1300,237,229,466,Tuesday
2020,1,21,1200,342,242,584,Tuesday
2020,1,21,1100,322,167,489,Tuesday
2020,1,21,1000,344,142,486,Tuesday
2020,1,21,900,313,198,511,Tuesday
2020,1,21,800,180,79,259,Tuesday
2020,1,21,700,81,25,106,Tuesday
2020,1,21,600,40,7,47,Tuesday
2020,1,21,500,16,4,20,Tuesday
2020,1,21,400,21,4,25,Tuesday
2020,1,21,300,17,4,21,Tuesday
2020,1,21,200,23,4,27,Tuesday
2020,1,21,100,37,24,61,Tuesday
2020,1,20,2400,54,33,87,Monday
2020,1,20,2300,54,83,137,Monday
2020,1,20,2200,67,77,144,Monday
2020,1,20,2100,96,113,209,Monday
2020,1,20,2000,110,135,245,Monday
2020,1,20,1900,132,270,402,Monday
2020,1,20,1800,164,342,506,Monday
2020,1,20,1700,210,444,654,Monday
2020,1,20,1600,244,448,692,Monday
2020,1,20,1500,244,389,633,Monday
2020,1,20,1400,288,297,585,Monday
2020,1,20,1300,315,262,577,Monday
2020,1,20,1200,365,228,593,Monday
2020,1,20,1100,377,190,567,Monday
2020,1,20,1000,409,135,544,Monday
2020,1,20,900,361,90,451,Monday
2020,1,20,800,162,52,214,Monday
2020,1,20,700,70,43,113,Monday
2020,1,20,600,28,19,47,Monday
2020,1,20,500,20,17,37,Monday
2020,1,20,400,19,11,30,Monday
2020,1,20,300,21,26,47,Monday
2020,1,20,200,25,47,72,Monday
2020,1,20,100,22,67,89,Monday
2020,1,19,2400,36,56,92,Sunday
2020,1,19,2300,45,84,129,Sunday
2020,1,19,2200,58,117,175,Sunday
2020,1,19,2100,72,185,257,Sunday
2020,1,19,2000,100,307,407,Sunday
2020,1,19,1900,121,510,631,Sunday
2020,1,19,1800,164,968,1132,Sunday
2020,1,19,1700,241,1287,1528,Sunday
2020,1,19,1600,280,933,1213,Sunday
2020,1,19,1500,326,760,1086,Sunday
2020,1,19,1400,408,623,1031,Sunday
2020,1,19,1300,468,511,979,Sunday
2020,1,19,1200,500,350,850,Sunday
2020,1,19,1100,452,215,667,Sunday
2020,1,19,1000,605,97,702,Sunday
2020,1,19,900,685,59,744,Sunday
2020,1,19,800,328,52,380,Sunday
2020,1,19,700,61,27,88,Sunday
2020,1,19,600,22,12,34,Sunday
2020,1,19,500,12,20,32,Sunday
2020,1,19,400,9,21,30,Sunday
2020,1,19,300,15,29,44,Sunday
2020,1,19,200,11,19,30,Sunday
2020,1,19,100,24,45,69,Sunday
2020,1,18,2400,26,40,66,Saturday
2020,1,18,2300,39,71,110,Saturday
2020,1,18,2200,43,104,147,Saturday
2020,1,18,2100,78,60,138,Saturday
2020,1,18,2000,93,180,273,Saturday
2020,1,18,1900,121,307,428,Saturday
2020,1,18,1800,174,553,727,Saturday
2020,1,18,1700,206,779,985,Saturday
2020,1,18,1600,257,492,749,Saturday
2020,1,18,1500,278,387,665,Saturday
2020,1,18,1400,296,302,598,Saturday
2020,1,18,1300,406,268,674,Saturday
2020,1,18,1200,414,225,639,Saturday
2020,1,18,1100,404,161,565,Saturday
2020,1,18,1000,446,134,580,Saturday
2020,1,18,900,595,71,666,Saturday
2020,1,18,800,275,40,315,Saturday
2020,1,18,700,57,20,77,Saturday
2020,1,18,600,28,27,55,Saturday
2020,1,18,500,18,17,35,Saturday
2020,1,18,400,13,26,39,Saturday
2020,1,18,300,19,28,47,Saturday
2020,1,18,200,13,30,43,Saturday
2020,1,18,100,33,46,79,Saturday
2020,1,17,2400,40,53,93,Friday
2020,1,17,2300,64,58,122,Friday
2020,1,17,2200,126,84,210,Friday
2020,1,17,2100,209,118,327,Friday
2020,1,17,2000,261,119,380,Friday
2020,1,17,1900,341,288,629,Friday
2020,1,17,1800,417,381,798,Friday
2020,1,17,1700,437,455,892,Friday
2020,1,17,1600,452,368,820,Friday
2020,1,17,1500,458,271,729,Friday
2020,1,17,1400,351,277,628,Friday
2020,1,17,1300,306,154,460,Friday
2020,1,17,1200,361,181,542,Friday
2020,1,17,1100,292,147,439,Friday
2020,1,17,1000,301,118,419,Friday
2020,1,17,900,253,107,360,Friday
2020,1,17,800,196,76,272,Friday
2020,1,17,700,81,32,113,Friday
2020,1,17,600,46,33,79,Friday
2020,1,17,500,16,29,45,Friday
2020,1,17,400,18,32,50,Friday
2020,1,17,300,23,26,49,Friday
2020,1,17,200,18,46,64,Friday
2020,1,17,100,43,128,171,Friday
2020,1,16,2400,46,114,160,Thursday
2020,1,16,2300,74,12,86,Thursday
2020,1,16,2200,71,24,95,Thursday
2020,1,16,2100,110,137,247,Thursday
2020,1,16,2000,157,93,250,Thursday
2020,1,16,1900,172,90,262,Thursday
2020,1,16,1800,184,163,347,Thursday
2020,1,16,1700,209,231,440,Thursday
2020,1,16,1600,226,231,457,Thursday
2020,1,16,1500,212,190,402,Thursday
2020,1,16,1400,203,127,330,Thursday
2020,1,16,1300,188,179,367,Thursday
2020,1,16,1200,242,109,351,Thursday
2020,1,16,1100,233,110,343,Thursday
2020,1,16,1000,203,95,298,Thursday
2020,1,16,900,175,77,252,Thursday
2020,1,16,800,132,43,175,Thursday
2020,1,16,700,58,55,113,Thursday
2020,1,16,600,31,35,66,Thursday
2020,1,16,500,21,11,32,Thursday
2020,1,16,400,19,8,27,Thursday
2020,1,16,300,22,12,34,Thursday
2020,1,16,200,27,5,32,Thursday
2020,1,16,100,29,24,53,Thursday
2020,1,15,2400,49,40,89,Wednesday
2020,1,15,2300,44,32,76,Wednesday
2020,1,15,2200,65,53,118,Wednesday
2020,1,15,2100,98,75,173,Wednesday
2020,1,15,2000,118,90,208,Wednesday
2020,1,15,1900,131,134,265,Wednesday
2020,1,15,1800,159,241,400,Wednesday
2020,1,15,1700,174,201,375,Wednesday
2020,1,15,1600,179,202,381,Wednesday
2020,1,15,1500,184,198,382,Wednesday
2020,1,15,1400,173,169,342,Wednesday
2020,1,15,1300,218,148,366,Wednesday
2020,1,15,1200,193,148,341,Wednesday
2020,1,15,1100,163,113,276,Wednesday
2020,1,15,1000,127,91,218,Wednesday
2020,1,15,900,126,62,188,Wednesday
2020,1,15,800,131,50,181,Wednesday
2020,1,15,700,43,28,71,Wednesday
2020,1,15,600,34,27,61,Wednesday
2020,1,15,500,19,29,48,Wednesday
2020,1,15,400,14,30,44,Wednesday
2020,1,15,300,26,18,44,Wednesday
2020,1,15,200,31,34,65,Wednesday
2020,1,15,100,37,29,66,Wednesday
2020,1,14,2400,41,51,92,Tuesday
2020,1,14,2300,52,67,119,Tuesday
2020,1,14,2200,58,61,119,Tuesday
2020,1,14,2100,74,70,144,Tuesday
2020,1,14,2000,84,101,185,Tuesday
2020,1,14,1900,100,146,246,Tuesday
2020,1,14,1800,123,185,308,Tuesday
2020,1,14,1700,139,203,342,Tuesday
2020,1,14,1600,149,201,350,Tuesday
2020,1,14,1500,147,220,367,Tuesday
2020,1,14,1400,189,244,433,Tuesday
2020,1,14,1300,170,199,369,Tuesday
2020,1,14,1200,212,175,387,Tuesday
2020,1,14,1100,180,107,287,Tuesday
2020,1,14,1000,145,119,264,Tuesday
2020,1,14,900,129,70,199,Tuesday
2020,1,14,800,152,45,197,Tuesday
2020,1,14,700,58,39,97,Tuesday
2020,1,14,600,26,27,53,Tuesday
2020,1,14,500,19,26,45,Tuesday
2020,1,14,400,15,23,38,Tuesday
2020,1,14,300,19,23,42,Tuesday
2020,1,14,200,25,26,51,Tuesday
2020,1,14,100,39,26,65,Tuesday
2020,1,13,2400,36,38,74,Monday
2020,1,13,2300,39,42,81,Monday
2020,1,13,2200,60,45,105,Monday
2020,1,13,2100,69,54,123,Monday
2020,1,13,2000,99,76,175,Monday
2020,1,13,1900,125,133,258,Monday
2020,1,13,1800,111,221,332,Monday
2020,1,13,1700,138,244,382,Monday
2020,1,13,1600,192,208,400,Monday
2020,1,13,1500,184,229,413,Monday
2020,1,13,1400,196,208,404,Monday
2020,1,13,1300,214,194,408,Monday
2020,1,13,1200,233,170,403,Monday
2020,1,13,1100,203,179,382,Monday
2020,1,13,1000,180,87,267,Monday
2020,1,13,900,147,42,189,Monday
2020,1,13,800,140,22,162,Monday
2020,1,13,700,52,18,70,Monday
2020,1,13,600,27,11,38,Monday
2020,1,13,500,17,7,24,Monday
2020,1,13,400,19,23,42,Monday
2020,1,13,300,12,29,41,Monday
2020,1,13,200,27,27,54,Monday
2020,1,13,100,11,68,79,Monday
2020,1,12,2400,26,34,60,Sunday
2020,1,12,2300,49,45,94,Sunday
2020,1,12,2200,36,76,112,Sunday
2020,1,12,2100,62,109,171,Sunday
2020,1,12,2000,70,148,218,Sunday
2020,1,12,1900,103,245,348,Sunday
2020,1,12,1800,96,466,562,Sunday
2020,1,12,1700,124,660,784,Sunday
2020,1,12,1600,195,469,664,Sunday
2020,1,12,1500,197,408,605,Sunday
2020,1,12,1400,203,468,671,Sunday
2020,1,12,1300,220,428,648,Sunday
2020,1,12,1200,246,312,558,Sunday
2020,1,12,1100,234,208,442,Sunday
2020,1,12,1000,236,113,349,Sunday
2020,1,12,900,299,62,361,Sunday
2020,1,12,800,240,39,279,Sunday
2020,1,12,700,43,36,79,Sunday
2020,1,12,600,23,21,44,Sunday
2020,1,12,500,12,11,23,Sunday
2020,1,12,400,16,18,34,Sunday
2020,1,12,300,13,24,37,Sunday
2020,1,12,200,15,26,41,Sunday
2020,1,12,100,20,31,51,Sunday
2020,1,11,2400,22,48,70,Saturday
2020,1,11,2300,37,34,71,Saturday
2020,1,11,2200,45,71,116,Saturday
2020,1,11,2100,67,100,167,Saturday
2020,1,11,2000,85,130,215,Saturday
2020,1,11,1900,97,228,325,Saturday
2020,1,11,1800,131,563,694,Saturday
2020,1,11,1700,156,844,1000,Saturday
2020,1,11,1600,192,530,722,Saturday
2020,1,11,1500,221,300,521,Saturday
2020,1,11,1400,224,253,477,Saturday
2020,1,11,1300,290,240,530,Saturday
2020,1,11,1200,352,229,581,Saturday
2020,1,11,1100,376,144,520,Saturday
2020,1,11,1000,440,98,538,Saturday
2020,1,11,900,702,72,774,Saturday
2020,1,11,800,378,55,433,Saturday
2020,1,11,700,103,36,139,Saturday
2020,1,11,600,30,24,54,Saturday
2020,1,11,500,16,12,28,Saturday
2020,1,11,400,11,18,29,Saturday
2020,1,11,300,15,28,43,Saturday
2020,1,11,200,19,56,75,Saturday
2020,1,11,100,25,31,56,Saturday
2020,1,10,2400,44,36,80,Friday
2020,1,10,2300,73,59,132,Friday
2020,1,10,2200,125,103,228,Friday
2020,1,10,2100,160,75,235,Friday
2020,1,10,2000,241,80,321,Friday
2020,1,10,1900,375,181,556,Friday
2020,1,10,1800,370,344,714,Friday
2020,1,10,1700,390,463,853,Friday
2020,1,10,1600,408,330,738,Friday
2020,1,10,1500,328,285,613,Friday
2020,1,10,1400,255,219,474,Friday
2020,1,10,1300,278,199,477,Friday
2020,1,10,1200,350,207,557,Friday
2020,1,10,1100,302,146,448,Friday
2020,1,10,1000,338,102,440,Friday
2020,1,10,900,309,88,397,Friday
2020,1,10,800,223,58,281,Friday
2020,1,10,700,93,39,132,Friday
2020,1,10,600,30,18,48,Friday
2020,1,10,500,20,31,51,Friday
2020,1,10,400,33,29,62,Friday
2020,1,10,300,27,38,65,Friday
2020,1,10,200,30,40,70,Friday
2020,1,10,100,37,49,86,Friday
2020,1,9,2400,67,48,115,Thursday
2020,1,9,2300,65,61,126,Thursday
2020,1,9,2200,91,70,161,Thursday
2020,1,9,2100,110,112,222,Thursday
2020,1,9,2000,129,180,309,Thursday
2020,1,9,1900,153,192,345,Thursday
2020,1,9,1800,193,244,437,Thursday
2020,1,9,1700,228,465,693,Thursday
2020,1,9,1600,241,326,567,Thursday
2020,1,9,1500,219,309,528,Thursday
2020,1,9,1400,222,246,468,Thursday
2020,1,9,1300,212,219,431,Thursday
2020,1,9,1200,210,174,384,Thursday
2020,1,9,1100,279,152,431,Thursday
2020,1,9,1000,298,113,411,Thursday
2020,1,9,900,353,101,454,Thursday
2020,1,9,800,200,43,243,Thursday
2020,1,9,700,69,48,117,Thursday
2020,1,9,600,50,32,82,Thursday
2020,1,9,500,21,20,41,Thursday
2020,1,9,400,32,29,61,Thursday
2020,1,9,300,19,34,53,Thursday
2020,1,9,200,23,33,56,Thursday
2020,1,9,100,38,54,92,Thursday
2020,1,8,2400,56,38,94,Wednesday
2020,1,8,2300,70,59,129,Wednesday
2020,1,8,2200,58,73,131,Wednesday
2020,1,8,2100,98,100,198,Wednesday
2020,1,8,2000,82,130,212,Wednesday
2020,1,8,1900,110,392,502,Wednesday
2020,1,8,1800,104,466,570,Wednesday
2020,1,8,1700,147,461,608,Wednesday
2020,1,8,1600,181,417,598,Wednesday
2020,1,8,1500,168,366,534,Wednesday
2020,1,8,1400,183,206,389,Wednesday
2020,1,8,1300,182,154,336,Wednesday
2020,1,8,1200,203,94,297,Wednesday
2020,1,8,1100,228,108,336,Wednesday
2020,1,8,1000,310,59,369,Wednesday
2020,1,8,900,379,50,429,Wednesday
2020,1,8,800,207,32,239,Wednesday
2020,1,8,700,55,13,68,Wednesday
2020,1,8,600,40,11,51,Wednesday
2020,1,8,500,17,1,18,Wednesday
2020,1,8,400,16,6,22,Wednesday
2020,1,8,300,17,6,23,Wednesday
2020,1,8,200,19,6,25,Wednesday
2020,1,8,100,23,51,74,Wednesday
2020,1,7,2400,39,47,86,Tuesday
2020,1,7,2300,33,16,49,Tuesday
2020,1,7,2200,63,17,80,Tuesday
2020,1,7,2100,71,40,111,Tuesday
2020,1,7,2000,78,70,148,Tuesday
2020,1,7,1900,109,101,210,Tuesday
2020,1,7,1800,106,258,364,Tuesday
2020,1,7,1700,148,333,481,Tuesday
2020,1,7,1600,198,273,471,Tuesday
2020,1,7,1500,161,233,394,Tuesday
2020,1,7,1400,220,213,433,Tuesday
2020,1,7,1300,219,175,394,Tuesday
2020,1,7,1200,229,177,406,Tuesday
2020,1,7,1100,259,156,415,Tuesday
2020,1,7,1000,317,119,436,Tuesday
2020,1,7,900,287,84,371,Tuesday
2020,1,7,800,176,74,250,Tuesday
2020,1,7,700,64,48,112,Tuesday
2020,1,7,600,32,27,59,Tuesday
2020,1,7,500,15,21,36,Tuesday
2020,1,7,400,24,23,47,Tuesday
2020,1,7,300,18,34,52,Tuesday
2020,1,7,200,27,34,61,Tuesday
2020,1,7,100,38,42,80,Tuesday
2020,1,6,2400,38,47,85,Monday
2020,1,6,2300,69,62,131,Monday
2020,1,6,2200,47,77,124,Monday
2020,1,6,2100,88,63,151,Monday
2020,1,6,2000,107,116,223,Monday
2020,1,6,1900,111,170,281,Monday
2020,1,6,1800,161,384,545,Monday
2020,1,6,1700,203,487,690,Monday
2020,1,6,1600,200,422,622,Monday
2020,1,6,1500,251,392,643,Monday
2020,1,6,1400,231,300,531,Monday
2020,1,6,1300,286,237,523,Monday
2020,1,6,1200,296,198,494,Monday
2020,1,6,1100,316,181,497,Monday
2020,1,6,1000,362,130,492,Monday
2020,1,6,900,380,74,454,Monday
2020,1,6,800,162,60,222,Monday
2020,1,6,700,82,33,115,Monday
2020,1,6,600,29,16,45,Monday
2020,1,6,500,18,17,35,Monday
2020,1,6,400,19,28,47,Monday
2020,1,6,300,15,86,101,Monday
2020,1,6,200,19,34,53,Monday
2020,1,6,100,23,11,34,Monday
2020,1,5,2400,35,16,51,Sunday
2020,1,5,2300,46,41,87,Sunday
2020,1,5,2200,45,92,137,Sunday
2020,1,5,2100,63,145,208,Sunday
2020,1,5,2000,94,217,311,Sunday
2020,1,5,1900,108,350,458,Sunday
2020,1,5,1800,128,752,880,Sunday
2020,1,5,1700,200,1166,1366,Sunday
2020,1,5,1600,238,1022,1260,Sunday
2020,1,5,1500,282,827,1109,Sunday
2020,1,5,1400,341,697,1038,Sunday
2020,1,5,1300,378,635,1013,Sunday
2020,1,5,1200,460,435,895,Sunday
2020,1,5,1100,431,279,710,Sunday
2020,1,5,1000,519,175,694,Sunday
2020,1,5,900,626,81,707,Sunday
2020,1,5,800,339,42,381,Sunday
2020,1,5,700,65,20,85,Sunday
2020,1,5,600,32,20,52,Sunday
2020,1,5,500,12,31,43,Sunday
2020,1,5,400,8,12,20,Sunday
2020,1,5,300,11,22,33,Sunday
2020,1,5,200,16,30,46,Sunday
2020,1,5,100,23,48,71,Sunday
2020,1,4,2400,27,52,79,Saturday
2020,1,4,2300,35,80,115,Saturday
2020,1,4,2200,50,100,150,Saturday
2020,1,4,2100,73,198,271,Saturday
2020,1,4,2000,81,215,296,Saturday
2020,1,4,1900,100,693,793,Saturday
2020,1,4,1800,115,1148,1263,Saturday
2020,1,4,1700,194,1047,1241,Saturday
2020,1,4,1600,267,747,1014,Saturday
2020,1,4,1500,285,654,939,Saturday
2020,1,4,1400,380,554,934,Saturday
2020,1,4,1300,525,446,971,Saturday
2020,1,4,1200,506,388,894,Saturday
2020,1,4,1100,465,252,717,Saturday
2020,1,4,1000,540,151,691,Saturday
2020,1,4,900,903,95,998,Saturday
2020,1,4,800,412,77,489,Saturday
2020,1,4,700,76,35,111,Saturday
2020,1,4,600,23,31,54,Saturday
2020,1,4,500,18,37,55,Saturday
2020,1,4,400,8,29,37,Saturday
2020,1,4,300,23,41,64,Saturday
2020,1,4,200,22,55,77,Saturday
2020,1,4,100,28,60,88,Saturday
2020,1,3,2400,47,54,101,Friday
2020,1,3,2300,65,92,157,Friday
2020,1,3,2200,98,102,200,Friday
2020,1,3,2100,129,134,263,Friday
2020,1,3,2000,168,248,416,Friday
2020,1,3,1900,197,523,720,Friday
2020,1,3,1800,251,990,1241,Friday
2020,1,3,1700,311,1034,1345,Friday
2020,1,3,1600,370,897,1267,Friday
2020,1,3,1500,394,709,1103,Friday
2020,1,3,1400,419,563,982,Friday
2020,1,3,1300,487,525,1012,Friday
2020,1,3,1200,529,408,937,Friday
2020,1,3,1100,577,250,827,Friday
2020,1,3,1000,703,138,841,Friday
2020,1,3,900,833,85,918,Friday
2020,1,3,800,392,60,452,Friday
2020,1,3,700,85,40,125,Friday
2020,1,3,600,36,29,65,Friday
2020,1,3,500,23,15,38,Friday
2020,1,3,400,23,30,53,Friday
2020,1,3,300,21,37,58,Friday
2020,1,3,200,31,40,71,Friday
2020,1,3,100,27,117,144,Friday
2020,1,2,2400,44,35,79,Thursday
2020,1,2,2300,58,44,102,Thursday
2020,1,2,2200,84,100,184,Thursday
2020,1,2,2100,94,158,252,Thursday
2020,1,2,2000,148,311,459,Thursday
2020,1,2,1900,164,435,599,Thursday
2020,1,2,1800,269,1007,1276,Thursday
2020,1,2,1700,292,1337,1629,Thursday
2020,1,2,1600,409,976,1385,Thursday
2020,1,2,1500,441,920,1361,Thursday
2020,1,2,1400,521,789,1310,Thursday
2020,1,2,1300,508,694,1202,Thursday
2020,1,2,1200,598,438,1036,Thursday
2020,1,2,1100,639,284,923,Thursday
2020,1,2,1000,705,182,887,Thursday
2020,1,2,900,754,102,856,Thursday
2020,1,2,800,357,68,425,Thursday
2020,1,2,700,83,55,138,Thursday
2020,1,2,600,34,60,94,Thursday
2020,1,2,500,22,33,55,Thursday
2020,1,2,400,14,17,31,Thursday
2020,1,2,300,18,50,68,Thursday
2020,1,2,200,21,34,55,Thursday
2020,1,2,100,23,50,73,Thursday
2020,1,1,2400,28,86,114,Wednesday
2020,1,1,2300,41,268,309,Wednesday
2020,1,1,2200,35,271,306,Wednesday
2020,1,1,2100,48,181,229,Wednesday
2020,1,1,2000,96,233,329,Wednesday
2020,1,1,1900,102,366,468,Wednesday
2020,1,1,1800,166,889,1055,Wednesday
2020,1,1,1700,265,1018,1283,Wednesday
2020,1,1,1600,397,951,1348,Wednesday
2020,1,1,1500,522,785,1307,Wednesday
2020,1,1,1400,558,700,1258,Wednesday
2020,1,1,1300,599,551,1150,Wednesday
2020,1,1,1200,587,364,951,Wednesday
2020,1,1,1100,475,207,682,Wednesday
2020,1,1,1000,462,88,550,Wednesday
2020,1,1,900,575,45,620,Wednesday
2020,1,1,800,222,39,261,Wednesday
2020,1,1,700,57,30,87,Wednesday
2020,1,1,600,22,15,37,Wednesday
2020,1,1,500,6,16,22,Wednesday
2020,1,1,400,19,48,67,Wednesday
2020,1,1,300,12,51,63,Wednesday
2020,1,1,200,14,54,68,Wednesday
2020,1,1,100,28,18,46,Wednesday
2019,12,31,2400,25,20,45,Tuesday
2019,12,31,2300,37,33,70,Tuesday
2019,12,31,2200,55,40,95,Tuesday
2019,12,31,2100,66,49,115,Tuesday
2019,12,31,2000,74,99,173,Tuesday
2019,12,31,1900,93,207,300,Tuesday
2019,12,31,1800,186,483,669,Tuesday
2019,12,31,1700,265,796,1061,Tuesday
2019,12,31,1600,419,820,1239,Tuesday
2019,12,31,1500,461,577,1038,Tuesday
2019,12,31,1400,396,463,859,Tuesday
2019,12,31,1300,449,431,880,Tuesday
2019,12,31,1200,517,330,847,Tuesday
2019,12,31,1100,496,232,728,Tuesday
2019,12,31,1000,527,150,677,Tuesday
2019,12,31,900,655,100,755,Tuesday
2019,12,31,800,271,46,317,Tuesday
2019,12,31,700,69,19,88,Tuesday
2019,12,31,600,34,19,53,Tuesday
2019,12,31,500,19,24,43,Tuesday
2019,12,31,400,14,22,36,Tuesday
2019,12,31,300,13,27,40,Tuesday
2019,12,31,200,22,38,60,Tuesday
2019,12,31,100,26,43,69,Tuesday
2019,12,30,2400,57,71,128,Monday
2019,12,30,2300,63,91,154,Monday
2019,12,30,2200,85,120,205,Monday
2019,12,30,2100,127,165,292,Monday
2019,12,30,2000,153,299,452,Monday
2019,12,30,1900,194,500,694,Monday
2019,12,30,1800,280,1204,1484,Monday
2019,12,30,1700,401,1432,1833,Monday
2019,12,30,1600,576,1163,1739,Monday
2019,12,30,1500,738,879,1617,Monday
2019,12,30,1400,756,708,1464,Monday
2019,12,30,1300,809,611,1420,Monday
2019,12,30,1200,900,423,1323,Monday
2019,12,30,1100,871,278,1149,Monday
2019,12,30,1000,978,158,1136,Monday
2019,12,30,900,967,94,1061,Monday
2019,12,30,800,387,61,448,Monday
2019,12,30,700,99,21,120,Monday
2019,12,30,600,32,14,46,Monday
2019,12,30,500,23,15,38,Monday
2019,12,30,400,18,18,36,Monday
2019,12,30,300,16,26,42,Monday
2019,12,30,200,21,28,49,Monday
2019,12,30,100,35,36,71,Monday
2019,12,29,2400,35,72,107,Sunday
2019,12,29,2300,33,72,105,Sunday
2019,12,29,2200,75,122,197,Sunday
2019,12,29,2100,98,206,304,Sunday
2019,12,29,2000,120,276,396,Sunday
2019,12,29,1900,166,786,952,Sunday
2019,12,29,1800,249,1139,1388,Sunday
2019,12,29,1700,409,1375,1784,Sunday
2019,12,29,1600,579,1119,1698,Sunday
2019,12,29,1500,741,914,1655,Sunday
2019,12,29,1400,844,776,1620,Sunday
2019,12,29,1300,872,620,1492,Sunday
2019,12,29,1200,931,398,1329,Sunday
2019,12,29,1100,824,265,1089,Sunday
2019,12,29,1000,878,156,1034,Sunday
2019,12,29,900,933,63,996,Sunday
2019,12,29,800,428,33,461,Sunday
2019,12,29,700,91,21,112,Sunday
2019,12,29,600,32,18,50,Sunday
2019,12,29,500,23,24,47,Sunday
2019,12,29,400,10,16,26,Sunday
2019,12,29,300,19,16,35,Sunday
2019,12,29,200,17,38,55,Sunday
2019,12,29,100,17,30,47,Sunday
2019,12,28,2400,25,33,58,Saturday
2019,12,28,2300,62,67,129,Saturday
2019,12,28,2200,84,90,174,Saturday
2019,12,28,2100,84,136,220,Saturday
2019,12,28,2000,127,203,330,Saturday
2019,12,28,1900,176,470,646,Saturday
2019,12,28,1800,253,1157,1410,Saturday
2019,12,28,1700,389,1305,1694,Saturday
2019,12,28,1600,579,997,1576,Saturday
2019,12,28,1500,825,775,1600,Saturday
2019,12,28,1400,855,633,1488,Saturday
2019,12,28,1300,921,509,1430,Saturday
2019,12,28,1200,1034,411,1445,Saturday
2019,12,28,1100,887,231,1118,Saturday
2019,12,28,1000,910,188,1098,Saturday
2019,12,28,900,911,101,1012,Saturday
2019,12,28,800,469,48,517,Saturday
2019,12,28,700,119,50,169,Saturday
2019,12,28,600,40,30,70,Saturday
2019,12,28,500,13,31,44,Saturday
2019,12,28,400,19,20,39,Saturday
2019,12,28,300,15,25,40,Saturday
2019,12,28,200,22,30,52,Saturday
2019,12,28,100,29,49,78,Saturday
2019,12,27,2400,47,118,165,Friday
2019,12,27,2300,55,248,303,Friday
2019,12,27,2200,107,142,249,Friday
2019,12,27,2100,134,137,271,Friday
2019,12,27,2000,178,113,291,Friday
2019,12,27,1900,247,316,563,Friday
2019,12,27,1800,328,861,1189,Friday
2019,12,27,1700,584,1133,1717,Friday
2019,12,27,1600,834,873,1707,Friday
2019,12,27,1500,1082,766,1848,Friday
2019,12,27,1400,1140,567,1707,Friday
2019,12,27,1300,819,532,1351,Friday
2019,12,27,1200,860,313,1173,Friday
2019,12,27,1100,954,226,1180,Friday
2019,12,27,1000,850,136,986,Friday
2019,12,27,900,841,86,927,Friday
2019,12,27,800,406,47,453,Friday
2019,12,27,700,131,25,156,Friday
2019,12,27,600,47,22,69,Friday
2019,12,27,500,18,18,36,Friday
2019,12,27,400,26,12,38,Friday
2019,12,27,300,21,16,37,Friday
2019,12,27,200,18,30,48,Friday
2019,12,27,100,28,39,67,Friday
2019,12,26,2400,41,44,85,Thursday
2019,12,26,2300,64,80,144,Thursday
2019,12,26,2200,74,73,147,Thursday
2019,12,26,2100,95,107,202,Thursday
2019,12,26,2000,160,167,327,Thursday
2019,12,26,1900,242,288,530,Thursday
2019,12,26,1800,274,676,950,Thursday
2019,12,26,1700,466,793,1259,Thursday
2019,12,26,1600,640,746,1386,Thursday
2019,12,26,1500,801,622,1423,Thursday
2019,12,26,1400,878,535,1413,Thursday
2019,12,26,1300,734,402,1136,Thursday
2019,12,26,1200,749,330,1079,Thursday
2019,12,26,1100,672,189,861,Thursday
2019,12,26,1000,612,93,705,Thursday
2019,12,26,900,551,49,600,Thursday
2019,12,26,800,234,32,266,Thursday
2019,12,26,700,87,9,96,Thursday
2019,12,26,600,45,7,52,Thursday
2019,12,26,500,25,10,35,Thursday
2019,12,26,400,17,12,29,Thursday
2019,12,26,300,9,9,18,Thursday
2019,12,26,200,16,12,28,Thursday
2019,12,26,100,20,17,37,Thursday
2019,12,25,2400,16,21,37,Wednesday
2019,12,25,2300,36,31,67,Wednesday
2019,12,25,2200,39,41,80,Wednesday
2019,12,25,2100,59,79,138,Wednesday
2019,12,25,2000,48,102,150,Wednesday
2019,12,25,1900,66,228,294,Wednesday
2019,12,25,1800,113,490,603,Wednesday
2019,12,25,1700,180,681,861,Wednesday
2019,12,25,1600,264,479,743,Wednesday
2019,12,25,1500,377,377,754,Wednesday
2019,12,25,1400,435,278,713,Wednesday
2019,12,25,1300,498,227,725,Wednesday
2019,12,25,1200,477,144,621,Wednesday
2019,12,25,1100,401,103,504,Wednesday
2019,12,25,1000,362,65,427,Wednesday
2019,12,25,900,321,38,359,Wednesday
2019,12,25,800,145,26,171,Wednesday
2019,12,25,700,42,18,60,Wednesday
2019,12,25,600,24,17,41,Wednesday
2019,12,25,500,11,15,26,Wednesday
2019,12,25,400,13,18,31,Wednesday
2019,12,25,300,11,12,23,Wednesday
2019,12,25,200,11,17,28,Wednesday
2019,12,25,100,22,30,52,Wednesday
2019,12,24,2400,24,39,63,Tuesday
2019,12,24,2300,34,55,89,Tuesday
2019,12,24,2200,54,69,123,Tuesday
2019,12,24,2100,67,82,149,Tuesday
2019,12,24,2000,68,99,167,Tuesday
2019,12,24,1900,119,163,282,Tuesday
2019,12,24,1800,184,405,589,Tuesday
2019,12,24,1700,245,515,760,Tuesday
2019,12,24,1600,334,547,881,Tuesday
2019,12,24,1500,407,413,820,Tuesday
2019,12,24,1400,461,452,913,Tuesday
2019,12,24,1300,486,242,728,Tuesday
2019,12,24,1200,422,256,678,Tuesday
2019,12,24,1100,430,211,641,Tuesday
2019,12,24,1000,487,137,624,Tuesday
2019,12,24,900,452,112,564,Tuesday
2019,12,24,800,191,47,238,Tuesday
2019,12,24,700,89,35,124,Tuesday
2019,12,24,600,39,39,78,Tuesday
2019,12,24,500,21,34,55,Tuesday
2019,12,24,400,15,20,35,Tuesday
2019,12,24,300,22,35,57,Tuesday
2019,12,24,200,20,36,56,Tuesday
2019,12,24,100,46,42,88,Tuesday
2019,12,23,2400,34,66,100,Monday
2019,12,23,2300,67,99,166,Monday
2019,12,23,2200,71,99,170,Monday
2019,12,23,2100,126,145,271,Monday
2019,12,23,2000,142,160,302,Monday
2019,12,23,1900,170,308,478,Monday
2019,12,23,1800,257,722,979,Monday
2019,12,23,1700,322,1021,1343,Monday
2019,12,23,1600,432,855,1287,Monday
2019,12,23,1500,552,582,1134,Monday
2019,12,23,1400,627,551,1178,Monday
2019,12,23,1300,631,455,1086,Monday
2019,12,23,1200,655,339,994,Monday
2019,12,23,1100,662,283,945,Monday
2019,12,23,1000,816,172,988,Monday
2019,12,23,900,725,79,804,Monday
2019,12,23,800,276,55,331,Monday
2019,12,23,700,92,30,122,Monday
2019,12,23,600,36,18,54,Monday
2019,12,23,500,19,19,38,Monday
2019,12,23,400,24,25,49,Monday
2019,12,23,300,14,19,33,Monday
2019,12,23,200,17,54,71,Monday
2019,12,23,100,27,55,82,Monday
2019,12,22,2400,45,118,163,Sunday
2019,12,22,2300,53,263,316,Sunday
2019,12,22,2200,53,65,118,Sunday
2019,12,22,2100,91,47,138,Sunday
2019,12,22,2000,130,187,317,Sunday
2019,12,22,1900,171,380,551,Sunday
2019,12,22,1800,216,1068,1284,Sunday
2019,12,22,1700,298,1013,1311,Sunday
2019,12,22,1600,394,855,1249,Sunday
2019,12,22,1500,428,799,1227,Sunday
2019,12,22,1400,510,680,1190,Sunday
2019,12,22,1300,659,369,1028,Sunday
2019,12,22,1200,657,376,1033,Sunday
2019,12,22,1100,688,267,955,Sunday
2019,12,22,1000,940,179,1119,Sunday
2019,12,22,900,827,113,940,Sunday
2019,12,22,800,515,55,570,Sunday
2019,12,22,700,127,26,153,Sunday
2019,12,22,600,46,30,76,Sunday
2019,12,22,500,26,18,44,Sunday
2019,12,22,400,22,20,42,Sunday
2019,12,22,300,24,36,60,Sunday
2019,12,22,200,15,97,112,Sunday
2019,12,22,100,31,233,264,Sunday
2019,12,21,2400,26,39,65,Saturday
2019,12,21,2300,40,343,383,Saturday
2019,12,21,2200,45,239,284,Saturday
2019,12,21,2100,69,222,291,Saturday
2019,12,21,2000,102,60,162,Saturday
2019,12,21,1900,121,143,264,Saturday
2019,12,21,1800,164,459,623,Saturday
2019,12,21,1700,199,787,986,Saturday
2019,12,21,1600,328,360,688,Saturday
2019,12,21,1500,432,362,794,Saturday
2019,12,21,1400,446,273,719,Saturday
2019,12,21,1300,486,174,660,Saturday
2019,12,21,1200,514,159,673,Saturday
2019,12,21,1100,484,123,607,Saturday
2019,12,21,1000,816,78,894,Saturday
2019,12,21,900,603,151,754,Saturday
2019,12,21,800,457,60,517,Saturday
2019,12,21,700,84,32,116,Saturday
2019,12,21,600,38,62,100,Saturday
2019,12,21,500,17,39,56,Saturday
2019,12,21,400,16,5,21,Saturday
2019,12,21,300,19,15,34,Saturday
2019,12,21,200,33,33,66,Saturday
2019,12,21,100,38,45,83,Saturday
2019,12,20,2400,52,120,172,Friday
2019,12,20,2300,89,151,240,Friday
2019,12,20,2200,105,173,278,Friday
2019,12,20,2100,170,93,263,Friday
2019,12,20,2000,211,274,485,Friday
2019,12,20,1900,218,148,366,Friday
2019,12,20,1800,269,311,580,Friday
2019,12,20,1700,355,410,765,Friday
2019,12,20,1600,385,310,695,Friday
2019,12,20,1500,365,232,597,Friday
2019,12,20,1400,386,207,593,Friday
2019,12,20,1300,363,166,529,Friday
2019,12,20,1200,393,163,556,Friday
2019,12,20,1100,326,157,483,Friday
2019,12,20,1000,435,118,553,Friday
2019,12,20,900,454,89,543,Friday
2019,12,20,800,235,55,290,Friday
2019,12,20,700,83,19,102,Friday
2019,12,20,600,50,15,65,Friday
2019,12,20,500,33,29,62,Friday
2019,12,20,400,21,19,40,Friday
2019,12,20,300,28,36,64,Friday
2019,12,20,200,39,45,84,Friday
2019,12,20,100,49,50,99,Friday
2019,12,19,2400,56,90,146,Thursday
2019,12,19,2300,66,101,167,Thursday
2019,12,19,2200,88,134,222,Thursday
2019,12,19,2100,146,137,283,Thursday
2019,12,19,2000,188,161,349,Thursday
2019,12,19,1900,221,234,455,Thursday
2019,12,19,1800,283,422,705,Thursday
2019,12,19,1700,263,595,858,Thursday
2019,12,19,1600,329,504,833,Thursday
2019,12,19,1500,317,449,766,Thursday
2019,12,19,1400,332,357,689,Thursday
2019,12,19,1300,317,273,590,Thursday
2019,12,19,1200,381,237,618,Thursday
2019,12,19,1100,378,190,568,Thursday
2019,12,19,1000,415,137,552,Thursday
2019,12,19,900,394,104,498,Thursday
2019,12,19,800,222,66,288,Thursday
2019,12,19,700,95,43,138,Thursday
2019,12,19,600,53,37,90,Thursday
2019,12,19,500,29,18,47,Thursday
2019,12,19,400,30,31,61,Thursday
2019,12,19,300,28,29,57,Thursday
2019,12,19,200,24,49,73,Thursday
2019,12,19,100,48,49,97,Thursday
2019,12,18,2400,58,60,118,Wednesday
2019,12,18,2300,80,76,156,Wednesday
2019,12,18,2200,91,59,150,Wednesday
2019,12,18,2100,126,103,229,Wednesday
2019,12,18,2000,105,200,305,Wednesday
2019,12,18,1900,140,258,398,Wednesday
2019,12,18,1800,200,437,637,Wednesday
2019,12,18,1700,231,461,692,Wednesday
2019,12,18,1600,247,518,765,Wednesday
2019,12,18,1500,246,395,641,Wednesday
2019,12,18,1400,276,249,525,Wednesday
2019,12,18,1300,319,296,615,Wednesday
2019,12,18,1200,295,225,520,Wednesday
2019,12,18,1100,336,227,563,Wednesday
2019,12,18,1000,357,163,520,Wednesday
2019,12,18,900,348,117,465,Wednesday
2019,12,18,800,210,72,282,Wednesday
2019,12,18,700,92,63,155,Wednesday
2019,12,18,600,40,45,85,Wednesday
2019,12,18,500,25,197,222,Wednesday
2019,12,18,400,20,55,75,Wednesday
2019,12,18,300,25,12,37,Wednesday
2019,12,18,200,20,8,28,Wednesday
2019,12,18,100,47,14,61,Wednesday
2019,12,17,2400,58,15,73,Tuesday
2019,12,17,2300,49,88,137,Tuesday
2019,12,17,2200,70,145,215,Tuesday
2019,12,17,2100,83,125,208,Tuesday
2019,12,17,2000,125,87,212,Tuesday
2019,12,17,1900,114,109,223,Tuesday
2019,12,17,1800,177,297,474,Tuesday
2019,12,17,1700,172,390,562,Tuesday
2019,12,17,1600,213,350,563,Tuesday
2019,12,17,1500,223,285,508,Tuesday
2019,12,17,1400,256,236,492,Tuesday
2019,12,17,1300,252,281,533,Tuesday
2019,12,17,1200,289,308,597,Tuesday
2019,12,17,1100,284,107,391,Tuesday
2019,12,17,1000,336,86,422,Tuesday
2019,12,17,900,332,75,407,Tuesday
2019,12,17,800,181,65,246,Tuesday
2019,12,17,700,74,46,120,Tuesday
2019,12,17,600,36,88,124,Tuesday
2019,12,17,500,16,91,107,Tuesday
2019,12,17,400,22,25,47,Tuesday
2019,12,17,300,26,11,37,Tuesday
2019,12,17,200,32,6,38,Tuesday
2019,12,17,100,33,10,43,Tuesday
2019,12,16,2400,56,12,68,Monday
2019,12,16,2300,66,15,81,Monday
2019,12,16,2200,59,25,84,Monday
2019,12,16,2100,92,55,147,Monday
2019,12,16,2000,142,89,231,Monday
2019,12,16,1900,127,154,281,Monday
2019,12,16,1800,180,304,484,Monday
2019,12,16,1700,226,440,666,Monday
2019,12,16,1600,232,413,645,Monday
2019,12,16,1500,272,334,606,Monday
2019,12,16,1400,308,307,615,Monday
2019,12,16,1300,323,285,608,Monday
2019,12,16,1200,318,192,510,Monday
2019,12,16,1100,346,171,517,Monday
2019,12,16,1000,351,130,481,Monday
2019,12,16,900,311,111,422,Monday
2019,12,16,800,204,37,241,Monday
2019,12,16,700,82,24,106,Monday
2019,12,16,600,36,18,54,Monday
2019,12,16,500,22,18,40,Monday
2019,12,16,400,23,31,54,Monday
2019,12,16,300,19,20,39,Monday
2019,12,16,200,30,18,48,Monday
2019,12,16,100,31,35,66,Monday
2019,12,15,2400,39,45,84,Sunday
2019,12,15,2300,41,80,121,Sunday
2019,12,15,2200,59,114,173,Sunday
2019,12,15,2100,65,137,202,Sunday
2019,12,15,2000,103,199,302,Sunday
2019,12,15,1900,158,258,416,Sunday
2019,12,15,1800,153,546,699,Sunday
2019,12,15,1700,218,927,1145,Sunday
2019,12,15,1600,257,736,993,Sunday
2019,12,15,1500,296,634,930,Sunday
2019,12,15,1400,328,552,880,Sunday
2019,12,15,1300,352,533,885,Sunday
2019,12,15,1200,373,354,727,Sunday
2019,12,15,1100,361,227,588,Sunday
2019,12,15,1000,411,128,539,Sunday
2019,12,15,900,529,69,598,Sunday
2019,12,15,800,316,39,355,Sunday
2019,12,15,700,73,23,96,Sunday
2019,12,15,600,32,18,50,Sunday
2019,12,15,500,17,19,36,Sunday
2019,12,15,400,17,18,35,Sunday
2019,12,15,300,12,14,26,Sunday
2019,12,15,200,16,25,41,Sunday
2019,12,15,100,25,31,56,Sunday
2019,12,14,2400,23,41,64,Saturday
2019,12,14,2300,37,52,89,Saturday
2019,12,14,2200,51,61,112,Saturday
2019,12,14,2100,60,96,156,Saturday
2019,12,14,2000,103,124,227,Saturday
2019,12,14,1900,109,233,342,Saturday
2019,12,14,1800,117,582,699,Saturday
2019,12,14,1700,216,892,1108,Saturday
2019,12,14,1600,299,595,894,Saturday
2019,12,14,1500,321,391,712,Saturday
2019,12,14,1400,329,296,625,Saturday
2019,12,14,1300,351,305,656,Saturday
2019,12,14,1200,381,270,651,Saturday
2019,12,14,1100,402,235,637,Saturday
2019,12,14,1000,494,140,634,Saturday
2019,12,14,900,694,106,800,Saturday
2019,12,14,800,416,43,459,Saturday
2019,12,14,700,92,46,138,Saturday
2019,12,14,600,29,37,66,Saturday
2019,12,14,500,24,20,44,Saturday
2019,12,14,400,23,22,45,Saturday
2019,12,14,300,21,23,44,Saturday
2019,12,14,200,30,35,65,Saturday
2019,12,14,100,35,43,78,Saturday
2019,12,13,2400,51,48,99,Friday
2019,12,13,2300,72,48,120,Friday
2019,12,13,2200,102,61,163,Friday
2019,12,13,2100,162,117,279,Friday
2019,12,13,2000,206,121,327,Friday
2019,12,13,1900,312,183,495,Friday
2019,12,13,1800,332,384,716,Friday
2019,12,13,1700,398,515,913,Friday
2019,12,13,1600,426,429,855,Friday
2019,12,13,1500,365,343,708,Friday
2019,12,13,1400,326,317,643,Friday
2019,12,13,1300,332,251,583,Friday
2019,12,13,1200,322,197,519,Friday
2019,12,13,1100,355,153,508,Friday
2019,12,13,1000,387,129,516,Friday
2019,12,13,900,337,83,420,Friday
2019,12,13,800,215,57,272,Friday
2019,12,13,700,81,44,125,Friday
2019,12,13,600,45,18,63,Friday
2019,12,13,500,30,14,44,Friday
2019,12,13,400,22,29,51,Friday
2019,12,13,300,33,16,49,Friday
2019,12,13,200,44,41,85,Friday
2019,12,13,100,42,61,103,Friday
2019,12,12,2400,55,51,106,Thursday
2019,12,12,2300,61,79,140,Thursday
2019,12,12,2200,85,111,196,Thursday
2019,12,12,2100,110,114,224,Thursday
2019,12,12,2000,160,94,254,Thursday
2019,12,12,1900,151,139,290,Thursday
2019,12,12,1800,221,319,540,Thursday
2019,12,12,1700,247,405,652,Thursday
2019,12,12,1600,280,375,655,Thursday
2019,12,12,1500,251,318,569,Thursday
2019,12,12,1400,252,238,490,Thursday
2019,12,12,1300,245,211,456,Thursday
2019,12,12,1200,233,180,413,Thursday
2019,12,12,1100,272,131,403,Thursday
2019,12,12,1000,290,118,408,Thursday
2019,12,12,900,281,85,366,Thursday
2019,12,12,800,188,51,239,Thursday
2019,12,12,700,66,58,124,Thursday
2019,12,12,600,35,38,73,Thursday
2019,12,12,500,25,20,45,Thursday
2019,12,12,400,29,11,40,Thursday
2019,12,12,300,35,34,69,Thursday
2019,12,12,200,43,32,75,Thursday
2019,12,12,100,40,43,83,Thursday
2019,12,11,2400,47,54,101,Wednesday
2019,12,11,2300,65,63,128,Wednesday
2019,12,11,2200,77,95,172,Wednesday
2019,12,11,2100,130,104,234,Wednesday
2019,12,11,2000,115,103,218,Wednesday
2019,12,11,1900,130,183,313,Wednesday
2019,12,11,1800,161,278,439,Wednesday
2019,12,11,1700,181,400,581,Wednesday
2019,12,11,1600,181,295,476,Wednesday
2019,12,11,1500,202,303,505,Wednesday
2019,12,11,1400,185,232,417,Wednesday
2019,12,11,1300,224,286,510,Wednesday
2019,12,11,1200,242,423,665,Wednesday
2019,12,11,1100,242,141,383,Wednesday
2019,12,11,1000,268,117,385,Wednesday
2019,12,11,900,266,78,344,Wednesday
2019,12,11,800,191,46,237,Wednesday
2019,12,11,700,79,30,109,Wednesday
2019,12,11,600,41,22,63,Wednesday
2019,12,11,500,21,20,41,Wednesday
2019,12,11,400,24,14,38,Wednesday
2019,12,11,300,23,24,47,Wednesday
2019,12,11,200,24,32,56,Wednesday
2019,12,11,100,43,30,73,Wednesday
2019,12,10,2400,45,67,112,Tuesday
2019,12,10,2300,51,35,86,Tuesday
2019,12,10,2200,79,25,104,Tuesday
2019,12,10,2100,75,82,157,Tuesday
2019,12,10,2000,105,43,148,Tuesday
2019,12,10,1900,141,141,282,Tuesday
2019,12,10,1800,148,291,439,Tuesday
2019,12,10,1700,200,394,594,Tuesday
2019,12,10,1600,192,373,565,Tuesday
2019,12,10,1500,205,246,451,Tuesday
2019,12,10,1400,195,214,409,Tuesday
2019,12,10,1300,216,232,448,Tuesday
2019,12,10,1200,259,187,446,Tuesday
2019,12,10,1100,283,159,442,Tuesday
2019,12,10,1000,285,144,429,Tuesday
2019,12,10,900,271,94,365,Tuesday
2019,12,10,800,195,81,276,Tuesday
2019,12,10,700,76,43,119,Tuesday
2019,12,10,600,40,37,77,Tuesday
2019,12,10,500,23,18,41,Tuesday
2019,12,10,400,18,31,49,Tuesday
2019,12,10,300,22,33,55,Tuesday
2019,12,10,200,34,40,74,Tuesday
2019,12,10,100,39,31,70,Tuesday
2019,12,9,2400,47,56,103,Monday
2019,12,9,2300,68,82,150,Monday
2019,12,9,2200,65,72,137,Monday
2019,12,9,2100,102,112,214,Monday
2019,12,9,2000,121,123,244,Monday
2019,12,9,1900,119,195,314,Monday
2019,12,9,1800,134,286,420,Monday
2019,12,9,1700,186,417,603,Monday
2019,12,9,1600,183,376,559,Monday
2019,12,9,1500,210,278,488,Monday
2019,12,9,1400,247,264,511,Monday
2019,12,9,1300,310,254,564,Monday
2019,12,9,1200,287,171,458,Monday
2019,12,9,1100,321,178,499,Monday
2019,12,9,1000,332,127,459,Monday
2019,12,9,900,312,102,414,Monday
2019,12,9,800,196,60,256,Monday
2019,12,9,700,82,32,114,Monday
2019,12,9,600,32,30,62,Monday
2019,12,9,500,23,25,48,Monday
2019,12,9,400,16,30,46,Monday
2019,12,9,300,22,22,44,Monday
2019,12,9,200,25,24,49,Monday
2019,12,9,100,23,48,71,Monday
2019,12,8,2400,35,55,90,Sunday
2019,12,8,2300,56,46,102,Sunday
2019,12,8,2200,58,76,134,Sunday
2019,12,8,2100,80,174,254,Sunday
2019,12,8,2000,108,205,313,Sunday
2019,12,8,1900,102,310,412,Sunday
2019,12,8,1800,153,731,884,Sunday
2019,12,8,1700,210,1126,1336,Sunday
2019,12,8,1600,272,957,1229,Sunday
2019,12,8,1500,247,720,967,Sunday
2019,12,8,1400,276,574,850,Sunday
2019,12,8,1300,342,385,727,Sunday
2019,12,8,1200,353,227,580,Sunday
2019,12,8,1100,448,164,612,Sunday
2019,12,8,1000,571,126,697,Sunday
2019,12,8,900,853,62,915,Sunday
2019,12,8,800,390,35,425,Sunday
2019,12,8,700,68,13,81,Sunday
2019,12,8,600,16,22,38,Sunday
2019,12,8,500,14,24,38,Sunday
2019,12,8,400,18,26,44,Sunday
2019,12,8,300,15,31,46,Sunday
2019,12,8,200,14,21,35,Sunday
2019,12,8,100,19,35,54,Sunday
2019,12,7,2400,23,42,65,Saturday
2019,12,7,2300,29,46,75,Saturday
2019,12,7,2200,44,58,102,Saturday
2019,12,7,2100,73,103,176,Saturday
2019,12,7,2000,72,104,176,Saturday
2019,12,7,1900,88,172,260,Saturday
2019,12,7,1800,126,546,672,Saturday
2019,12,7,1700,154,861,1015,Saturday
2019,12,7,1600,203,596,799,Saturday
2019,12,7,1500,206,434,640,Saturday
2019,12,7,1400,245,329,574,Saturday
2019,12,7,1300,280,260,540,Saturday
2019,12,7,1200,404,212,616,Saturday
2019,12,7,1100,388,162,550,Saturday
2019,12,7,1000,507,100,607,Saturday
2019,12,7,900,777,94,871,Saturday
2019,12,7,800,406,65,471,Saturday
2019,12,7,700,83,45,128,Saturday
2019,12,7,600,39,44,83,Saturday
2019,12,7,500,15,25,40,Saturday
2019,12,7,400,23,23,46,Saturday
2019,12,7,300,15,25,40,Saturday
2019,12,7,200,27,35,62,Saturday
2019,12,7,100,27,48,75,Saturday
2019,12,6,2400,34,125,159,Friday
2019,12,6,2300,67,337,404,Friday
2019,12,6,2200,89,116,205,Friday
2019,12,6,2100,160,84,244,Friday
2019,12,6,2000,218,76,294,Friday
2019,12,6,1900,230,118,348,Friday
2019,12,6,1800,265,275,540,Friday
2019,12,6,1700,306,416,722,Friday
2019,12,6,1600,315,283,598,Friday
2019,12,6,1500,285,198,483,Friday
2019,12,6,1400,317,184,501,Friday
2019,12,6,1300,320,202,522,Friday
2019,12,6,1200,320,151,471,Friday
2019,12,6,1100,374,119,493,Friday
2019,12,6,1000,355,99,454,Friday
2019,12,6,900,354,78,432,Friday
2019,12,6,800,225,58,283,Friday
2019,12,6,700,97,45,142,Friday
2019,12,6,600,41,33,74,Friday
2019,12,6,500,31,19,50,Friday
2019,12,6,400,32,17,49,Friday
2019,12,6,300,32,33,65,Friday
2019,12,6,200,28,40,68,Friday
2019,12,6,100,45,39,84,Friday
2019,12,5,2400,58,36,94,Thursday
2019,12,5,2300,81,68,149,Thursday
2019,12,5,2200,105,90,195,Thursday
2019,12,5,2100,129,120,249,Thursday
2019,12,5,2000,173,117,290,Thursday
2019,12,5,1900,194,182,376,Thursday
2019,12,5,1800,201,260,461,Thursday
2019,12,5,1700,221,426,647,Thursday
2019,12,5,1600,254,434,688,Thursday
2019,12,5,1500,242,398,640,Thursday
2019,12,5,1400,253,313,566,Thursday
2019,12,5,1300,279,241,520,Thursday
2019,12,5,1200,290,184,474,Thursday
2019,12,5,1100,282,165,447,Thursday
2019,12,5,1000,346,125,471,Thursday
2019,12,5,900,394,87,481,Thursday
2019,12,5,800,222,67,289,Thursday
2019,12,5,700,87,57,144,Thursday
2019,12,5,600,47,35,82,Thursday
2019,12,5,500,35,50,85,Thursday
2019,12,5,400,25,42,67,Thursday
2019,12,5,300,25,81,106,Thursday
2019,12,5,200,32,37,69,Thursday
2019,12,5,100,40,30,70,Thursday
2019,12,4,2400,50,170,220,Wednesday
2019,12,4,2300,89,96,185,Wednesday
2019,12,4,2200,55,119,174,Wednesday
2019,12,4,2100,123,99,222,Wednesday
2019,12,4,2000,90,34,124,Wednesday
2019,12,4,1900,103,93,196,Wednesday
2019,12,4,1800,132,208,340,Wednesday
2019,12,4,1700,160,408,568,Wednesday
2019,12,4,1600,178,354,532,Wednesday
2019,12,4,1500,187,178,365,Wednesday
2019,12,4,1400,184,177,361,Wednesday
2019,12,4,1300,242,200,442,Wednesday
2019,12,4,1200,242,165,407,Wednesday
2019,12,4,1100,235,161,396,Wednesday
2019,12,4,1000,278,121,399,Wednesday
2019,12,4,900,259,72,331,Wednesday
2019,12,4,800,183,78,261,Wednesday
2019,12,4,700,79,42,121,Wednesday
2019,12,4,600,39,65,104,Wednesday
2019,12,4,500,17,36,53,Wednesday
2019,12,4,400,22,29,51,Wednesday
2019,12,4,300,23,46,69,Wednesday
2019,12,4,200,33,42,75,Wednesday
2019,12,4,100,41,43,84,Wednesday
2019,12,3,2400,54,56,110,Tuesday
2019,12,3,2300,56,64,120,Tuesday
2019,12,3,2200,70,80,150,Tuesday
2019,12,3,2100,79,99,178,Tuesday
2019,12,3,2000,99,106,205,Tuesday
2019,12,3,1900,117,150,267,Tuesday
2019,12,3,1800,145,280,425,Tuesday
2019,12,3,1700,178,379,557,Tuesday
2019,12,3,1600,201,299,500,Tuesday
2019,12,3,1500,202,237,439,Tuesday
2019,12,3,1400,200,275,475,Tuesday
2019,12,3,1300,225,166,391,Tuesday
2019,12,3,1200,233,176,409,Tuesday
2019,12,3,1100,268,143,411,Tuesday
2019,12,3,1000,256,117,373,Tuesday
2019,12,3,900,257,90,347,Tuesday
2019,12,3,800,169,46,215,Tuesday
2019,12,3,700,62,43,105,Tuesday
2019,12,3,600,44,33,77,Tuesday
2019,12,3,500,34,24,58,Tuesday
2019,12,3,400,24,23,47,Tuesday
2019,12,3,300,13,30,43,Tuesday
2019,12,3,200,32,26,58,Tuesday
2019,12,3,100,44,29,73,Tuesday
2019,12,2,2400,48,39,87,Monday
2019,12,2,2300,64,51,115,Monday
2019,12,2,2200,76,70,146,Monday
2019,12,2,2100,110,93,203,Monday
2019,12,2,2000,119,141,260,Monday
2019,12,2,1900,140,150,290,Monday
2019,12,2,1800,144,262,406,Monday
2019,12,2,1700,203,431,634,Monday
2019,12,2,1600,224,305,529,Monday
2019,12,2,1500,239,285,524,Monday
2019,12,2,1400,252,244,496,Monday
2019,12,2,1300,279,225,504,Monday
2019,12,2,1200,304,185,489,Monday
2019,12,2,1100,330,165,495,Monday
2019,12,2,1000,285,116,401,Monday
2019,12,2,900,248,76,324,Monday
2019,12,2,800,192,43,235,Monday
2019,12,2,700,91,38,129,Monday
2019,12,2,600,37,15,52,Monday
2019,12,2,500,27,25,52,Monday
2019,12,2,400,24,19,43,Monday
2019,12,2,300,26,15,41,Monday
2019,12,2,200,27,28,55,Monday
2019,12,2,100,29,34,63,Monday
2019,12,1,2400,27,57,84,Sunday
2019,12,1,2300,40,57,97,Sunday
2019,12,1,2200,69,87,156,Sunday
2019,12,1,2100,90,125,215,Sunday
2019,12,1,2000,102,232,334,Sunday
2019,12,1,1900,134,272,406,Sunday
2019,12,1,1800,160,563,723,Sunday
2019,12,1,1700,249,1031,1280,Sunday
2019,12,1,1600,238,833,1071,Sunday
2019,12,1,1500,283,658,941,Sunday
2019,12,1,1400,271,452,723,Sunday
2019,12,1,1300,360,396,756,Sunday
2019,12,1,1200,367,287,654,Sunday
2019,12,1,1100,458,209,667,Sunday
2019,12,1,1000,417,122,539,Sunday
2019,12,1,900,450,57,507,Sunday
2019,12,1,800,317,42,359,Sunday
2019,12,1,700,75,28,103,Sunday
2019,12,1,600,29,19,48,Sunday
2019,12,1,500,16,26,42,Sunday
2019,12,1,400,21,21,42,Sunday
2019,12,1,300,15,18,33,Sunday
2019,12,1,200,18,30,48,Sunday
2019,12,1,100,36,33,69,Sunday
2019,11,30,2400,39,36,75,Saturday
2019,11,30,2300,41,55,96,Saturday
2019,11,30,2200,62,63,125,Saturday
2019,11,30,2100,50,106,156,Saturday
2019,11,30,2000,107,121,228,Saturday
2019,11,30,1900,113,207,320,Saturday
2019,11,30,1800,109,539,648,Saturday
2019,11,30,1700,170,921,1091,Saturday
2019,11,30,1600,226,580,806,Saturday
2019,11,30,1500,254,413,667,Saturday
2019,11,30,1400,311,333,644,Saturday
2019,11,30,1300,363,244,607,Saturday
2019,11,30,1200,497,217,714,Saturday
2019,11,30,1100,486,139,625,Saturday
2019,11,30,1000,517,145,662,Saturday
2019,11,30,900,572,90,662,Saturday
2019,11,30,800,405,64,469,Saturday
2019,11,30,700,85,46,131,Saturday
2019,11,30,600,33,23,56,Saturday
2019,11,30,500,19,39,58,Saturday
2019,11,30,400,29,20,49,Saturday
2019,11,30,300,24,13,37,Saturday
2019,11,30,200,35,34,69,Saturday
2019,11,30,100,35,48,83,Saturday
2019,11,29,2400,49,57,106,Friday
2019,11,29,2300,69,61,130,Friday
2019,11,29,2200,114,116,230,Friday
2019,11,29,2100,134,108,242,Friday
2019,11,29,2000,206,130,336,Friday
2019,11,29,1900,287,206,493,Friday
2019,11,29,1800,292,390,682,Friday
2019,11,29,1700,360,536,896,Friday
2019,11,29,1600,377,465,842,Friday
2019,11,29,1500,374,355,729,Friday
2019,11,29,1400,358,280,638,Friday
2019,11,29,1300,375,263,638,Friday
2019,11,29,1200,411,216,627,Friday
2019,11,29,1100,360,218,578,Friday
2019,11,29,1000,384,138,522,Friday
2019,11,29,900,321,113,434,Friday
2019,11,29,800,220,61,281,Friday
2019,11,29,700,92,42,134,Friday
2019,11,29,600,34,42,76,Friday
2019,11,29,500,20,41,61,Friday
2019,11,29,400,26,33,59,Friday
2019,11,29,300,24,51,75,Friday
2019,11,29,200,33,32,65,Friday
2019,11,29,100,30,43,73,Friday
2019,11,28,2400,58,65,123,Thursday
2019,11,28,2300,81,84,165,Thursday
2019,11,28,2200,77,81,158,Thursday
2019,11,28,2100,103,83,186,Thursday
2019,11,28,2000,135,115,250,Thursday
2019,11,28,1900,166,161,327,Thursday
2019,11,28,1800,237,339,576,Thursday
2019,11,28,1700,257,433,690,Thursday
2019,11,28,1600,281,366,647,Thursday
2019,11,28,1500,254,318,572,Thursday
2019,11,28,1400,265,252,517,Thursday
2019,11,28,1300,261,229,490,Thursday
2019,11,28,1200,275,207,482,Thursday
2019,11,28,1100,282,166,448,Thursday
2019,11,28,1000,267,106,373,Thursday
2019,11,28,900,256,100,356,Thursday
2019,11,28,800,170,62,232,Thursday
2019,11,28,700,67,43,110,Thursday
2019,11,28,600,36,40,76,Thursday
2019,11,28,500,26,26,52,Thursday
2019,11,28,400,28,31,59,Thursday
2019,11,28,300,27,25,52,Thursday
2019,11,28,200,37,27,64,Thursday
2019,11,28,100,48,41,89,Thursday
2019,11,27,2400,61,55,116,Wednesday
2019,11,27,2300,51,81,132,Wednesday
2019,11,27,2200,85,65,150,Wednesday
2019,11,27,2100,122,92,214,Wednesday
2019,11,27,2000,97,101,198,Wednesday
2019,11,27,1900,130,171,301,Wednesday
2019,11,27,1800,150,293,443,Wednesday
2019,11,27,1700,169,337,506,Wednesday
2019,11,27,1600,215,384,599,Wednesday
2019,11,27,1500,207,245,452,Wednesday
2019,11,27,1400,214,216,430,Wednesday
2019,11,27,1300,268,240,508,Wednesday
2019,11,27,1200,260,163,423,Wednesday
2019,11,27,1100,270,170,440,Wednesday
2019,11,27,1000,223,134,357,Wednesday
2019,11,27,900,215,96,311,Wednesday
2019,11,27,800,228,59,287,Wednesday
2019,11,27,700,74,80,154,Wednesday
2019,11,27,600,34,26,60,Wednesday
2019,11,27,500,27,9,36,Wednesday
2019,11,27,400,17,21,38,Wednesday
2019,11,27,300,30,28,58,Wednesday
2019,11,27,200,35,45,80,Wednesday
2019,11,27,100,42,37,79,Wednesday
2019,11,26,2400,43,46,89,Tuesday
2019,11,26,2300,44,67,111,Tuesday
2019,11,26,2200,75,69,144,Tuesday
2019,11,26,2100,83,122,205,Tuesday
2019,11,26,2000,93,104,197,Tuesday
2019,11,26,1900,110,175,285,Tuesday
2019,11,26,1800,115,285,400,Tuesday
2019,11,26,1700,195,360,555,Tuesday
2019,11,26,1600,206,306,512,Tuesday
2019,11,26,1500,218,297,515,Tuesday
2019,11,26,1400,220,214,434,Tuesday
2019,11,26,1300,251,215,466,Tuesday
2019,11,26,1200,280,198,478,Tuesday
2019,11,26,1100,291,178,469,Tuesday
2019,11,26,1000,268,130,398,Tuesday
2019,11,26,900,221,92,313,Tuesday
2019,11,26,800,152,54,206,Tuesday
2019,11,26,700,60,44,104,Tuesday
2019,11,26,600,37,41,78,Tuesday
2019,11,26,500,24,17,41,Tuesday
2019,11,26,400,21,31,52,Tuesday
2019,11,26,300,16,12,28,Tuesday
2019,11,26,200,27,30,57,Tuesday
2019,11,26,100,43,53,96,Tuesday
2019,11,25,2400,44,49,93,Monday
2019,11,25,2300,63,75,138,Monday
2019,11,25,2200,64,74,138,Monday
2019,11,25,2100,93,85,178,Monday
2019,11,25,2000,117,108,225,Monday
2019,11,25,1900,135,202,337,Monday
2019,11,25,1800,158,339,497,Monday
2019,11,25,1700,213,441,654,Monday
2019,11,25,1600,244,355,599,Monday
2019,11,25,1500,255,351,606,Monday
2019,11,25,1400,269,282,551,Monday
2019,11,25,1300,344,243,587,Monday
2019,11,25,1200,377,185,562,Monday
2019,11,25,1100,421,145,566,Monday
2019,11,25,1000,366,115,481,Monday
2019,11,25,900,331,60,391,Monday
2019,11,25,800,162,43,205,Monday
2019,11,25,700,77,35,112,Monday
2019,11,25,600,41,27,68,Monday
2019,11,25,500,22,26,48,Monday
2019,11,25,400,21,18,39,Monday
2019,11,25,300,23,14,37,Monday
2019,11,25,200,27,24,51,Monday
2019,11,25,100,17,37,54,Monday
2019,11,24,2400,25,56,81,Sunday
2019,11,24,2300,42,59,101,Sunday
2019,11,24,2200,73,103,176,Sunday
2019,11,24,2100,79,121,200,Sunday
2019,11,24,2000,87,181,268,Sunday
2019,11,24,1900,101,269,370,Sunday
2019,11,24,1800,160,535,695,Sunday
2019,11,24,1700,207,839,1046,Sunday
2019,11,24,1600,265,731,996,Sunday
2019,11,24,1500,287,596,883,Sunday
2019,11,24,1400,321,499,820,Sunday
2019,11,24,1300,336,358,694,Sunday
2019,11,24,1200,377,275,652,Sunday
2019,11,24,1100,383,188,571,Sunday
2019,11,24,1000,446,106,552,Sunday
2019,11,24,900,533,64,597,Sunday
2019,11,24,800,261,43,304,Sunday
2019,11,24,700,78,19,97,Sunday
2019,11,24,600,21,10,31,Sunday
2019,11,24,500,14,19,33,Sunday
2019,11,24,400,19,13,32,Sunday
2019,11,24,300,15,11,26,Sunday
2019,11,24,200,18,24,42,Sunday
2019,11,24,100,13,40,53,Sunday
2019,11,23,2400,39,66,105,Saturday
2019,11,23,2300,46,49,95,Saturday
2019,11,23,2200,50,41,91,Saturday
2019,11,23,2100,79,48,127,Saturday
2019,11,23,2000,94,88,182,Saturday
2019,11,23,1900,131,176,307,Saturday
2019,11,23,1800,138,427,565,Saturday
2019,11,23,1700,188,708,896,Saturday
2019,11,23,1600,231,533,764,Saturday
2019,11,23,1500,282,412,694,Saturday
2019,11,23,1400,288,382,670,Saturday
2019,11,23,1300,361,344,705,Saturday
2019,11,23,1200,427,232,659,Saturday
2019,11,23,1100,436,197,633,Saturday
2019,11,23,1000,461,123,584,Saturday
2019,11,23,900,501,86,587,Saturday
2019,11,23,800,284,66,350,Saturday
2019,11,23,700,64,36,100,Saturday
2019,11,23,600,31,34,65,Saturday
2019,11,23,500,19,23,42,Saturday
2019,11,23,400,17,20,37,Saturday
2019,11,23,300,18,26,44,Saturday
2019,11,23,200,22,36,58,Saturday
2019,11,23,100,33,58,91,Saturday
2019,11,22,2400,49,61,110,Friday
2019,11,22,2300,62,69,131,Friday
2019,11,22,2200,112,94,206,Friday
2019,11,22,2100,150,129,279,Friday
2019,11,22,2000,209,145,354,Friday
2019,11,22,1900,240,228,468,Friday
2019,11,22,1800,273,455,728,Friday
2019,11,22,1700,351,448,799,Friday
2019,11,22,1600,384,470,854,Friday
2019,11,22,1500,331,391,722,Friday
2019,11,22,1400,356,418,774,Friday
2019,11,22,1300,328,286,614,Friday
2019,11,22,1200,368,218,586,Friday
2019,11,22,1100,339,153,492,Friday
2019,11,22,1000,341,143,484,Friday
2019,11,22,900,328,96,424,Friday
2019,11,22,800,183,68,251,Friday
2019,11,22,700,63,55,118,Friday
2019,11,22,600,39,43,82,Friday
2019,11,22,500,22,32,54,Friday
2019,11,22,400,27,37,64,Friday
2019,11,22,300,30,42,72,Friday
2019,11,22,200,38,50,88,Friday
2019,11,22,100,48,59,107,Friday
2019,11,21,2400,70,76,146,Thursday
2019,11,21,2300,66,66,132,Thursday
2019,11,21,2200,103,88,191,Thursday
2019,11,21,2100,106,125,231,Thursday
2019,11,21,2000,152,115,267,Thursday
2019,11,21,1900,143,157,300,Thursday
2019,11,21,1800,204,310,514,Thursday
2019,11,21,1700,213,394,607,Thursday
2019,11,21,1600,253,355,608,Thursday
2019,11,21,1500,255,322,577,Thursday
2019,11,21,1400,242,286,528,Thursday
2019,11,21,1300,278,225,503,Thursday
2019,11,21,1200,259,209,468,Thursday
2019,11,21,1100,287,160,447,Thursday
2019,11,21,1000,261,117,378,Thursday
2019,11,21,900,268,91,359,Thursday
2019,11,21,800,168,55,223,Thursday
2019,11,21,700,90,40,130,Thursday
2019,11,21,600,43,32,75,Thursday
2019,11,21,500,29,33,62,Thursday
2019,11,21,400,21,31,52,Thursday
2019,11,21,300,18,32,50,Thursday
2019,11,21,200,29,36,65,Thursday
2019,11,21,100,51,54,105,Thursday
2019,11,20,2400,49,61,110,Wednesday
2019,11,20,2300,56,72,128,Wednesday
2019,11,20,2200,95,92,187,Wednesday
2019,11,20,2100,99,118,217,Wednesday
2019,11,20,2000,120,124,244,Wednesday
2019,11,20,1900,134,171,305,Wednesday
2019,11,20,1800,168,280,448,Wednesday
2019,11,20,1700,225,350,575,Wednesday
2019,11,20,1600,225,327,552,Wednesday
2019,11,20,1500,253,303,556,Wednesday
2019,11,20,1400,257,224,481,Wednesday
2019,11,20,1300,270,243,513,Wednesday
2019,11,20,1200,294,182,476,Wednesday
2019,11,20,1100,267,138,405,Wednesday
2019,11,20,1000,274,130,404,Wednesday
2019,11,20,900,255,106,361,Wednesday
2019,11,20,800,146,56,202,Wednesday
2019,11,20,700,70,41,111,Wednesday
2019,11,20,600,45,42,87,Wednesday
2019,11,20,500,29,27,56,Wednesday
2019,11,20,400,18,43,61,Wednesday
2019,11,20,300,30,38,68,Wednesday
2019,11,20,200,28,24,52,Wednesday
2019,11,20,100,43,28,71,Wednesday
2019,11,19,2400,39,60,99,Tuesday
2019,11,19,2300,73,85,158,Tuesday
2019,11,19,2200,61,66,127,Tuesday
2019,11,19,2100,85,119,204,Tuesday
2019,11,19,2000,82,114,196,Tuesday
2019,11,19,1900,96,135,231,Tuesday
2019,11,19,1800,116,246,362,Tuesday
2019,11,19,1700,159,288,447,Tuesday
2019,11,19,1600,160,278,438,Tuesday
2019,11,19,1500,214,266,480,Tuesday
2019,11,19,1400,175,225,400,Tuesday
2019,11,19,1300,189,209,398,Tuesday
2019,11,19,1200,234,169,403,Tuesday
2019,11,19,1100,244,137,381,Tuesday
2019,11,19,1000,231,128,359,Tuesday
2019,11,19,900,217,94,311,Tuesday
2019,11,19,800,208,60,268,Tuesday
2019,11,19,700,57,28,85,Tuesday
2019,11,19,600,35,23,58,Tuesday
2019,11,19,500,17,36,53,Tuesday
2019,11,19,400,22,32,54,Tuesday
2019,11,19,300,21,33,54,Tuesday
2019,11,19,200,21,34,55,Tuesday
2019,11,19,100,50,47,97,Tuesday
2019,11,18,2400,44,52,96,Monday
2019,11,18,2300,76,58,134,Monday
2019,11,18,2200,66,61,127,Monday
2019,11,18,2100,98,88,186,Monday
2019,11,18,2000,114,123,237,Monday
2019,11,18,1900,136,159,295,Monday
2019,11,18,1800,138,288,426,Monday
2019,11,18,1700,202,346,548,Monday
2019,11,18,1600,232,348,580,Monday
2019,11,18,1500,249,292,541,Monday
2019,11,18,1400,266,267,533,Monday
2019,11,18,1300,249,244,493,Monday
2019,11,18,1200,339,180,519,Monday
2019,11,18,1100,345,160,505,Monday
2019,11,18,1000,350,119,469,Monday
2019,11,18,900,285,76,361,Monday
2019,11,18,800,181,45,226,Monday
2019,11,18,700,87,26,113,Monday
2019,11,18,600,30,14,44,Monday
2019,11,18,500,26,21,47,Monday
2019,11,18,400,18,21,39,Monday
2019,11,18,300,8,15,23,Monday
2019,11,18,200,27,23,50,Monday
2019,11,18,100,19,32,51,Monday
2019,11,17,2400,27,48,75,Sunday
2019,11,17,2300,43,66,109,Sunday
2019,11,17,2200,69,74,143,Sunday
2019,11,17,2100,86,141,227,Sunday
2019,11,17,2000,123,154,277,Sunday
2019,11,17,1900,128,282,410,Sunday
2019,11,17,1800,159,541,700,Sunday
2019,11,17,1700,192,633,825,Sunday
2019,11,17,1600,270,649,919,Sunday
2019,11,17,1500,259,598,857,Sunday
2019,11,17,1400,313,563,876,Sunday
2019,11,17,1300,354,416,770,Sunday
2019,11,17,1200,352,314,666,Sunday
2019,11,17,1100,383,183,566,Sunday
2019,11,17,1000,385,118,503,Sunday
2019,11,17,900,354,70,424,Sunday
2019,11,17,800,208,37,245,Sunday
2019,11,17,700,65,20,85,Sunday
2019,11,17,600,23,15,38,Sunday
2019,11,17,500,16,19,35,Sunday
2019,11,17,400,12,13,25,Sunday
2019,11,17,300,14,20,34,Sunday
2019,11,17,200,20,30,50,Sunday
2019,11,17,100,23,36,59,Sunday
2019,11,16,2400,35,25,60,Saturday
2019,11,16,2300,35,51,86,Saturday
2019,11,16,2200,62,66,128,Saturday
2019,11,16,2100,68,68,136,Saturday
2019,11,16,2000,113,127,240,Saturday
2019,11,16,1900,97,210,307,Saturday
2019,11,16,1800,152,461,613,Saturday
2019,11,16,1700,188,605,793,Saturday
2019,11,16,1600,258,565,823,Saturday
2019,11,16,1500,276,461,737,Saturday
2019,11,16,1400,320,383,703,Saturday
2019,11,16,1300,369,326,695,Saturday
2019,11,16,1200,399,222,621,Saturday
2019,11,16,1100,415,228,643,Saturday
2019,11,16,1000,467,140,607,Saturday
2019,11,16,900,539,90,629,Saturday
2019,11,16,800,282,49,331,Saturday
2019,11,16,700,88,36,124,Saturday
2019,11,16,600,32,31,63,Saturday
2019,11,16,500,24,31,55,Saturday
2019,11,16,400,22,32,54,Saturday
2019,11,16,300,21,32,53,Saturday
2019,11,16,200,25,31,56,Saturday
2019,11,16,100,32,52,84,Saturday
2019,11,15,2400,33,69,102,Friday
2019,11,15,2300,56,53,109,Friday
2019,11,15,2200,85,73,158,Friday
2019,11,15,2100,137,94,231,Friday
2019,11,15,2000,219,146,365,Friday
2019,11,15,1900,241,196,437,Friday
2019,11,15,1800,272,378,650,Friday
2019,11,15,1700,308,463,771,Friday
2019,11,15,1600,342,438,780,Friday
2019,11,15,1500,330,370,700,Friday
2019,11,15,1400,323,316,639,Friday
2019,11,15,1300,338,291,629,Friday
2019,11,15,1200,331,275,606,Friday
2019,11,15,1100,345,168,513,Friday
2019,11,15,1000,341,149,490,Friday
2019,11,15,900,305,111,416,Friday
2019,11,15,800,228,72,300,Friday
2019,11,15,700,76,41,117,Friday
2019,11,15,600,47,32,79,Friday
2019,11,15,500,17,40,57,Friday
2019,11,15,400,26,42,68,Friday
2019,11,15,300,18,39,57,Friday
2019,11,15,200,34,49,83,Friday
2019,11,15,100,53,35,88,Friday
2019,11,14,2400,58,51,109,Thursday
2019,11,14,2300,63,76,139,Thursday
2019,11,14,2200,73,106,179,Thursday
2019,11,14,2100,112,109,221,Thursday
2019,11,14,2000,134,129,263,Thursday
2019,11,14,1900,161,172,333,Thursday
2019,11,14,1800,181,348,529,Thursday
2019,11,14,1700,237,391,628,Thursday
2019,11,14,1600,254,361,615,Thursday
2019,11,14,1500,237,360,597,Thursday
2019,11,14,1400,225,281,506,Thursday
2019,11,14,1300,277,299,576,Thursday
2019,11,14,1200,303,221,524,Thursday
2019,11,14,1100,325,183,508,Thursday
2019,11,14,1000,293,120,413,Thursday
2019,11,14,900,249,110,359,Thursday
2019,11,14,800,175,50,225,Thursday
2019,11,14,700,81,42,123,Thursday
2019,11,14,600,45,35,80,Thursday
2019,11,14,500,19,52,71,Thursday
2019,11,14,400,28,33,61,Thursday
2019,11,14,300,27,29,56,Thursday
2019,11,14,200,31,37,68,Thursday
2019,11,14,100,36,49,85,Thursday
2019,11,13,2400,55,85,140,Wednesday
2019,11,13,2300,62,63,125,Wednesday
2019,11,13,2200,70,87,157,Wednesday
2019,11,13,2100,105,96,201,Wednesday
2019,11,13,2000,105,124,229,Wednesday
2019,11,13,1900,148,193,341,Wednesday
2019,11,13,1800,178,334,512,Wednesday
2019,11,13,1700,210,396,606,Wednesday
2019,11,13,1600,226,343,569,Wednesday
2019,11,13,1500,266,372,638,Wednesday
2019,11,13,1400,274,295,569,Wednesday
2019,11,13,1300,327,268,595,Wednesday
2019,11,13,1200,306,210,516,Wednesday
2019,11,13,1100,316,188,504,Wednesday
2019,11,13,1000,323,120,443,Wednesday
2019,11,13,900,247,112,359,Wednesday
2019,11,13,800,172,73,245,Wednesday
2019,11,13,700,78,53,131,Wednesday
2019,11,13,600,35,33,68,Wednesday
2019,11,13,500,22,25,47,Wednesday
2019,11,13,400,14,35,49,Wednesday
2019,11,13,300,30,29,59,Wednesday
2019,11,13,200,22,38,60,Wednesday
2019,11,13,100,44,29,73,Wednesday
2019,11,12,2400,54,52,106,Tuesday
2019,11,12,2300,45,67,112,Tuesday
2019,11,12,2200,72,76,148,Tuesday
2019,11,12,2100,81,108,189,Tuesday
2019,11,12,2000,106,128,234,Tuesday
2019,11,12,1900,148,197,345,Tuesday
2019,11,12,1800,165,319,484,Tuesday
2019,11,12,1700,157,402,559,Tuesday
2019,11,12,1600,206,340,546,Tuesday
2019,11,12,1500,238,301,539,Tuesday
2019,11,12,1400,242,258,500,Tuesday
2019,11,12,1300,293,187,480,Tuesday
2019,11,12,1200,317,162,479,Tuesday
2019,11,12,1100,290,116,406,Tuesday
2019,11,12,1000,272,104,376,Tuesday
2019,11,12,900,263,55,318,Tuesday
2019,11,12,800,161,44,205,Tuesday
2019,11,12,700,76,35,111,Tuesday
2019,11,12,600,31,16,47,Tuesday
2019,11,12,500,18,11,29,Tuesday
2019,11,12,400,13,24,37,Tuesday
2019,11,12,300,15,16,31,Tuesday
2019,11,12,200,24,25,49,Tuesday
2019,11,12,100,14,33,47,Tuesday
2019,11,11,2400,34,51,85,Monday
2019,11,11,2300,51,73,124,Monday
2019,11,11,2200,55,98,153,Monday
2019,11,11,2100,62,106,168,Monday
2019,11,11,2000,103,196,299,Monday
2019,11,11,1900,131,337,468,Monday
2019,11,11,1800,180,606,786,Monday
2019,11,11,1700,238,870,1108,Monday
2019,11,11,1600,302,857,1159,Monday
2019,11,11,1500,373,784,1157,Monday
2019,11,11,1400,423,711,1134,Monday
2019,11,11,1300,563,529,1092,Monday
2019,11,11,1200,640,354,994,Monday
2019,11,11,1100,558,206,764,Monday
2019,11,11,1000,471,124,595,Monday
2019,11,11,900,380,55,435,Monday
2019,11,11,800,159,41,200,Monday
2019,11,11,700,60,24,84,Monday
2019,11,11,600,30,16,46,Monday
2019,11,11,500,20,14,34,Monday
2019,11,11,400,13,12,25,Monday
2019,11,11,300,10,20,30,Monday
2019,11,11,200,23,25,48,Monday
2019,11,11,100,32,35,67,Monday
2019,11,10,2400,27,38,65,Sunday
2019,11,10,2300,35,61,96,Sunday
2019,11,10,2200,51,69,120,Sunday
2019,11,10,2100,76,92,168,Sunday
2019,11,10,2000,102,154,256,Sunday
2019,11,10,1900,101,205,306,Sunday
2019,11,10,1800,146,420,566,Sunday
2019,11,10,1700,194,608,802,Sunday
2019,11,10,1600,249,517,766,Sunday
2019,11,10,1500,294,515,809,Sunday
2019,11,10,1400,315,458,773,Sunday
2019,11,10,1300,353,283,636,Sunday
2019,11,10,1200,374,218,592,Sunday
2019,11,10,1100,328,142,470,Sunday
2019,11,10,1000,270,106,376,Sunday
2019,11,10,900,296,56,352,Sunday
2019,11,10,800,94,27,121,Sunday
2019,11,10,700,33,15,48,Sunday
2019,11,10,600,18,14,32,Sunday
2019,11,10,500,11,10,21,Sunday
2019,11,10,400,8,25,33,Sunday
2019,11,10,300,16,28,44,Sunday
2019,11,10,200,16,24,40,Sunday
2019,11,10,100,26,28,54,Sunday
2019,11,9,2400,20,54,74,Saturday
2019,11,9,2300,32,56,88,Saturday
2019,11,9,2200,50,53,103,Saturday
2019,11,9,2100,73,76,149,Saturday
2019,11,9,2000,97,129,226,Saturday
2019,11,9,1900,124,198,322,Saturday
2019,11,9,1800,156,385,541,Saturday
2019,11,9,1700,210,537,747,Saturday
2019,11,9,1600,287,546,833,Saturday
2019,11,9,1500,345,458,803,Saturday
2019,11,9,1400,424,443,867,Saturday
2019,11,9,1300,469,331,800,Saturday
2019,11,9,1200,490,255,745,Saturday
2019,11,9,1100,517,208,725,Saturday
2019,11,9,1000,446,128,574,Saturday
2019,11,9,900,387,87,474,Saturday
2019,11,9,800,216,55,271,Saturday
2019,11,9,700,83,24,107,Saturday
2019,11,9,600,26,38,64,Saturday
2019,11,9,500,20,26,46,Saturday
2019,11,9,400,19,27,46,Saturday
2019,11,9,300,16,72,88,Saturday
2019,11,9,200,41,3,44,Saturday
2019,11,9,100,43,39,82,Saturday
2019,11,8,2400,48,53,101,Friday
2019,11,8,2300,85,71,156,Friday
2019,11,8,2200,117,96,213,Friday
2019,11,8,2100,219,158,377,Friday
2019,11,8,2000,300,148,448,Friday
2019,11,8,1900,389,260,649,Friday
2019,11,8,1800,422,377,799,Friday
2019,11,8,1700,488,465,953,Friday
2019,11,8,1600,470,448,918,Friday
2019,11,8,1500,473,395,868,Friday
2019,11,8,1400,449,362,811,Friday
2019,11,8,1300,381,321,702,Friday
2019,11,8,1200,432,282,714,Friday
2019,11,8,1100,402,193,595,Friday
2019,11,8,1000,367,173,540,Friday
2019,11,8,900,265,108,373,Friday
2019,11,8,800,175,61,236,Friday
2019,11,8,700,80,50,130,Friday
2019,11,8,600,48,27,75,Friday
2019,11,8,500,37,36,73,Friday
2019,11,8,400,32,24,56,Friday
2019,11,8,300,26,37,63,Friday
2019,11,8,200,30,45,75,Friday
2019,11,8,100,38,57,95,Friday
2019,11,7,2400,67,64,131,Thursday
2019,11,7,2300,68,70,138,Thursday
2019,11,7,2200,92,123,215,Thursday
2019,11,7,2100,130,133,263,Thursday
2019,11,7,2000,168,125,293,Thursday
2019,11,7,1900,177,201,378,Thursday
2019,11,7,1800,240,332,572,Thursday
2019,11,7,1700,255,362,617,Thursday
2019,11,7,1600,296,399,695,Thursday
2019,11,7,1500,260,334,594,Thursday
2019,11,7,1400,248,310,558,Thursday
2019,11,7,1300,260,354,614,Thursday
2019,11,7,1200,314,215,529,Thursday
2019,11,7,1100,320,180,500,Thursday
2019,11,7,1000,266,141,407,Thursday
2019,11,7,900,247,128,375,Thursday
2019,11,7,800,169,60,229,Thursday
2019,11,7,700,100,45,145,Thursday
2019,11,7,600,40,31,71,Thursday
2019,11,7,500,32,28,60,Thursday
2019,11,7,400,21,34,55,Thursday
2019,11,7,300,28,28,56,Thursday
2019,11,7,200,38,34,72,Thursday
2019,11,7,100,43,46,89,Thursday
2019,11,6,2400,50,41,91,Wednesday
2019,11,6,2300,61,97,158,Wednesday
2019,11,6,2200,83,84,167,Wednesday
2019,11,6,2100,101,121,222,Wednesday
2019,11,6,2000,113,123,236,Wednesday
2019,11,6,1900,117,199,316,Wednesday
2019,11,6,1800,149,286,435,Wednesday
2019,11,6,1700,201,306,507,Wednesday
2019,11,6,1600,213,289,502,Wednesday
2019,11,6,1500,201,251,452,Wednesday
2019,11,6,1400,223,273,496,Wednesday
2019,11,6,1300,262,201,463,Wednesday
2019,11,6,1200,275,209,484,Wednesday
2019,11,6,1100,250,153,403,Wednesday
2019,11,6,1000,235,130,365,Wednesday
2019,11,6,900,198,110,308,Wednesday
2019,11,6,800,173,65,238,Wednesday
2019,11,6,700,80,56,136,Wednesday
2019,11,6,600,25,21,46,Wednesday
2019,11,6,500,24,21,45,Wednesday
2019,11,6,400,27,43,70,Wednesday
2019,11,6,300,25,31,56,Wednesday
2019,11,6,200,25,31,56,Wednesday
2019,11,6,100,46,42,88,Wednesday
2019,11,5,2400,38,69,107,Tuesday
2019,11,5,2300,58,65,123,Tuesday
2019,11,5,2200,56,99,155,Tuesday
2019,11,5,2100,84,83,167,Tuesday
2019,11,5,2000,61,122,183,Tuesday
2019,11,5,1900,92,144,236,Tuesday
2019,11,5,1800,128,211,339,Tuesday
2019,11,5,1700,160,259,419,Tuesday
2019,11,5,1600,197,224,421,Tuesday
2019,11,5,1500,158,281,439,Tuesday
2019,11,5,1400,183,184,367,Tuesday
2019,11,5,1300,200,162,362,Tuesday
2019,11,5,1200,210,166,376,Tuesday
2019,11,5,1100,199,158,357,Tuesday
2019,11,5,1000,189,127,316,Tuesday
2019,11,5,900,168,90,258,Tuesday
2019,11,5,800,161,62,223,Tuesday
2019,11,5,700,73,41,114,Tuesday
2019,11,5,600,38,39,77,Tuesday
2019,11,5,500,18,18,36,Tuesday
2019,11,5,400,22,41,63,Tuesday
2019,11,5,300,23,27,50,Tuesday
2019,11,5,200,22,45,67,Tuesday
2019,11,5,100,30,43,73,Tuesday
2019,11,4,2400,44,47,91,Monday
2019,11,4,2300,64,66,130,Monday
2019,11,4,2200,88,76,164,Monday
2019,11,4,2100,80,79,159,Monday
2019,11,4,2000,109,153,262,Monday
2019,11,4,1900,146,160,306,Monday
2019,11,4,1800,161,255,416,Monday
2019,11,4,1700,229,328,557,Monday
2019,11,4,1600,270,304,574,Monday
2019,11,4,1500,294,299,593,Monday
2019,11,4,1400,291,244,535,Monday
2019,11,4,1300,342,206,548,Monday
2019,11,4,1200,327,194,521,Monday
2019,11,4,1100,352,168,520,Monday
2019,11,4,1000,280,125,405,Monday
2019,11,4,900,220,64,284,Monday
2019,11,4,800,166,46,212,Monday
2019,11,4,700,99,26,125,Monday
2019,11,4,600,39,26,65,Monday
2019,11,4,500,14,15,29,Monday
2019,11,4,400,19,20,39,Monday
2019,11,4,300,20,23,43,Monday
2019,11,4,200,19,29,48,Monday
2019,11,4,100,19,36,55,Monday
2019,11,3,2400,45,51,96,Sunday
2019,11,3,2300,30,77,107,Sunday
2019,11,3,2200,75,77,152,Sunday
2019,11,3,2100,72,145,217,Sunday
2019,11,3,2000,98,193,291,Sunday
2019,11,3,1900,101,265,366,Sunday
2019,11,3,1800,159,402,561,Sunday
2019,11,3,1700,207,558,765,Sunday
2019,11,3,1600,229,602,831,Sunday
2019,11,3,1500,248,499,747,Sunday
2019,11,3,1400,285,464,749,Sunday
2019,11,3,1300,329,378,707,Sunday
2019,11,3,1200,339,288,627,Sunday
2019,11,3,1100,328,203,531,Sunday
2019,11,3,1000,251,123,374,Sunday
2019,11,3,900,190,73,263,Sunday
2019,11,3,800,151,24,175,Sunday
2019,11,3,700,67,20,87,Sunday
2019,11,3,600,38,23,61,Sunday
2019,11,3,500,20,14,34,Sunday
2019,11,3,400,7,9,16,Sunday
2019,11,3,300,18,14,32,Sunday
2019,11,3,200,25,15,40,Sunday
2019,11,3,100,30,36,66,Sunday
2019,11,2,2400,33,53,86,Saturday
2019,11,2,2300,43,60,103,Saturday
2019,11,2,2200,66,66,132,Saturday
2019,11,2,2100,89,140,229,Saturday
2019,11,2,2000,103,176,279,Saturday
2019,11,2,1900,139,269,408,Saturday
2019,11,2,1800,162,365,527,Saturday
2019,11,2,1700,216,434,650,Saturday
2019,11,2,1600,257,465,722,Saturday
2019,11,2,1500,334,426,760,Saturday
2019,11,2,1400,361,317,678,Saturday
2019,11,2,1300,389,290,679,Saturday
2019,11,2,1200,413,246,659,Saturday
2019,11,2,1100,382,154,536,Saturday
2019,11,2,1000,296,115,411,Saturday
2019,11,2,900,251,92,343,Saturday
2019,11,2,800,213,70,283,Saturday
2019,11,2,700,101,31,132,Saturday
2019,11,2,600,24,30,54,Saturday
2019,11,2,500,24,26,50,Saturday
2019,11,2,400,17,28,45,Saturday
2019,11,2,300,24,25,49,Saturday
2019,11,2,200,21,41,62,Saturday
2019,11,2,100,31,55,86,Saturday
2019,11,1,2400,47,59,106,Friday
2019,11,1,2300,74,104,178,Friday
2019,11,1,2200,113,88,201,Friday
2019,11,1,2100,155,114,269,Friday
2019,11,1,2000,251,203,454,Friday
2019,11,1,1900,226,272,498,Friday
2019,11,1,1800,317,381,698,Friday
2019,11,1,1700,358,402,760,Friday
2019,11,1,1600,374,396,770,Friday
2019,11,1,1500,375,389,764,Friday
2019,11,1,1400,379,335,714,Friday
2019,11,1,1300,404,262,666,Friday
2019,11,1,1200,399,212,611,Friday
2019,11,1,1100,345,151,496,Friday
2019,11,1,1000,262,138,400,Friday
2019,11,1,900,246,98,344,Friday
2019,11,1,800,193,54,247,Friday
2019,11,1,700,96,47,143,Friday
2019,11,1,600,42,50,92,Friday
2019,11,1,500,25,47,72,Friday
2019,11,1,400,30,37,67,Friday
2019,11,1,300,28,40,68,Friday
2019,11,1,200,31,40,71,Friday
2019,11,1,100,49,44,93,Friday
2019,10,31,2400,38,48,86,Thursday
2019,10,31,2300,63,78,141,Thursday
2019,10,31,2200,78,87,165,Thursday
2019,10,31,2100,115,93,208,Thursday
2019,10,31,2000,155,174,329,Thursday
2019,10,31,1900,159,218,377,Thursday
2019,10,31,1800,171,305,476,Thursday
2019,10,31,1700,224,252,476,Thursday
2019,10,31,1600,229,289,518,Thursday
2019,10,31,1500,217,288,505,Thursday
2019,10,31,1400,264,239,503,Thursday
2019,10,31,1300,260,218,478,Thursday
2019,10,31,1200,254,188,442,Thursday
2019,10,31,1100,222,143,365,Thursday
2019,10,31,1000,195,106,301,Thursday
2019,10,31,900,176,83,259,Thursday
2019,10,31,800,144,63,207,Thursday
2019,10,31,700,78,44,122,Thursday
2019,10,31,600,33,29,62,Thursday
2019,10,31,500,26,48,74,Thursday
2019,10,31,400,27,28,55,Thursday
2019,10,31,300,25,39,64,Thursday
2019,10,31,200,44,57,101,Thursday
2019,10,31,100,42,60,102,Thursday
2019,10,30,2400,54,74,128,Wednesday
2019,10,30,2300,79,68,147,Wednesday
2019,10,30,2200,93,106,199,Wednesday
2019,10,30,2100,127,143,270,Wednesday
2019,10,30,2000,135,165,300,Wednesday
2019,10,30,1900,159,247,406,Wednesday
2019,10,30,1800,194,289,483,Wednesday
2019,10,30,1700,230,316,546,Wednesday
2019,10,30,1600,233,341,574,Wednesday
2019,10,30,1500,247,288,535,Wednesday
2019,10,30,1400,258,344,602,Wednesday
2019,10,30,1300,296,248,544,Wednesday
2019,10,30,1200,276,162,438,Wednesday
2019,10,30,1100,249,170,419,Wednesday
2019,10,30,1000,204,137,341,Wednesday
2019,10,30,900,197,94,291,Wednesday
2019,10,30,800,161,83,244,Wednesday
2019,10,30,700,70,21,91,Wednesday
2019,10,30,600,37,36,73,Wednesday
2019,10,30,500,27,32,59,Wednesday
2019,10,30,400,26,37,63,Wednesday
2019,10,30,300,26,42,68,Wednesday
2019,10,30,200,34,49,83,Wednesday
2019,10,30,100,46,52,98,Wednesday
2019,10,29,2400,58,67,125,Tuesday
2019,10,29,2300,74,93,167,Tuesday
2019,10,29,2200,71,89,160,Tuesday
2019,10,29,2100,95,131,226,Tuesday
2019,10,29,2000,126,165,291,Tuesday
2019,10,29,1900,125,242,367,Tuesday
2019,10,29,1800,157,317,474,Tuesday
2019,10,29,1700,204,305,509,Tuesday
2019,10,29,1600,245,300,545,Tuesday
2019,10,29,1500,254,281,535,Tuesday
2019,10,29,1400,265,253,518,Tuesday
2019,10,29,1300,282,206,488,Tuesday
2019,10,29,1200,289,199,488,Tuesday
2019,10,29,1100,274,153,427,Tuesday
2019,10,29,1000,219,120,339,Tuesday
2019,10,29,900,162,94,256,Tuesday
2019,10,29,800,159,57,216,Tuesday
2019,10,29,700,59,53,112,Tuesday
2019,10,29,600,30,47,77,Tuesday
2019,10,29,500,28,19,47,Tuesday
2019,10,29,400,18,17,35,Tuesday
2019,10,29,300,25,28,53,Tuesday
2019,10,29,200,27,36,63,Tuesday
2019,10,29,100,44,48,92,Tuesday
2019,10,28,2400,44,62,106,Monday
2019,10,28,2300,53,65,118,Monday
2019,10,28,2200,70,88,158,Monday
2019,10,28,2100,104,146,250,Monday
2019,10,28,2000,114,170,284,Monday
2019,10,28,1900,119,282,401,Monday
2019,10,28,1800,182,273,455,Monday
2019,10,28,1700,203,270,473,Monday
2019,10,28,1600,264,281,545,Monday
2019,10,28,1500,299,286,585,Monday
2019,10,28,1400,298,245,543,Monday
2019,10,28,1300,316,233,549,Monday
2019,10,28,1200,298,188,486,Monday
2019,10,28,1100,292,124,416,Monday
2019,10,28,1000,188,100,288,Monday
2019,10,28,900,156,80,236,Monday
2019,10,28,800,119,46,165,Monday
2019,10,28,700,70,25,95,Monday
2019,10,28,600,31,30,61,Monday
2019,10,28,500,10,25,35,Monday
2019,10,28,400,20,14,34,Monday
2019,10,28,300,10,24,34,Monday
2019,10,28,200,22,31,53,Monday
2019,10,28,100,28,61,89,Monday
2019,10,27,2400,35,70,105,Sunday
2019,10,27,2300,48,83,131,Sunday
2019,10,27,2200,75,103,178,Sunday
2019,10,27,2100,81,164,245,Sunday
2019,10,27,2000,128,256,384,Sunday
2019,10,27,1900,155,414,569,Sunday
2019,10,27,1800,199,481,680,Sunday
2019,10,27,1700,261,543,804,Sunday
2019,10,27,1600,295,590,885,Sunday
2019,10,27,1500,327,528,855,Sunday
2019,10,27,1400,343,526,869,Sunday
2019,10,27,1300,405,463,868,Sunday
2019,10,27,1200,419,324,743,Sunday
2019,10,27,1100,381,261,642,Sunday
2019,10,27,1000,286,139,425,Sunday
2019,10,27,900,180,79,259,Sunday
2019,10,27,800,104,34,138,Sunday
2019,10,27,700,44,25,69,Sunday
2019,10,27,600,23,13,36,Sunday
2019,10,27,500,14,14,28,Sunday
2019,10,27,400,17,10,27,Sunday
2019,10,27,300,12,17,29,Sunday
2019,10,27,200,20,31,51,Sunday
2019,10,27,100,18,43,61,Sunday
2019,10,26,2400,23,52,75,Saturday
2019,10,26,2300,40,55,95,Saturday
2019,10,26,2200,49,74,123,Saturday
2019,10,26,2100,82,106,188,Saturday
2019,10,26,2000,79,161,240,Saturday
2019,10,26,1900,147,256,403,Saturday
2019,10,26,1800,164,351,515,Saturday
2019,10,26,1700,206,384,590,Saturday
2019,10,26,1600,260,406,666,Saturday
2019,10,26,1500,298,405,703,Saturday
2019,10,26,1400,326,341,667,Saturday
2019,10,26,1300,359,310,669,Saturday
2019,10,26,1200,456,247,703,Saturday
2019,10,26,1100,405,196,601,Saturday
2019,10,26,1000,292,137,429,Saturday
2019,10,26,900,193,80,273,Saturday
2019,10,26,800,135,54,189,Saturday
2019,10,26,700,75,46,121,Saturday
2019,10,26,600,31,37,68,Saturday
2019,10,26,500,23,35,58,Saturday
2019,10,26,400,15,32,47,Saturday
2019,10,26,300,23,36,59,Saturday
2019,10,26,200,18,41,59,Saturday
2019,10,26,100,42,49,91,Saturday
2019,10,25,2400,54,83,137,Friday
2019,10,25,2300,70,78,148,Friday
2019,10,25,2200,93,91,184,Friday
2019,10,25,2100,143,128,271,Friday
2019,10,25,2000,238,218,456,Friday
2019,10,25,1900,283,278,561,Friday
2019,10,25,1800,306,321,627,Friday
2019,10,25,1700,381,381,762,Friday
2019,10,25,1600,431,432,863,Friday
2019,10,25,1500,405,395,800,Friday
2019,10,25,1400,404,378,782,Friday
2019,10,25,1300,393,271,664,Friday
2019,10,25,1200,362,272,634,Friday
2019,10,25,1100,365,201,566,Friday
2019,10,25,1000,311,133,444,Friday
2019,10,25,900,233,104,337,Friday
2019,10,25,800,161,55,216,Friday
2019,10,25,700,91,43,134,Friday
2019,10,25,600,45,42,87,Friday
2019,10,25,500,22,33,55,Friday
2019,10,25,400,33,35,68,Friday
2019,10,25,300,34,32,66,Friday
2019,10,25,200,32,49,81,Friday
2019,10,25,100,47,56,103,Friday
2019,10,24,2400,59,81,140,Thursday
2019,10,24,2300,82,106,188,Thursday
2019,10,24,2200,97,114,211,Thursday
2019,10,24,2100,129,130,259,Thursday
2019,10,24,2000,178,261,439,Thursday
2019,10,24,1900,202,295,497,Thursday
2019,10,24,1800,203,356,559,Thursday
2019,10,24,1700,301,420,721,Thursday
2019,10,24,1600,349,374,723,Thursday
2019,10,24,1500,345,434,779,Thursday
2019,10,24,1400,341,325,666,Thursday
2019,10,24,1300,333,281,614,Thursday
2019,10,24,1200,386,241,627,Thursday
2019,10,24,1100,387,157,544,Thursday
2019,10,24,1000,342,118,460,Thursday
2019,10,24,900,244,118,362,Thursday
2019,10,24,800,180,46,226,Thursday
2019,10,24,700,86,54,140,Thursday
2019,10,24,600,43,41,84,Thursday
2019,10,24,500,32,45,77,Thursday
2019,10,24,400,28,28,56,Thursday
2019,10,24,300,22,34,56,Thursday
2019,10,24,200,42,44,86,Thursday
2019,10,24,100,49,48,97,Thursday
2019,10,23,2400,56,61,117,Wednesday
2019,10,23,2300,79,91,170,Wednesday
2019,10,23,2200,106,104,210,Wednesday
2019,10,23,2100,121,155,276,Wednesday
2019,10,23,2000,154,225,379,Wednesday
2019,10,23,1900,169,282,451,Wednesday
2019,10,23,1800,190,354,544,Wednesday
2019,10,23,1700,242,365,607,Wednesday
2019,10,23,1600,281,373,654,Wednesday
2019,10,23,1500,274,366,640,Wednesday
2019,10,23,1400,288,222,510,Wednesday
2019,10,23,1300,332,257,589,Wednesday
2019,10,23,1200,376,200,576,Wednesday
2019,10,23,1100,318,145,463,Wednesday
2019,10,23,1000,316,134,450,Wednesday
2019,10,23,900,209,118,327,Wednesday
2019,10,23,800,193,81,274,Wednesday
2019,10,23,700,83,52,135,Wednesday
2019,10,23,600,50,40,90,Wednesday
2019,10,23,500,29,23,52,Wednesday
2019,10,23,400,25,38,63,Wednesday
2019,10,23,300,22,44,66,Wednesday
2019,10,23,200,25,53,78,Wednesday
2019,10,23,100,41,43,84,Wednesday
2019,10,22,2400,65,59,124,Tuesday
2019,10,22,2300,62,70,132,Tuesday
2019,10,22,2200,73,115,188,Tuesday
2019,10,22,2100,92,153,245,Tuesday
2019,10,22,2000,120,189,309,Tuesday
2019,10,22,1900,150,274,424,Tuesday
2019,10,22,1800,176,327,503,Tuesday
2019,10,22,1700,203,315,518,Tuesday
2019,10,22,1600,225,400,625,Tuesday
2019,10,22,1500,253,339,592,Tuesday
2019,10,22,1400,284,286,570,Tuesday
2019,10,22,1300,293,244,537,Tuesday
2019,10,22,1200,374,233,607,Tuesday
2019,10,22,1100,289,169,458,Tuesday
2019,10,22,1000,284,134,418,Tuesday
2019,10,22,900,238,93,331,Tuesday
2019,10,22,800,174,69,243,Tuesday
2019,10,22,700,80,35,115,Tuesday
2019,10,22,600,39,42,81,Tuesday
2019,10,22,500,29,39,68,Tuesday
2019,10,22,400,17,32,49,Tuesday
2019,10,22,300,24,43,67,Tuesday
2019,10,22,200,30,40,70,Tuesday
2019,10,22,100,37,41,78,Tuesday
2019,10,21,2400,47,63,110,Monday
2019,10,21,2300,94,53,147,Monday
2019,10,21,2200,71,101,172,Monday
2019,10,21,2100,111,135,246,Monday
2019,10,21,2000,146,204,350,Monday
2019,10,21,1900,161,257,418,Monday
2019,10,21,1800,205,393,598,Monday
2019,10,21,1700,231,438,669,Monday
2019,10,21,1600,270,393,663,Monday
2019,10,21,1500,340,374,714,Monday
2019,10,21,1400,325,336,661,Monday
2019,10,21,1300,362,280,642,Monday
2019,10,21,1200,400,234,634,Monday
2019,10,21,1100,417,186,603,Monday
2019,10,21,1000,357,139,496,Monday
2019,10,21,900,258,90,348,Monday
2019,10,21,800,202,48,250,Monday
2019,10,21,700,97,29,126,Monday
2019,10,21,600,38,17,55,Monday
2019,10,21,500,23,28,51,Monday
2019,10,21,400,18,26,44,Monday
2019,10,21,300,14,25,39,Monday
2019,10,21,200,16,27,43,Monday
2019,10,21,100,28,40,68,Monday
2019,10,20,2400,40,64,104,Sunday
2019,10,20,2300,62,87,149,Sunday
2019,10,20,2200,79,119,198,Sunday
2019,10,20,2100,92,264,356,Sunday
2019,10,20,2000,138,330,468,Sunday
2019,10,20,1900,165,546,711,Sunday
2019,10,20,1800,215,642,857,Sunday
2019,10,20,1700,305,674,979,Sunday
2019,10,20,1600,357,872,1229,Sunday
2019,10,20,1500,407,751,1158,Sunday
2019,10,20,1400,500,622,1122,Sunday
2019,10,20,1300,540,538,1078,Sunday
2019,10,20,1200,572,436,1008,Sunday
2019,10,20,1100,527,245,772,Sunday
2019,10,20,1000,427,166,593,Sunday
2019,10,20,900,263,83,346,Sunday
2019,10,20,800,148,40,188,Sunday
2019,10,20,700,78,28,106,Sunday
2019,10,20,600,31,20,51,Sunday
2019,10,20,500,14,25,39,Sunday
2019,10,20,400,13,25,38,Sunday
2019,10,20,300,12,24,36,Sunday
2019,10,20,200,23,26,49,Sunday
2019,10,20,100,21,37,58,Sunday
2019,10,19,2400,33,55,88,Saturday
2019,10,19,2300,45,57,102,Saturday
2019,10,19,2200,54,92,146,Saturday
2019,10,19,2100,94,160,254,Saturday
2019,10,19,2000,117,276,393,Saturday
2019,10,19,1900,157,462,619,Saturday
2019,10,19,1800,194,538,732,Saturday
2019,10,19,1700,280,582,862,Saturday
2019,10,19,1600,351,523,874,Saturday
2019,10,19,1500,417,552,969,Saturday
2019,10,19,1400,480,439,919,Saturday
2019,10,19,1300,527,359,886,Saturday
2019,10,19,1200,601,352,953,Saturday
2019,10,19,1100,582,271,853,Saturday
2019,10,19,1000,468,181,649,Saturday
2019,10,19,900,327,112,439,Saturday
2019,10,19,800,189,72,261,Saturday
2019,10,19,700,84,40,124,Saturday
2019,10,19,600,49,32,81,Saturday
2019,10,19,500,18,36,54,Saturday
2019,10,19,400,22,25,47,Saturday
2019,10,19,300,21,34,55,Saturday
2019,10,19,200,30,51,81,Saturday
2019,10,19,100,47,72,119,Saturday
2019,10,18,2400,68,74,142,Friday
2019,10,18,2300,79,94,173,Friday
2019,10,18,2200,132,94,226,Friday
2019,10,18,2100,192,209,401,Friday
2019,10,18,2000,278,340,618,Friday
2019,10,18,1900,323,447,770,Friday
2019,10,18,1800,395,507,902,Friday
2019,10,18,1700,392,555,947,Friday
2019,10,18,1600,445,579,1024,Friday
2019,10,18,1500,439,507,946,Friday
2019,10,18,1400,473,424,897,Friday
2019,10,18,1300,561,428,989,Friday
2019,10,18,1200,595,307,902,Friday
2019,10,18,1100,625,223,848,Friday
2019,10,18,1000,454,195,649,Friday
2019,10,18,900,345,132,477,Friday
2019,10,18,800,216,68,284,Friday
2019,10,18,700,89,62,151,Friday
2019,10,18,600,59,45,104,Friday
2019,10,18,500,38,41,79,Friday
2019,10,18,400,25,37,62,Friday
2019,10,18,300,30,27,57,Friday
2019,10,18,200,37,57,94,Friday
2019,10,18,100,49,73,122,Friday
2019,10,17,2400,80,80,160,Thursday
2019,10,17,2300,104,110,214,Thursday
2019,10,17,2200,143,128,271,Thursday
2019,10,17,2100,152,204,356,Thursday
2019,10,17,2000,188,311,499,Thursday
2019,10,17,1900,216,354,570,Thursday
2019,10,17,1800,294,480,774,Thursday
2019,10,17,1700,311,487,798,Thursday
2019,10,17,1600,374,559,933,Thursday
2019,10,17,1500,391,418,809,Thursday
2019,10,17,1400,380,389,769,Thursday
2019,10,17,1300,452,347,799,Thursday
2019,10,17,1200,434,232,666,Thursday
2019,10,17,1100,482,214,696,Thursday
2019,10,17,1000,409,144,553,Thursday
2019,10,17,900,256,110,366,Thursday
2019,10,17,800,206,79,285,Thursday
2019,10,17,700,91,53,144,Thursday
2019,10,17,600,43,45,88,Thursday
2019,10,17,500,27,29,56,Thursday
2019,10,17,400,28,34,62,Thursday
2019,10,17,300,20,35,55,Thursday
2019,10,17,200,34,46,80,Thursday
2019,10,17,100,36,58,94,Thursday
2019,10,16,2400,56,93,149,Wednesday
2019,10,16,2300,69,99,168,Wednesday
2019,10,16,2200,105,137,242,Wednesday
2019,10,16,2100,123,217,340,Wednesday
2019,10,16,2000,150,283,433,Wednesday
2019,10,16,1900,188,357,545,Wednesday
2019,10,16,1800,206,545,751,Wednesday
2019,10,16,1700,286,571,857,Wednesday
2019,10,16,1600,315,522,837,Wednesday
2019,10,16,1500,318,477,795,Wednesday
2019,10,16,1400,389,405,794,Wednesday
2019,10,16,1300,453,338,791,Wednesday
2019,10,16,1200,553,271,824,Wednesday
2019,10,16,1100,533,233,766,Wednesday
2019,10,16,1000,396,157,553,Wednesday
2019,10,16,900,330,114,444,Wednesday
2019,10,16,800,213,77,290,Wednesday
2019,10,16,700,112,47,159,Wednesday
2019,10,16,600,48,43,91,Wednesday
2019,10,16,500,29,36,65,Wednesday
2019,10,16,400,18,44,62,Wednesday
2019,10,16,300,28,28,56,Wednesday
2019,10,16,200,27,52,79,Wednesday
2019,10,16,100,51,60,111,Wednesday
2019,10,15,2400,61,94,155,Tuesday
2019,10,15,2300,77,75,152,Tuesday
2019,10,15,2200,97,119,216,Tuesday
2019,10,15,2100,109,212,321,Tuesday
2019,10,15,2000,140,335,475,Tuesday
2019,10,15,1900,171,514,685,Tuesday
2019,10,15,1800,243,575,818,Tuesday
2019,10,15,1700,296,724,1020,Tuesday
2019,10,15,1600,398,668,1066,Tuesday
2019,10,15,1500,383,512,895,Tuesday
2019,10,15,1400,445,459,904,Tuesday
2019,10,15,1300,508,404,912,Tuesday
2019,10,15,1200,623,323,946,Tuesday
2019,10,15,1100,659,222,881,Tuesday
2019,10,15,1000,561,154,715,Tuesday
2019,10,15,900,380,92,472,Tuesday
2019,10,15,800,238,68,306,Tuesday
2019,10,15,700,118,29,147,Tuesday
2019,10,15,600,40,20,60,Tuesday
2019,10,15,500,16,16,32,Tuesday
2019,10,15,400,23,38,61,Tuesday
2019,10,15,300,15,27,42,Tuesday
2019,10,15,200,19,39,58,Tuesday
2019,10,15,100,24,51,75,Tuesday
2019,10,14,2400,35,75,110,Monday
2019,10,14,2300,47,121,168,Monday
2019,10,14,2200,57,210,267,Monday
2019,10,14,2100,88,361,449,Monday
2019,10,14,2000,130,663,793,Monday
2019,10,14,1900,195,971,1166,Monday
2019,10,14,1800,269,1351,1620,Monday
2019,10,14,1700,352,1687,2039,Monday
2019,10,14,1600,448,1606,2054,Monday
2019,10,14,1500,603,1462,2065,Monday
2019,10,14,1400,753,1444,2197,Monday
2019,10,14,1300,815,1061,1876,Monday
2019,10,14,1200,876,720,1596,Monday
2019,10,14,1100,815,374,1189,Monday
2019,10,14,1000,593,187,780,Monday
2019,10,14,900,399,91,490,Monday
2019,10,14,800,227,40,267,Monday
2019,10,14,700,138,19,157,Monday
2019,10,14,600,60,11,71,Monday
2019,10,14,500,41,15,56,Monday
2019,10,14,400,17,15,32,Monday
2019,10,14,300,32,19,51,Monday
2019,10,14,200,24,18,42,Monday
2019,10,14,100,31,34,65,Monday
2019,10,13,2400,36,47,83,Sunday
2019,10,13,2300,54,103,157,Sunday
2019,10,13,2200,67,147,214,Sunday
2019,10,13,2100,84,213,297,Sunday
2019,10,13,2000,120,354,474,Sunday
2019,10,13,1900,137,513,650,Sunday
2019,10,13,1800,204,694,898,Sunday
2019,10,13,1700,298,839,1137,Sunday
2019,10,13,1600,369,778,1147,Sunday
2019,10,13,1500,475,772,1247,Sunday
2019,10,13,1400,594,726,1320,Sunday
2019,10,13,1300,622,520,1142,Sunday
2019,10,13,1200,737,412,1149,Sunday
2019,10,13,1100,654,289,943,Sunday
2019,10,13,1000,519,149,668,Sunday
2019,10,13,900,350,71,421,Sunday
2019,10,13,800,211,32,243,Sunday
2019,10,13,700,95,27,122,Sunday
2019,10,13,600,45,10,55,Sunday
2019,10,13,500,17,18,35,Sunday
2019,10,13,400,9,17,26,Sunday
2019,10,13,300,9,22,31,Sunday
2019,10,13,200,20,34,54,Sunday
2019,10,13,100,18,52,70,Sunday
2019,10,12,2400,30,57,87,Saturday
2019,10,12,2300,51,91,142,Saturday
2019,10,12,2200,64,117,181,Saturday
2019,10,12,2100,89,250,339,Saturday
2019,10,12,2000,109,451,560,Saturday
2019,10,12,1900,137,671,808,Saturday
2019,10,12,1800,247,795,1042,Saturday
2019,10,12,1700,377,888,1265,Saturday
2019,10,12,1600,514,844,1358,Saturday
2019,10,12,1500,668,686,1354,Saturday
2019,10,12,1400,788,574,1362,Saturday
2019,10,12,1300,946,535,1481,Saturday
2019,10,12,1200,1070,428,1498,Saturday
2019,10,12,1100,1081,281,1362,Saturday
2019,10,12,1000,883,165,1048,Saturday
2019,10,12,900,536,126,662,Saturday
2019,10,12,800,327,65,392,Saturday
2019,10,12,700,182,49,231,Saturday
2019,10,12,600,71,39,110,Saturday
2019,10,12,500,41,35,76,Saturday
2019,10,12,400,30,34,64,Saturday
2019,10,12,300,28,34,62,Saturday
2019,10,12,200,35,51,86,Saturday
2019,10,12,100,49,84,133,Saturday
2019,10,11,2400,70,84,154,Friday
2019,10,11,2300,135,160,295,Friday
2019,10,11,2200,192,231,423,Friday
2019,10,11,2100,345,245,590,Friday
2019,10,11,2000,535,427,962,Friday
2019,10,11,1900,703,580,1283,Friday
2019,10,11,1800,827,792,1619,Friday
2019,10,11,1700,956,808,1764,Friday
2019,10,11,1600,931,839,1770,Friday
2019,10,11,1500,960,690,1650,Friday
2019,10,11,1400,902,569,1471,Friday
2019,10,11,1300,897,461,1358,Friday
2019,10,11,1200,988,342,1330,Friday
2019,10,11,1100,948,260,1208,Friday
2019,10,11,1000,769,190,959,Friday
2019,10,11,900,552,139,691,Friday
2019,10,11,800,355,81,436,Friday
2019,10,11,700,189,63,252,Friday
2019,10,11,600,79,37,116,Friday
2019,10,11,500,34,47,81,Friday
2019,10,11,400,38,46,84,Friday
2019,10,11,300,32,38,70,Friday
2019,10,11,200,46,63,109,Friday
2019,10,11,100,44,52,96,Friday
2019,10,10,2400,60,84,144,Thursday
2019,10,10,2300,96,151,247,Thursday
2019,10,10,2200,164,169,333,Thursday
2019,10,10,2100,218,261,479,Thursday
2019,10,10,2000,340,341,681,Thursday
2019,10,10,1900,458,510,968,Thursday
2019,10,10,1800,470,707,1177,Thursday
2019,10,10,1700,484,685,1169,Thursday
2019,10,10,1600,511,649,1160,Thursday
2019,10,10,1500,598,470,1068,Thursday
2019,10,10,1400,503,414,917,Thursday
2019,10,10,1300,612,356,968,Thursday
2019,10,10,1200,694,279,973,Thursday
2019,10,10,1100,667,213,880,Thursday
2019,10,10,1000,586,203,789,Thursday
2019,10,10,900,356,79,435,Thursday
2019,10,10,800,295,54,349,Thursday
2019,10,10,700,162,58,220,Thursday
2019,10,10,600,52,36,88,Thursday
2019,10,10,500,35,46,81,Thursday
2019,10,10,400,32,41,73,Thursday
2019,10,10,300,27,47,74,Thursday
2019,10,10,200,41,44,85,Thursday
2019,10,10,100,40,58,98,Thursday
2019,10,9,2400,54,67,121,Wednesday
2019,10,9,2300,80,101,181,Wednesday
2019,10,9,2200,104,94,198,Wednesday
2019,10,9,2100,130,179,309,Wednesday
2019,10,9,2000,165,315,480,Wednesday
2019,10,9,1900,219,454,673,Wednesday
2019,10,9,1800,253,544,797,Wednesday
2019,10,9,1700,301,565,866,Wednesday
2019,10,9,1600,315,522,837,Wednesday
2019,10,9,1500,388,392,780,Wednesday
2019,10,9,1400,389,347,736,Wednesday
2019,10,9,1300,435,302,737,Wednesday
2019,10,9,1200,566,264,830,Wednesday
2019,10,9,1100,512,177,689,Wednesday
2019,10,9,1000,449,145,594,Wednesday
2019,10,9,900,312,106,418,Wednesday
2019,10,9,800,234,62,296,Wednesday
2019,10,9,700,103,54,157,Wednesday
2019,10,9,600,50,50,100,Wednesday
2019,10,9,500,16,23,39,Wednesday
2019,10,9,400,29,17,46,Wednesday
2019,10,9,300,22,26,48,Wednesday
2019,10,9,200,35,24,59,Wednesday
2019,10,9,100,38,31,69,Wednesday
2019,10,8,2400,56,43,99,Tuesday
2019,10,8,2300,66,85,151,Tuesday
2019,10,8,2200,88,111,199,Tuesday
2019,10,8,2100,110,117,227,Tuesday
2019,10,8,2000,106,200,306,Tuesday
2019,10,8,1900,113,265,378,Tuesday
2019,10,8,1800,138,346,484,Tuesday
2019,10,8,1700,206,363,569,Tuesday
2019,10,8,1600,230,323,553,Tuesday
2019,10,8,1500,247,366,613,Tuesday
2019,10,8,1400,235,294,529,Tuesday
2019,10,8,1300,295,244,539,Tuesday
2019,10,8,1200,340,231,571,Tuesday
2019,10,8,1100,343,188,531,Tuesday
2019,10,8,1000,243,130,373,Tuesday
2019,10,8,900,189,97,286,Tuesday
2019,10,8,800,116,63,179,Tuesday
2019,10,8,700,48,69,117,Tuesday
2019,10,8,600,41,8,49,Tuesday
2019,10,8,500,23,85,108,Tuesday
2019,10,8,400,19,44,63,Tuesday
2019,10,8,300,26,33,59,Tuesday
2019,10,8,200,31,30,61,Tuesday
2019,10,8,100,38,50,88,Tuesday
2019,10,7,2400,57,60,117,Monday
2019,10,7,2300,84,90,174,Monday
2019,10,7,2200,84,125,209,Monday
2019,10,7,2100,134,213,347,Monday
2019,10,7,2000,192,297,489,Monday
2019,10,7,1900,195,521,716,Monday
2019,10,7,1800,249,677,926,Monday
2019,10,7,1700,307,719,1026,Monday
2019,10,7,1600,375,730,1105,Monday
2019,10,7,1500,417,575,992,Monday
2019,10,7,1400,468,507,975,Monday
2019,10,7,1300,509,440,949,Monday
2019,10,7,1200,679,343,1022,Monday
2019,10,7,1100,704,232,936,Monday
2019,10,7,1000,585,158,743,Monday
2019,10,7,900,433,125,558,Monday
2019,10,7,800,318,53,371,Monday
2019,10,7,700,160,30,190,Monday
2019,10,7,600,63,38,101,Monday
2019,10,7,500,27,21,48,Monday
2019,10,7,400,18,25,43,Monday
2019,10,7,300,18,27,45,Monday
2019,10,7,200,31,36,67,Monday
2019,10,7,100,22,61,83,Monday
2019,10,6,2400,39,81,120,Sunday
2019,10,6,2300,57,111,168,Sunday
2019,10,6,2200,92,167,259,Sunday
2019,10,6,2100,134,395,529,Sunday
2019,10,6,2000,161,656,817,Sunday
2019,10,6,1900,191,950,1141,Sunday
2019,10,6,1800,237,1176,1413,Sunday
2019,10,6,1700,361,1135,1496,Sunday
2019,10,6,1600,443,1020,1463,Sunday
2019,10,6,1500,546,921,1467,Sunday
2019,10,6,1400,596,756,1352,Sunday
2019,10,6,1300,661,581,1242,Sunday
2019,10,6,1200,831,461,1292,Sunday
2019,10,6,1100,788,320,1108,Sunday
2019,10,6,1000,750,156,906,Sunday
2019,10,6,900,565,86,651,Sunday
2019,10,6,800,302,45,347,Sunday
2019,10,6,700,209,19,228,Sunday
2019,10,6,600,74,22,96,Sunday
2019,10,6,500,31,25,56,Sunday
2019,10,6,400,28,17,45,Sunday
2019,10,6,300,9,29,38,Sunday
2019,10,6,200,25,34,59,Sunday
2019,10,6,100,25,48,73,Sunday
2019,10,5,2400,35,56,91,Saturday
2019,10,5,2300,46,83,129,Saturday
2019,10,5,2200,85,116,201,Saturday
2019,10,5,2100,126,274,400,Saturday
2019,10,5,2000,140,399,539,Saturday
2019,10,5,1900,184,651,835,Saturday
2019,10,5,1800,230,830,1060,Saturday
2019,10,5,1700,324,864,1188,Saturday
2019,10,5,1600,367,746,1113,Saturday
2019,10,5,1500,488,633,1121,Saturday
2019,10,5,1400,598,562,1160,Saturday
2019,10,5,1300,691,439,1130,Saturday
2019,10,5,1200,815,386,1201,Saturday
2019,10,5,1100,873,295,1168,Saturday
2019,10,5,1000,772,210,982,Saturday
2019,10,5,900,511,100,611,Saturday
2019,10,5,800,316,67,383,Saturday
2019,10,5,700,192,47,239,Saturday
2019,10,5,600,87,42,129,Saturday
2019,10,5,500,35,47,82,Saturday
2019,10,5,400,18,33,51,Saturday
2019,10,5,300,17,38,55,Saturday
2019,10,5,200,29,46,75,Saturday
2019,10,5,100,41,65,106,Saturday
2019,10,4,2400,63,57,120,Friday
2019,10,4,2300,73,90,163,Friday
2019,10,4,2200,142,152,294,Friday
2019,10,4,2100,236,264,500,Friday
2019,10,4,2000,346,442,788,Friday
2019,10,4,1900,450,599,1049,Friday
2019,10,4,1800,485,751,1236,Friday
2019,10,4,1700,513,771,1284,Friday
2019,10,4,1600,555,786,1341,Friday
2019,10,4,1500,591,592,1183,Friday
2019,10,4,1400,595,561,1156,Friday
2019,10,4,1300,610,512,1122,Friday
2019,10,4,1200,805,342,1147,Friday
2019,10,4,1100,876,243,1119,Friday
2019,10,4,1000,735,202,937,Friday
2019,10,4,900,553,139,692,Friday
2019,10,4,800,326,82,408,Friday
2019,10,4,700,196,52,248,Friday
2019,10,4,600,77,41,118,Friday
2019,10,4,500,51,55,106,Friday
2019,10,4,400,29,49,78,Friday
2019,10,4,300,39,51,90,Friday
2019,10,4,200,38,52,90,Friday
2019,10,4,100,47,58,105,Friday
2019,10,3,2400,55,64,119,Thursday
2019,10,3,2300,73,103,176,Thursday
2019,10,3,2200,110,155,265,Thursday
2019,10,3,2100,161,251,412,Thursday
2019,10,3,2000,194,413,607,Thursday
2019,10,3,1900,263,567,830,Thursday
2019,10,3,1800,286,698,984,Thursday
2019,10,3,1700,346,681,1027,Thursday
2019,10,3,1600,379,578,957,Thursday
2019,10,3,1500,456,529,985,Thursday
2019,10,3,1400,471,444,915,Thursday
2019,10,3,1300,548,348,896,Thursday
2019,10,3,1200,664,366,1030,Thursday
2019,10,3,1100,738,253,991,Thursday
2019,10,3,1000,678,162,840,Thursday
2019,10,3,900,477,122,599,Thursday
2019,10,3,800,287,73,360,Thursday
2019,10,3,700,142,50,192,Thursday
2019,10,3,600,81,46,127,Thursday
2019,10,3,500,35,38,73,Thursday
2019,10,3,400,34,30,64,Thursday
2019,10,3,300,30,47,77,Thursday
2019,10,3,200,31,36,67,Thursday
2019,10,3,100,39,51,90,Thursday
2019,10,2,2400,74,75,149,Wednesday
2019,10,2,2300,81,93,174,Wednesday
2019,10,2,2200,108,144,252,Wednesday
2019,10,2,2100,133,280,413,Wednesday
2019,10,2,2000,203,418,621,Wednesday
2019,10,2,1900,208,639,847,Wednesday
2019,10,2,1800,289,790,1079,Wednesday
2019,10,2,1700,292,623,915,Wednesday
2019,10,2,1600,320,587,907,Wednesday
2019,10,2,1500,404,570,974,Wednesday
2019,10,2,1400,422,421,843,Wednesday
2019,10,2,1300,537,372,909,Wednesday
2019,10,2,1200,692,293,985,Wednesday
2019,10,2,1100,695,232,927,Wednesday
2019,10,2,1000,675,181,856,Wednesday
2019,10,2,900,445,143,588,Wednesday
2019,10,2,800,260,83,343,Wednesday
2019,10,2,700,170,54,224,Wednesday
2019,10,2,600,84,49,133,Wednesday
2019,10,2,500,38,48,86,Wednesday
2019,10,2,400,30,46,76,Wednesday
2019,10,2,300,21,38,59,Wednesday
2019,10,2,200,35,49,84,Wednesday
2019,10,2,100,40,67,107,Wednesday
2019,10,1,2400,62,71,133,Tuesday
2019,10,1,2300,73,100,173,Tuesday
2019,10,1,2200,103,168,271,Tuesday
2019,10,1,2100,127,338,465,Tuesday
2019,10,1,2000,149,446,595,Tuesday
2019,10,1,1900,211,688,899,Tuesday
2019,10,1,1800,219,764,983,Tuesday
2019,10,1,1700,350,726,1076,Tuesday
2019,10,1,1600,367,665,1032,Tuesday
2019,10,1,1500,391,504,895,Tuesday
2019,10,1,1400,457,402,859,Tuesday
2019,10,1,1300,557,360,917,Tuesday
2019,10,1,1200,652,320,972,Tuesday
2019,10,1,1100,791,235,1026,Tuesday
2019,10,1,1000,598,177,775,Tuesday
2019,10,1,900,470,110,580,Tuesday
2019,10,1,800,276,62,338,Tuesday
2019,10,1,700,169,53,222,Tuesday
2019,10,1,600,72,36,108,Tuesday
2019,10,1,500,43,37,80,Tuesday
2019,10,1,400,29,41,70,Tuesday
2019,10,1,300,20,30,50,Tuesday
2019,10,1,200,23,34,57,Tuesday
2019,10,1,100,44,59,103,Tuesday
2019,9,30,2400,74,66,140,Monday
2019,9,30,2300,80,83,163,Monday
2019,9,30,2200,94,123,217,Monday
2019,9,30,2100,122,293,415,Monday
2019,9,30,2000,176,403,579,Monday
2019,9,30,1900,197,580,777,Monday
2019,9,30,1800,222,639,861,Monday
2019,9,30,1700,301,697,998,Monday
2019,9,30,1600,347,524,871,Monday
2019,9,30,1500,436,492,928,Monday
2019,9,30,1400,453,399,852,Monday
2019,9,30,1300,520,379,899,Monday
2019,9,30,1200,598,324,922,Monday
2019,9,30,1100,576,234,810,Monday
2019,9,30,1000,437,146,583,Monday
2019,9,30,900,305,105,410,Monday
2019,9,30,800,179,36,215,Monday
2019,9,30,700,92,41,133,Monday
2019,9,30,600,31,23,54,Monday
2019,9,30,500,17,17,34,Monday
2019,9,30,400,13,14,27,Monday
2019,9,30,300,15,30,45,Monday
2019,9,30,200,13,28,41,Monday
2019,9,30,100,33,40,73,Monday
2019,9,29,2400,16,60,76,Sunday
2019,9,29,2300,39,88,127,Sunday
2019,9,29,2200,55,168,223,Sunday
2019,9,29,2100,73,285,358,Sunday
2019,9,29,2000,142,436,578,Sunday
2019,9,29,1900,146,590,736,Sunday
2019,9,29,1800,221,810,1031,Sunday
2019,9,29,1700,292,869,1161,Sunday
2019,9,29,1600,341,875,1216,Sunday
2019,9,29,1500,479,746,1225,Sunday
2019,9,29,1400,453,652,1105,Sunday
2019,9,29,1300,398,640,1038,Sunday
2019,9,29,1200,593,475,1068,Sunday
2019,9,29,1100,603,261,864,Sunday
2019,9,29,1000,488,164,652,Sunday
2019,9,29,900,304,74,378,Sunday
2019,9,29,800,173,49,222,Sunday
2019,9,29,700,72,22,94,Sunday
2019,9,29,600,47,20,67,Sunday
2019,9,29,500,23,21,44,Sunday
2019,9,29,400,17,16,33,Sunday
2019,9,29,300,6,23,29,Sunday
2019,9,29,200,20,29,49,Sunday
2019,9,29,100,17,40,57,Sunday
2019,9,28,2400,38,70,108,Saturday
2019,9,28,2300,49,80,129,Saturday
2019,9,28,2200,69,121,190,Saturday
2019,9,28,2100,83,238,321,Saturday
2019,9,28,2000,116,396,512,Saturday
2019,9,28,1900,156,557,713,Saturday
2019,9,28,1800,230,739,969,Saturday
2019,9,28,1700,277,627,904,Saturday
2019,9,28,1600,328,572,900,Saturday
2019,9,28,1500,409,518,927,Saturday
2019,9,28,1400,450,397,847,Saturday
2019,9,28,1300,522,360,882,Saturday
2019,9,28,1200,696,321,1017,Saturday
2019,9,28,1100,647,260,907,Saturday
2019,9,28,1000,604,170,774,Saturday
2019,9,28,900,398,106,504,Saturday
2019,9,28,800,194,73,267,Saturday
2019,9,28,700,130,35,165,Saturday
2019,9,28,600,61,43,104,Saturday
2019,9,28,500,42,31,73,Saturday
2019,9,28,400,28,33,61,Saturday
2019,9,28,300,21,31,52,Saturday
2019,9,28,200,30,43,73,Saturday
2019,9,28,100,42,61,103,Saturday
2019,9,27,2400,68,84,152,Friday
2019,9,27,2300,81,100,181,Friday
2019,9,27,2200,132,135,267,Friday
2019,9,27,2100,179,250,429,Friday
2019,9,27,2000,256,372,628,Friday
2019,9,27,1900,366,436,802,Friday
2019,9,27,1800,447,749,1196,Friday
2019,9,27,1700,542,872,1414,Friday
2019,9,27,1600,591,957,1548,Friday
2019,9,27,1500,617,639,1256,Friday
2019,9,27,1400,582,538,1120,Friday
2019,9,27,1300,658,508,1166,Friday
2019,9,27,1200,816,395,1211,Friday
2019,9,27,1100,778,329,1107,Friday
2019,9,27,1000,809,213,1022,Friday
2019,9,27,900,591,146,737,Friday
2019,9,27,800,349,74,423,Friday
2019,9,27,700,196,71,267,Friday
2019,9,27,600,98,44,142,Friday
2019,9,27,500,54,48,102,Friday
2019,9,27,400,37,36,73,Friday
2019,9,27,300,27,39,66,Friday
2019,9,27,200,50,61,111,Friday
2019,9,27,100,60,70,130,Friday
2019,9,26,2400,78,76,154,Thursday
2019,9,26,2300,108,111,219,Thursday
2019,9,26,2200,161,174,335,Thursday
2019,9,26,2100,171,301,472,Thursday
2019,9,26,2000,257,561,818,Thursday
2019,9,26,1900,278,624,902,Thursday
2019,9,26,1800,351,902,1253,Thursday
2019,9,26,1700,471,777,1248,Thursday
2019,9,26,1600,483,805,1288,Thursday
2019,9,26,1500,536,618,1154,Thursday
2019,9,26,1400,579,512,1091,Thursday
2019,9,26,1300,620,492,1112,Thursday
2019,9,26,1200,808,402,1210,Thursday
2019,9,26,1100,791,321,1112,Thursday
2019,9,26,1000,750,209,959,Thursday
2019,9,26,900,518,154,672,Thursday
2019,9,26,800,345,76,421,Thursday
2019,9,26,700,181,56,237,Thursday
2019,9,26,600,81,51,132,Thursday
2019,9,26,500,52,29,81,Thursday
2019,9,26,400,45,45,90,Thursday
2019,9,26,300,25,38,63,Thursday
2019,9,26,200,40,49,89,Thursday
2019,9,26,100,44,55,99,Thursday
2019,9,25,2400,70,65,135,Wednesday
2019,9,25,2300,97,127,224,Wednesday
2019,9,25,2200,104,182,286,Wednesday
2019,9,25,2100,161,315,476,Wednesday
2019,9,25,2000,199,538,737,Wednesday
2019,9,25,1900,244,758,1002,Wednesday
2019,9,25,1800,288,937,1225,Wednesday
2019,9,25,1700,381,861,1242,Wednesday
2019,9,25,1600,428,802,1230,Wednesday
2019,9,25,1500,472,670,1142,Wednesday
2019,9,25,1400,556,569,1125,Wednesday
2019,9,25,1300,607,554,1161,Wednesday
2019,9,25,1200,769,418,1187,Wednesday
2019,9,25,1100,884,306,1190,Wednesday
2019,9,25,1000,804,241,1045,Wednesday
2019,9,25,900,643,148,791,Wednesday
2019,9,25,800,460,78,538,Wednesday
2019,9,25,700,247,73,320,Wednesday
2019,9,25,600,128,53,181,Wednesday
2019,9,25,500,80,35,115,Wednesday
2019,9,25,400,30,45,75,Wednesday
2019,9,25,300,29,55,84,Wednesday
2019,9,25,200,24,63,87,Wednesday
2019,9,25,100,55,45,100,Wednesday
2019,9,24,2400,56,92,148,Tuesday
2019,9,24,2300,91,98,189,Tuesday
2019,9,24,2200,113,163,276,Tuesday
2019,9,24,2100,136,297,433,Tuesday
2019,9,24,2000,212,543,755,Tuesday
2019,9,24,1900,197,733,930,Tuesday
2019,9,24,1800,289,868,1157,Tuesday
2019,9,24,1700,359,786,1145,Tuesday
2019,9,24,1600,433,756,1189,Tuesday
2019,9,24,1500,433,709,1142,Tuesday
2019,9,24,1400,476,520,996,Tuesday
2019,9,24,1300,543,516,1059,Tuesday
2019,9,24,1200,783,446,1229,Tuesday
2019,9,24,1100,861,355,1216,Tuesday
2019,9,24,1000,735,253,988,Tuesday
2019,9,24,900,660,149,809,Tuesday
2019,9,24,800,401,91,492,Tuesday
2019,9,24,700,247,81,328,Tuesday
2019,9,24,600,103,44,147,Tuesday
2019,9,24,500,64,44,108,Tuesday
2019,9,24,400,37,45,82,Tuesday
2019,9,24,300,23,49,72,Tuesday
2019,9,24,200,32,49,81,Tuesday
2019,9,24,100,45,77,122,Tuesday
2019,9,23,2400,54,75,129,Monday
2019,9,23,2300,92,105,197,Monday
2019,9,23,2200,110,117,227,Monday
2019,9,23,2100,144,360,504,Monday
2019,9,23,2000,219,558,777,Monday
2019,9,23,1900,201,812,1013,Monday
2019,9,23,1800,300,1003,1303,Monday
2019,9,23,1700,398,1058,1456,Monday
2019,9,23,1600,466,1064,1530,Monday
2019,9,23,1500,514,948,1462,Monday
2019,9,23,1400,589,691,1280,Monday
2019,9,23,1300,743,671,1414,Monday
2019,9,23,1200,999,508,1507,Monday
2019,9,23,1100,989,378,1367,Monday
2019,9,23,1000,907,259,1166,Monday
2019,9,23,900,700,165,865,Monday
2019,9,23,800,503,102,605,Monday
2019,9,23,700,286,59,345,Monday
2019,9,23,600,151,44,195,Monday
2019,9,23,500,84,18,102,Monday
2019,9,23,400,41,23,64,Monday
2019,9,23,300,22,34,56,Monday
2019,9,23,200,25,47,72,Monday
2019,9,23,100,35,60,95,Monday
2019,9,22,2400,53,94,147,Sunday
2019,9,22,2300,47,168,215,Sunday
2019,9,22,2200,104,259,363,Sunday
2019,9,22,2100,153,551,704,Sunday
2019,9,22,2000,178,878,1056,Sunday
2019,9,22,1900,224,1364,1588,Sunday
2019,9,22,1800,353,1714,2067,Sunday
2019,9,22,1700,472,1758,2230,Sunday
2019,9,22,1600,590,1733,2323,Sunday
2019,9,22,1500,776,1470,2246,Sunday
2019,9,22,1400,846,1244,2090,Sunday
2019,9,22,1300,998,1101,2099,Sunday
2019,9,22,1200,1082,905,1987,Sunday
2019,9,22,1100,1117,606,1723,Sunday
2019,9,22,1000,1049,365,1414,Sunday
2019,9,22,900,731,165,896,Sunday
2019,9,22,800,495,79,574,Sunday
2019,9,22,700,288,41,329,Sunday
2019,9,22,600,165,30,195,Sunday
2019,9,22,500,92,35,127,Sunday
2019,9,22,400,27,22,49,Sunday
2019,9,22,300,23,20,43,Sunday
2019,9,22,200,24,36,60,Sunday
2019,9,22,100,37,60,97,Sunday
2019,9,21,2400,44,86,130,Saturday
2019,9,21,2300,49,124,173,Saturday
2019,9,21,2200,128,251,379,Saturday
2019,9,21,2100,149,609,758,Saturday
2019,9,21,2000,172,818,990,Saturday
2019,9,21,1900,269,1228,1497,Saturday
2019,9,21,1800,321,1336,1657,Saturday
2019,9,21,1700,456,1336,1792,Saturday
2019,9,21,1600,553,1091,1644,Saturday
2019,9,21,1500,708,858,1566,Saturday
2019,9,21,1400,804,782,1586,Saturday
2019,9,21,1300,979,581,1560,Saturday
2019,9,21,1200,1178,507,1685,Saturday
2019,9,21,1100,1221,391,1612,Saturday
2019,9,21,1000,1189,282,1471,Saturday
2019,9,21,900,903,162,1065,Saturday
2019,9,21,800,649,85,734,Saturday
2019,9,21,700,373,78,451,Saturday
2019,9,21,600,221,43,264,Saturday
2019,9,21,500,106,36,142,Saturday
2019,9,21,400,42,30,72,Saturday
2019,9,21,300,47,51,98,Saturday
2019,9,21,200,39,61,100,Saturday
2019,9,21,100,42,60,102,Saturday
2019,9,20,2400,71,112,183,Friday
2019,9,20,2300,147,124,271,Friday
2019,9,20,2200,197,209,406,Friday
2019,9,20,2100,357,439,796,Friday
2019,9,20,2000,544,611,1155,Friday
2019,9,20,1900,601,937,1538,Friday
2019,9,20,1800,743,974,1717,Friday
2019,9,20,1700,830,1003,1833,Friday
2019,9,20,1600,866,904,1770,Friday
2019,9,20,1500,905,841,1746,Friday
2019,9,20,1400,883,625,1508,Friday
2019,9,20,1300,1148,517,1665,Friday
2019,9,20,1200,1176,477,1653,Friday
2019,9,20,1100,990,344,1334,Friday
2019,9,20,1000,951,249,1200,Friday
2019,9,20,900,786,160,946,Friday
2019,9,20,800,496,92,588,Friday
2019,9,20,700,286,59,345,Friday
2019,9,20,600,167,45,212,Friday
2019,9,20,500,66,52,118,Friday
2019,9,20,400,37,54,91,Friday
2019,9,20,300,30,45,75,Friday
2019,9,20,200,36,48,84,Friday
2019,9,20,100,53,73,126,Friday
2019,9,19,2400,70,91,161,Thursday
2019,9,19,2300,111,133,244,Thursday
2019,9,19,2200,172,205,377,Thursday
2019,9,19,2100,262,416,678,Thursday
2019,9,19,2000,362,617,979,Thursday
2019,9,19,1900,385,934,1319,Thursday
2019,9,19,1800,511,1083,1594,Thursday
2019,9,19,1700,556,995,1551,Thursday
2019,9,19,1600,606,843,1449,Thursday
2019,9,19,1500,686,676,1362,Thursday
2019,9,19,1400,690,548,1238,Thursday
2019,9,19,1300,772,519,1291,Thursday
2019,9,19,1200,942,392,1334,Thursday
2019,9,19,1100,955,311,1266,Thursday
2019,9,19,1000,982,232,1214,Thursday
2019,9,19,900,767,157,924,Thursday
2019,9,19,800,462,85,547,Thursday
2019,9,19,700,321,64,385,Thursday
2019,9,19,600,125,56,181,Thursday
2019,9,19,500,60,42,102,Thursday
2019,9,19,400,33,41,74,Thursday
2019,9,19,300,36,34,70,Thursday
2019,9,19,200,32,49,81,Thursday
2019,9,19,100,50,55,105,Thursday
2019,9,18,2400,70,90,160,Wednesday
2019,9,18,2300,99,125,224,Wednesday
2019,9,18,2200,131,180,311,Wednesday
2019,9,18,2100,168,332,500,Wednesday
2019,9,18,2000,224,515,739,Wednesday
2019,9,18,1900,252,710,962,Wednesday
2019,9,18,1800,332,875,1207,Wednesday
2019,9,18,1700,409,889,1298,Wednesday
2019,9,18,1600,489,812,1301,Wednesday
2019,9,18,1500,496,650,1146,Wednesday
2019,9,18,1400,533,532,1065,Wednesday
2019,9,18,1300,606,461,1067,Wednesday
2019,9,18,1200,774,441,1215,Wednesday
2019,9,18,1100,902,308,1210,Wednesday
2019,9,18,1000,843,247,1090,Wednesday
2019,9,18,900,676,163,839,Wednesday
2019,9,18,800,403,93,496,Wednesday
2019,9,18,700,247,67,314,Wednesday
2019,9,18,600,99,48,147,Wednesday
2019,9,18,500,53,38,91,Wednesday
2019,9,18,400,28,37,65,Wednesday
2019,9,18,300,30,44,74,Wednesday
2019,9,18,200,35,55,90,Wednesday
2019,9,18,100,51,55,106,Wednesday
2019,9,17,2400,62,89,151,Tuesday
2019,9,17,2300,93,118,211,Tuesday
2019,9,17,2200,100,227,327,Tuesday
2019,9,17,2100,122,445,567,Tuesday
2019,9,17,2000,195,653,848,Tuesday
2019,9,17,1900,232,791,1023,Tuesday
2019,9,17,1800,308,968,1276,Tuesday
2019,9,17,1700,368,950,1318,Tuesday
2019,9,17,1600,408,907,1315,Tuesday
2019,9,17,1500,461,627,1088,Tuesday
2019,9,17,1400,542,572,1114,Tuesday
2019,9,17,1300,665,490,1155,Tuesday
2019,9,17,1200,795,418,1213,Tuesday
2019,9,17,1100,1055,325,1380,Tuesday
2019,9,17,1000,858,241,1099,Tuesday
2019,9,17,900,690,148,838,Tuesday
2019,9,17,800,493,98,591,Tuesday
2019,9,17,700,272,74,346,Tuesday
2019,9,17,600,139,42,181,Tuesday
2019,9,17,500,50,31,81,Tuesday
2019,9,17,400,33,43,76,Tuesday
2019,9,17,300,29,41,70,Tuesday
2019,9,17,200,34,49,83,Tuesday
2019,9,17,100,45,59,104,Tuesday
2019,9,16,2400,56,97,153,Monday
2019,9,16,2300,93,123,216,Monday
2019,9,16,2200,108,234,342,Monday
2019,9,16,2100,153,379,532,Monday
2019,9,16,2000,175,510,685,Monday
2019,9,16,1900,263,768,1031,Monday
2019,9,16,1800,297,823,1120,Monday
2019,9,16,1700,360,936,1296,Monday
2019,9,16,1600,422,783,1205,Monday
2019,9,16,1500,541,698,1239,Monday
2019,9,16,1400,577,565,1142,Monday
2019,9,16,1300,577,521,1098,Monday
2019,9,16,1200,789,414,1203,Monday
2019,9,16,1100,911,323,1234,Monday
2019,9,16,1000,817,202,1019,Monday
2019,9,16,900,587,129,716,Monday
2019,9,16,800,385,78,463,Monday
2019,9,16,700,236,36,272,Monday
2019,9,16,600,117,30,147,Monday
2019,9,16,500,42,35,77,Monday
2019,9,16,400,20,28,48,Monday
2019,9,16,300,34,35,69,Monday
2019,9,16,200,34,54,88,Monday
2019,9,16,100,31,72,103,Monday
2019,9,15,2400,49,81,130,Sunday
2019,9,15,2300,77,141,218,Sunday
2019,9,15,2200,111,252,363,Sunday
2019,9,15,2100,162,399,561,Sunday
2019,9,15,2000,193,638,831,Sunday
2019,9,15,1900,242,982,1224,Sunday
2019,9,15,1800,346,1308,1654,Sunday
2019,9,15,1700,422,1279,1701,Sunday
2019,9,15,1600,503,1211,1714,Sunday
2019,9,15,1500,587,1099,1686,Sunday
2019,9,15,1400,651,991,1642,Sunday
2019,9,15,1300,731,915,1646,Sunday
2019,9,15,1200,800,640,1440,Sunday
2019,9,15,1100,884,441,1325,Sunday
2019,9,15,1000,782,274,1056,Sunday
2019,9,15,900,525,122,647,Sunday
2019,9,15,800,373,71,444,Sunday
2019,9,15,700,217,28,245,Sunday
2019,9,15,600,116,21,137,Sunday
2019,9,15,500,32,15,47,Sunday
2019,9,15,400,23,27,50,Sunday
2019,9,15,300,20,27,47,Sunday
2019,9,15,200,30,34,64,Sunday
2019,9,15,100,32,49,81,Sunday
2019,9,14,2400,40,73,113,Saturday
2019,9,14,2300,61,109,170,Saturday
2019,9,14,2200,100,229,329,Saturday
2019,9,14,2100,127,384,511,Saturday
2019,9,14,2000,195,516,711,Saturday
2019,9,14,1900,215,852,1067,Saturday
2019,9,14,1800,283,1048,1331,Saturday
2019,9,14,1700,352,1034,1386,Saturday
2019,9,14,1600,420,876,1296,Saturday
2019,9,14,1500,557,703,1260,Saturday
2019,9,14,1400,631,666,1297,Saturday
2019,9,14,1300,698,622,1320,Saturday
2019,9,14,1200,908,506,1414,Saturday
2019,9,14,1100,1020,433,1453,Saturday
2019,9,14,1000,926,237,1163,Saturday
2019,9,14,900,677,129,806,Saturday
2019,9,14,800,429,88,517,Saturday
2019,9,14,700,301,43,344,Saturday
2019,9,14,600,147,36,183,Saturday
2019,9,14,500,57,33,90,Saturday
2019,9,14,400,28,38,66,Saturday
2019,9,14,300,25,34,59,Saturday
2019,9,14,200,46,50,96,Saturday
2019,9,14,100,56,57,113,Saturday
2019,9,13,2400,58,86,144,Friday
2019,9,13,2300,115,118,233,Friday
2019,9,13,2200,199,249,448,Friday
2019,9,13,2100,256,396,652,Friday
2019,9,13,2000,427,530,957,Friday
2019,9,13,1900,527,729,1256,Friday
2019,9,13,1800,601,817,1418,Friday
2019,9,13,1700,667,917,1584,Friday
2019,9,13,1600,634,859,1493,Friday
2019,9,13,1500,699,668,1367,Friday
2019,9,13,1400,712,588,1300,Friday
2019,9,13,1300,723,573,1296,Friday
2019,9,13,1200,890,540,1430,Friday
2019,9,13,1100,998,391,1389,Friday
2019,9,13,1000,816,252,1068,Friday
2019,9,13,900,675,160,835,Friday
2019,9,13,800,417,87,504,Friday
2019,9,13,700,262,54,316,Friday
2019,9,13,600,137,48,185,Friday
2019,9,13,500,74,36,110,Friday
2019,9,13,400,30,37,67,Friday
2019,9,13,300,38,46,84,Friday
2019,9,13,200,32,43,75,Friday
2019,9,13,100,56,60,116,Friday
2019,9,12,2400,66,91,157,Thursday
2019,9,12,2300,107,156,263,Thursday
2019,9,12,2200,168,247,415,Thursday
2019,9,12,2100,198,413,611,Thursday
2019,9,12,2000,282,582,864,Thursday
2019,9,12,1900,347,846,1193,Thursday
2019,9,12,1800,392,1016,1408,Thursday
2019,9,12,1700,465,897,1362,Thursday
2019,9,12,1600,489,844,1333,Thursday
2019,9,12,1500,547,699,1246,Thursday
2019,9,12,1400,572,646,1218,Thursday
2019,9,12,1300,744,509,1253,Thursday
2019,9,12,1200,853,475,1328,Thursday
2019,9,12,1100,1011,350,1361,Thursday
2019,9,12,1000,982,276,1258,Thursday
2019,9,12,900,779,183,962,Thursday
2019,9,12,800,539,118,657,Thursday
2019,9,12,700,280,73,353,Thursday
2019,9,12,600,167,58,225,Thursday
2019,9,12,500,63,34,97,Thursday
2019,9,12,400,32,42,74,Thursday
2019,9,12,300,29,42,71,Thursday
2019,9,12,200,36,69,105,Thursday
2019,9,12,100,48,84,132,Thursday
2019,9,11,2400,76,97,173,Wednesday
2019,9,11,2300,107,137,244,Wednesday
2019,9,11,2200,113,213,326,Wednesday
2019,9,11,2100,189,402,591,Wednesday
2019,9,11,2000,227,547,774,Wednesday
2019,9,11,1900,261,802,1063,Wednesday
2019,9,11,1800,307,904,1211,Wednesday
2019,9,11,1700,377,857,1234,Wednesday
2019,9,11,1600,445,735,1180,Wednesday
2019,9,11,1500,463,574,1037,Wednesday
2019,9,11,1400,485,524,1009,Wednesday
2019,9,11,1300,595,452,1047,Wednesday
2019,9,11,1200,793,365,1158,Wednesday
2019,9,11,1100,888,253,1141,Wednesday
2019,9,11,1000,779,191,970,Wednesday
2019,9,11,900,662,143,805,Wednesday
2019,9,11,800,404,83,487,Wednesday
2019,9,11,700,240,66,306,Wednesday
2019,9,11,600,128,59,187,Wednesday
2019,9,11,500,64,42,106,Wednesday
2019,9,11,400,29,43,72,Wednesday
2019,9,11,300,33,42,75,Wednesday
2019,9,11,200,30,45,75,Wednesday
2019,9,11,100,47,42,89,Wednesday
2019,9,10,2400,65,89,154,Tuesday
2019,9,10,2300,91,118,209,Tuesday
2019,9,10,2200,120,190,310,Tuesday
2019,9,10,2100,155,330,485,Tuesday
2019,9,10,2000,163,527,690,Tuesday
2019,9,10,1900,254,694,948,Tuesday
2019,9,10,1800,295,818,1113,Tuesday
2019,9,10,1700,368,730,1098,Tuesday
2019,9,10,1600,443,722,1165,Tuesday
2019,9,10,1500,461,457,918,Tuesday
2019,9,10,1400,476,498,974,Tuesday
2019,9,10,1300,540,471,1011,Tuesday
2019,9,10,1200,648,351,999,Tuesday
2019,9,10,1100,735,261,996,Tuesday
2019,9,10,1000,703,261,964,Tuesday
2019,9,10,900,516,67,583,Tuesday
2019,9,10,800,327,89,416,Tuesday
2019,9,10,700,178,64,242,Tuesday
2019,9,10,600,70,32,102,Tuesday
2019,9,10,500,34,55,89,Tuesday
2019,9,10,400,34,59,93,Tuesday
2019,9,10,300,25,52,77,Tuesday
2019,9,10,200,29,56,85,Tuesday
2019,9,10,100,41,54,95,Tuesday
2019,9,9,2400,67,79,146,Monday
2019,9,9,2300,91,116,207,Monday
2019,9,9,2200,116,194,310,Monday
2019,9,9,2100,157,319,476,Monday
2019,9,9,2000,194,508,702,Monday
2019,9,9,1900,211,699,910,Monday
2019,9,9,1800,276,991,1267,Monday
2019,9,9,1700,348,790,1138,Monday
2019,9,9,1600,425,904,1329,Monday
2019,9,9,1500,494,661,1155,Monday
2019,9,9,1400,516,648,1164,Monday
2019,9,9,1300,610,491,1101,Monday
2019,9,9,1200,799,434,1233,Monday
2019,9,9,1100,875,320,1195,Monday
2019,9,9,1000,783,233,1016,Monday
2019,9,9,900,593,128,721,Monday
2019,9,9,800,363,78,441,Monday
2019,9,9,700,209,57,266,Monday
2019,9,9,600,95,25,120,Monday
2019,9,9,500,34,34,68,Monday
2019,9,9,400,18,26,44,Monday
2019,9,9,300,18,44,62,Monday
2019,9,9,200,22,51,73,Monday
2019,9,9,100,25,86,111,Monday
2019,9,8,2400,40,113,153,Sunday
2019,9,8,2300,87,151,238,Sunday
2019,9,8,2200,83,302,385,Sunday
2019,9,8,2100,159,567,726,Sunday
2019,9,8,2000,210,806,1016,Sunday
2019,9,8,1900,258,1140,1398,Sunday
2019,9,8,1800,328,1369,1697,Sunday
2019,9,8,1700,387,1375,1762,Sunday
2019,9,8,1600,495,1243,1738,Sunday
2019,9,8,1500,577,1045,1622,Sunday
2019,9,8,1400,616,987,1603,Sunday
2019,9,8,1300,699,876,1575,Sunday
2019,9,8,1200,801,656,1457,Sunday
2019,9,8,1100,822,455,1277,Sunday
2019,9,8,1000,781,289,1070,Sunday
2019,9,8,900,537,155,692,Sunday
2019,9,8,800,385,72,457,Sunday
2019,9,8,700,196,41,237,Sunday
2019,9,8,600,123,28,151,Sunday
2019,9,8,500,73,34,107,Sunday
2019,9,8,400,26,25,51,Sunday
2019,9,8,300,14,38,52,Sunday
2019,9,8,200,22,38,60,Sunday
2019,9,8,100,48,63,111,Sunday
2019,9,7,2400,52,106,158,Saturday
2019,9,7,2300,87,152,239,Saturday
2019,9,7,2200,110,362,472,Saturday
2019,9,7,2100,145,574,719,Saturday
2019,9,7,2000,180,792,972,Saturday
2019,9,7,1900,263,1024,1287,Saturday
2019,9,7,1800,319,1233,1552,Saturday
2019,9,7,1700,388,1142,1530,Saturday
2019,9,7,1600,506,1009,1515,Saturday
2019,9,7,1500,628,744,1372,Saturday
2019,9,7,1400,755,639,1394,Saturday
2019,9,7,1300,797,596,1393,Saturday
2019,9,7,1200,979,462,1441,Saturday
2019,9,7,1100,1055,389,1444,Saturday
2019,9,7,1000,1034,264,1298,Saturday
2019,9,7,900,821,159,980,Saturday
2019,9,7,800,532,80,612,Saturday
2019,9,7,700,317,59,376,Saturday
2019,9,7,600,207,33,240,Saturday
2019,9,7,500,130,44,174,Saturday
2019,9,7,400,44,40,84,Saturday
2019,9,7,300,38,48,86,Saturday
2019,9,7,200,44,59,103,Saturday
2019,9,7,100,36,71,107,Saturday
2019,9,6,2400,83,97,180,Friday
2019,9,6,2300,120,134,254,Friday
2019,9,6,2200,196,339,535,Friday
2019,9,6,2100,354,411,765,Friday
2019,9,6,2000,544,589,1133,Friday
2019,9,6,1900,620,784,1404,Friday
2019,9,6,1800,624,956,1580,Friday
2019,9,6,1700,713,965,1678,Friday
2019,9,6,1600,657,808,1465,Friday
2019,9,6,1500,662,684,1346,Friday
2019,9,6,1400,694,641,1335,Friday
2019,9,6,1300,724,568,1292,Friday
2019,9,6,1200,910,439,1349,Friday
2019,9,6,1100,959,396,1355,Friday
2019,9,6,1000,901,277,1178,Friday
2019,9,6,900,708,185,893,Friday
2019,9,6,800,518,106,624,Friday
2019,9,6,700,339,60,399,Friday
2019,9,6,600,174,47,221,Friday
2019,9,6,500,84,43,127,Friday
2019,9,6,400,41,61,102,Friday
2019,9,6,300,21,52,73,Friday
2019,9,6,200,46,52,98,Friday
2019,9,6,100,47,65,112,Friday
2019,9,5,2400,77,123,200,Thursday
2019,9,5,2300,119,183,302,Thursday
2019,9,5,2200,169,315,484,Thursday
2019,9,5,2100,261,448,709,Thursday
2019,9,5,2000,348,639,987,Thursday
2019,9,5,1900,343,800,1143,Thursday
2019,9,5,1800,391,1012,1403,Thursday
2019,9,5,1700,462,899,1361,Thursday
2019,9,5,1600,521,747,1268,Thursday
2019,9,5,1500,510,645,1155,Thursday
2019,9,5,1400,590,579,1169,Thursday
2019,9,5,1300,665,461,1126,Thursday
2019,9,5,1200,807,433,1240,Thursday
2019,9,5,1100,892,322,1214,Thursday
2019,9,5,1000,861,245,1106,Thursday
2019,9,5,900,702,168,870,Thursday
2019,9,5,800,529,100,629,Thursday
2019,9,5,700,313,82,395,Thursday
2019,9,5,600,172,44,216,Thursday
2019,9,5,500,104,48,152,Thursday
2019,9,5,400,42,71,113,Thursday
2019,9,5,300,28,51,79,Thursday
2019,9,5,200,28,60,88,Thursday
2019,9,5,100,47,68,115,Thursday
2019,9,4,2400,90,118,208,Wednesday
2019,9,4,2300,95,149,244,Wednesday
2019,9,4,2200,135,280,415,Wednesday
2019,9,4,2100,186,428,614,Wednesday
2019,9,4,2000,217,631,848,Wednesday
2019,9,4,1900,243,816,1059,Wednesday
2019,9,4,1800,330,1082,1412,Wednesday
2019,9,4,1700,405,897,1302,Wednesday
2019,9,4,1600,412,918,1330,Wednesday
2019,9,4,1500,489,726,1215,Wednesday
2019,9,4,1400,519,610,1129,Wednesday
2019,9,4,1300,609,490,1099,Wednesday
2019,9,4,1200,844,449,1293,Wednesday
2019,9,4,1100,821,323,1144,Wednesday
2019,9,4,1000,795,205,1000,Wednesday
2019,9,4,900,687,159,846,Wednesday
2019,9,4,800,487,103,590,Wednesday
2019,9,4,700,293,72,365,Wednesday
2019,9,4,600,165,45,210,Wednesday
2019,9,4,500,75,43,118,Wednesday
2019,9,4,400,38,32,70,Wednesday
2019,9,4,300,30,38,68,Wednesday
2019,9,4,200,36,59,95,Wednesday
2019,9,4,100,57,79,136,Wednesday
2019,9,3,2400,75,117,192,Tuesday
2019,9,3,2300,80,174,254,Tuesday
2019,9,3,2200,124,378,502,Tuesday
2019,9,3,2100,153,560,713,Tuesday
2019,9,3,2000,242,822,1064,Tuesday
2019,9,3,1900,270,1030,1300,Tuesday
2019,9,3,1800,322,1189,1511,Tuesday
2019,9,3,1700,410,1151,1561,Tuesday
2019,9,3,1600,481,899,1380,Tuesday
2019,9,3,1500,539,862,1401,Tuesday
2019,9,3,1400,625,705,1330,Tuesday
2019,9,3,1300,747,623,1370,Tuesday
2019,9,3,1200,934,534,1468,Tuesday
2019,9,3,1100,1031,399,1430,Tuesday
2019,9,3,1000,910,289,1199,Tuesday
2019,9,3,900,683,215,898,Tuesday
2019,9,3,800,481,128,609,Tuesday
2019,9,3,700,313,74,387,Tuesday
2019,9,3,600,204,41,245,Tuesday
2019,9,3,500,98,36,134,Tuesday
2019,9,3,400,28,34,62,Tuesday
2019,9,3,300,27,50,77,Tuesday
2019,9,3,200,30,68,98,Tuesday
2019,9,3,100,49,148,197,Tuesday
2019,9,2,2400,61,267,328,Monday
2019,9,2,2300,101,539,640,Monday
2019,9,2,2200,107,818,925,Monday
2019,9,2,2100,158,1089,1247,Monday
2019,9,2,2000,202,1320,1522,Monday
2019,9,2,1900,241,2115,2356,Monday
2019,9,2,1800,354,2137,2491,Monday
2019,9,2,1700,450,2164,2614,Monday
2019,9,2,1600,550,1967,2517,Monday
2019,9,2,1500,735,1925,2660,Monday
2019,9,2,1400,827,1897,2724,Monday
2019,9,2,1300,902,1709,2611,Monday
2019,9,2,1200,1090,1228,2318,Monday
2019,9,2,1100,1139,848,1987,Monday
2019,9,2,1000,1004,490,1494,Monday
2019,9,2,900,758,239,997,Monday
2019,9,2,800,510,97,607,Monday
2019,9,2,700,285,49,334,Monday
2019,9,2,600,161,29,190,Monday
2019,9,2,500,85,38,123,Monday
2019,9,2,400,48,60,108,Monday
2019,9,2,300,21,62,83,Monday
2019,9,2,200,45,99,144,Monday
2019,9,2,100,55,158,213,Monday
2019,9,1,2400,62,243,305,Sunday
2019,9,1,2300,122,334,456,Sunday
2019,9,1,2200,140,689,829,Sunday
2019,9,1,2100,193,877,1070,Sunday
2019,9,1,2000,236,1317,1553,Sunday
2019,9,1,1900,349,1459,1808,Sunday
2019,9,1,1800,478,1695,2173,Sunday
2019,9,1,1700,548,1703,2251,Sunday
2019,9,1,1600,691,1450,2141,Sunday
2019,9,1,1500,785,1254,2039,Sunday
2019,9,1,1400,935,1176,2111,Sunday
2019,9,1,1300,1049,974,2023,Sunday
2019,9,1,1200,1192,729,1921,Sunday
2019,9,1,1100,1160,449,1609,Sunday
2019,9,1,1000,1058,285,1343,Sunday
2019,9,1,900,771,147,918,Sunday
2019,9,1,800,560,59,619,Sunday
2019,9,1,700,321,46,367,Sunday
2019,9,1,600,181,35,216,Sunday
2019,9,1,500,95,23,118,Sunday
2019,9,1,400,28,31,59,Sunday
2019,9,1,300,33,58,91,Sunday
2019,9,1,200,44,55,99,Sunday
2019,9,1,100,44,106,150,Sunday
2019,8,31,2400,81,143,224,Saturday
2019,8,31,2300,127,241,368,Saturday
2019,8,31,2200,170,413,583,Saturday
2019,8,31,2100,174,534,708,Saturday
2019,8,31,2000,289,871,1160,Saturday
2019,8,31,1900,345,1102,1447,Saturday
2019,8,31,1800,419,1218,1637,Saturday
2019,8,31,1700,596,1332,1928,Saturday
2019,8,31,1600,731,1284,2015,Saturday
2019,8,31,1500,874,998,1872,Saturday
2019,8,31,1400,1286,950,2236,Saturday
2019,8,31,1300,1160,874,2034,Saturday
2019,8,31,1200,1398,675,2073,Saturday
2019,8,31,1100,1458,524,1982,Saturday
2019,8,31,1000,1316,349,1665,Saturday
2019,8,31,900,1030,194,1224,Saturday
2019,8,31,800,709,112,821,Saturday
2019,8,31,700,492,51,543,Saturday
2019,8,31,600,245,62,307,Saturday
2019,8,31,500,141,44,185,Saturday
2019,8,31,400,51,57,108,Saturday
2019,8,31,300,30,59,89,Saturday
2019,8,31,200,59,83,142,Saturday
2019,8,31,100,61,99,160,Saturday
2019,8,30,2400,144,183,327,Friday
2019,8,30,2300,240,257,497,Friday
2019,8,30,2200,362,424,786,Friday
2019,8,30,2100,623,538,1161,Friday
2019,8,30,2000,1028,876,1904,Friday
2019,8,30,1900,1157,1069,2226,Friday
2019,8,30,1800,1289,1223,2512,Friday
2019,8,30,1700,1366,1185,2551,Friday
2019,8,30,1600,1314,1159,2473,Friday
2019,8,30,1500,1483,944,2427,Friday
2019,8,30,1400,1355,844,2199,Friday
2019,8,30,1300,1189,719,1908,Friday
2019,8,30,1200,1292,597,1889,Friday
2019,8,30,1100,1379,447,1826,Friday
2019,8,30,1000,1320,319,1639,Friday
2019,8,30,900,1052,216,1268,Friday
2019,8,30,800,736,112,848,Friday
2019,8,30,700,490,82,572,Friday
2019,8,30,600,253,59,312,Friday
2019,8,30,500,110,38,148,Friday
2019,8,30,400,55,77,132,Friday
2019,8,30,300,37,49,86,Friday
2019,8,30,200,73,72,145,Friday
2019,8,30,100,83,127,210,Friday
2019,8,29,2400,131,165,296,Thursday
2019,8,29,2300,186,239,425,Thursday
2019,8,29,2200,324,401,725,Thursday
2019,8,29,2100,462,618,1080,Thursday
2019,8,29,2000,678,804,1482,Thursday
2019,8,29,1900,748,1043,1791,Thursday
2019,8,29,1800,790,1127,1917,Thursday
2019,8,29,1700,811,1101,1912,Thursday
2019,8,29,1600,849,1043,1892,Thursday
2019,8,29,1500,909,909,1818,Thursday
2019,8,29,1400,958,786,1744,Thursday
2019,8,29,1300,1070,642,1712,Thursday
2019,8,29,1200,1195,503,1698,Thursday
2019,8,29,1100,1250,369,1619,Thursday
2019,8,29,1000,1066,251,1317,Thursday
2019,8,29,900,917,198,1115,Thursday
2019,8,29,800,629,118,747,Thursday
2019,8,29,700,343,86,429,Thursday
2019,8,29,600,181,57,238,Thursday
2019,8,29,500,94,39,133,Thursday
2019,8,29,400,53,65,118,Thursday
2019,8,29,300,37,68,105,Thursday
2019,8,29,200,45,57,102,Thursday
2019,8,29,100,58,133,191,Thursday
2019,8,28,2400,100,109,209,Wednesday
2019,8,28,2300,142,220,362,Wednesday
2019,8,28,2200,208,464,672,Wednesday
2019,8,28,2100,293,590,883,Wednesday
2019,8,28,2000,342,830,1172,Wednesday
2019,8,28,1900,410,1091,1501,Wednesday
2019,8,28,1800,459,1177,1636,Wednesday
2019,8,28,1700,609,1053,1662,Wednesday
2019,8,28,1600,661,958,1619,Wednesday
2019,8,28,1500,671,771,1442,Wednesday
2019,8,28,1400,737,665,1402,Wednesday
2019,8,28,1300,897,659,1556,Wednesday
2019,8,28,1200,1062,529,1591,Wednesday
2019,8,28,1100,1132,401,1533,Wednesday
2019,8,28,1000,1008,255,1263,Wednesday
2019,8,28,900,829,197,1026,Wednesday
2019,8,28,800,539,120,659,Wednesday
2019,8,28,700,357,78,435,Wednesday
2019,8,28,600,196,47,243,Wednesday
2019,8,28,500,107,61,168,Wednesday
2019,8,28,400,41,58,99,Wednesday
2019,8,28,300,30,53,83,Wednesday
2019,8,28,200,49,65,114,Wednesday
2019,8,28,100,66,66,132,Wednesday
2019,8,27,2400,95,132,227,Tuesday
2019,8,27,2300,110,237,347,Tuesday
2019,8,27,2200,155,465,620,Tuesday
2019,8,27,2100,241,567,808,Tuesday
2019,8,27,2000,293,871,1164,Tuesday
2019,8,27,1900,337,1141,1478,Tuesday
2019,8,27,1800,425,1124,1549,Tuesday
2019,8,27,1700,499,1257,1756,Tuesday
2019,8,27,1600,593,989,1582,Tuesday
2019,8,27,1500,679,786,1465,Tuesday
2019,8,27,1400,754,686,1440,Tuesday
2019,8,27,1300,871,675,1546,Tuesday
2019,8,27,1200,1007,494,1501,Tuesday
2019,8,27,1100,977,396,1373,Tuesday
2019,8,27,1000,951,288,1239,Tuesday
2019,8,27,900,825,205,1030,Tuesday
2019,8,27,800,603,118,721,Tuesday
2019,8,27,700,333,88,421,Tuesday
2019,8,27,600,193,59,252,Tuesday
2019,8,27,500,110,44,154,Tuesday
2019,8,27,400,40,57,97,Tuesday
2019,8,27,300,26,40,66,Tuesday
2019,8,27,200,50,87,137,Tuesday
2019,8,27,100,51,106,157,Tuesday
2019,8,26,2400,93,154,247,Monday
2019,8,26,2300,100,281,381,Monday
2019,8,26,2200,184,459,643,Monday
2019,8,26,2100,214,694,908,Monday
2019,8,26,2000,301,961,1262,Monday
2019,8,26,1900,377,1177,1554,Monday
2019,8,26,1800,434,1559,1993,Monday
2019,8,26,1700,526,1308,1834,Monday
2019,8,26,1600,630,1316,1946,Monday
2019,8,26,1500,777,1034,1811,Monday
2019,8,26,1400,927,835,1762,Monday
2019,8,26,1300,885,781,1666,Monday
2019,8,26,1200,1108,600,1708,Monday
2019,8,26,1100,1229,440,1669,Monday
2019,8,26,1000,1010,315,1325,Monday
2019,8,26,900,822,189,1011,Monday
2019,8,26,800,594,100,694,Monday
2019,8,26,700,359,74,433,Monday
2019,8,26,600,208,49,257,Monday
2019,8,26,500,101,31,132,Monday
2019,8,26,400,43,33,76,Monday
2019,8,26,300,34,36,70,Monday
2019,8,26,200,32,54,86,Monday
2019,8,26,100,34,113,147,Monday
2019,8,25,2400,57,213,270,Sunday
2019,8,25,2300,86,300,386,Sunday
2019,8,25,2200,137,603,740,Sunday
2019,8,25,2100,239,903,1142,Sunday
2019,8,25,2000,289,1422,1711,Sunday
2019,8,25,1900,396,1845,2241,Sunday
2019,8,25,1800,464,1953,2417,Sunday
2019,8,25,1700,591,2040,2631,Sunday
2019,8,25,1600,715,2010,2725,Sunday
2019,8,25,1500,839,1557,2396,Sunday
2019,8,25,1400,916,1379,2295,Sunday
2019,8,25,1300,1040,1236,2276,Sunday
2019,8,25,1200,1190,863,2053,Sunday
2019,8,25,1100,1248,594,1842,Sunday
2019,8,25,1000,1063,288,1351,Sunday
2019,8,25,900,814,183,997,Sunday
2019,8,25,800,491,82,573,Sunday
2019,8,25,700,291,52,343,Sunday
2019,8,25,600,161,21,182,Sunday
2019,8,25,500,73,29,102,Sunday
2019,8,25,400,21,30,51,Sunday
2019,8,25,300,21,38,59,Sunday
2019,8,25,200,35,45,80,Sunday
2019,8,25,100,48,86,134,Sunday
2019,8,24,2400,57,168,225,Saturday
2019,8,24,2300,109,302,411,Saturday
2019,8,24,2200,161,467,628,Saturday
2019,8,24,2100,189,675,864,Saturday
2019,8,24,2000,273,947,1220,Saturday
2019,8,24,1900,359,1557,1916,Saturday
2019,8,24,1800,482,1639,2121,Saturday
2019,8,24,1700,556,1482,2038,Saturday
2019,8,24,1600,742,1261,2003,Saturday
2019,8,24,1500,815,1085,1900,Saturday
2019,8,24,1400,1088,998,2086,Saturday
2019,8,24,1300,1149,788,1937,Saturday
2019,8,24,1200,1338,625,1963,Saturday
2019,8,24,1100,1416,463,1879,Saturday
2019,8,24,1000,1276,300,1576,Saturday
2019,8,24,900,963,190,1153,Saturday
2019,8,24,800,685,110,795,Saturday
2019,8,24,700,386,69,455,Saturday
2019,8,24,600,230,46,276,Saturday
2019,8,24,500,91,50,141,Saturday
2019,8,24,400,64,40,104,Saturday
2019,8,24,300,38,67,105,Saturday
2019,8,24,200,55,54,109,Saturday
2019,8,24,100,79,116,195,Saturday
2019,8,23,2400,104,184,288,Friday
2019,8,23,2300,162,277,439,Friday
2019,8,23,2200,299,427,726,Friday
2019,8,23,2100,442,622,1064,Friday
2019,8,23,2000,729,828,1557,Friday
2019,8,23,1900,917,1249,2166,Friday
2019,8,23,1800,910,1335,2245,Friday
2019,8,23,1700,927,1322,2249,Friday
2019,8,23,1600,962,1287,2249,Friday
2019,8,23,1500,1044,1046,2090,Friday
2019,8,23,1400,1373,949,2322,Friday
2019,8,23,1300,934,840,1774,Friday
2019,8,23,1200,1381,673,2054,Friday
2019,8,23,1100,1301,458,1759,Friday
2019,8,23,1000,1204,310,1514,Friday
2019,8,23,900,956,187,1143,Friday
2019,8,23,800,607,124,731,Friday
2019,8,23,700,406,98,504,Friday
2019,8,23,600,236,54,290,Friday
2019,8,23,500,117,69,186,Friday
2019,8,23,400,52,58,110,Friday
2019,8,23,300,38,61,99,Friday
2019,8,23,200,53,85,138,Friday
2019,8,23,100,85,138,223,Friday
2019,8,22,2400,85,180,265,Thursday
2019,8,22,2300,195,336,531,Thursday
2019,8,22,2200,239,523,762,Thursday
2019,8,22,2100,358,559,917,Thursday
2019,8,22,2000,512,854,1366,Thursday
2019,8,22,1900,573,1056,1629,Thursday
2019,8,22,1800,638,1368,2006,Thursday
2019,8,22,1700,703,1211,1914,Thursday
2019,8,22,1600,779,1092,1871,Thursday
2019,8,22,1500,821,940,1761,Thursday
2019,8,22,1400,848,781,1629,Thursday
2019,8,22,1300,986,699,1685,Thursday
2019,8,22,1200,1173,583,1756,Thursday
2019,8,22,1100,1228,426,1654,Thursday
2019,8,22,1000,1128,248,1376,Thursday
2019,8,22,900,816,179,995,Thursday
2019,8,22,800,648,134,782,Thursday
2019,8,22,700,372,77,449,Thursday
2019,8,22,600,220,69,289,Thursday
2019,8,22,500,126,55,181,Thursday
2019,8,22,400,46,41,87,Thursday
2019,8,22,300,38,52,90,Thursday
2019,8,22,200,41,46,87,Thursday
2019,8,22,100,58,82,140,Thursday
2019,8,21,2400,83,144,227,Wednesday
2019,8,21,2300,129,208,337,Wednesday
2019,8,21,2200,186,494,680,Wednesday
2019,8,21,2100,244,646,890,Wednesday
2019,8,21,2000,308,1041,1349,Wednesday
2019,8,21,1900,384,1215,1599,Wednesday
2019,8,21,1800,492,1237,1729,Wednesday
2019,8,21,1700,548,1164,1712,Wednesday
2019,8,21,1600,678,1081,1759,Wednesday
2019,8,21,1500,865,916,1781,Wednesday
2019,8,21,1400,812,735,1547,Wednesday
2019,8,21,1300,877,688,1565,Wednesday
2019,8,21,1200,972,514,1486,Wednesday
2019,8,21,1100,1117,407,1524,Wednesday
2019,8,21,1000,1065,269,1334,Wednesday
2019,8,21,900,880,206,1086,Wednesday
2019,8,21,800,606,118,724,Wednesday
2019,8,21,700,361,83,444,Wednesday
2019,8,21,600,216,61,277,Wednesday
2019,8,21,500,105,47,152,Wednesday
2019,8,21,400,45,45,90,Wednesday
2019,8,21,300,36,60,96,Wednesday
2019,8,21,200,54,55,109,Wednesday
2019,8,21,100,60,100,160,Wednesday
2019,8,20,2400,83,123,206,Tuesday
2019,8,20,2300,132,300,432,Tuesday
2019,8,20,2200,149,463,612,Tuesday
2019,8,20,2100,239,673,912,Tuesday
2019,8,20,2000,286,866,1152,Tuesday
2019,8,20,1900,347,1157,1504,Tuesday
2019,8,20,1800,454,1379,1833,Tuesday
2019,8,20,1700,485,1198,1683,Tuesday
2019,8,20,1600,620,1092,1712,Tuesday
2019,8,20,1500,650,869,1519,Tuesday
2019,8,20,1400,817,788,1605,Tuesday
2019,8,20,1300,913,712,1625,Tuesday
2019,8,20,1200,1116,565,1681,Tuesday
2019,8,20,1100,1166,432,1598,Tuesday
2019,8,20,1000,1093,312,1405,Tuesday
2019,8,20,900,850,186,1036,Tuesday
2019,8,20,800,634,131,765,Tuesday
2019,8,20,700,408,78,486,Tuesday
2019,8,20,600,237,47,284,Tuesday
2019,8,20,500,133,45,178,Tuesday
2019,8,20,400,54,42,96,Tuesday
2019,8,20,300,24,56,80,Tuesday
2019,8,20,200,43,58,101,Tuesday
2019,8,20,100,43,111,154,Tuesday
2019,8,19,2400,83,155,238,Monday
2019,8,19,2300,120,279,399,Monday
2019,8,19,2200,151,582,733,Monday
2019,8,19,2100,206,743,949,Monday
2019,8,19,2000,287,1133,1420,Monday
2019,8,19,1900,356,1334,1690,Monday
2019,8,19,1800,517,1578,2095,Monday
2019,8,19,1700,634,1425,2059,Monday
2019,8,19,1600,696,1222,1918,Monday
2019,8,19,1500,864,1102,1966,Monday
2019,8,19,1400,998,908,1906,Monday
2019,8,19,1300,1155,832,1987,Monday
2019,8,19,1200,1348,607,1955,Monday
2019,8,19,1100,1423,468,1891,Monday
2019,8,19,1000,1191,288,1479,Monday
2019,8,19,900,951,222,1173,Monday
2019,8,19,800,703,147,850,Monday
2019,8,19,700,388,80,468,Monday
2019,8,19,600,203,35,238,Monday
2019,8,19,500,111,22,133,Monday
2019,8,19,400,53,38,91,Monday
2019,8,19,300,27,50,77,Monday
2019,8,19,200,35,70,105,Monday
2019,8,19,100,46,126,172,Monday
2019,8,18,2400,75,195,270,Sunday
2019,8,18,2300,99,420,519,Sunday
2019,8,18,2200,156,706,862,Sunday
2019,8,18,2100,212,1217,1429,Sunday
2019,8,18,2000,253,1604,1857,Sunday
2019,8,18,1900,395,1841,2236,Sunday
2019,8,18,1800,534,2159,2693,Sunday
2019,8,18,1700,728,1981,2709,Sunday
2019,8,18,1600,839,1767,2606,Sunday
2019,8,18,1500,1118,1581,2699,Sunday
2019,8,18,1400,1034,1341,2375,Sunday
2019,8,18,1300,1203,1174,2377,Sunday
2019,8,18,1200,1351,877,2228,Sunday
2019,8,18,1100,1399,591,1990,Sunday
2019,8,18,1000,1171,366,1537,Sunday
2019,8,18,900,918,162,1080,Sunday
2019,8,18,800,639,86,725,Sunday
2019,8,18,700,339,36,375,Sunday
2019,8,18,600,208,30,238,Sunday
2019,8,18,500,105,23,128,Sunday
2019,8,18,400,42,32,74,Sunday
2019,8,18,300,22,25,47,Sunday
2019,8,18,200,33,50,83,Sunday
2019,8,18,100,49,77,126,Sunday
2019,8,17,2400,61,143,204,Saturday
2019,8,17,2300,115,273,388,Saturday
2019,8,17,2200,133,484,617,Saturday
2019,8,17,2100,192,750,942,Saturday
2019,8,17,2000,325,1192,1517,Saturday
2019,8,17,1900,389,1548,1937,Saturday
2019,8,17,1800,448,1677,2125,Saturday
2019,8,17,1700,641,1474,2115,Saturday
2019,8,17,1600,804,1339,2143,Saturday
2019,8,17,1500,916,1129,2045,Saturday
2019,8,17,1400,1109,897,2006,Saturday
2019,8,17,1300,1326,821,2147,Saturday
2019,8,17,1200,1447,689,2136,Saturday
2019,8,17,1100,1485,504,1989,Saturday
2019,8,17,1000,1416,321,1737,Saturday
2019,8,17,900,1121,215,1336,Saturday
2019,8,17,800,739,120,859,Saturday
2019,8,17,700,388,80,468,Saturday
2019,8,17,600,233,59,292,Saturday
2019,8,17,500,110,47,157,Saturday
2019,8,17,400,39,50,89,Saturday
2019,8,17,300,41,56,97,Saturday
2019,8,17,200,40,162,202,Saturday
2019,8,17,100,48,116,164,Saturday
2019,8,16,2400,82,153,235,Friday
2019,8,16,2300,162,276,438,Friday
2019,8,16,2200,248,410,658,Friday
2019,8,16,2100,454,602,1056,Friday
2019,8,16,2000,731,805,1536,Friday
2019,8,16,1900,883,1006,1889,Friday
2019,8,16,1800,948,1090,2038,Friday
2019,8,16,1700,981,1217,2198,Friday
2019,8,16,1600,1036,1057,2093,Friday
2019,8,16,1500,1061,1136,2197,Friday
2019,8,16,1400,1075,1086,2161,Friday
2019,8,16,1300,1194,990,2184,Friday
2019,8,16,1200,1362,760,2122,Friday
2019,8,16,1100,1343,486,1829,Friday
2019,8,16,1000,1126,325,1451,Friday
2019,8,16,900,791,192,983,Friday
2019,8,16,800,547,114,661,Friday
2019,8,16,700,323,79,402,Friday
2019,8,16,600,180,54,234,Friday
2019,8,16,500,92,40,132,Friday
2019,8,16,400,43,40,83,Friday
2019,8,16,300,43,60,103,Friday
2019,8,16,200,52,59,111,Friday
2019,8,16,100,51,88,139,Friday
2019,8,15,2400,86,148,234,Thursday
2019,8,15,2300,176,342,518,Thursday
2019,8,15,2200,234,490,724,Thursday
2019,8,15,2100,351,671,1022,Thursday
2019,8,15,2000,536,869,1405,Thursday
2019,8,15,1900,531,1283,1814,Thursday
2019,8,15,1800,658,1435,2093,Thursday
2019,8,15,1700,711,1289,2000,Thursday
2019,8,15,1600,797,1154,1951,Thursday
2019,8,15,1500,876,990,1866,Thursday
2019,8,15,1400,913,925,1838,Thursday
2019,8,15,1300,1024,781,1805,Thursday
2019,8,15,1200,1290,599,1889,Thursday
2019,8,15,1100,1385,439,1824,Thursday
2019,8,15,1000,1308,296,1604,Thursday
2019,8,15,900,986,210,1196,Thursday
2019,8,15,800,729,133,862,Thursday
2019,8,15,700,412,74,486,Thursday
2019,8,15,600,264,63,327,Thursday
2019,8,15,500,96,51,147,Thursday
2019,8,15,400,57,66,123,Thursday
2019,8,15,300,43,52,95,Thursday
2019,8,15,200,59,90,149,Thursday
2019,8,15,100,59,108,167,Thursday
2019,8,14,2400,83,117,200,Wednesday
2019,8,14,2300,137,276,413,Wednesday
2019,8,14,2200,177,484,661,Wednesday
2019,8,14,2100,237,621,858,Wednesday
2019,8,14,2000,327,808,1135,Wednesday
2019,8,14,1900,419,1117,1536,Wednesday
2019,8,14,1800,514,1318,1832,Wednesday
2019,8,14,1700,560,1252,1812,Wednesday
2019,8,14,1600,670,1033,1703,Wednesday
2019,8,14,1500,728,881,1609,Wednesday
2019,8,14,1400,807,744,1551,Wednesday
2019,8,14,1300,942,612,1554,Wednesday
2019,8,14,1200,1180,550,1730,Wednesday
2019,8,14,1100,1248,441,1689,Wednesday
2019,8,14,1000,999,309,1308,Wednesday
2019,8,14,900,863,193,1056,Wednesday
2019,8,14,800,630,134,764,Wednesday
2019,8,14,700,373,70,443,Wednesday
2019,8,14,600,211,54,265,Wednesday
2019,8,14,500,98,39,137,Wednesday
2019,8,14,400,60,54,114,Wednesday
2019,8,14,300,31,56,87,Wednesday
2019,8,14,200,52,63,115,Wednesday
2019,8,14,100,48,96,144,Wednesday
2019,8,13,2400,83,137,220,Tuesday
2019,8,13,2300,122,401,523,Tuesday
2019,8,13,2200,161,386,547,Tuesday
2019,8,13,2100,225,751,976,Tuesday
2019,8,13,2000,304,1025,1329,Tuesday
2019,8,13,1900,366,1151,1517,Tuesday
2019,8,13,1800,433,1366,1799,Tuesday
2019,8,13,1700,531,1268,1799,Tuesday
2019,8,13,1600,694,1039,1733,Tuesday
2019,8,13,1500,839,944,1783,Tuesday
2019,8,13,1400,857,730,1587,Tuesday
2019,8,13,1300,827,669,1496,Tuesday
2019,8,13,1200,1022,519,1541,Tuesday
2019,8,13,1100,1176,404,1580,Tuesday
2019,8,13,1000,1036,310,1346,Tuesday
2019,8,13,900,955,177,1132,Tuesday
2019,8,13,800,615,129,744,Tuesday
2019,8,13,700,386,75,461,Tuesday
2019,8,13,600,224,67,291,Tuesday
2019,8,13,500,105,62,167,Tuesday
2019,8,13,400,47,73,120,Tuesday
2019,8,13,300,39,161,200,Tuesday
2019,8,13,200,46,29,75,Tuesday
2019,8,13,100,39,21,60,Tuesday
2019,8,12,2400,89,86,175,Monday
2019,8,12,2300,102,275,377,Monday
2019,8,12,2200,156,466,622,Monday
2019,8,12,2100,231,680,911,Monday
2019,8,12,2000,337,876,1213,Monday
2019,8,12,1900,389,1132,1521,Monday
2019,8,12,1800,539,1361,1900,Monday
2019,8,12,1700,445,1210,1655,Monday
2019,8,12,1600,674,1104,1778,Monday
2019,8,12,1500,820,985,1805,Monday
2019,8,12,1400,937,812,1749,Monday
2019,8,12,1300,1047,746,1793,Monday
2019,8,12,1200,1244,623,1867,Monday
2019,8,12,1100,1248,414,1662,Monday
2019,8,12,1000,1024,262,1286,Monday
2019,8,12,900,709,199,908,Monday
2019,8,12,800,480,129,609,Monday
2019,8,12,700,252,72,324,Monday
2019,8,12,600,129,38,167,Monday
2019,8,12,500,51,57,108,Monday
2019,8,12,400,23,35,58,Monday
2019,8,12,300,28,37,65,Monday
2019,8,12,200,28,58,86,Monday
2019,8,12,100,37,109,146,Monday
2019,8,11,2400,61,167,228,Sunday
2019,8,11,2300,82,278,360,Sunday
2019,8,11,2200,154,547,701,Sunday
2019,8,11,2100,200,837,1037,Sunday
2019,8,11,2000,248,1233,1481,Sunday
2019,8,11,1900,344,1578,1922,Sunday
2019,8,11,1800,494,1893,2387,Sunday
2019,8,11,1700,599,1871,2470,Sunday
2019,8,11,1600,705,1736,2441,Sunday
2019,8,11,1500,897,1581,2478,Sunday
2019,8,11,1400,925,1343,2268,Sunday
2019,8,11,1300,985,1155,2140,Sunday
2019,8,11,1200,1147,940,2087,Sunday
2019,8,11,1100,1130,549,1679,Sunday
2019,8,11,1000,956,304,1260,Sunday
2019,8,11,900,706,157,863,Sunday
2019,8,11,800,418,85,503,Sunday
2019,8,11,700,258,35,293,Sunday
2019,8,11,600,133,45,178,Sunday
2019,8,11,500,60,39,99,Sunday
2019,8,11,400,19,37,56,Sunday
2019,8,11,300,24,49,73,Sunday
2019,8,11,200,33,65,98,Sunday
2019,8,11,100,38,107,145,Sunday
2019,8,10,2400,55,161,216,Saturday
2019,8,10,2300,93,343,436,Saturday
2019,8,10,2200,132,533,665,Saturday
2019,8,10,2100,220,807,1027,Saturday
2019,8,10,2000,265,1205,1470,Saturday
2019,8,10,1900,323,1639,1962,Saturday
2019,8,10,1800,436,1631,2067,Saturday
2019,8,10,1700,609,1443,2052,Saturday
2019,8,10,1600,697,1244,1941,Saturday
2019,8,10,1500,867,1113,1980,Saturday
2019,8,10,1400,1078,962,2040,Saturday
2019,8,10,1300,1040,920,1960,Saturday
2019,8,10,1200,1295,778,2073,Saturday
2019,8,10,1100,1399,484,1883,Saturday
2019,8,10,1000,1207,311,1518,Saturday
2019,8,10,900,940,172,1112,Saturday
2019,8,10,800,605,108,713,Saturday
2019,8,10,700,317,84,401,Saturday
2019,8,10,600,164,53,217,Saturday
2019,8,10,500,71,40,111,Saturday
2019,8,10,400,45,52,97,Saturday
2019,8,10,300,31,83,114,Saturday
2019,8,10,200,43,72,115,Saturday
2019,8,10,100,53,82,135,Saturday
2019,8,9,2400,87,176,263,Friday
2019,8,9,2300,132,293,425,Friday
2019,8,9,2200,248,522,770,Friday
2019,8,9,2100,394,1020,1414,Friday
2019,8,9,2000,600,1752,2352,Friday
2019,8,9,1900,738,1223,1961,Friday
2019,8,9,1800,865,913,1778,Friday
2019,8,9,1700,874,874,1748,Friday
2019,8,9,1600,954,1188,2142,Friday
2019,8,9,1500,1013,1137,2150,Friday
2019,8,9,1400,1055,973,2028,Friday
2019,8,9,1300,1085,879,1964,Friday
2019,8,9,1200,1324,693,2017,Friday
2019,8,9,1100,1391,515,1906,Friday
2019,8,9,1000,1249,331,1580,Friday
2019,8,9,900,1000,193,1193,Friday
2019,8,9,800,689,132,821,Friday
2019,8,9,700,387,70,457,Friday
2019,8,9,600,241,50,291,Friday
2019,8,9,500,147,49,196,Friday
2019,8,9,400,67,49,116,Friday
2019,8,9,300,50,69,119,Friday
2019,8,9,200,73,96,169,Friday
2019,8,9,100,58,126,184,Friday
2019,8,8,2400,119,200,319,Thursday
2019,8,8,2300,159,409,568,Thursday
2019,8,8,2200,241,570,811,Thursday
2019,8,8,2100,358,796,1154,Thursday
2019,8,8,2000,481,1005,1486,Thursday
2019,8,8,1900,554,1309,1863,Thursday
2019,8,8,1800,647,1405,2052,Thursday
2019,8,8,1700,643,1285,1928,Thursday
2019,8,8,1600,837,1147,1984,Thursday
2019,8,8,1500,868,1009,1877,Thursday
2019,8,8,1400,912,806,1718,Thursday
2019,8,8,1300,1072,787,1859,Thursday
2019,8,8,1200,1306,590,1896,Thursday
2019,8,8,1100,1319,447,1766,Thursday
2019,8,8,1000,1223,306,1529,Thursday
2019,8,8,900,1050,185,1235,Thursday
2019,8,8,800,733,107,840,Thursday
2019,8,8,700,482,75,557,Thursday
2019,8,8,600,298,81,379,Thursday
2019,8,8,500,139,52,191,Thursday
2019,8,8,400,60,49,109,Thursday
2019,8,8,300,40,55,95,Thursday
2019,8,8,200,70,71,141,Thursday
2019,8,8,100,54,100,154,Thursday
2019,8,7,2400,81,188,269,Wednesday
2019,8,7,2300,171,399,570,Wednesday
2019,8,7,2200,211,535,746,Wednesday
2019,8,7,2100,288,750,1038,Wednesday
2019,8,7,2000,333,991,1324,Wednesday
2019,8,7,1900,444,1274,1718,Wednesday
2019,8,7,1800,498,1500,1998,Wednesday
2019,8,7,1700,584,1280,1864,Wednesday
2019,8,7,1600,669,1172,1841,Wednesday
2019,8,7,1500,749,941,1690,Wednesday
2019,8,7,1400,849,782,1631,Wednesday
2019,8,7,1300,1031,740,1771,Wednesday
2019,8,7,1200,1181,627,1808,Wednesday
2019,8,7,1100,1250,448,1698,Wednesday
2019,8,7,1000,1133,324,1457,Wednesday
2019,8,7,900,955,203,1158,Wednesday
2019,8,7,800,675,135,810,Wednesday
2019,8,7,700,410,98,508,Wednesday
2019,8,7,600,287,55,342,Wednesday
2019,8,7,500,128,50,178,Wednesday
2019,8,7,400,52,44,96,Wednesday
2019,8,7,300,48,59,107,Wednesday
2019,8,7,200,50,82,132,Wednesday
2019,8,7,100,53,118,171,Wednesday
2019,8,6,2400,81,169,250,Tuesday
2019,8,6,2300,122,257,379,Tuesday
2019,8,6,2200,161,485,646,Tuesday
2019,8,6,2100,211,937,1148,Tuesday
2019,8,6,2000,296,1190,1486,Tuesday
2019,8,6,1900,341,1467,1808,Tuesday
2019,8,6,1800,491,1720,2211,Tuesday
2019,8,6,1700,550,1586,2136,Tuesday
2019,8,6,1600,748,1405,2153,Tuesday
2019,8,6,1500,819,1125,1944,Tuesday
2019,8,6,1400,919,1033,1952,Tuesday
2019,8,6,1300,1088,916,2004,Tuesday
2019,8,6,1200,1245,699,1944,Tuesday
2019,8,6,1100,1344,574,1918,Tuesday
2019,8,6,1000,1125,392,1517,Tuesday
2019,8,6,900,1031,271,1302,Tuesday
2019,8,6,800,703,200,903,Tuesday
2019,8,6,700,415,131,546,Tuesday
2019,8,6,600,205,59,264,Tuesday
2019,8,6,500,118,44,162,Tuesday
2019,8,6,400,47,42,89,Tuesday
2019,8,6,300,34,76,110,Tuesday
2019,8,6,200,39,102,141,Tuesday
2019,8,6,100,50,277,327,Tuesday
2019,8,5,2400,96,577,673,Monday
2019,8,5,2300,100,899,999,Monday
2019,8,5,2200,154,1118,1272,Monday
2019,8,5,2100,206,1640,1846,Monday
2019,8,5,2000,303,2051,2354,Monday
2019,8,5,1900,395,2292,2687,Monday
2019,8,5,1800,595,2338,2933,Monday
2019,8,5,1700,724,2226,2950,Monday
2019,8,5,1600,967,2253,3220,Monday
2019,8,5,1500,1221,1941,3162,Monday
2019,8,5,1400,1383,1794,3177,Monday
2019,8,5,1300,1094,1678,2772,Monday
2019,8,5,1200,1194,1361,2555,Monday
2019,8,5,1100,1511,774,2285,Monday
2019,8,5,1000,1276,512,1788,Monday
2019,8,5,900,1139,272,1411,Monday
2019,8,5,800,759,175,934,Monday
2019,8,5,700,433,84,517,Monday
2019,8,5,600,235,65,300,Monday
2019,8,5,500,119,90,209,Monday
2019,8,5,400,58,156,214,Monday
2019,8,5,300,26,83,109,Monday
2019,8,5,200,44,91,135,Monday
2019,8,5,100,46,114,160,Monday
2019,8,4,2400,88,175,263,Sunday
2019,8,4,2300,126,442,568,Sunday
2019,8,4,2200,174,721,895,Sunday
2019,8,4,2100,223,1248,1471,Sunday
2019,8,4,2000,322,1495,1817,Sunday
2019,8,4,1900,424,1766,2190,Sunday
2019,8,4,1800,567,1871,2438,Sunday
2019,8,4,1700,701,1718,2419,Sunday
2019,8,4,1600,937,1634,2571,Sunday
2019,8,4,1500,1151,1246,2397,Sunday
2019,8,4,1400,1260,1038,2298,Sunday
2019,8,4,1300,1193,827,2020,Sunday
2019,8,4,1200,1636,647,2283,Sunday
2019,8,4,1100,1182,459,1641,Sunday
2019,8,4,1000,1235,293,1528,Sunday
2019,8,4,900,1105,198,1303,Sunday
2019,8,4,800,718,106,824,Sunday
2019,8,4,700,417,53,470,Sunday
2019,8,4,600,249,32,281,Sunday
2019,8,4,500,124,26,150,Sunday
2019,8,4,400,56,39,95,Sunday
2019,8,4,300,25,42,67,Sunday
2019,8,4,200,32,53,85,Sunday
2019,8,4,100,49,107,156,Sunday
2019,8,3,2400,81,186,267,Saturday
2019,8,3,2300,132,416,548,Saturday
2019,8,3,2200,180,571,751,Saturday
2019,8,3,2100,246,845,1091,Saturday
2019,8,3,2000,391,1128,1519,Saturday
2019,8,3,1900,443,1395,1838,Saturday
2019,8,3,1800,562,1520,2082,Saturday
2019,8,3,1700,728,1344,2072,Saturday
2019,8,3,1600,1130,1286,2416,Saturday
2019,8,3,1500,1386,1052,2438,Saturday
2019,8,3,1400,1290,849,2139,Saturday
2019,8,3,1300,1337,799,2136,Saturday
2019,8,3,1200,1592,575,2167,Saturday
2019,8,3,1100,1907,463,2370,Saturday
2019,8,3,1000,1728,316,2044,Saturday
2019,8,3,900,1508,200,1708,Saturday
2019,8,3,800,1060,128,1188,Saturday
2019,8,3,700,654,61,715,Saturday
2019,8,3,600,338,53,391,Saturday
2019,8,3,500,194,40,234,Saturday
2019,8,3,400,90,61,151,Saturday
2019,8,3,300,78,64,142,Saturday
2019,8,3,200,67,90,157,Saturday
2019,8,3,100,99,119,218,Saturday
2019,8,2,2400,155,185,340,Friday
2019,8,2,2300,295,348,643,Friday
2019,8,2,2200,465,443,908,Friday
2019,8,2,2100,746,651,1397,Friday
2019,8,2,2000,1068,883,1951,Friday
2019,8,2,1900,1306,1124,2430,Friday
2019,8,2,1800,1411,1374,2785,Friday
2019,8,2,1700,1454,1353,2807,Friday
2019,8,2,1600,1619,1240,2859,Friday
2019,8,2,1500,1508,1090,2598,Friday
2019,8,2,1400,1555,952,2507,Friday
2019,8,2,1300,1604,841,2445,Friday
2019,8,2,1200,1821,734,2555,Friday
2019,8,2,1100,1821,466,2287,Friday
2019,8,2,1000,1677,306,1983,Friday
2019,8,2,900,1356,183,1539,Friday
2019,8,2,800,980,143,1123,Friday
2019,8,2,700,573,82,655,Friday
2019,8,2,600,313,53,366,Friday
2019,8,2,500,144,46,190,Friday
2019,8,2,400,81,51,132,Friday
2019,8,2,300,58,66,124,Friday
2019,8,2,200,68,64,132,Friday
2019,8,2,100,86,121,207,Friday
2019,8,1,2400,163,173,336,Thursday
2019,8,1,2300,244,337,581,Thursday
2019,8,1,2200,381,419,800,Thursday
2019,8,1,2100,579,674,1253,Thursday
2019,8,1,2000,828,886,1714,Thursday
2019,8,1,1900,897,1229,2126,Thursday
2019,8,1,1800,997,1238,2235,Thursday
2019,8,1,1700,935,1204,2139,Thursday
2019,8,1,1600,1074,1104,2178,Thursday
2019,8,1,1500,1093,881,1974,Thursday
2019,8,1,1400,1186,764,1950,Thursday
2019,8,1,1300,1212,727,1939,Thursday
2019,8,1,1200,1545,612,2157,Thursday
2019,8,1,1100,1612,406,2018,Thursday
2019,8,1,1000,1346,299,1645,Thursday
2019,8,1,900,1107,198,1305,Thursday
2019,8,1,800,832,135,967,Thursday
2019,8,1,700,484,73,557,Thursday
2019,8,1,600,258,47,305,Thursday
2019,8,1,500,113,54,167,Thursday
2019,8,1,400,43,46,89,Thursday
2019,8,1,300,47,55,102,Thursday
2019,8,1,200,61,78,139,Thursday
2019,8,1,100,85,109,194,Thursday
2019,7,31,2400,100,139,239,Wednesday
2019,7,31,2300,163,305,468,Wednesday
2019,7,31,2200,217,488,705,Wednesday
2019,7,31,2100,333,645,978,Wednesday
2019,7,31,2000,417,853,1270,Wednesday
2019,7,31,1900,494,1093,1587,Wednesday
2019,7,31,1800,552,1267,1819,Wednesday
2019,7,31,1700,644,1203,1847,Wednesday
2019,7,31,1600,758,981,1739,Wednesday
2019,7,31,1500,831,843,1674,Wednesday
2019,7,31,1400,896,764,1660,Wednesday
2019,7,31,1300,865,691,1556,Wednesday
2019,7,31,1200,1054,619,1673,Wednesday
2019,7,31,1100,1134,387,1521,Wednesday
2019,7,31,1000,1072,277,1349,Wednesday
2019,7,31,900,889,182,1071,Wednesday
2019,7,31,800,660,129,789,Wednesday
2019,7,31,700,389,80,469,Wednesday
2019,7,31,600,215,70,285,Wednesday
2019,7,31,500,115,55,170,Wednesday
2019,7,31,400,38,65,103,Wednesday
2019,7,31,300,37,52,89,Wednesday
2019,7,31,200,40,64,104,Wednesday
2019,7,31,100,50,104,154,Wednesday
2019,7,30,2400,77,157,234,Tuesday
2019,7,30,2300,126,311,437,Tuesday
2019,7,30,2200,163,452,615,Tuesday
2019,7,30,2100,220,639,859,Tuesday
2019,7,30,2000,301,839,1140,Tuesday
2019,7,30,1900,371,1035,1406,Tuesday
2019,7,30,1800,410,1308,1718,Tuesday
2019,7,30,1700,570,1168,1738,Tuesday
2019,7,30,1600,652,1048,1700,Tuesday
2019,7,30,1500,694,1027,1721,Tuesday
2019,7,30,1400,828,818,1646,Tuesday
2019,7,30,1300,894,602,1496,Tuesday
2019,7,30,1200,1010,547,1557,Tuesday
2019,7,30,1100,1135,413,1548,Tuesday
2019,7,30,1000,1041,277,1318,Tuesday
2019,7,30,900,866,201,1067,Tuesday
2019,7,30,800,615,145,760,Tuesday
2019,7,30,700,348,66,414,Tuesday
2019,7,30,600,222,54,276,Tuesday
2019,7,30,500,119,53,172,Tuesday
2019,7,30,400,42,59,101,Tuesday
2019,7,30,300,34,67,101,Tuesday
2019,7,30,200,43,78,121,Tuesday
2019,7,30,100,53,85,138,Tuesday
2019,7,29,2400,85,182,267,Monday
2019,7,29,2300,106,381,487,Monday
2019,7,29,2200,148,491,639,Monday
2019,7,29,2100,251,773,1024,Monday
2019,7,29,2000,305,1004,1309,Monday
2019,7,29,1900,384,1295,1679,Monday
2019,7,29,1800,441,1401,1842,Monday
2019,7,29,1700,582,1322,1904,Monday
2019,7,29,1600,741,1124,1865,Monday
2019,7,29,1500,855,980,1835,Monday
2019,7,29,1400,937,911,1848,Monday
2019,7,29,1300,1075,753,1828,Monday
2019,7,29,1200,1240,587,1827,Monday
2019,7,29,1100,1334,485,1819,Monday
2019,7,29,1000,1166,304,1470,Monday
2019,7,29,900,900,213,1113,Monday
2019,7,29,800,677,145,822,Monday
2019,7,29,700,415,104,519,Monday
2019,7,29,600,222,45,267,Monday
2019,7,29,500,121,46,167,Monday
2019,7,29,400,32,41,73,Monday
2019,7,29,300,32,50,82,Monday
2019,7,29,200,44,79,123,Monday
2019,7,29,100,49,142,191,Monday
2019,7,28,2400,51,261,312,Sunday
2019,7,28,2300,143,463,606,Sunday
2019,7,28,2200,159,817,976,Sunday
2019,7,28,2100,258,1209,1467,Sunday
2019,7,28,2000,314,1574,1888,Sunday
2019,7,28,1900,442,1864,2306,Sunday
2019,7,28,1800,519,1957,2476,Sunday
2019,7,28,1700,670,1884,2554,Sunday
2019,7,28,1600,774,1719,2493,Sunday
2019,7,28,1500,1015,1502,2517,Sunday
2019,7,28,1400,1096,1255,2351,Sunday
2019,7,28,1300,1236,1029,2265,Sunday
2019,7,28,1200,1293,838,2131,Sunday
2019,7,28,1100,1297,522,1819,Sunday
2019,7,28,1000,1185,313,1498,Sunday
2019,7,28,900,986,160,1146,Sunday
2019,7,28,800,658,125,783,Sunday
2019,7,28,700,355,48,403,Sunday
2019,7,28,600,179,41,220,Sunday
2019,7,28,500,103,25,128,Sunday
2019,7,28,400,32,30,62,Sunday
2019,7,28,300,26,41,67,Sunday
2019,7,28,200,29,55,84,Sunday
2019,7,28,100,41,102,143,Sunday
2019,7,27,2400,70,154,224,Saturday
2019,7,27,2300,112,315,427,Saturday
2019,7,27,2200,178,462,640,Saturday
2019,7,27,2100,255,692,947,Saturday
2019,7,27,2000,328,921,1249,Saturday
2019,7,27,1900,420,1115,1535,Saturday
2019,7,27,1800,734,1386,2120,Saturday
2019,7,27,1700,876,1407,2283,Saturday
2019,7,27,1600,907,1238,2145,Saturday
2019,7,27,1500,1016,1091,2107,Saturday
2019,7,27,1400,1062,1120,2182,Saturday
2019,7,27,1300,1137,1077,2214,Saturday
2019,7,27,1200,1290,604,1894,Saturday
2019,7,27,1100,1323,451,1774,Saturday
2019,7,27,1000,1143,307,1450,Saturday
2019,7,27,900,1082,186,1268,Saturday
2019,7,27,800,832,143,975,Saturday
2019,7,27,700,328,73,401,Saturday
2019,7,27,600,154,35,189,Saturday
2019,7,27,500,126,54,180,Saturday
2019,7,27,400,56,52,108,Saturday
2019,7,27,300,36,57,93,Saturday
2019,7,27,200,48,81,129,Saturday
2019,7,27,100,78,119,197,Saturday
2019,7,26,2400,115,196,311,Friday
2019,7,26,2300,219,346,565,Friday
2019,7,26,2200,326,479,805,Friday
2019,7,26,2100,503,690,1193,Friday
2019,7,26,2000,817,979,1796,Friday
2019,7,26,1900,940,1171,2111,Friday
2019,7,26,1800,977,1360,2337,Friday
2019,7,26,1700,1084,1367,2451,Friday
2019,7,26,1600,1089,1131,2220,Friday
2019,7,26,1500,1193,964,2157,Friday
2019,7,26,1400,1160,921,2081,Friday
2019,7,26,1300,1237,757,1994,Friday
2019,7,26,1200,1541,618,2159,Friday
2019,7,26,1100,1530,454,1984,Friday
2019,7,26,1000,1410,313,1723,Friday
2019,7,26,900,1090,220,1310,Friday
2019,7,26,800,792,139,931,Friday
2019,7,26,700,504,83,587,Friday
2019,7,26,600,271,66,337,Friday
2019,7,26,500,140,67,207,Friday
2019,7,26,400,69,58,127,Friday
2019,7,26,300,40,48,88,Friday
2019,7,26,200,51,81,132,Friday
2019,7,26,100,60,122,182,Friday
2019,7,25,2400,115,192,307,Thursday
2019,7,25,2300,186,314,500,Thursday
2019,7,25,2200,276,500,776,Thursday
2019,7,25,2100,436,680,1116,Thursday
2019,7,25,2000,569,900,1469,Thursday
2019,7,25,1900,600,1152,1752,Thursday
2019,7,25,1800,657,1283,1940,Thursday
2019,7,25,1700,746,1214,1960,Thursday
2019,7,25,1600,842,1091,1933,Thursday
2019,7,25,1500,829,854,1683,Thursday
2019,7,25,1400,947,751,1698,Thursday
2019,7,25,1300,1083,669,1752,Thursday
2019,7,25,1200,1269,561,1830,Thursday
2019,7,25,1100,1321,369,1690,Thursday
2019,7,25,1000,1208,296,1504,Thursday
2019,7,25,900,1002,187,1189,Thursday
2019,7,25,800,782,121,903,Thursday
2019,7,25,700,477,86,563,Thursday
2019,7,25,600,263,52,315,Thursday
2019,7,25,500,157,43,200,Thursday
2019,7,25,400,56,50,106,Thursday
2019,7,25,300,42,45,87,Thursday
2019,7,25,200,40,69,109,Thursday
2019,7,25,100,72,118,190,Thursday
2019,7,24,2400,75,302,377,Wednesday
2019,7,24,2300,130,324,454,Wednesday
2019,7,24,2200,194,208,402,Wednesday
2019,7,24,2100,264,368,632,Wednesday
2019,7,24,2000,345,595,940,Wednesday
2019,7,24,1900,424,938,1362,Wednesday
2019,7,24,1800,452,913,1365,Wednesday
2019,7,24,1700,573,1030,1603,Wednesday
2019,7,24,1600,687,997,1684,Wednesday
2019,7,24,1500,723,864,1587,Wednesday
2019,7,24,1400,765,881,1646,Wednesday
2019,7,24,1300,900,707,1607,Wednesday
2019,7,24,1200,1057,586,1643,Wednesday
2019,7,24,1100,1091,425,1516,Wednesday
2019,7,24,1000,944,277,1221,Wednesday
2019,7,24,900,673,185,858,Wednesday
2019,7,24,800,515,135,650,Wednesday
2019,7,24,700,259,74,333,Wednesday
2019,7,24,600,123,66,189,Wednesday
2019,7,24,500,53,47,100,Wednesday
2019,7,24,400,38,45,83,Wednesday
2019,7,24,300,26,56,82,Wednesday
2019,7,24,200,52,69,121,Wednesday
2019,7,24,100,49,98,147,Wednesday
2019,7,23,2400,85,192,277,Tuesday
2019,7,23,2300,118,389,507,Tuesday
2019,7,23,2200,169,444,613,Tuesday
2019,7,23,2100,251,674,925,Tuesday
2019,7,23,2000,305,918,1223,Tuesday
2019,7,23,1900,328,1143,1471,Tuesday
2019,7,23,1800,435,1416,1851,Tuesday
2019,7,23,1700,461,1153,1614,Tuesday
2019,7,23,1600,622,1059,1681,Tuesday
2019,7,23,1500,665,908,1573,Tuesday
2019,7,23,1400,735,867,1602,Tuesday
2019,7,23,1300,888,663,1551,Tuesday
2019,7,23,1200,1189,626,1815,Tuesday
2019,7,23,1100,1167,441,1608,Tuesday
2019,7,23,1000,1031,294,1325,Tuesday
2019,7,23,900,925,177,1102,Tuesday
2019,7,23,800,725,147,872,Tuesday
2019,7,23,700,406,77,483,Tuesday
2019,7,23,600,244,59,303,Tuesday
2019,7,23,500,155,42,197,Tuesday
2019,7,23,400,35,59,94,Tuesday
2019,7,23,300,34,104,138,Tuesday
2019,7,23,200,47,131,178,Tuesday
2019,7,23,100,47,91,138,Tuesday
2019,7,22,2400,80,157,237,Monday
2019,7,22,2300,129,323,452,Monday
2019,7,22,2200,192,475,667,Monday
2019,7,22,2100,232,802,1034,Monday
2019,7,22,2000,294,1001,1295,Monday
2019,7,22,1900,351,1341,1692,Monday
2019,7,22,1800,472,1526,1998,Monday
2019,7,22,1700,579,1400,1979,Monday
2019,7,22,1600,719,1218,1937,Monday
2019,7,22,1500,804,1066,1870,Monday
2019,7,22,1400,938,886,1824,Monday
2019,7,22,1300,1130,801,1931,Monday
2019,7,22,1200,1251,597,1848,Monday
2019,7,22,1100,1319,449,1768,Monday
2019,7,22,1000,1151,318,1469,Monday
2019,7,22,900,964,214,1178,Monday
2019,7,22,800,696,153,849,Monday
2019,7,22,700,418,93,511,Monday
2019,7,22,600,259,46,305,Monday
2019,7,22,500,133,25,158,Monday
2019,7,22,400,29,43,72,Monday
2019,7,22,300,28,58,86,Monday
2019,7,22,200,34,75,109,Monday
2019,7,22,100,45,130,175,Monday
2019,7,21,2400,67,295,362,Sunday
2019,7,21,2300,117,567,684,Sunday
2019,7,21,2200,159,840,999,Sunday
2019,7,21,2100,263,1455,1718,Sunday
2019,7,21,2000,369,1736,2105,Sunday
2019,7,21,1900,435,2173,2608,Sunday
2019,7,21,1800,545,2094,2639,Sunday
2019,7,21,1700,702,1995,2697,Sunday
2019,7,21,1600,927,1626,2553,Sunday
2019,7,21,1500,1300,1564,2864,Sunday
2019,7,21,1400,1213,1152,2365,Sunday
2019,7,21,1300,1329,1109,2438,Sunday
2019,7,21,1200,1031,807,1838,Sunday
2019,7,21,1100,1428,485,1913,Sunday
2019,7,21,1000,1323,305,1628,Sunday
2019,7,21,900,1049,178,1227,Sunday
2019,7,21,800,715,99,814,Sunday
2019,7,21,700,383,55,438,Sunday
2019,7,21,600,217,24,241,Sunday
2019,7,21,500,144,32,176,Sunday
2019,7,21,400,35,29,64,Sunday
2019,7,21,300,37,49,86,Sunday
2019,7,21,200,34,61,95,Sunday
2019,7,21,100,50,121,171,Sunday
2019,7,20,2400,66,254,320,Saturday
2019,7,20,2300,98,654,752,Saturday
2019,7,20,2200,158,907,1065,Saturday
2019,7,20,2100,215,1114,1329,Saturday
2019,7,20,2000,262,1005,1267,Saturday
2019,7,20,1900,345,938,1283,Saturday
2019,7,20,1800,437,767,1204,Saturday
2019,7,20,1700,567,705,1272,Saturday
2019,7,20,1600,648,681,1329,Saturday
2019,7,20,1500,839,689,1528,Saturday
2019,7,20,1400,1015,726,1741,Saturday
2019,7,20,1300,1146,657,1803,Saturday
2019,7,20,1200,1362,560,1922,Saturday
2019,7,20,1100,1404,397,1801,Saturday
2019,7,20,1000,1290,253,1543,Saturday
2019,7,20,900,929,144,1073,Saturday
2019,7,20,800,631,108,739,Saturday
2019,7,20,700,344,61,405,Saturday
2019,7,20,600,163,45,208,Saturday
2019,7,20,500,84,46,130,Saturday
2019,7,20,400,36,50,86,Saturday
2019,7,20,300,44,52,96,Saturday
2019,7,20,200,49,68,117,Saturday
2019,7,20,100,71,106,177,Saturday
2019,7,19,2400,110,156,266,Friday
2019,7,19,2300,169,222,391,Friday
2019,7,19,2200,327,325,652,Friday
2019,7,19,2100,558,499,1057,Friday
2019,7,19,2000,891,709,1600,Friday
2019,7,19,1900,944,896,1840,Friday
2019,7,19,1800,1002,1122,2124,Friday
2019,7,19,1700,1077,1187,2264,Friday
2019,7,19,1600,1190,1201,2391,Friday
2019,7,19,1500,1192,979,2171,Friday
2019,7,19,1400,1214,941,2155,Friday
2019,7,19,1300,1283,754,2037,Friday
2019,7,19,1200,1475,639,2114,Friday
2019,7,19,1100,1399,449,1848,Friday
2019,7,19,1000,1176,248,1424,Friday
2019,7,19,900,879,193,1072,Friday
2019,7,19,800,640,111,751,Friday
2019,7,19,700,327,76,403,Friday
2019,7,19,600,169,50,219,Friday
2019,7,19,500,102,43,145,Friday
2019,7,19,400,55,49,104,Friday
2019,7,19,300,48,51,99,Friday
2019,7,19,200,46,73,119,Friday
2019,7,19,100,70,88,158,Friday
2019,7,18,2400,114,181,295,Thursday
2019,7,18,2300,176,253,429,Thursday
2019,7,18,2200,261,443,704,Thursday
2019,7,18,2100,406,543,949,Thursday
2019,7,18,2000,520,698,1218,Thursday
2019,7,18,1900,564,902,1466,Thursday
2019,7,18,1800,713,1266,1979,Thursday
2019,7,18,1700,705,1235,1940,Thursday
2019,7,18,1600,852,1150,2002,Thursday
2019,7,18,1500,925,1032,1957,Thursday
2019,7,18,1400,866,827,1693,Thursday
2019,7,18,1300,1108,762,1870,Thursday
2019,7,18,1200,1261,561,1822,Thursday
2019,7,18,1100,1284,349,1633,Thursday
2019,7,18,1000,1100,246,1346,Thursday
2019,7,18,900,875,185,1060,Thursday
2019,7,18,800,645,159,804,Thursday
2019,7,18,700,365,83,448,Thursday
2019,7,18,600,200,42,242,Thursday
2019,7,18,500,98,50,148,Thursday
2019,7,18,400,45,30,75,Thursday
2019,7,18,300,38,52,90,Thursday
2019,7,18,200,51,84,135,Thursday
2019,7,18,100,60,105,165,Thursday
2019,7,17,2400,99,228,327,Wednesday
2019,7,17,2300,135,614,749,Wednesday
2019,7,17,2200,189,876,1065,Wednesday
2019,7,17,2100,236,604,840,Wednesday
2019,7,17,2000,372,475,847,Wednesday
2019,7,17,1900,378,499,877,Wednesday
2019,7,17,1800,478,664,1142,Wednesday
2019,7,17,1700,567,842,1409,Wednesday
2019,7,17,1600,591,896,1487,Wednesday
2019,7,17,1500,715,927,1642,Wednesday
2019,7,17,1400,752,893,1645,Wednesday
2019,7,17,1300,793,762,1555,Wednesday
2019,7,17,1200,1143,571,1714,Wednesday
2019,7,17,1100,1184,393,1577,Wednesday
2019,7,17,1000,1046,286,1332,Wednesday
2019,7,17,900,752,171,923,Wednesday
2019,7,17,800,617,133,750,Wednesday
2019,7,17,700,345,83,428,Wednesday
2019,7,17,600,194,44,238,Wednesday
2019,7,17,500,110,29,139,Wednesday
2019,7,17,400,43,53,96,Wednesday
2019,7,17,300,29,60,89,Wednesday
2019,7,17,200,49,73,122,Wednesday
2019,7,17,100,52,92,144,Wednesday
2019,7,16,2400,81,146,227,Tuesday
2019,7,16,2300,125,262,387,Tuesday
2019,7,16,2200,161,420,581,Tuesday
2019,7,16,2100,180,529,709,Tuesday
2019,7,16,2000,316,792,1108,Tuesday
2019,7,16,1900,340,1015,1355,Tuesday
2019,7,16,1800,456,1160,1616,Tuesday
2019,7,16,1700,511,1032,1543,Tuesday
2019,7,16,1600,631,942,1573,Tuesday
2019,7,16,1500,696,883,1579,Tuesday
2019,7,16,1400,746,685,1431,Tuesday
2019,7,16,1300,892,644,1536,Tuesday
2019,7,16,1200,1022,570,1592,Tuesday
2019,7,16,1100,1104,392,1496,Tuesday
2019,7,16,1000,1001,263,1264,Tuesday
2019,7,16,900,777,212,989,Tuesday
2019,7,16,800,590,142,732,Tuesday
2019,7,16,700,360,79,439,Tuesday
2019,7,16,600,167,49,216,Tuesday
2019,7,16,500,90,22,112,Tuesday
2019,7,16,400,38,48,86,Tuesday
2019,7,16,300,34,74,108,Tuesday
2019,7,16,200,37,94,131,Tuesday
2019,7,16,100,52,114,166,Tuesday
2019,7,15,2400,88,168,256,Monday
2019,7,15,2300,144,319,463,Monday
2019,7,15,2200,165,454,619,Monday
2019,7,15,2100,246,669,915,Monday
2019,7,15,2000,298,956,1254,Monday
2019,7,15,1900,418,1198,1616,Monday
2019,7,15,1800,501,1389,1890,Monday
2019,7,15,1700,634,1314,1948,Monday
2019,7,15,1600,823,1167,1990,Monday
2019,7,15,1500,972,978,1950,Monday
2019,7,15,1400,1263,826,2089,Monday
2019,7,15,1300,986,709,1695,Monday
2019,7,15,1200,1259,602,1861,Monday
2019,7,15,1100,1415,398,1813,Monday
2019,7,15,1000,1243,299,1542,Monday
2019,7,15,900,979,165,1144,Monday
2019,7,15,800,698,127,825,Monday
2019,7,15,700,419,87,506,Monday
2019,7,15,600,234,42,276,Monday
2019,7,15,500,126,30,156,Monday
2019,7,15,400,32,26,58,Monday
2019,7,15,300,34,42,76,Monday
2019,7,15,200,40,76,116,Monday
2019,7,15,100,42,109,151,Monday
2019,7,14,2400,78,154,232,Sunday
2019,7,14,2300,130,342,472,Sunday
2019,7,14,2200,149,525,674,Sunday
2019,7,14,2100,236,844,1080,Sunday
2019,7,14,2000,339,1140,1479,Sunday
2019,7,14,1900,383,1347,1730,Sunday
2019,7,14,1800,497,1550,2047,Sunday
2019,7,14,1700,629,1688,2317,Sunday
2019,7,14,1600,876,1599,2475,Sunday
2019,7,14,1500,958,1556,2514,Sunday
2019,7,14,1400,1080,1384,2464,Sunday
2019,7,14,1300,1223,1155,2378,Sunday
2019,7,14,1200,1359,1075,2434,Sunday
2019,7,14,1100,1231,541,1772,Sunday
2019,7,14,1000,1078,330,1408,Sunday
2019,7,14,900,778,184,962,Sunday
2019,7,14,800,564,105,669,Sunday
2019,7,14,700,309,52,361,Sunday
2019,7,14,600,163,30,193,Sunday
2019,7,14,500,71,33,104,Sunday
2019,7,14,400,25,28,53,Sunday
2019,7,14,300,27,56,83,Sunday
2019,7,14,200,31,57,88,Sunday
2019,7,14,100,48,59,107,Sunday
2019,7,13,2400,69,173,242,Saturday
2019,7,13,2300,101,317,418,Saturday
2019,7,13,2200,148,423,571,Saturday
2019,7,13,2100,233,651,884,Saturday
2019,7,13,2000,269,907,1176,Saturday
2019,7,13,1900,351,1239,1590,Saturday
2019,7,13,1800,466,1467,1933,Saturday
2019,7,13,1700,599,1443,2042,Saturday
2019,7,13,1600,771,1250,2021,Saturday
2019,7,13,1500,995,1041,2036,Saturday
2019,7,13,1400,1173,774,1947,Saturday
2019,7,13,1300,1216,760,1976,Saturday
2019,7,13,1200,1401,606,2007,Saturday
2019,7,13,1100,1489,427,1916,Saturday
2019,7,13,1000,1393,316,1709,Saturday
2019,7,13,900,1159,190,1349,Saturday
2019,7,13,800,757,122,879,Saturday
2019,7,13,700,389,69,458,Saturday
2019,7,13,600,230,49,279,Saturday
2019,7,13,500,93,37,130,Saturday
2019,7,13,400,39,43,82,Saturday
2019,7,13,300,42,44,86,Saturday
2019,7,13,200,59,65,124,Saturday
2019,7,13,100,71,101,172,Saturday
2019,7,12,2400,93,194,287,Friday
2019,7,12,2300,196,304,500,Friday
2019,7,12,2200,291,424,715,Friday
2019,7,12,2100,507,614,1121,Friday
2019,7,12,2000,656,845,1501,Friday
2019,7,12,1900,778,1052,1830,Friday
2019,7,12,1800,913,1219,2132,Friday
2019,7,12,1700,960,1242,2202,Friday
2019,7,12,1600,1131,1159,2290,Friday
2019,7,12,1500,1154,946,2100,Friday
2019,7,12,1400,1169,889,2058,Friday
2019,7,12,1300,1216,843,2059,Friday
2019,7,12,1200,1353,619,1972,Friday
2019,7,12,1100,1497,486,1983,Friday
2019,7,12,1000,1306,295,1601,Friday
2019,7,12,900,1023,198,1221,Friday
2019,7,12,800,778,163,941,Friday
2019,7,12,700,465,87,552,Friday
2019,7,12,600,229,69,298,Friday
2019,7,12,500,155,45,200,Friday
2019,7,12,400,57,47,104,Friday
2019,7,12,300,49,59,108,Friday
2019,7,12,200,48,71,119,Friday
2019,7,12,100,84,102,186,Friday
2019,7,11,2400,105,183,288,Thursday
2019,7,11,2300,159,351,510,Thursday
2019,7,11,2200,221,450,671,Thursday
2019,7,11,2100,364,509,873,Thursday
2019,7,11,2000,505,824,1329,Thursday
2019,7,11,1900,596,1057,1653,Thursday
2019,7,11,1800,603,1269,1872,Thursday
2019,7,11,1700,735,1076,1811,Thursday
2019,7,11,1600,801,993,1794,Thursday
2019,7,11,1500,869,984,1853,Thursday
2019,7,11,1400,960,695,1655,Thursday
2019,7,11,1300,1083,764,1847,Thursday
2019,7,11,1200,1246,582,1828,Thursday
2019,7,11,1100,1257,373,1630,Thursday
2019,7,11,1000,1132,332,1464,Thursday
2019,7,11,900,896,219,1115,Thursday
2019,7,11,800,704,146,850,Thursday
2019,7,11,700,403,84,487,Thursday
2019,7,11,600,186,65,251,Thursday
2019,7,11,500,114,37,151,Thursday
2019,7,11,400,42,41,83,Thursday
2019,7,11,300,42,43,85,Thursday
2019,7,11,200,59,65,124,Thursday
2019,7,11,100,45,111,156,Thursday
2019,7,10,2400,116,141,257,Wednesday
2019,7,10,2300,146,246,392,Wednesday
2019,7,10,2200,195,396,591,Wednesday
2019,7,10,2100,280,481,761,Wednesday
2019,7,10,2000,318,728,1046,Wednesday
2019,7,10,1900,376,928,1304,Wednesday
2019,7,10,1800,485,1088,1573,Wednesday
2019,7,10,1700,575,1105,1680,Wednesday
2019,7,10,1600,648,1085,1733,Wednesday
2019,7,10,1500,761,827,1588,Wednesday
2019,7,10,1400,821,812,1633,Wednesday
2019,7,10,1300,947,751,1698,Wednesday
2019,7,10,1200,1144,578,1722,Wednesday
2019,7,10,1100,1035,407,1442,Wednesday
2019,7,10,1000,1005,276,1281,Wednesday
2019,7,10,900,763,208,971,Wednesday
2019,7,10,800,581,143,724,Wednesday
2019,7,10,700,365,87,452,Wednesday
2019,7,10,600,184,39,223,Wednesday
2019,7,10,500,95,49,144,Wednesday
2019,7,10,400,34,63,97,Wednesday
2019,7,10,300,29,58,87,Wednesday
2019,7,10,200,51,68,119,Wednesday
2019,7,10,100,60,88,148,Wednesday
2019,7,9,2400,92,171,263,Tuesday
2019,7,9,2300,127,267,394,Tuesday
2019,7,9,2200,182,427,609,Tuesday
2019,7,9,2100,274,593,867,Tuesday
2019,7,9,2000,295,805,1100,Tuesday
2019,7,9,1900,333,963,1296,Tuesday
2019,7,9,1800,409,1151,1560,Tuesday
2019,7,9,1700,497,1106,1603,Tuesday
2019,7,9,1600,580,1037,1617,Tuesday
2019,7,9,1500,629,813,1442,Tuesday
2019,7,9,1400,755,741,1496,Tuesday
2019,7,9,1300,906,646,1552,Tuesday
2019,7,9,1200,1058,518,1576,Tuesday
2019,7,9,1100,1130,389,1519,Tuesday
2019,7,9,1000,1063,250,1313,Tuesday
2019,7,9,900,930,176,1106,Tuesday
2019,7,9,800,652,129,781,Tuesday
2019,7,9,700,357,94,451,Tuesday
2019,7,9,600,190,46,236,Tuesday
2019,7,9,500,113,45,158,Tuesday
2019,7,9,400,45,57,102,Tuesday
2019,7,9,300,28,50,78,Tuesday
2019,7,9,200,45,65,110,Tuesday
2019,7,9,100,56,109,165,Tuesday
2019,7,8,2400,79,192,271,Monday
2019,7,8,2300,113,280,393,Monday
2019,7,8,2200,169,465,634,Monday
2019,7,8,2100,221,658,879,Monday
2019,7,8,2000,307,836,1143,Monday
2019,7,8,1900,358,1233,1591,Monday
2019,7,8,1800,441,1223,1664,Monday
2019,7,8,1700,527,1138,1665,Monday
2019,7,8,1600,660,1047,1707,Monday
2019,7,8,1500,847,964,1811,Monday
2019,7,8,1400,924,739,1663,Monday
2019,7,8,1300,1057,617,1674,Monday
2019,7,8,1200,1245,544,1789,Monday
2019,7,8,1100,1250,372,1622,Monday
2019,7,8,1000,1138,298,1436,Monday
2019,7,8,900,775,170,945,Monday
2019,7,8,800,582,121,703,Monday
2019,7,8,700,301,74,375,Monday
2019,7,8,600,150,27,177,Monday
2019,7,8,500,74,29,103,Monday
2019,7,8,400,32,40,72,Monday
2019,7,8,300,30,99,129,Monday
2019,7,8,200,36,72,108,Monday
2019,7,8,100,26,47,73,Monday
2019,7,7,2400,56,144,200,Sunday
2019,7,7,2300,109,351,460,Sunday
2019,7,7,2200,173,617,790,Sunday
2019,7,7,2100,205,782,987,Sunday
2019,7,7,2000,269,1161,1430,Sunday
2019,7,7,1900,351,1414,1765,Sunday
2019,7,7,1800,462,1603,2065,Sunday
2019,7,7,1700,618,1742,2360,Sunday
2019,7,7,1600,736,1653,2389,Sunday
2019,7,7,1500,878,1419,2297,Sunday
2019,7,7,1400,960,1216,2176,Sunday
2019,7,7,1300,1117,1014,2131,Sunday
2019,7,7,1200,1303,694,1997,Sunday
2019,7,7,1100,1203,470,1673,Sunday
2019,7,7,1000,1057,257,1314,Sunday
2019,7,7,900,746,164,910,Sunday
2019,7,7,800,515,103,618,Sunday
2019,7,7,700,331,34,365,Sunday
2019,7,7,600,141,27,168,Sunday
2019,7,7,500,75,18,93,Sunday
2019,7,7,400,25,31,56,Sunday
2019,7,7,300,19,28,47,Sunday
2019,7,7,200,33,66,99,Sunday
2019,7,7,100,23,96,119,Sunday
2019,7,6,2400,53,166,219,Saturday
2019,7,6,2300,111,316,427,Saturday
2019,7,6,2200,163,426,589,Saturday
2019,7,6,2100,189,702,891,Saturday
2019,7,6,2000,287,814,1101,Saturday
2019,7,6,1900,326,1024,1350,Saturday
2019,7,6,1800,435,1272,1707,Saturday
2019,7,6,1700,511,1222,1733,Saturday
2019,7,6,1600,665,1431,2096,Saturday
2019,7,6,1500,781,1198,1979,Saturday
2019,7,6,1400,935,805,1740,Saturday
2019,7,6,1300,1090,813,1903,Saturday
2019,7,6,1200,1283,614,1897,Saturday
2019,7,6,1100,1280,411,1691,Saturday
2019,7,6,1000,1081,271,1352,Saturday
2019,7,6,900,839,181,1020,Saturday
2019,7,6,800,604,104,708,Saturday
2019,7,6,700,394,77,471,Saturday
2019,7,6,600,208,37,245,Saturday
2019,7,6,500,79,38,117,Saturday
2019,7,6,400,42,40,82,Saturday
2019,7,6,300,28,63,91,Saturday
2019,7,6,200,36,73,109,Saturday
2019,7,6,100,60,111,171,Saturday
2019,7,5,2400,93,154,247,Friday
2019,7,5,2300,138,332,470,Friday
2019,7,5,2200,201,521,722,Friday
2019,7,5,2100,333,619,952,Friday
2019,7,5,2000,459,865,1324,Friday
2019,7,5,1900,594,1092,1686,Friday
2019,7,5,1800,619,1268,1887,Friday
2019,7,5,1700,780,1222,2002,Friday
2019,7,5,1600,859,1136,1995,Friday
2019,7,5,1500,899,927,1826,Friday
2019,7,5,1400,960,913,1873,Friday
2019,7,5,1300,1060,699,1759,Friday
2019,7,5,1200,1305,723,2028,Friday
2019,7,5,1100,1282,512,1794,Friday
2019,7,5,1000,1081,302,1383,Friday
2019,7,5,900,791,165,956,Friday
2019,7,5,800,578,120,698,Friday
2019,7,5,700,322,85,407,Friday
2019,7,5,600,202,58,260,Friday
2019,7,5,500,76,45,121,Friday
2019,7,5,400,40,45,85,Friday
2019,7,5,300,38,42,80,Friday
2019,7,5,200,35,67,102,Friday
2019,7,5,100,55,110,165,Friday
2019,7,4,2400,89,143,232,Thursday
2019,7,4,2300,171,276,447,Thursday
2019,7,4,2200,204,346,550,Thursday
2019,7,4,2100,314,614,928,Thursday
2019,7,4,2000,389,740,1129,Thursday
2019,7,4,1900,443,906,1349,Thursday
2019,7,4,1800,530,1155,1685,Thursday
2019,7,4,1700,603,1213,1816,Thursday
2019,7,4,1600,683,1163,1846,Thursday
2019,7,4,1500,754,998,1752,Thursday
2019,7,4,1400,807,997,1804,Thursday
2019,7,4,1300,924,882,1806,Thursday
2019,7,4,1200,1092,717,1809,Thursday
2019,7,4,1100,1066,536,1602,Thursday
2019,7,4,1000,925,339,1264,Thursday
2019,7,4,900,694,224,918,Thursday
2019,7,4,800,520,138,658,Thursday
2019,7,4,700,310,77,387,Thursday
2019,7,4,600,145,59,204,Thursday
2019,7,4,500,74,39,113,Thursday
2019,7,4,400,47,42,89,Thursday
2019,7,4,300,34,54,88,Thursday
2019,7,4,200,50,59,109,Thursday
2019,7,4,100,49,112,161,Thursday
2019,7,3,2400,79,170,249,Wednesday
2019,7,3,2300,125,312,437,Wednesday
2019,7,3,2200,172,541,713,Wednesday
2019,7,3,2100,214,760,974,Wednesday
2019,7,3,2000,304,981,1285,Wednesday
2019,7,3,1900,351,1199,1550,Wednesday
2019,7,3,1800,474,1389,1863,Wednesday
2019,7,3,1700,561,1265,1826,Wednesday
2019,7,3,1600,645,1195,1840,Wednesday
2019,7,3,1500,743,1060,1803,Wednesday
2019,7,3,1400,874,910,1784,Wednesday
2019,7,3,1300,975,763,1738,Wednesday
2019,7,3,1200,1150,596,1746,Wednesday
2019,7,3,1100,1271,426,1697,Wednesday
2019,7,3,1000,1151,317,1468,Wednesday
2019,7,3,900,938,208,1146,Wednesday
2019,7,3,800,762,140,902,Wednesday
2019,7,3,700,491,73,564,Wednesday
2019,7,3,600,246,46,292,Wednesday
2019,7,3,500,140,42,182,Wednesday
2019,7,3,400,45,39,84,Wednesday
2019,7,3,300,36,73,109,Wednesday
2019,7,3,200,41,76,117,Wednesday
2019,7,3,100,69,121,190,Wednesday
2019,7,2,2400,87,253,340,Tuesday
2019,7,2,2300,127,398,525,Tuesday
2019,7,2,2200,175,611,786,Tuesday
2019,7,2,2100,225,896,1121,Tuesday
2019,7,2,2000,285,1158,1443,Tuesday
2019,7,2,1900,315,1410,1725,Tuesday
2019,7,2,1800,430,1511,1941,Tuesday
2019,7,2,1700,546,1494,2040,Tuesday
2019,7,2,1600,672,1305,1977,Tuesday
2019,7,2,1500,786,1254,2040,Tuesday
2019,7,2,1400,882,1082,1964,Tuesday
2019,7,2,1300,1060,916,1976,Tuesday
2019,7,2,1200,1197,676,1873,Tuesday
2019,7,2,1100,1231,557,1788,Tuesday
2019,7,2,1000,1102,380,1482,Tuesday
2019,7,2,900,834,264,1098,Tuesday
2019,7,2,800,551,169,720,Tuesday
2019,7,2,700,314,120,434,Tuesday
2019,7,2,600,129,46,175,Tuesday
2019,7,2,500,57,40,97,Tuesday
2019,7,2,400,23,31,54,Tuesday
2019,7,2,300,27,38,65,Tuesday
2019,7,2,200,32,65,97,Tuesday
2019,7,2,100,41,116,157,Tuesday
2019,7,1,2400,65,280,345,Monday
2019,7,1,2300,81,460,541,Monday
2019,7,1,2200,128,871,999,Monday
2019,7,1,2100,173,1312,1485,Monday
2019,7,1,2000,248,1789,2037,Monday
2019,7,1,1900,322,2039,2361,Monday
2019,7,1,1800,388,2329,2717,Monday
2019,7,1,1700,517,2176,2693,Monday
2019,7,1,1600,665,2043,2708,Monday
2019,7,1,1500,814,1961,2775,Monday
2019,7,1,1400,911,1563,2474,Monday
2019,7,1,1300,1075,1356,2431,Monday
2019,7,1,1200,1156,1072,2228,Monday
2019,7,1,1100,1209,744,1953,Monday
2019,7,1,1000,1047,395,1442,Monday
2019,7,1,900,972,235,1207,Monday
2019,7,1,800,753,169,922,Monday
2019,7,1,700,476,54,530,Monday
2019,7,1,600,253,26,279,Monday
2019,7,1,500,120,35,155,Monday
2019,7,1,400,52,57,109,Monday
2019,7,1,300,31,63,94,Monday
2019,7,1,200,35,64,99,Monday
2019,7,1,100,48,118,166,Monday
2019,6,30,2400,69,254,323,Sunday
2019,6,30,2300,119,493,612,Sunday
2019,6,30,2200,179,755,934,Sunday
2019,6,30,2100,255,966,1221,Sunday
2019,6,30,2000,315,1347,1662,Sunday
2019,6,30,1900,383,1539,1922,Sunday
2019,6,30,1800,524,1556,2080,Sunday
2019,6,30,1700,671,1513,2184,Sunday
2019,6,30,1600,867,1354,2221,Sunday
2019,6,30,1500,1228,1169,2397,Sunday
2019,6,30,1400,1340,904,2244,Sunday
2019,6,30,1300,1411,785,2196,Sunday
2019,6,30,1200,1355,680,2035,Sunday
2019,6,30,1100,1448,413,1861,Sunday
2019,6,30,1000,1371,236,1607,Sunday
2019,6,30,900,1095,151,1246,Sunday
2019,6,30,800,791,90,881,Sunday
2019,6,30,700,436,45,481,Sunday
2019,6,30,600,214,31,245,Sunday
2019,6,30,500,100,26,126,Sunday
2019,6,30,400,26,25,51,Sunday
2019,6,30,300,33,29,62,Sunday
2019,6,30,200,37,51,88,Sunday
2019,6,30,100,49,64,113,Sunday
2019,6,29,2400,91,176,267,Saturday
2019,6,29,2300,162,247,409,Saturday
2019,6,29,2200,196,439,635,Saturday
2019,6,29,2100,234,646,880,Saturday
2019,6,29,2000,337,786,1123,Saturday
2019,6,29,1900,491,1093,1584,Saturday
2019,6,29,1800,600,1240,1840,Saturday
2019,6,29,1700,758,1105,1863,Saturday
2019,6,29,1600,1012,1074,2086,Saturday
2019,6,29,1500,1484,856,2340,Saturday
2019,6,29,1400,1337,732,2069,Saturday
2019,6,29,1300,1540,731,2271,Saturday
2019,6,29,1200,1720,568,2288,Saturday
2019,6,29,1100,1777,391,2168,Saturday
2019,6,29,1000,1733,292,2025,Saturday
2019,6,29,900,1476,190,1666,Saturday
2019,6,29,800,962,129,1091,Saturday
2019,6,29,700,565,80,645,Saturday
2019,6,29,600,295,56,351,Saturday
2019,6,29,500,145,35,180,Saturday
2019,6,29,400,74,44,118,Saturday
2019,6,29,300,53,67,120,Saturday
2019,6,29,200,54,73,127,Saturday
2019,6,29,100,92,114,206,Saturday
2019,6,28,2400,207,181,388,Friday
2019,6,28,2300,312,286,598,Friday
2019,6,28,2200,500,315,815,Friday
2019,6,28,2100,747,528,1275,Friday
2019,6,28,2000,1188,635,1823,Friday
2019,6,28,1900,1452,1090,2542,Friday
2019,6,28,1800,1524,1012,2536,Friday
2019,6,28,1700,1693,1017,2710,Friday
2019,6,28,1600,1626,924,2550,Friday
2019,6,28,1500,1591,821,2412,Friday
2019,6,28,1400,1531,747,2278,Friday
2019,6,28,1300,1614,687,2301,Friday
2019,6,28,1200,1750,616,2366,Friday
2019,6,28,1100,1843,424,2267,Friday
2019,6,28,1000,1624,289,1913,Friday
2019,6,28,900,1270,198,1468,Friday
2019,6,28,800,923,145,1068,Friday
2019,6,28,700,546,87,633,Friday
2019,6,28,600,225,48,273,Friday
2019,6,28,500,108,51,159,Friday
2019,6,28,400,56,39,95,Friday
2019,6,28,300,69,44,113,Friday
2019,6,28,200,55,59,114,Friday
2019,6,28,100,73,99,172,Friday
2019,6,27,2400,113,118,231,Thursday
2019,6,27,2300,202,228,430,Thursday
2019,6,27,2200,303,314,617,Thursday
2019,6,27,2100,534,320,854,Thursday
2019,6,27,2000,732,550,1282,Thursday
2019,6,27,1900,809,828,1637,Thursday
2019,6,27,1800,825,880,1705,Thursday
2019,6,27,1700,948,830,1778,Thursday
2019,6,27,1600,950,801,1751,Thursday
2019,6,27,1500,873,737,1610,Thursday
2019,6,27,1400,924,639,1563,Thursday
2019,6,27,1300,1071,572,1643,Thursday
2019,6,27,1200,1113,493,1606,Thursday
2019,6,27,1100,1063,388,1451,Thursday
2019,6,27,1000,942,257,1199,Thursday
2019,6,27,900,779,185,964,Thursday
2019,6,27,800,542,130,672,Thursday
2019,6,27,700,287,79,366,Thursday
2019,6,27,600,128,53,181,Thursday
2019,6,27,500,54,51,105,Thursday
2019,6,27,400,41,45,86,Thursday
2019,6,27,300,36,39,75,Thursday
2019,6,27,200,44,46,90,Thursday
2019,6,27,100,55,89,144,Thursday
2019,6,26,2400,110,143,253,Wednesday
2019,6,26,2300,120,166,286,Wednesday
2019,6,26,2200,217,349,566,Wednesday
2019,6,26,2100,283,444,727,Wednesday
2019,6,26,2000,357,609,966,Wednesday
2019,6,26,1900,385,765,1150,Wednesday
2019,6,26,1800,461,944,1405,Wednesday
2019,6,26,1700,497,806,1303,Wednesday
2019,6,26,1600,570,794,1364,Wednesday
2019,6,26,1500,595,693,1288,Wednesday
2019,6,26,1400,775,622,1397,Wednesday
2019,6,26,1300,699,538,1237,Wednesday
2019,6,26,1200,906,402,1308,Wednesday
2019,6,26,1100,894,359,1253,Wednesday
2019,6,26,1000,880,234,1114,Wednesday
2019,6,26,900,695,166,861,Wednesday
2019,6,26,800,514,100,614,Wednesday
2019,6,26,700,297,72,369,Wednesday
2019,6,26,600,169,49,218,Wednesday
2019,6,26,500,54,48,102,Wednesday
2019,6,26,400,28,39,67,Wednesday
2019,6,26,300,31,50,81,Wednesday
2019,6,26,200,49,76,125,Wednesday
2019,6,26,100,56,90,146,Wednesday
2019,6,25,2400,78,126,204,Tuesday
2019,6,25,2300,105,220,325,Tuesday
2019,6,25,2200,156,404,560,Tuesday
2019,6,25,2100,242,448,690,Tuesday
2019,6,25,2000,282,559,841,Tuesday
2019,6,25,1900,274,750,1024,Tuesday
2019,6,25,1800,343,948,1291,Tuesday
2019,6,25,1700,414,869,1283,Tuesday
2019,6,25,1600,467,785,1252,Tuesday
2019,6,25,1500,531,627,1158,Tuesday
2019,6,25,1400,558,529,1087,Tuesday
2019,6,25,1300,631,448,1079,Tuesday
2019,6,25,1200,763,485,1248,Tuesday
2019,6,25,1100,859,305,1164,Tuesday
2019,6,25,1000,882,242,1124,Tuesday
2019,6,25,900,731,157,888,Tuesday
2019,6,25,800,601,121,722,Tuesday
2019,6,25,700,314,62,376,Tuesday
2019,6,25,600,151,52,203,Tuesday
2019,6,25,500,69,35,104,Tuesday
2019,6,25,400,31,32,63,Tuesday
2019,6,25,300,30,46,76,Tuesday
2019,6,25,200,40,58,98,Tuesday
2019,6,25,100,49,80,129,Tuesday
2019,6,24,2400,68,112,180,Monday
2019,6,24,2300,95,240,335,Monday
2019,6,24,2200,151,388,539,Monday
2019,6,24,2100,218,490,708,Monday
2019,6,24,2000,231,788,1019,Monday
2019,6,24,1900,257,1157,1414,Monday
2019,6,24,1800,337,932,1269,Monday
2019,6,24,1700,540,837,1377,Monday
2019,6,24,1600,558,898,1456,Monday
2019,6,24,1500,600,731,1331,Monday
2019,6,24,1400,696,683,1379,Monday
2019,6,24,1300,907,572,1479,Monday
2019,6,24,1200,959,468,1427,Monday
2019,6,24,1100,964,366,1330,Monday
2019,6,24,1000,938,233,1171,Monday
2019,6,24,900,834,133,967,Monday
2019,6,24,800,595,134,729,Monday
2019,6,24,700,286,69,355,Monday
2019,6,24,600,137,42,179,Monday
2019,6,24,500,64,19,83,Monday
2019,6,24,400,25,19,44,Monday
2019,6,24,300,25,26,51,Monday
2019,6,24,200,31,51,82,Monday
2019,6,24,100,30,79,109,Monday
2019,6,23,2400,42,148,190,Sunday
2019,6,23,2300,71,277,348,Sunday
2019,6,23,2200,128,407,535,Sunday
2019,6,23,2100,195,654,849,Sunday
2019,6,23,2000,227,885,1112,Sunday
2019,6,23,1900,295,1123,1418,Sunday
2019,6,23,1800,361,1236,1597,Sunday
2019,6,23,1700,457,1422,1879,Sunday
2019,6,23,1600,589,1178,1767,Sunday
2019,6,23,1500,614,1089,1703,Sunday
2019,6,23,1400,635,1051,1686,Sunday
2019,6,23,1300,763,1015,1778,Sunday
2019,6,23,1200,841,711,1552,Sunday
2019,6,23,1100,839,461,1300,Sunday
2019,6,23,1000,692,258,950,Sunday
2019,6,23,900,521,131,652,Sunday
2019,6,23,800,440,70,510,Sunday
2019,6,23,700,183,32,215,Sunday
2019,6,23,600,84,16,100,Sunday
2019,6,23,500,34,23,57,Sunday
2019,6,23,400,29,17,46,Sunday
2019,6,23,300,25,22,47,Sunday
2019,6,23,200,24,44,68,Sunday
2019,6,23,100,27,69,96,Sunday
2019,6,22,2400,54,130,184,Saturday
2019,6,22,2300,73,234,307,Saturday
2019,6,22,2200,154,347,501,Saturday
2019,6,22,2100,181,547,728,Saturday
2019,6,22,2000,226,700,926,Saturday
2019,6,22,1900,283,1076,1359,Saturday
2019,6,22,1800,330,1098,1428,Saturday
2019,6,22,1700,430,1006,1436,Saturday
2019,6,22,1600,508,849,1357,Saturday
2019,6,22,1500,594,742,1336,Saturday
2019,6,22,1400,638,638,1276,Saturday
2019,6,22,1300,747,573,1320,Saturday
2019,6,22,1200,830,430,1260,Saturday
2019,6,22,1100,1077,386,1463,Saturday
2019,6,22,1000,1044,212,1256,Saturday
2019,6,22,900,853,177,1030,Saturday
2019,6,22,800,660,81,741,Saturday
2019,6,22,700,382,48,430,Saturday
2019,6,22,600,136,47,183,Saturday
2019,6,22,500,85,31,116,Saturday
2019,6,22,400,35,22,57,Saturday
2019,6,22,300,33,43,76,Saturday
2019,6,22,200,30,47,77,Saturday
2019,6,22,100,51,79,130,Saturday
2019,6,21,2400,103,131,234,Friday
2019,6,21,2300,115,224,339,Friday
2019,6,21,2200,232,365,597,Friday
2019,6,21,2100,333,426,759,Friday
2019,6,21,2000,523,586,1109,Friday
2019,6,21,1900,661,727,1388,Friday
2019,6,21,1800,638,871,1509,Friday
2019,6,21,1700,740,770,1510,Friday
2019,6,21,1600,815,769,1584,Friday
2019,6,21,1500,860,588,1448,Friday
2019,6,21,1400,760,618,1378,Friday
2019,6,21,1300,818,472,1290,Friday
2019,6,21,1200,1020,432,1452,Friday
2019,6,21,1100,1071,307,1378,Friday
2019,6,21,1000,870,210,1080,Friday
2019,6,21,900,676,143,819,Friday
2019,6,21,800,467,100,567,Friday
2019,6,21,700,246,61,307,Friday
2019,6,21,600,74,55,129,Friday
2019,6,21,500,46,41,87,Friday
2019,6,21,400,41,49,90,Friday
2019,6,21,300,38,43,81,Friday
2019,6,21,200,46,46,92,Friday
2019,6,21,100,53,83,136,Friday
2019,6,20,2400,87,108,195,Thursday
2019,6,20,2300,104,174,278,Thursday
2019,6,20,2200,187,470,657,Thursday
2019,6,20,2100,258,406,664,Thursday
2019,6,20,2000,387,455,842,Thursday
2019,6,20,1900,434,567,1001,Thursday
2019,6,20,1800,441,799,1240,Thursday
2019,6,20,1700,526,738,1264,Thursday
2019,6,20,1600,607,675,1282,Thursday
2019,6,20,1500,651,620,1271,Thursday
2019,6,20,1400,662,596,1258,Thursday
2019,6,20,1300,703,611,1314,Thursday
2019,6,20,1200,879,424,1303,Thursday
2019,6,20,1100,951,376,1327,Thursday
2019,6,20,1000,822,215,1037,Thursday
2019,6,20,900,632,153,785,Thursday
2019,6,20,800,481,77,558,Thursday
2019,6,20,700,247,64,311,Thursday
2019,6,20,600,76,53,129,Thursday
2019,6,20,500,42,50,92,Thursday
2019,6,20,400,32,44,76,Thursday
2019,6,20,300,43,45,88,Thursday
2019,6,20,200,44,47,91,Thursday
2019,6,20,100,46,76,122,Thursday
2019,6,19,2400,88,113,201,Wednesday
2019,6,19,2300,102,168,270,Wednesday
2019,6,19,2200,158,269,427,Wednesday
2019,6,19,2100,215,384,599,Wednesday
2019,6,19,2000,255,434,689,Wednesday
2019,6,19,1900,285,565,850,Wednesday
2019,6,19,1800,344,741,1085,Wednesday
2019,6,19,1700,445,875,1320,Wednesday
2019,6,19,1600,441,743,1184,Wednesday
2019,6,19,1500,470,577,1047,Wednesday
2019,6,19,1400,512,591,1103,Wednesday
2019,6,19,1300,595,476,1071,Wednesday
2019,6,19,1200,752,391,1143,Wednesday
2019,6,19,1100,812,339,1151,Wednesday
2019,6,19,1000,738,182,920,Wednesday
2019,6,19,900,589,160,749,Wednesday
2019,6,19,800,487,112,599,Wednesday
2019,6,19,700,257,66,323,Wednesday
2019,6,19,600,90,59,149,Wednesday
2019,6,19,500,45,34,79,Wednesday
2019,6,19,400,22,39,61,Wednesday
2019,6,19,300,28,44,72,Wednesday
2019,6,19,200,37,53,90,Wednesday
2019,6,19,100,64,70,134,Wednesday
2019,6,18,2400,76,109,185,Tuesday
2019,6,18,2300,96,190,286,Tuesday
2019,6,18,2200,146,342,488,Tuesday
2019,6,18,2100,223,482,705,Tuesday
2019,6,18,2000,217,571,788,Tuesday
2019,6,18,1900,240,780,1020,Tuesday
2019,6,18,1800,280,923,1203,Tuesday
2019,6,18,1700,357,823,1180,Tuesday
2019,6,18,1600,403,824,1227,Tuesday
2019,6,18,1500,480,629,1109,Tuesday
2019,6,18,1400,579,561,1140,Tuesday
2019,6,18,1300,658,451,1109,Tuesday
2019,6,18,1200,776,390,1166,Tuesday
2019,6,18,1100,892,302,1194,Tuesday
2019,6,18,1000,842,235,1077,Tuesday
2019,6,18,900,704,155,859,Tuesday
2019,6,18,800,554,115,669,Tuesday
2019,6,18,700,296,73,369,Tuesday
2019,6,18,600,126,65,191,Tuesday
2019,6,18,500,73,38,111,Tuesday
2019,6,18,400,33,63,96,Tuesday
2019,6,18,300,31,52,83,Tuesday
2019,6,18,200,36,58,94,Tuesday
2019,6,18,100,64,93,157,Tuesday
2019,6,17,2400,67,131,198,Monday
2019,6,17,2300,105,242,347,Monday
2019,6,17,2200,130,359,489,Monday
2019,6,17,2100,222,506,728,Monday
2019,6,17,2000,235,653,888,Monday
2019,6,17,1900,254,873,1127,Monday
2019,6,17,1800,331,1103,1434,Monday
2019,6,17,1700,430,875,1305,Monday
2019,6,17,1600,462,780,1242,Monday
2019,6,17,1500,584,778,1362,Monday
2019,6,17,1400,640,647,1287,Monday
2019,6,17,1300,632,567,1199,Monday
2019,6,17,1200,692,459,1151,Monday
2019,6,17,1100,784,346,1130,Monday
2019,6,17,1000,859,249,1108,Monday
2019,6,17,900,701,188,889,Monday
2019,6,17,800,545,115,660,Monday
2019,6,17,700,285,84,369,Monday
2019,6,17,600,115,27,142,Monday
2019,6,17,500,54,72,126,Monday
2019,6,17,400,33,18,51,Monday
2019,6,17,300,22,9,31,Monday
2019,6,17,200,27,46,73,Monday
2019,6,17,100,33,77,110,Monday
2019,6,16,2400,49,169,218,Sunday
2019,6,16,2300,98,329,427,Sunday
2019,6,16,2200,113,515,628,Sunday
2019,6,16,2100,190,782,972,Sunday
2019,6,16,2000,206,1062,1268,Sunday
2019,6,16,1900,281,1383,1664,Sunday
2019,6,16,1800,359,1504,1863,Sunday
2019,6,16,1700,461,1554,2015,Sunday
2019,6,16,1600,542,1441,1983,Sunday
2019,6,16,1500,711,1382,2093,Sunday
2019,6,16,1400,842,1152,1994,Sunday
2019,6,16,1300,919,999,1918,Sunday
2019,6,16,1200,1092,766,1858,Sunday
2019,6,16,1100,1126,505,1631,Sunday
2019,6,16,1000,999,268,1267,Sunday
2019,6,16,900,684,143,827,Sunday
2019,6,16,800,496,98,594,Sunday
2019,6,16,700,228,44,272,Sunday
2019,6,16,600,111,45,156,Sunday
2019,6,16,500,56,22,78,Sunday
2019,6,16,400,25,16,41,Sunday
2019,6,16,300,31,28,59,Sunday
2019,6,16,200,24,38,62,Sunday
2019,6,16,100,29,74,103,Sunday
2019,6,15,2400,45,160,205,Saturday
2019,6,15,2300,91,229,320,Saturday
2019,6,15,2200,127,401,528,Saturday
2019,6,15,2100,192,521,713,Saturday
2019,6,15,2000,218,692,910,Saturday
2019,6,15,1900,235,981,1216,Saturday
2019,6,15,1800,346,1001,1347,Saturday
2019,6,15,1700,418,967,1385,Saturday
2019,6,15,1600,515,893,1408,Saturday
2019,6,15,1500,624,701,1325,Saturday
2019,6,15,1400,672,540,1212,Saturday
2019,6,15,1300,778,511,1289,Saturday
2019,6,15,1200,988,421,1409,Saturday
2019,6,15,1100,1070,327,1397,Saturday
2019,6,15,1000,996,230,1226,Saturday
2019,6,15,900,811,144,955,Saturday
2019,6,15,800,577,103,680,Saturday
2019,6,15,700,302,59,361,Saturday
2019,6,15,600,133,59,192,Saturday
2019,6,15,500,62,30,92,Saturday
2019,6,15,400,42,30,72,Saturday
2019,6,15,300,27,39,66,Saturday
2019,6,15,200,30,54,84,Saturday
2019,6,15,100,58,67,125,Saturday
2019,6,14,2400,85,119,204,Friday
2019,6,14,2300,151,208,359,Friday
2019,6,14,2200,248,259,507,Friday
2019,6,14,2100,498,450,948,Friday
2019,6,14,2000,779,496,1275,Friday
2019,6,14,1900,823,752,1575,Friday
2019,6,14,1800,762,864,1626,Friday
2019,6,14,1700,807,707,1514,Friday
2019,6,14,1600,780,799,1579,Friday
2019,6,14,1500,851,621,1472,Friday
2019,6,14,1400,789,591,1380,Friday
2019,6,14,1300,779,548,1327,Friday
2019,6,14,1200,925,447,1372,Friday
2019,6,14,1100,1068,391,1459,Friday
2019,6,14,1000,909,189,1098,Friday
2019,6,14,900,687,131,818,Friday
2019,6,14,800,480,92,572,Friday
2019,6,14,700,272,93,365,Friday
2019,6,14,600,108,70,178,Friday
2019,6,14,500,43,40,83,Friday
2019,6,14,400,36,39,75,Friday
2019,6,14,300,39,43,82,Friday
2019,6,14,200,51,54,105,Friday
2019,6,14,100,60,60,120,Friday
2019,6,13,2400,89,129,218,Thursday
2019,6,13,2300,147,151,298,Thursday
2019,6,13,2200,180,242,422,Thursday
2019,6,13,2100,285,339,624,Thursday
2019,6,13,2000,391,630,1021,Thursday
2019,6,13,1900,383,725,1108,Thursday
2019,6,13,1800,468,936,1404,Thursday
2019,6,13,1700,496,753,1249,Thursday
2019,6,13,1600,570,664,1234,Thursday
2019,6,13,1500,561,650,1211,Thursday
2019,6,13,1400,595,550,1145,Thursday
2019,6,13,1300,692,465,1157,Thursday
2019,6,13,1200,852,414,1266,Thursday
2019,6,13,1100,924,381,1305,Thursday
2019,6,13,1000,827,225,1052,Thursday
2019,6,13,900,710,178,888,Thursday
2019,6,13,800,572,116,688,Thursday
2019,6,13,700,268,65,333,Thursday
2019,6,13,600,125,54,179,Thursday
2019,6,13,500,66,40,106,Thursday
2019,6,13,400,35,37,72,Thursday
2019,6,13,300,26,43,69,Thursday
2019,6,13,200,41,65,106,Thursday
2019,6,13,100,59,72,131,Thursday
2019,6,12,2400,88,121,209,Wednesday
2019,6,12,2300,91,218,309,Wednesday
2019,6,12,2200,188,317,505,Wednesday
2019,6,12,2100,202,407,609,Wednesday
2019,6,12,2000,267,577,844,Wednesday
2019,6,12,1900,284,723,1007,Wednesday
2019,6,12,1800,363,996,1359,Wednesday
2019,6,12,1700,446,757,1203,Wednesday
2019,6,12,1600,499,761,1260,Wednesday
2019,6,12,1500,480,636,1116,Wednesday
2019,6,12,1400,625,487,1112,Wednesday
2019,6,12,1300,689,437,1126,Wednesday
2019,6,12,1200,803,406,1209,Wednesday
2019,6,12,1100,862,292,1154,Wednesday
2019,6,12,1000,752,204,956,Wednesday
2019,6,12,900,654,170,824,Wednesday
2019,6,12,800,593,109,702,Wednesday
2019,6,12,700,246,54,300,Wednesday
2019,6,12,600,98,53,151,Wednesday
2019,6,12,500,63,52,115,Wednesday
2019,6,12,400,36,39,75,Wednesday
2019,6,12,300,29,52,81,Wednesday
2019,6,12,200,36,61,97,Wednesday
2019,6,12,100,58,98,156,Wednesday
2019,6,11,2400,71,90,161,Tuesday
2019,6,11,2300,108,179,287,Tuesday
2019,6,11,2200,138,309,447,Tuesday
2019,6,11,2100,165,430,595,Tuesday
2019,6,11,2000,211,538,749,Tuesday
2019,6,11,1900,218,744,962,Tuesday
2019,6,11,1800,293,830,1123,Tuesday
2019,6,11,1700,330,670,1000,Tuesday
2019,6,11,1600,387,678,1065,Tuesday
2019,6,11,1500,452,551,1003,Tuesday
2019,6,11,1400,504,529,1033,Tuesday
2019,6,11,1300,585,449,1034,Tuesday
2019,6,11,1200,729,369,1098,Tuesday
2019,6,11,1100,815,275,1090,Tuesday
2019,6,11,1000,803,250,1053,Tuesday
2019,6,11,900,665,150,815,Tuesday
2019,6,11,800,510,103,613,Tuesday
2019,6,11,700,242,64,306,Tuesday
2019,6,11,600,98,47,145,Tuesday
2019,6,11,500,52,38,90,Tuesday
2019,6,11,400,27,55,82,Tuesday
2019,6,11,300,24,31,55,Tuesday
2019,6,11,200,32,51,83,Tuesday
2019,6,11,100,46,74,120,Tuesday
2019,6,10,2400,66,102,168,Monday
2019,6,10,2300,102,159,261,Monday
2019,6,10,2200,123,274,397,Monday
2019,6,10,2100,151,372,523,Monday
2019,6,10,2000,191,556,747,Monday
2019,6,10,1900,211,764,975,Monday
2019,6,10,1800,298,963,1261,Monday
2019,6,10,1700,369,829,1198,Monday
2019,6,10,1600,449,838,1287,Monday
2019,6,10,1500,504,609,1113,Monday
2019,6,10,1400,530,622,1152,Monday
2019,6,10,1300,707,527,1234,Monday
2019,6,10,1200,803,369,1172,Monday
2019,6,10,1100,909,284,1193,Monday
2019,6,10,1000,813,223,1036,Monday
2019,6,10,900,652,157,809,Monday
2019,6,10,800,455,75,530,Monday
2019,6,10,700,230,50,280,Monday
2019,6,10,600,85,31,116,Monday
2019,6,10,500,50,32,82,Monday
2019,6,10,400,22,30,52,Monday
2019,6,10,300,22,22,44,Monday
2019,6,10,200,26,37,63,Monday
2019,6,10,100,23,72,95,Monday
2019,6,9,2400,53,141,194,Sunday
2019,6,9,2300,103,246,349,Sunday
2019,6,9,2200,128,443,571,Sunday
2019,6,9,2100,160,612,772,Sunday
2019,6,9,2000,217,827,1044,Sunday
2019,6,9,1900,276,1043,1319,Sunday
2019,6,9,1800,341,1336,1677,Sunday
2019,6,9,1700,411,1347,1758,Sunday
2019,6,9,1600,595,1156,1751,Sunday
2019,6,9,1500,716,1043,1759,Sunday
2019,6,9,1400,746,895,1641,Sunday
2019,6,9,1300,744,779,1523,Sunday
2019,6,9,1200,856,572,1428,Sunday
2019,6,9,1100,868,383,1251,Sunday
2019,6,9,1000,831,223,1054,Sunday
2019,6,9,900,607,115,722,Sunday
2019,6,9,800,440,62,502,Sunday
2019,6,9,700,186,31,217,Sunday
2019,6,9,600,67,17,84,Sunday
2019,6,9,500,47,20,67,Sunday
2019,6,9,400,31,24,55,Sunday
2019,6,9,300,17,24,41,Sunday
2019,6,9,200,17,29,46,Sunday
2019,6,9,100,31,41,72,Sunday
2019,6,8,2400,55,71,126,Saturday
2019,6,8,2300,71,174,245,Saturday
2019,6,8,2200,97,259,356,Saturday
2019,6,8,2100,154,454,608,Saturday
2019,6,8,2000,162,562,724,Saturday
2019,6,8,1900,236,713,949,Saturday
2019,6,8,1800,312,824,1136,Saturday
2019,6,8,1700,443,841,1284,Saturday
2019,6,8,1600,479,734,1213,Saturday
2019,6,8,1500,592,645,1237,Saturday
2019,6,8,1400,610,561,1171,Saturday
2019,6,8,1300,789,436,1225,Saturday
2019,6,8,1200,898,388,1286,Saturday
2019,6,8,1100,990,254,1244,Saturday
2019,6,8,1000,792,226,1018,Saturday
2019,6,8,900,612,140,752,Saturday
2019,6,8,800,345,107,452,Saturday
2019,6,8,700,185,68,253,Saturday
2019,6,8,600,84,35,119,Saturday
2019,6,8,500,48,27,75,Saturday
2019,6,8,400,24,25,49,Saturday
2019,6,8,300,29,33,62,Saturday
2019,6,8,200,33,34,67,Saturday
2019,6,8,100,36,60,96,Saturday
2019,6,7,2400,64,103,167,Friday
2019,6,7,2300,131,153,284,Friday
2019,6,7,2200,194,199,393,Friday
2019,6,7,2100,303,314,617,Friday
2019,6,7,2000,466,406,872,Friday
2019,6,7,1900,519,498,1017,Friday
2019,6,7,1800,627,656,1283,Friday
2019,6,7,1700,667,691,1358,Friday
2019,6,7,1600,740,644,1384,Friday
2019,6,7,1500,619,616,1235,Friday
2019,6,7,1400,626,532,1158,Friday
2019,6,7,1300,689,450,1139,Friday
2019,6,7,1200,753,420,1173,Friday
2019,6,7,1100,802,343,1145,Friday
2019,6,7,1000,631,259,890,Friday
2019,6,7,900,556,173,729,Friday
2019,6,7,800,369,107,476,Friday
2019,6,7,700,177,65,242,Friday
2019,6,7,600,82,42,124,Friday
2019,6,7,500,29,37,66,Friday
2019,6,7,400,40,33,73,Friday
2019,6,7,300,27,41,68,Friday
2019,6,7,200,47,53,100,Friday
2019,6,7,100,50,68,118,Friday
2019,6,6,2400,70,96,166,Thursday
2019,6,6,2300,105,185,290,Thursday
2019,6,6,2200,189,265,454,Thursday
2019,6,6,2100,246,396,642,Thursday
2019,6,6,2000,379,474,853,Thursday
2019,6,6,1900,384,835,1219,Thursday
2019,6,6,1800,467,801,1268,Thursday
2019,6,6,1700,517,675,1192,Thursday
2019,6,6,1600,574,738,1312,Thursday
2019,6,6,1500,621,646,1267,Thursday
2019,6,6,1400,614,612,1226,Thursday
2019,6,6,1300,728,511,1239,Thursday
2019,6,6,1200,831,483,1314,Thursday
2019,6,6,1100,994,294,1288,Thursday
2019,6,6,1000,943,212,1155,Thursday
2019,6,6,900,689,167,856,Thursday
2019,6,6,800,430,82,512,Thursday
2019,6,6,700,201,58,259,Thursday
2019,6,6,600,87,41,128,Thursday
2019,6,6,500,47,45,92,Thursday
2019,6,6,400,46,29,75,Thursday
2019,6,6,300,30,32,62,Thursday
2019,6,6,200,46,31,77,Thursday
2019,6,6,100,52,70,122,Thursday
2019,6,5,2400,79,127,206,Wednesday
2019,6,5,2300,100,165,265,Wednesday
2019,6,5,2200,138,263,401,Wednesday
2019,6,5,2100,175,343,518,Wednesday
2019,6,5,2000,218,462,680,Wednesday
2019,6,5,1900,249,659,908,Wednesday
2019,6,5,1800,312,843,1155,Wednesday
2019,6,5,1700,413,821,1234,Wednesday
2019,6,5,1600,440,765,1205,Wednesday
2019,6,5,1500,518,671,1189,Wednesday
2019,6,5,1400,603,533,1136,Wednesday
2019,6,5,1300,660,533,1193,Wednesday
2019,6,5,1200,828,369,1197,Wednesday
2019,6,5,1100,915,329,1244,Wednesday
2019,6,5,1000,810,211,1021,Wednesday
2019,6,5,900,634,151,785,Wednesday
2019,6,5,800,436,111,547,Wednesday
2019,6,5,700,225,66,291,Wednesday
2019,6,5,600,84,46,130,Wednesday
2019,6,5,500,41,36,77,Wednesday
2019,6,5,400,27,32,59,Wednesday
2019,6,5,300,35,39,74,Wednesday
2019,6,5,200,49,45,94,Wednesday
2019,6,5,100,47,69,116,Wednesday
2019,6,4,2400,71,109,180,Tuesday
2019,6,4,2300,82,144,226,Tuesday
2019,6,4,2200,120,261,381,Tuesday
2019,6,4,2100,155,341,496,Tuesday
2019,6,4,2000,214,535,749,Tuesday
2019,6,4,1900,250,715,965,Tuesday
2019,6,4,1800,277,785,1062,Tuesday
2019,6,4,1700,401,800,1201,Tuesday
2019,6,4,1600,426,711,1137,Tuesday
2019,6,4,1500,460,612,1072,Tuesday
2019,6,4,1400,556,513,1069,Tuesday
2019,6,4,1300,611,420,1031,Tuesday
2019,6,4,1200,719,382,1101,Tuesday
2019,6,4,1100,883,293,1176,Tuesday
2019,6,4,1000,763,198,961,Tuesday
2019,6,4,900,666,154,820,Tuesday
2019,6,4,800,420,95,515,Tuesday
2019,6,4,700,208,63,271,Tuesday
2019,6,4,600,89,29,118,Tuesday
2019,6,4,500,42,45,87,Tuesday
2019,6,4,400,22,39,61,Tuesday
2019,6,4,300,33,48,81,Tuesday
2019,6,4,200,43,49,92,Tuesday
2019,6,4,100,55,76,131,Tuesday
2019,6,3,2400,64,102,166,Monday
2019,6,3,2300,90,184,274,Monday
2019,6,3,2200,103,266,369,Monday
2019,6,3,2100,193,420,613,Monday
2019,6,3,2000,200,549,749,Monday
2019,6,3,1900,202,795,997,Monday
2019,6,3,1800,351,946,1297,Monday
2019,6,3,1700,409,842,1251,Monday
2019,6,3,1600,524,831,1355,Monday
2019,6,3,1500,552,684,1236,Monday
2019,6,3,1400,598,614,1212,Monday
2019,6,3,1300,676,487,1163,Monday
2019,6,3,1200,870,440,1310,Monday
2019,6,3,1100,871,319,1190,Monday
2019,6,3,1000,806,213,1019,Monday
2019,6,3,900,619,147,766,Monday
2019,6,3,800,384,93,477,Monday
2019,6,3,700,200,67,267,Monday
2019,6,3,600,80,25,105,Monday
2019,6,3,500,51,26,77,Monday
2019,6,3,400,26,27,53,Monday
2019,6,3,300,14,40,54,Monday
2019,6,3,200,30,41,71,Monday
2019,6,3,100,43,72,115,Monday
2019,6,2,2400,50,116,166,Sunday
2019,6,2,2300,74,252,326,Sunday
2019,6,2,2200,128,361,489,Sunday
2019,6,2,2100,161,568,729,Sunday
2019,6,2,2000,196,882,1078,Sunday
2019,6,2,1900,256,1142,1398,Sunday
2019,6,2,1800,321,1270,1591,Sunday
2019,6,2,1700,356,1339,1695,Sunday
2019,6,2,1600,533,1239,1772,Sunday
2019,6,2,1500,541,1076,1617,Sunday
2019,6,2,1400,679,983,1662,Sunday
2019,6,2,1300,756,807,1563,Sunday
2019,6,2,1200,905,613,1518,Sunday
2019,6,2,1100,869,355,1224,Sunday
2019,6,2,1000,785,229,1014,Sunday
2019,6,2,900,568,153,721,Sunday
2019,6,2,800,318,74,392,Sunday
2019,6,2,700,159,33,192,Sunday
2019,6,2,600,60,28,88,Sunday
2019,6,2,500,35,15,50,Sunday
2019,6,2,400,28,17,45,Sunday
2019,6,2,300,33,20,53,Sunday
2019,6,2,200,23,33,56,Sunday
2019,6,2,100,36,69,105,Sunday
2019,6,1,2400,50,96,146,Saturday
2019,6,1,2300,80,150,230,Saturday
2019,6,1,2200,133,275,408,Saturday
2019,6,1,2100,124,416,540,Saturday
2019,6,1,2000,205,540,745,Saturday
2019,6,1,1900,255,721,976,Saturday
2019,6,1,1800,318,898,1216,Saturday
2019,6,1,1700,393,915,1308,Saturday
2019,6,1,1600,445,784,1229,Saturday
2019,6,1,1500,549,666,1215,Saturday
2019,6,1,1400,664,542,1206,Saturday
2019,6,1,1300,831,420,1251,Saturday
2019,6,1,1200,961,381,1342,Saturday
2019,6,1,1100,1025,287,1312,Saturday
2019,6,1,1000,894,168,1062,Saturday
2019,6,1,900,671,131,802,Saturday
2019,6,1,800,394,99,493,Saturday
2019,6,1,700,205,67,272,Saturday
2019,6,1,600,109,46,155,Saturday
2019,6,1,500,38,28,66,Saturday
2019,6,1,400,29,45,74,Saturday
2019,6,1,300,29,38,67,Saturday
2019,6,1,200,29,41,70,Saturday
2019,6,1,100,33,70,103,Saturday
2019,5,31,2400,82,98,180,Friday
2019,5,31,2300,119,147,266,Friday
2019,5,31,2200,249,213,462,Friday
2019,5,31,2100,375,290,665,Friday
2019,5,31,2000,615,504,1119,Friday
2019,5,31,1900,613,634,1247,Friday
2019,5,31,1800,750,779,1529,Friday
2019,5,31,1700,762,710,1472,Friday
2019,5,31,1600,724,785,1509,Friday
2019,5,31,1500,715,578,1293,Friday
2019,5,31,1400,760,468,1228,Friday
2019,5,31,1300,770,444,1214,Friday
2019,5,31,1200,927,348,1275,Friday
2019,5,31,1100,878,298,1176,Friday
2019,5,31,1000,841,239,1080,Friday
2019,5,31,900,603,142,745,Friday
2019,5,31,800,336,93,429,Friday
2019,5,31,700,203,50,253,Friday
2019,5,31,600,89,57,146,Friday
2019,5,31,500,43,44,87,Friday
2019,5,31,400,28,45,73,Friday
2019,5,31,300,35,38,73,Friday
2019,5,31,200,43,60,103,Friday
2019,5,31,100,42,62,104,Friday
2019,5,30,2400,89,97,186,Thursday
2019,5,30,2300,135,127,262,Thursday
2019,5,30,2200,173,226,399,Thursday
2019,5,30,2100,248,489,737,Thursday
2019,5,30,2000,319,524,843,Thursday
2019,5,30,1900,360,623,983,Thursday
2019,5,30,1800,398,649,1047,Thursday
2019,5,30,1700,441,599,1040,Thursday
2019,5,30,1600,483,570,1053,Thursday
2019,5,30,1500,561,588,1149,Thursday
2019,5,30,1400,613,512,1125,Thursday
2019,5,30,1300,634,394,1028,Thursday
2019,5,30,1200,720,359,1079,Thursday
2019,5,30,1100,748,259,1007,Thursday
2019,5,30,1000,770,214,984,Thursday
2019,5,30,900,533,139,672,Thursday
2019,5,30,800,353,93,446,Thursday
2019,5,30,700,177,73,250,Thursday
2019,5,30,600,75,96,171,Thursday
2019,5,30,500,48,12,60,Thursday
2019,5,30,400,28,8,36,Thursday
2019,5,30,300,29,24,53,Thursday
2019,5,30,200,50,63,113,Thursday
2019,5,30,100,44,53,97,Thursday
2019,5,29,2400,66,138,204,Wednesday
2019,5,29,2300,105,161,266,Wednesday
2019,5,29,2200,134,247,381,Wednesday
2019,5,29,2100,174,347,521,Wednesday
2019,5,29,2000,202,469,671,Wednesday
2019,5,29,1900,247,599,846,Wednesday
2019,5,29,1800,290,730,1020,Wednesday
2019,5,29,1700,364,685,1049,Wednesday
2019,5,29,1600,481,655,1136,Wednesday
2019,5,29,1500,449,677,1126,Wednesday
2019,5,29,1400,511,413,924,Wednesday
2019,5,29,1300,582,366,948,Wednesday
2019,5,29,1200,694,327,1021,Wednesday
2019,5,29,1100,759,272,1031,Wednesday
2019,5,29,1000,674,235,909,Wednesday
2019,5,29,900,589,151,740,Wednesday
2019,5,29,800,340,91,431,Wednesday
2019,5,29,700,187,53,240,Wednesday
2019,5,29,600,66,48,114,Wednesday
2019,5,29,500,38,39,77,Wednesday
2019,5,29,400,35,52,87,Wednesday
2019,5,29,300,35,41,76,Wednesday
2019,5,29,200,41,65,106,Wednesday
2019,5,29,100,60,68,128,Wednesday
2019,5,28,2400,67,86,153,Tuesday
2019,5,28,2300,86,142,228,Tuesday
2019,5,28,2200,104,212,316,Tuesday
2019,5,28,2100,154,313,467,Tuesday
2019,5,28,2000,192,447,639,Tuesday
2019,5,28,1900,210,598,808,Tuesday
2019,5,28,1800,250,781,1031,Tuesday
2019,5,28,1700,321,683,1004,Tuesday
2019,5,28,1600,375,649,1024,Tuesday
2019,5,28,1500,424,586,1010,Tuesday
2019,5,28,1400,436,481,917,Tuesday
2019,5,28,1300,540,425,965,Tuesday
2019,5,28,1200,712,353,1065,Tuesday
2019,5,28,1100,780,277,1057,Tuesday
2019,5,28,1000,631,213,844,Tuesday
2019,5,28,900,519,150,669,Tuesday
2019,5,28,800,312,108,420,Tuesday
2019,5,28,700,157,61,218,Tuesday
2019,5,28,600,74,34,108,Tuesday
2019,5,28,500,32,45,77,Tuesday
2019,5,28,400,25,30,55,Tuesday
2019,5,28,300,27,28,55,Tuesday
2019,5,28,200,39,47,86,Tuesday
2019,5,28,100,41,56,97,Tuesday
2019,5,27,2400,65,86,151,Monday
2019,5,27,2300,90,146,236,Monday
2019,5,27,2200,112,256,368,Monday
2019,5,27,2100,142,422,564,Monday
2019,5,27,2000,213,528,741,Monday
2019,5,27,1900,215,670,885,Monday
2019,5,27,1800,287,951,1238,Monday
2019,5,27,1700,356,750,1106,Monday
2019,5,27,1600,442,702,1144,Monday
2019,5,27,1500,501,639,1140,Monday
2019,5,27,1400,563,571,1134,Monday
2019,5,27,1300,696,499,1195,Monday
2019,5,27,1200,842,323,1165,Monday
2019,5,27,1100,906,282,1188,Monday
2019,5,27,1000,759,217,976,Monday
2019,5,27,900,600,132,732,Monday
2019,5,27,800,354,112,466,Monday
2019,5,27,700,160,54,214,Monday
2019,5,27,600,62,33,95,Monday
2019,5,27,500,38,18,56,Monday
2019,5,27,400,31,26,57,Monday
2019,5,27,300,33,33,66,Monday
2019,5,27,200,30,35,65,Monday
2019,5,27,100,35,96,131,Monday
2019,5,26,2400,57,104,161,Sunday
2019,5,26,2300,71,239,310,Sunday
2019,5,26,2200,91,348,439,Sunday
2019,5,26,2100,145,660,805,Sunday
2019,5,26,2000,188,881,1069,Sunday
2019,5,26,1900,245,1096,1341,Sunday
2019,5,26,1800,306,1372,1678,Sunday
2019,5,26,1700,408,1378,1786,Sunday
2019,5,26,1600,487,1262,1749,Sunday
2019,5,26,1500,582,1034,1616,Sunday
2019,5,26,1400,666,889,1555,Sunday
2019,5,26,1300,766,647,1413,Sunday
2019,5,26,1200,927,537,1464,Sunday
2019,5,26,1100,913,380,1293,Sunday
2019,5,26,1000,748,218,966,Sunday
2019,5,26,900,528,103,631,Sunday
2019,5,26,800,303,64,367,Sunday
2019,5,26,700,133,32,165,Sunday
2019,5,26,600,53,18,71,Sunday
2019,5,26,500,52,20,72,Sunday
2019,5,26,400,32,25,57,Sunday
2019,5,26,300,21,30,51,Sunday
2019,5,26,200,24,33,57,Sunday
2019,5,26,100,27,65,92,Sunday
2019,5,25,2400,30,210,240,Saturday
2019,5,25,2300,59,698,757,Saturday
2019,5,25,2200,84,367,451,Saturday
2019,5,25,2100,112,202,314,Saturday
2019,5,25,2000,157,304,461,Saturday
2019,5,25,1900,205,382,587,Saturday
2019,5,25,1800,251,460,711,Saturday
2019,5,25,1700,320,464,784,Saturday
2019,5,25,1600,380,426,806,Saturday
2019,5,25,1500,478,407,885,Saturday
2019,5,25,1400,527,379,906,Saturday
2019,5,25,1300,628,421,1049,Saturday
2019,5,25,1200,715,367,1082,Saturday
2019,5,25,1100,739,268,1007,Saturday
2019,5,25,1000,579,173,752,Saturday
2019,5,25,900,465,87,552,Saturday
2019,5,25,800,285,83,368,Saturday
2019,5,25,700,145,63,208,Saturday
2019,5,25,600,62,36,98,Saturday
2019,5,25,500,21,26,47,Saturday
2019,5,25,400,25,30,55,Saturday
2019,5,25,300,23,44,67,Saturday
2019,5,25,200,36,59,95,Saturday
2019,5,25,100,58,54,112,Saturday
2019,5,24,2400,50,92,142,Friday
2019,5,24,2300,117,122,239,Friday
2019,5,24,2200,169,174,343,Friday
2019,5,24,2100,309,272,581,Friday
2019,5,24,2000,491,433,924,Friday
2019,5,24,1900,559,590,1149,Friday
2019,5,24,1800,636,627,1263,Friday
2019,5,24,1700,683,645,1328,Friday
2019,5,24,1600,669,614,1283,Friday
2019,5,24,1500,666,686,1352,Friday
2019,5,24,1400,598,513,1111,Friday
2019,5,24,1300,639,433,1072,Friday
2019,5,24,1200,734,381,1115,Friday
2019,5,24,1100,777,252,1029,Friday
2019,5,24,1000,690,181,871,Friday
2019,5,24,900,492,137,629,Friday
2019,5,24,800,428,101,529,Friday
2019,5,24,700,172,59,231,Friday
2019,5,24,600,78,40,118,Friday
2019,5,24,500,45,22,67,Friday
2019,5,24,400,30,43,73,Friday
2019,5,24,300,42,43,85,Friday
2019,5,24,200,38,57,95,Friday
2019,5,24,100,39,55,94,Friday
2019,5,23,2400,79,89,168,Thursday
2019,5,23,2300,119,140,259,Thursday
2019,5,23,2200,150,194,344,Thursday
2019,5,23,2100,222,260,482,Thursday
2019,5,23,2000,271,436,707,Thursday
2019,5,23,1900,312,445,757,Thursday
2019,5,23,1800,353,651,1004,Thursday
2019,5,23,1700,401,686,1087,Thursday
2019,5,23,1600,438,612,1050,Thursday
2019,5,23,1500,492,557,1049,Thursday
2019,5,23,1400,512,419,931,Thursday
2019,5,23,1300,536,402,938,Thursday
2019,5,23,1200,667,331,998,Thursday
2019,5,23,1100,723,249,972,Thursday
2019,5,23,1000,623,191,814,Thursday
2019,5,23,900,440,143,583,Thursday
2019,5,23,800,256,99,355,Thursday
2019,5,23,700,162,58,220,Thursday
2019,5,23,600,59,50,109,Thursday
2019,5,23,500,29,24,53,Thursday
2019,5,23,400,28,40,68,Thursday
2019,5,23,300,34,32,66,Thursday
2019,5,23,200,40,39,79,Thursday
2019,5,23,100,54,62,116,Thursday
2019,5,22,2400,73,76,149,Wednesday
2019,5,22,2300,90,144,234,Wednesday
2019,5,22,2200,99,208,307,Wednesday
2019,5,22,2100,161,345,506,Wednesday
2019,5,22,2000,207,603,810,Wednesday
2019,5,22,1900,195,403,598,Wednesday
2019,5,22,1800,270,655,925,Wednesday
2019,5,22,1700,336,739,1075,Wednesday
2019,5,22,1600,395,589,984,Wednesday
2019,5,22,1500,418,541,959,Wednesday
2019,5,22,1400,482,441,923,Wednesday
2019,5,22,1300,584,434,1018,Wednesday
2019,5,22,1200,672,333,1005,Wednesday
2019,5,22,1100,694,249,943,Wednesday
2019,5,22,1000,570,196,766,Wednesday
2019,5,22,900,404,142,546,Wednesday
2019,5,22,800,283,112,395,Wednesday
2019,5,22,700,135,68,203,Wednesday
2019,5,22,600,62,38,100,Wednesday
2019,5,22,500,30,35,65,Wednesday
2019,5,22,400,33,29,62,Wednesday
2019,5,22,300,23,46,69,Wednesday
2019,5,22,200,39,47,86,Wednesday
2019,5,22,100,45,76,121,Wednesday
2019,5,21,2400,66,88,154,Tuesday
2019,5,21,2300,79,132,211,Tuesday
2019,5,21,2200,97,228,325,Tuesday
2019,5,21,2100,116,362,478,Tuesday
2019,5,21,2000,152,523,675,Tuesday
2019,5,21,1900,199,999,1198,Tuesday
2019,5,21,1800,245,736,981,Tuesday
2019,5,21,1700,287,830,1117,Tuesday
2019,5,21,1600,367,770,1137,Tuesday
2019,5,21,1500,426,754,1180,Tuesday
2019,5,21,1400,476,699,1175,Tuesday
2019,5,21,1300,510,521,1031,Tuesday
2019,5,21,1200,657,441,1098,Tuesday
2019,5,21,1100,750,307,1057,Tuesday
2019,5,21,1000,613,256,869,Tuesday
2019,5,21,900,415,163,578,Tuesday
2019,5,21,800,304,127,431,Tuesday
2019,5,21,700,156,60,216,Tuesday
2019,5,21,600,37,35,72,Tuesday
2019,5,21,500,22,21,43,Tuesday
2019,5,21,400,27,30,57,Tuesday
2019,5,21,300,16,30,46,Tuesday
2019,5,21,200,26,71,97,Tuesday
2019,5,21,100,31,106,137,Tuesday
2019,5,20,2400,22,145,167,Monday
2019,5,20,2300,49,297,346,Monday
2019,5,20,2200,85,607,692,Monday
2019,5,20,2100,91,869,960,Monday
2019,5,20,2000,146,1408,1554,Monday
2019,5,20,1900,188,1682,1870,Monday
2019,5,20,1800,264,2345,2609,Monday
2019,5,20,1700,381,2372,2753,Monday
2019,5,20,1600,456,2394,2850,Monday
2019,5,20,1500,566,1697,2263,Monday
2019,5,20,1400,687,1763,2450,Monday
2019,5,20,1300,788,1445,2233,Monday
2019,5,20,1200,887,1060,1947,Monday
2019,5,20,1100,922,658,1580,Monday
2019,5,20,1000,701,310,1011,Monday
2019,5,20,900,542,148,690,Monday
2019,5,20,800,281,89,370,Monday
2019,5,20,700,149,26,175,Monday
2019,5,20,600,56,17,73,Monday
2019,5,20,500,33,15,48,Monday
2019,5,20,400,26,27,53,Monday
2019,5,20,300,19,29,48,Monday
2019,5,20,200,24,50,74,Monday
2019,5,20,100,36,55,91,Monday
2019,5,19,2400,47,128,175,Sunday
2019,5,19,2300,72,189,261,Sunday
2019,5,19,2200,89,391,480,Sunday
2019,5,19,2100,144,543,687,Sunday
2019,5,19,2000,188,786,974,Sunday
2019,5,19,1900,216,925,1141,Sunday
2019,5,19,1800,320,1117,1437,Sunday
2019,5,19,1700,447,1175,1622,Sunday
2019,5,19,1600,483,1067,1550,Sunday
2019,5,19,1500,624,915,1539,Sunday
2019,5,19,1400,749,731,1480,Sunday
2019,5,19,1300,939,532,1471,Sunday
2019,5,19,1200,1010,437,1447,Sunday
2019,5,19,1100,941,228,1169,Sunday
2019,5,19,1000,820,165,985,Sunday
2019,5,19,900,460,96,556,Sunday
2019,5,19,800,286,55,341,Sunday
2019,5,19,700,113,23,136,Sunday
2019,5,19,600,48,22,70,Sunday
2019,5,19,500,24,15,39,Sunday
2019,5,19,400,23,18,41,Sunday
2019,5,19,300,22,19,41,Sunday
2019,5,19,200,20,26,46,Sunday
2019,5,19,100,31,45,76,Sunday
2019,5,18,2400,33,67,100,Saturday
2019,5,18,2300,59,101,160,Saturday
2019,5,18,2200,113,186,299,Saturday
2019,5,18,2100,141,220,361,Saturday
2019,5,18,2000,177,328,505,Saturday
2019,5,18,1900,229,523,752,Saturday
2019,5,18,1800,309,548,857,Saturday
2019,5,18,1700,465,621,1086,Saturday
2019,5,18,1600,549,613,1162,Saturday
2019,5,18,1500,720,505,1225,Saturday
2019,5,18,1400,842,417,1259,Saturday
2019,5,18,1300,932,401,1333,Saturday
2019,5,18,1200,1074,313,1387,Saturday
2019,5,18,1100,1081,255,1336,Saturday
2019,5,18,1000,820,178,998,Saturday
2019,5,18,900,569,127,696,Saturday
2019,5,18,800,384,64,448,Saturday
2019,5,18,700,149,46,195,Saturday
2019,5,18,600,78,30,108,Saturday
2019,5,18,500,38,35,73,Saturday
2019,5,18,400,40,34,74,Saturday
2019,5,18,300,33,40,73,Saturday
2019,5,18,200,47,40,87,Saturday
2019,5,18,100,55,58,113,Saturday
2019,5,17,2400,97,104,201,Friday
2019,5,17,2300,163,114,277,Friday
2019,5,17,2200,308,174,482,Friday
2019,5,17,2100,526,292,818,Friday
2019,5,17,2000,957,356,1313,Friday
2019,5,17,1900,1158,510,1668,Friday
2019,5,17,1800,1244,580,1824,Friday
2019,5,17,1700,1305,673,1978,Friday
2019,5,17,1600,1251,661,1912,Friday
2019,5,17,1500,1240,581,1821,Friday
2019,5,17,1400,1263,481,1744,Friday
2019,5,17,1300,1180,386,1566,Friday
2019,5,17,1200,1317,369,1686,Friday
2019,5,17,1100,1214,257,1471,Friday
2019,5,17,1000,1089,195,1284,Friday
2019,5,17,900,754,130,884,Friday
2019,5,17,800,425,102,527,Friday
2019,5,17,700,223,68,291,Friday
2019,5,17,600,87,40,127,Friday
2019,5,17,500,56,30,86,Friday
2019,5,17,400,48,18,66,Friday
2019,5,17,300,37,32,69,Friday
2019,5,17,200,32,55,87,Friday
2019,5,17,100,50,68,118,Friday
2019,5,16,2400,108,92,200,Thursday
2019,5,16,2300,148,130,278,Thursday
2019,5,16,2200,290,163,453,Thursday
2019,5,16,2100,422,255,677,Thursday
2019,5,16,2000,679,339,1018,Thursday
2019,5,16,1900,734,475,1209,Thursday
2019,5,16,1800,756,534,1290,Thursday
2019,5,16,1700,730,528,1258,Thursday
2019,5,16,1600,732,519,1251,Thursday
2019,5,16,1500,709,488,1197,Thursday
2019,5,16,1400,640,350,990,Thursday
2019,5,16,1300,727,382,1109,Thursday
2019,5,16,1200,782,306,1088,Thursday
2019,5,16,1100,794,269,1063,Thursday
2019,5,16,1000,622,216,838,Thursday
2019,5,16,900,468,138,606,Thursday
2019,5,16,800,345,81,426,Thursday
2019,5,16,700,170,60,230,Thursday
2019,5,16,600,80,45,125,Thursday
2019,5,16,500,33,35,68,Thursday
2019,5,16,400,25,45,70,Thursday
2019,5,16,300,39,29,68,Thursday
2019,5,16,200,37,44,81,Thursday
2019,5,16,100,56,58,114,Thursday
2019,5,15,2400,74,79,153,Wednesday
2019,5,15,2300,100,141,241,Wednesday
2019,5,15,2200,124,178,302,Wednesday
2019,5,15,2100,185,215,400,Wednesday
2019,5,15,2000,222,343,565,Wednesday
2019,5,15,1900,253,395,648,Wednesday
2019,5,15,1800,309,510,819,Wednesday
2019,5,15,1700,408,554,962,Wednesday
2019,5,15,1600,495,449,944,Wednesday
2019,5,15,1500,449,440,889,Wednesday
2019,5,15,1400,447,438,885,Wednesday
2019,5,15,1300,485,298,783,Wednesday
2019,5,15,1200,569,301,870,Wednesday
2019,5,15,1100,582,253,835,Wednesday
2019,5,15,1000,572,177,749,Wednesday
2019,5,15,900,414,141,555,Wednesday
2019,5,15,800,250,103,353,Wednesday
2019,5,15,700,146,63,209,Wednesday
2019,5,15,600,53,46,99,Wednesday
2019,5,15,500,29,36,65,Wednesday
2019,5,15,400,26,35,61,Wednesday
2019,5,15,300,29,27,56,Wednesday
2019,5,15,200,40,46,86,Wednesday
2019,5,15,100,48,50,98,Wednesday
2019,5,14,2400,73,75,148,Tuesday
2019,5,14,2300,90,125,215,Tuesday
2019,5,14,2200,83,129,212,Tuesday
2019,5,14,2100,119,193,312,Tuesday
2019,5,14,2000,172,307,479,Tuesday
2019,5,14,1900,162,434,596,Tuesday
2019,5,14,1800,241,543,784,Tuesday
2019,5,14,1700,280,515,795,Tuesday
2019,5,14,1600,347,562,909,Tuesday
2019,5,14,1500,398,557,955,Tuesday
2019,5,14,1400,426,344,770,Tuesday
2019,5,14,1300,454,307,761,Tuesday
2019,5,14,1200,511,319,830,Tuesday
2019,5,14,1100,541,273,814,Tuesday
2019,5,14,1000,489,181,670,Tuesday
2019,5,14,900,356,151,507,Tuesday
2019,5,14,800,261,99,360,Tuesday
2019,5,14,700,119,54,173,Tuesday
2019,5,14,600,52,40,92,Tuesday
2019,5,14,500,28,27,55,Tuesday
2019,5,14,400,29,43,72,Tuesday
2019,5,14,300,20,37,57,Tuesday
2019,5,14,200,31,40,71,Tuesday
2019,5,14,100,41,54,95,Tuesday
2019,5,13,2400,73,102,175,Monday
2019,5,13,2300,84,130,214,Monday
2019,5,13,2200,110,201,311,Monday
2019,5,13,2100,121,267,388,Monday
2019,5,13,2000,166,372,538,Monday
2019,5,13,1900,165,686,851,Monday
2019,5,13,1800,275,346,621,Monday
2019,5,13,1700,323,593,916,Monday
2019,5,13,1600,387,521,908,Monday
2019,5,13,1500,430,542,972,Monday
2019,5,13,1400,474,414,888,Monday
2019,5,13,1300,517,405,922,Monday
2019,5,13,1200,626,342,968,Monday
2019,5,13,1100,666,267,933,Monday
2019,5,13,1000,554,188,742,Monday
2019,5,13,900,356,123,479,Monday
2019,5,13,800,277,85,362,Monday
2019,5,13,700,137,45,182,Monday
2019,5,13,600,47,21,68,Monday
2019,5,13,500,24,13,37,Monday
2019,5,13,400,19,24,43,Monday
2019,5,13,300,24,31,55,Monday
2019,5,13,200,22,42,64,Monday
2019,5,13,100,29,65,94,Monday
2019,5,12,2400,36,107,143,Sunday
2019,5,12,2300,54,194,248,Sunday
2019,5,12,2200,103,288,391,Sunday
2019,5,12,2100,124,427,551,Sunday
2019,5,12,2000,158,682,840,Sunday
2019,5,12,1900,215,693,908,Sunday
2019,5,12,1800,305,893,1198,Sunday
2019,5,12,1700,415,912,1327,Sunday
2019,5,12,1600,432,929,1361,Sunday
2019,5,12,1500,456,874,1330,Sunday
2019,5,12,1400,545,678,1223,Sunday
2019,5,12,1300,576,618,1194,Sunday
2019,5,12,1200,713,503,1216,Sunday
2019,5,12,1100,554,300,854,Sunday
2019,5,12,1000,481,173,654,Sunday
2019,5,12,900,303,90,393,Sunday
2019,5,12,800,175,67,242,Sunday
2019,5,12,700,78,16,94,Sunday
2019,5,12,600,30,24,54,Sunday
2019,5,12,500,21,6,27,Sunday
2019,5,12,400,18,24,42,Sunday
2019,5,12,300,12,22,34,Sunday
2019,5,12,200,24,24,48,Sunday
2019,5,12,100,26,42,68,Sunday
2019,5,11,2400,44,81,125,Saturday
2019,5,11,2300,70,100,170,Saturday
2019,5,11,2200,110,186,296,Saturday
2019,5,11,2100,125,281,406,Saturday
2019,5,11,2000,166,380,546,Saturday
2019,5,11,1900,199,572,771,Saturday
2019,5,11,1800,282,705,987,Saturday
2019,5,11,1700,330,670,1000,Saturday
2019,5,11,1600,432,654,1086,Saturday
2019,5,11,1500,490,594,1084,Saturday
2019,5,11,1400,631,502,1133,Saturday
2019,5,11,1300,674,446,1120,Saturday
2019,5,11,1200,746,380,1126,Saturday
2019,5,11,1100,777,257,1034,Saturday
2019,5,11,1000,632,210,842,Saturday
2019,5,11,900,441,139,580,Saturday
2019,5,11,800,247,86,333,Saturday
2019,5,11,700,136,47,183,Saturday
2019,5,11,600,54,37,91,Saturday
2019,5,11,500,23,30,53,Saturday
2019,5,11,400,18,31,49,Saturday
2019,5,11,300,25,21,46,Saturday
2019,5,11,200,31,42,73,Saturday
2019,5,11,100,39,56,95,Saturday
2019,5,10,2400,69,79,148,Friday
2019,5,10,2300,109,131,240,Friday
2019,5,10,2200,161,182,343,Friday
2019,5,10,2100,241,308,549,Friday
2019,5,10,2000,375,297,672,Friday
2019,5,10,1900,494,544,1038,Friday
2019,5,10,1800,527,542,1069,Friday
2019,5,10,1700,569,595,1164,Friday
2019,5,10,1600,569,663,1232,Friday
2019,5,10,1500,592,399,991,Friday
2019,5,10,1400,593,438,1031,Friday
2019,5,10,1300,630,381,1011,Friday
2019,5,10,1200,678,338,1016,Friday
2019,5,10,1100,664,270,934,Friday
2019,5,10,1000,528,216,744,Friday
2019,5,10,900,393,117,510,Friday
2019,5,10,800,266,104,370,Friday
2019,5,10,700,113,49,162,Friday
2019,5,10,600,62,43,105,Friday
2019,5,10,500,27,44,71,Friday
2019,5,10,400,29,40,69,Friday
2019,5,10,300,27,34,61,Friday
2019,5,10,200,34,40,74,Friday
2019,5,10,100,47,58,105,Friday
2019,5,9,2400,69,83,152,Thursday
2019,5,9,2300,89,133,222,Thursday
2019,5,9,2200,124,162,286,Thursday
2019,5,9,2100,188,223,411,Thursday
2019,5,9,2000,262,350,612,Thursday
2019,5,9,1900,302,426,728,Thursday
2019,5,9,1800,320,480,800,Thursday
2019,5,9,1700,401,593,994,Thursday
2019,5,9,1600,456,514,970,Thursday
2019,5,9,1500,427,405,832,Thursday
2019,5,9,1400,468,462,930,Thursday
2019,5,9,1300,515,361,876,Thursday
2019,5,9,1200,612,317,929,Thursday
2019,5,9,1100,583,241,824,Thursday
2019,5,9,1000,436,159,595,Thursday
2019,5,9,900,360,121,481,Thursday
2019,5,9,800,241,81,322,Thursday
2019,5,9,700,114,54,168,Thursday
2019,5,9,600,49,37,86,Thursday
2019,5,9,500,26,26,52,Thursday
2019,5,9,400,26,34,60,Thursday
2019,5,9,300,30,38,68,Thursday
2019,5,9,200,29,41,70,Thursday
2019,5,9,100,32,45,77,Thursday
2019,5,8,2400,63,82,145,Wednesday
2019,5,8,2300,94,123,217,Wednesday
2019,5,8,2200,97,176,273,Wednesday
2019,5,8,2100,127,195,322,Wednesday
2019,5,8,2000,172,307,479,Wednesday
2019,5,8,1900,189,370,559,Wednesday
2019,5,8,1800,249,452,701,Wednesday
2019,5,8,1700,317,440,757,Wednesday
2019,5,8,1600,374,472,846,Wednesday
2019,5,8,1500,378,363,741,Wednesday
2019,5,8,1400,428,384,812,Wednesday
2019,5,8,1300,412,347,759,Wednesday
2019,5,8,1200,487,246,733,Wednesday
2019,5,8,1100,521,230,751,Wednesday
2019,5,8,1000,420,176,596,Wednesday
2019,5,8,900,295,135,430,Wednesday
2019,5,8,800,246,100,346,Wednesday
2019,5,8,700,119,60,179,Wednesday
2019,5,8,600,50,45,95,Wednesday
2019,5,8,500,25,38,63,Wednesday
2019,5,8,400,22,40,62,Wednesday
2019,5,8,300,27,44,71,Wednesday
2019,5,8,200,43,52,95,Wednesday
2019,5,8,100,49,71,120,Wednesday
2019,5,7,2400,57,91,148,Tuesday
2019,5,7,2300,63,105,168,Tuesday
2019,5,7,2200,101,137,238,Tuesday
2019,5,7,2100,128,212,340,Tuesday
2019,5,7,2000,135,272,407,Tuesday
2019,5,7,1900,177,327,504,Tuesday
2019,5,7,1800,220,402,622,Tuesday
2019,5,7,1700,247,489,736,Tuesday
2019,5,7,1600,290,432,722,Tuesday
2019,5,7,1500,336,407,743,Tuesday
2019,5,7,1400,335,371,706,Tuesday
2019,5,7,1300,397,418,815,Tuesday
2019,5,7,1200,448,279,727,Tuesday
2019,5,7,1100,463,223,686,Tuesday
2019,5,7,1000,377,183,560,Tuesday
2019,5,7,900,314,127,441,Tuesday
2019,5,7,800,243,92,335,Tuesday
2019,5,7,700,106,57,163,Tuesday
2019,5,7,600,44,32,76,Tuesday
2019,5,7,500,30,38,68,Tuesday
2019,5,7,400,24,31,55,Tuesday
2019,5,7,300,24,34,58,Tuesday
2019,5,7,200,40,50,90,Tuesday
2019,5,7,100,44,56,100,Tuesday
2019,5,6,2400,57,70,127,Monday
2019,5,6,2300,76,96,172,Monday
2019,5,6,2200,85,135,220,Monday
2019,5,6,2100,119,227,346,Monday
2019,5,6,2000,160,298,458,Monday
2019,5,6,1900,238,476,714,Monday
2019,5,6,1800,243,597,840,Monday
2019,5,6,1700,312,562,874,Monday
2019,5,6,1600,359,485,844,Monday
2019,5,6,1500,382,452,834,Monday
2019,5,6,1400,452,369,821,Monday
2019,5,6,1300,498,352,850,Monday
2019,5,6,1200,579,292,871,Monday
2019,5,6,1100,583,209,792,Monday
2019,5,6,1000,432,195,627,Monday
2019,5,6,900,322,128,450,Monday
2019,5,6,800,231,89,320,Monday
2019,5,6,700,131,39,170,Monday
2019,5,6,600,42,25,67,Monday
2019,5,6,500,27,15,42,Monday
2019,5,6,400,15,18,33,Monday
2019,5,6,300,19,30,49,Monday
2019,5,6,200,24,37,61,Monday
2019,5,6,100,26,75,101,Monday
2019,5,5,2400,26,80,106,Sunday
2019,5,5,2300,59,175,234,Sunday
2019,5,5,2200,81,208,289,Sunday
2019,5,5,2100,133,343,476,Sunday
2019,5,5,2000,132,518,650,Sunday
2019,5,5,1900,210,657,867,Sunday
2019,5,5,1800,236,944,1180,Sunday
2019,5,5,1700,311,971,1282,Sunday
2019,5,5,1600,381,914,1295,Sunday
2019,5,5,1500,440,722,1162,Sunday
2019,5,5,1400,489,650,1139,Sunday
2019,5,5,1300,565,553,1118,Sunday
2019,5,5,1200,623,426,1049,Sunday
2019,5,5,1100,629,223,852,Sunday
2019,5,5,1000,577,175,752,Sunday
2019,5,5,900,445,70,515,Sunday
2019,5,5,800,198,37,235,Sunday
2019,5,5,700,75,25,100,Sunday
2019,5,5,600,30,11,41,Sunday
2019,5,5,500,16,19,35,Sunday
2019,5,5,400,15,20,35,Sunday
2019,5,5,300,20,22,42,Sunday
2019,5,5,200,15,28,43,Sunday
2019,5,5,100,20,46,66,Sunday
2019,5,4,2400,31,55,86,Saturday
2019,5,4,2300,46,71,117,Saturday
2019,5,4,2200,62,107,169,Saturday
2019,5,4,2100,98,174,272,Saturday
2019,5,4,2000,125,255,380,Saturday
2019,5,4,1900,164,357,521,Saturday
2019,5,4,1800,228,511,739,Saturday
2019,5,4,1700,298,652,950,Saturday
2019,5,4,1600,402,605,1007,Saturday
2019,5,4,1500,389,510,899,Saturday
2019,5,4,1400,448,405,853,Saturday
2019,5,4,1300,520,384,904,Saturday
2019,5,4,1200,625,295,920,Saturday
2019,5,4,1100,686,231,917,Saturday
2019,5,4,1000,600,177,777,Saturday
2019,5,4,900,475,100,575,Saturday
2019,5,4,800,276,73,349,Saturday
2019,5,4,700,112,46,158,Saturday
2019,5,4,600,44,29,73,Saturday
2019,5,4,500,17,24,41,Saturday
2019,5,4,400,27,25,52,Saturday
2019,5,4,300,16,30,46,Saturday
2019,5,4,200,38,46,84,Saturday
2019,5,4,100,39,43,82,Saturday
2019,5,3,2400,75,75,150,Friday
2019,5,3,2300,70,102,172,Friday
2019,5,3,2200,145,169,314,Friday
2019,5,3,2100,196,264,460,Friday
2019,5,3,2000,325,344,669,Friday
2019,5,3,1900,449,391,840,Friday
2019,5,3,1800,520,553,1073,Friday
2019,5,3,1700,529,682,1211,Friday
2019,5,3,1600,536,566,1102,Friday
2019,5,3,1500,576,485,1061,Friday
2019,5,3,1400,501,424,925,Friday
2019,5,3,1300,601,418,1019,Friday
2019,5,3,1200,639,326,965,Friday
2019,5,3,1100,643,265,908,Friday
2019,5,3,1000,571,171,742,Friday
2019,5,3,900,427,151,578,Friday
2019,5,3,800,263,102,365,Friday
2019,5,3,700,119,68,187,Friday
2019,5,3,600,46,35,81,Friday
2019,5,3,500,37,40,77,Friday
2019,5,3,400,27,30,57,Friday
2019,5,3,300,29,30,59,Friday
2019,5,3,200,44,57,101,Friday
2019,5,3,100,50,53,103,Friday
2019,5,2,2400,62,66,128,Thursday
2019,5,2,2300,82,96,178,Thursday
2019,5,2,2200,130,149,279,Thursday
2019,5,2,2100,165,230,395,Thursday
2019,5,2,2000,225,281,506,Thursday
2019,5,2,1900,263,446,709,Thursday
2019,5,2,1800,316,595,911,Thursday
2019,5,2,1700,379,600,979,Thursday
2019,5,2,1600,382,549,931,Thursday
2019,5,2,1500,418,365,783,Thursday
2019,5,2,1400,445,404,849,Thursday
2019,5,2,1300,441,297,738,Thursday
2019,5,2,1200,538,275,813,Thursday
2019,5,2,1100,577,188,765,Thursday
2019,5,2,1000,503,160,663,Thursday
2019,5,2,900,371,127,498,Thursday
2019,5,2,800,267,80,347,Thursday
2019,5,2,700,125,45,170,Thursday
2019,5,2,600,49,43,92,Thursday
2019,5,2,500,18,32,50,Thursday
2019,5,2,400,28,45,73,Thursday
2019,5,2,300,32,45,77,Thursday
2019,5,2,200,25,38,63,Thursday
2019,5,2,100,40,61,101,Thursday
2019,5,1,2400,64,72,136,Wednesday
2019,5,1,2300,82,89,171,Wednesday
2019,5,1,2200,100,131,231,Wednesday
2019,5,1,2100,138,203,341,Wednesday
2019,5,1,2000,150,257,407,Wednesday
2019,5,1,1900,191,366,557,Wednesday
2019,5,1,1800,242,469,711,Wednesday
2019,5,1,1700,264,512,776,Wednesday
2019,5,1,1600,291,416,707,Wednesday
2019,5,1,1500,368,272,640,Wednesday
2019,5,1,1400,310,514,824,Wednesday
2019,5,1,1300,355,170,525,Wednesday
2019,5,1,1200,425,271,696,Wednesday
2019,5,1,1100,489,268,757,Wednesday
2019,5,1,1000,415,207,622,Wednesday
2019,5,1,900,307,134,441,Wednesday
2019,5,1,800,222,81,303,Wednesday
2019,5,1,700,100,71,171,Wednesday
2019,5,1,600,37,37,74,Wednesday
2019,5,1,500,20,45,65,Wednesday
2019,5,1,400,13,47,60,Wednesday
2019,5,1,300,32,117,149,Wednesday
2019,5,1,200,32,113,145,Wednesday
2019,5,1,100,42,35,77,Wednesday
2019,4,30,2400,52,11,63,Tuesday
2019,4,30,2300,88,23,111,Tuesday
2019,4,30,2200,96,59,155,Tuesday
2019,4,30,2100,111,196,307,Tuesday
2019,4,30,2000,142,260,402,Tuesday
2019,4,30,1900,177,368,545,Tuesday
2019,4,30,1800,231,448,679,Tuesday
2019,4,30,1700,252,441,693,Tuesday
2019,4,30,1600,302,445,747,Tuesday
2019,4,30,1500,277,358,635,Tuesday
2019,4,30,1400,322,324,646,Tuesday
2019,4,30,1300,425,314,739,Tuesday
2019,4,30,1200,429,239,668,Tuesday
2019,4,30,1100,441,213,654,Tuesday
2019,4,30,1000,382,155,537,Tuesday
2019,4,30,900,298,116,414,Tuesday
2019,4,30,800,199,72,271,Tuesday
2019,4,30,700,101,56,157,Tuesday
2019,4,30,600,42,28,70,Tuesday
2019,4,30,500,21,33,54,Tuesday
2019,4,30,400,25,46,71,Tuesday
2019,4,30,300,23,41,64,Tuesday
2019,4,30,200,28,53,81,Tuesday
2019,4,30,100,35,56,91,Tuesday
2019,4,29,2400,88,81,169,Monday
2019,4,29,2300,83,90,173,Monday
2019,4,29,2200,113,162,275,Monday
2019,4,29,2100,141,232,373,Monday
2019,4,29,2000,138,313,451,Monday
2019,4,29,1900,194,370,564,Monday
2019,4,29,1800,233,596,829,Monday
2019,4,29,1700,268,467,735,Monday
2019,4,29,1600,330,492,822,Monday
2019,4,29,1500,366,368,734,Monday
2019,4,29,1400,424,390,814,Monday
2019,4,29,1300,447,301,748,Monday
2019,4,29,1200,545,261,806,Monday
2019,4,29,1100,559,238,797,Monday
2019,4,29,1000,484,156,640,Monday
2019,4,29,900,354,115,469,Monday
2019,4,29,800,201,60,261,Monday
2019,4,29,700,123,35,158,Monday
2019,4,29,600,30,21,51,Monday
2019,4,29,500,26,16,42,Monday
2019,4,29,400,32,12,44,Monday
2019,4,29,300,41,25,66,Monday
2019,4,29,200,34,43,77,Monday
2019,4,29,100,32,67,99,Monday
2019,4,28,2400,29,81,110,Sunday
2019,4,28,2300,54,125,179,Sunday
2019,4,28,2200,77,187,264,Sunday
2019,4,28,2100,94,269,363,Sunday
2019,4,28,2000,136,422,558,Sunday
2019,4,28,1900,175,561,736,Sunday
2019,4,28,1800,213,742,955,Sunday
2019,4,28,1700,299,874,1173,Sunday
2019,4,28,1600,370,784,1154,Sunday
2019,4,28,1500,439,607,1046,Sunday
2019,4,28,1400,485,554,1039,Sunday
2019,4,28,1300,470,498,968,Sunday
2019,4,28,1200,513,362,875,Sunday
2019,4,28,1100,463,225,688,Sunday
2019,4,28,1000,408,131,539,Sunday
2019,4,28,900,325,88,413,Sunday
2019,4,28,800,145,38,183,Sunday
2019,4,28,700,56,30,86,Sunday
2019,4,28,600,29,14,43,Sunday
2019,4,28,500,14,15,29,Sunday
2019,4,28,400,15,21,36,Sunday
2019,4,28,300,14,26,40,Sunday
2019,4,28,200,26,39,65,Sunday
2019,4,28,100,12,23,35,Sunday
2019,4,27,2400,15,54,69,Saturday
2019,4,27,2300,26,67,93,Saturday
2019,4,27,2200,20,90,110,Saturday
2019,4,27,2100,34,139,173,Saturday
2019,4,27,2000,48,223,271,Saturday
2019,4,27,1900,98,343,441,Saturday
2019,4,27,1800,175,552,727,Saturday
2019,4,27,1700,225,521,746,Saturday
2019,4,27,1600,235,529,764,Saturday
2019,4,27,1500,289,411,700,Saturday
2019,4,27,1400,298,386,684,Saturday
2019,4,27,1300,405,300,705,Saturday
2019,4,27,1200,458,328,786,Saturday
2019,4,27,1100,461,220,681,Saturday
2019,4,27,1000,508,124,632,Saturday
2019,4,27,900,387,113,500,Saturday
2019,4,27,800,209,84,293,Saturday
2019,4,27,700,79,52,131,Saturday
2019,4,27,600,48,35,83,Saturday
2019,4,27,500,17,30,47,Saturday
2019,4,27,400,30,24,54,Saturday
2019,4,27,300,35,38,73,Saturday
2019,4,27,200,32,40,72,Saturday
2019,4,27,100,33,37,70,Saturday
2019,4,26,2400,52,115,167,Friday
2019,4,26,2300,83,61,144,Friday
2019,4,26,2200,123,175,298,Friday
2019,4,26,2100,205,238,443,Friday
2019,4,26,2000,282,345,627,Friday
2019,4,26,1900,362,479,841,Friday
2019,4,26,1800,410,575,985,Friday
2019,4,26,1700,425,560,985,Friday
2019,4,26,1600,435,537,972,Friday
2019,4,26,1500,460,547,1007,Friday
2019,4,26,1400,454,402,856,Friday
2019,4,26,1300,426,428,854,Friday
2019,4,26,1200,523,354,877,Friday
2019,4,26,1100,534,237,771,Friday
2019,4,26,1000,423,192,615,Friday
2019,4,26,900,324,136,460,Friday
2019,4,26,800,217,85,302,Friday
2019,4,26,700,134,63,197,Friday
2019,4,26,600,53,44,97,Friday
2019,4,26,500,34,37,71,Friday
2019,4,26,400,32,36,68,Friday
2019,4,26,300,39,40,79,Friday
2019,4,26,200,29,67,96,Friday
2019,4,26,100,39,70,109,Friday
2019,4,25,2400,70,94,164,Thursday
2019,4,25,2300,95,140,235,Thursday
2019,4,25,2200,106,194,300,Thursday
2019,4,25,2100,154,256,410,Thursday
2019,4,25,2000,205,401,606,Thursday
2019,4,25,1900,236,442,678,Thursday
2019,4,25,1800,313,526,839,Thursday
2019,4,25,1700,359,603,962,Thursday
2019,4,25,1600,345,473,818,Thursday
2019,4,25,1500,366,477,843,Thursday
2019,4,25,1400,395,441,836,Thursday
2019,4,25,1300,433,329,762,Thursday
2019,4,25,1200,547,338,885,Thursday
2019,4,25,1100,550,210,760,Thursday
2019,4,25,1000,444,144,588,Thursday
2019,4,25,900,387,126,513,Thursday
2019,4,25,800,218,87,305,Thursday
2019,4,25,700,114,62,176,Thursday
2019,4,25,600,56,44,100,Thursday
2019,4,25,500,24,27,51,Thursday
2019,4,25,400,33,43,76,Thursday
2019,4,25,300,38,41,79,Thursday
2019,4,25,200,33,40,73,Thursday
2019,4,25,100,45,71,116,Thursday
2019,4,24,2400,76,83,159,Wednesday
2019,4,24,2300,80,106,186,Wednesday
2019,4,24,2200,113,168,281,Wednesday
2019,4,24,2100,144,249,393,Wednesday
2019,4,24,2000,162,277,439,Wednesday
2019,4,24,1900,202,359,561,Wednesday
2019,4,24,1800,241,533,774,Wednesday
2019,4,24,1700,264,507,771,Wednesday
2019,4,24,1600,284,470,754,Wednesday
2019,4,24,1500,324,391,715,Wednesday
2019,4,24,1400,298,377,675,Wednesday
2019,4,24,1300,417,319,736,Wednesday
2019,4,24,1200,478,317,795,Wednesday
2019,4,24,1100,470,236,706,Wednesday
2019,4,24,1000,417,166,583,Wednesday
2019,4,24,900,312,127,439,Wednesday
2019,4,24,800,211,68,279,Wednesday
2019,4,24,700,106,54,160,Wednesday
2019,4,24,600,59,39,98,Wednesday
2019,4,24,500,28,35,63,Wednesday
2019,4,24,400,27,40,67,Wednesday
2019,4,24,300,33,47,80,Wednesday
2019,4,24,200,26,64,90,Wednesday
2019,4,24,100,49,47,96,Wednesday
2019,4,23,2400,71,68,139,Tuesday
2019,4,23,2300,74,112,186,Tuesday
2019,4,23,2200,106,171,277,Tuesday
2019,4,23,2100,136,233,369,Tuesday
2019,4,23,2000,126,302,428,Tuesday
2019,4,23,1900,180,404,584,Tuesday
2019,4,23,1800,231,607,838,Tuesday
2019,4,23,1700,277,602,879,Tuesday
2019,4,23,1600,353,618,971,Tuesday
2019,4,23,1500,332,517,849,Tuesday
2019,4,23,1400,391,452,843,Tuesday
2019,4,23,1300,416,389,805,Tuesday
2019,4,23,1200,551,303,854,Tuesday
2019,4,23,1100,539,243,782,Tuesday
2019,4,23,1000,468,199,667,Tuesday
2019,4,23,900,309,129,438,Tuesday
2019,4,23,800,230,81,311,Tuesday
2019,4,23,700,124,50,174,Tuesday
2019,4,23,600,56,33,89,Tuesday
2019,4,23,500,22,30,52,Tuesday
2019,4,23,400,25,41,66,Tuesday
2019,4,23,300,28,44,72,Tuesday
2019,4,23,200,30,49,79,Tuesday
2019,4,23,100,36,77,113,Tuesday
2019,4,22,2400,58,105,163,Monday
2019,4,22,2300,83,142,225,Monday
2019,4,22,2200,99,249,348,Monday
2019,4,22,2100,123,399,522,Monday
2019,4,22,2000,162,494,656,Monday
2019,4,22,1900,182,795,977,Monday
2019,4,22,1800,239,1075,1314,Monday
2019,4,22,1700,349,1291,1640,Monday
2019,4,22,1600,435,1096,1531,Monday
2019,4,22,1500,490,1025,1515,Monday
2019,4,22,1400,549,928,1477,Monday
2019,4,22,1300,705,784,1489,Monday
2019,4,22,1200,788,552,1340,Monday
2019,4,22,1100,742,378,1120,Monday
2019,4,22,1000,642,231,873,Monday
2019,4,22,900,460,112,572,Monday
2019,4,22,800,243,73,316,Monday
2019,4,22,700,114,44,158,Monday
2019,4,22,600,53,34,87,Monday
2019,4,22,500,19,23,42,Monday
2019,4,22,400,15,32,47,Monday
2019,4,22,300,21,46,67,Monday
2019,4,22,200,21,54,75,Monday
2019,4,22,100,24,93,117,Monday
2019,4,21,2400,26,136,162,Sunday
2019,4,21,2300,56,171,227,Sunday
2019,4,21,2200,74,351,425,Sunday
2019,4,21,2100,96,524,620,Sunday
2019,4,21,2000,136,724,860,Sunday
2019,4,21,1900,180,985,1165,Sunday
2019,4,21,1800,286,1371,1657,Sunday
2019,4,21,1700,331,1410,1741,Sunday
2019,4,21,1600,383,1336,1719,Sunday
2019,4,21,1500,475,1062,1537,Sunday
2019,4,21,1400,501,880,1381,Sunday
2019,4,21,1300,583,750,1333,Sunday
2019,4,21,1200,734,532,1266,Sunday
2019,4,21,1100,675,308,983,Sunday
2019,4,21,1000,570,193,763,Sunday
2019,4,21,900,367,110,477,Sunday
2019,4,21,800,190,41,231,Sunday
2019,4,21,700,109,20,129,Sunday
2019,4,21,600,46,25,71,Sunday
2019,4,21,500,23,16,39,Sunday
2019,4,21,400,15,11,26,Sunday
2019,4,21,300,19,16,35,Sunday
2019,4,21,200,25,33,58,Sunday
2019,4,21,100,33,34,67,Sunday
2019,4,20,2400,30,44,74,Saturday
2019,4,20,2300,70,79,149,Saturday
2019,4,20,2200,92,171,263,Saturday
2019,4,20,2100,111,310,421,Saturday
2019,4,20,2000,132,382,514,Saturday
2019,4,20,1900,173,601,774,Saturday
2019,4,20,1800,246,850,1096,Saturday
2019,4,20,1700,333,966,1299,Saturday
2019,4,20,1600,374,778,1152,Saturday
2019,4,20,1500,467,602,1069,Saturday
2019,4,20,1400,540,519,1059,Saturday
2019,4,20,1300,679,380,1059,Saturday
2019,4,20,1200,772,333,1105,Saturday
2019,4,20,1100,808,198,1006,Saturday
2019,4,20,1000,682,144,826,Saturday
2019,4,20,900,552,89,641,Saturday
2019,4,20,800,258,49,307,Saturday
2019,4,20,700,90,28,118,Saturday
2019,4,20,600,60,15,75,Saturday
2019,4,20,500,21,17,38,Saturday
2019,4,20,400,22,10,32,Saturday
2019,4,20,300,14,21,35,Saturday
2019,4,20,200,26,20,46,Saturday
2019,4,20,100,29,36,65,Saturday
2019,4,19,2400,31,47,78,Friday
2019,4,19,2300,55,78,133,Friday
2019,4,19,2200,83,135,218,Friday
2019,4,19,2100,133,224,357,Friday
2019,4,19,2000,203,274,477,Friday
2019,4,19,1900,216,360,576,Friday
2019,4,19,1800,305,547,852,Friday
2019,4,19,1700,479,758,1237,Friday
2019,4,19,1600,620,739,1359,Friday
2019,4,19,1500,766,648,1414,Friday
2019,4,19,1400,977,635,1612,Friday
2019,4,19,1300,1163,561,1724,Friday
2019,4,19,1200,1327,381,1708,Friday
2019,4,19,1100,1317,314,1631,Friday
2019,4,19,1000,1139,205,1344,Friday
2019,4,19,900,895,142,1037,Friday
2019,4,19,800,476,87,563,Friday
2019,4,19,700,245,55,300,Friday
2019,4,19,600,124,45,169,Friday
2019,4,19,500,61,33,94,Friday
2019,4,19,400,33,59,92,Friday
2019,4,19,300,51,23,74,Friday
2019,4,19,200,52,63,115,Friday
2019,4,19,100,69,80,149,Friday
2019,4,18,2400,127,85,212,Thursday
2019,4,18,2300,213,174,387,Thursday
2019,4,18,2200,359,171,530,Thursday
2019,4,18,2100,628,220,848,Thursday
2019,4,18,2000,1109,273,1382,Thursday
2019,4,18,1900,928,397,1325,Thursday
2019,4,18,1800,782,514,1296,Thursday
2019,4,18,1700,738,647,1385,Thursday
2019,4,18,1600,661,628,1289,Thursday
2019,4,18,1500,655,601,1256,Thursday
2019,4,18,1400,595,456,1051,Thursday
2019,4,18,1300,575,348,923,Thursday
2019,4,18,1200,684,324,1008,Thursday
2019,4,18,1100,686,263,949,Thursday
2019,4,18,1000,641,178,819,Thursday
2019,4,18,900,464,110,574,Thursday
2019,4,18,800,283,83,366,Thursday
2019,4,18,700,140,43,183,Thursday
2019,4,18,600,74,48,122,Thursday
2019,4,18,500,35,40,75,Thursday
2019,4,18,400,35,36,71,Thursday
2019,4,18,300,31,44,75,Thursday
2019,4,18,200,35,57,92,Thursday
2019,4,18,100,41,61,102,Thursday
2019,4,17,2400,73,92,165,Wednesday
2019,4,17,2300,114,108,222,Wednesday
2019,4,17,2200,123,157,280,Wednesday
2019,4,17,2100,205,187,392,Wednesday
2019,4,17,2000,232,238,470,Wednesday
2019,4,17,1900,237,285,522,Wednesday
2019,4,17,1800,276,411,687,Wednesday
2019,4,17,1700,310,437,747,Wednesday
2019,4,17,1600,322,397,719,Wednesday
2019,4,17,1500,391,389,780,Wednesday
2019,4,17,1400,377,343,720,Wednesday
2019,4,17,1300,374,286,660,Wednesday
2019,4,17,1200,463,234,697,Wednesday
2019,4,17,1100,462,222,684,Wednesday
2019,4,17,1000,433,191,624,Wednesday
2019,4,17,900,317,127,444,Wednesday
2019,4,17,800,224,77,301,Wednesday
2019,4,17,700,118,50,168,Wednesday
2019,4,17,600,51,40,91,Wednesday
2019,4,17,500,28,38,66,Wednesday
2019,4,17,400,28,45,73,Wednesday
2019,4,17,300,36,42,78,Wednesday
2019,4,17,200,35,51,86,Wednesday
2019,4,17,100,47,55,102,Wednesday
2019,4,16,2400,64,68,132,Tuesday
2019,4,16,2300,77,99,176,Tuesday
2019,4,16,2200,93,135,228,Tuesday
2019,4,16,2100,120,159,279,Tuesday
2019,4,16,2000,142,214,356,Tuesday
2019,4,16,1900,177,267,444,Tuesday
2019,4,16,1800,205,456,661,Tuesday
2019,4,16,1700,256,506,762,Tuesday
2019,4,16,1600,270,404,674,Tuesday
2019,4,16,1500,277,368,645,Tuesday
2019,4,16,1400,309,321,630,Tuesday
2019,4,16,1300,330,291,621,Tuesday
2019,4,16,1200,408,247,655,Tuesday
2019,4,16,1100,431,207,638,Tuesday
2019,4,16,1000,322,180,502,Tuesday
2019,4,16,900,300,119,419,Tuesday
2019,4,16,800,216,57,273,Tuesday
2019,4,16,700,101,47,148,Tuesday
2019,4,16,600,47,36,83,Tuesday
2019,4,16,500,28,35,63,Tuesday
2019,4,16,400,17,37,54,Tuesday
2019,4,16,300,28,53,81,Tuesday
2019,4,16,200,29,46,75,Tuesday
2019,4,16,100,41,53,94,Tuesday
2019,4,15,2400,63,80,143,Monday
2019,4,15,2300,72,67,139,Monday
2019,4,15,2200,96,118,214,Monday
2019,4,15,2100,108,167,275,Monday
2019,4,15,2000,158,216,374,Monday
2019,4,15,1900,164,269,433,Monday
2019,4,15,1800,208,400,608,Monday
2019,4,15,1700,268,458,726,Monday
2019,4,15,1600,287,476,763,Monday
2019,4,15,1500,319,411,730,Monday
2019,4,15,1400,344,314,658,Monday
2019,4,15,1300,390,266,656,Monday
2019,4,15,1200,456,249,705,Monday
2019,4,15,1100,485,202,687,Monday
2019,4,15,1000,395,155,550,Monday
2019,4,15,900,310,115,425,Monday
2019,4,15,800,232,68,300,Monday
2019,4,15,700,68,46,114,Monday
2019,4,15,600,47,24,71,Monday
2019,4,15,500,20,15,35,Monday
2019,4,15,400,19,20,39,Monday
2019,4,15,300,16,29,45,Monday
2019,4,15,200,24,25,49,Monday
2019,4,15,100,31,53,84,Monday
2019,4,14,2400,31,62,93,Sunday
2019,4,14,2300,59,110,169,Sunday
2019,4,14,2200,62,191,253,Sunday
2019,4,14,2100,99,281,380,Sunday
2019,4,14,2000,122,380,502,Sunday
2019,4,14,1900,153,550,703,Sunday
2019,4,14,1800,227,740,967,Sunday
2019,4,14,1700,275,1002,1277,Sunday
2019,4,14,1600,288,720,1008,Sunday
2019,4,14,1500,344,718,1062,Sunday
2019,4,14,1400,341,648,989,Sunday
2019,4,14,1300,430,484,914,Sunday
2019,4,14,1200,444,364,808,Sunday
2019,4,14,1100,430,246,676,Sunday
2019,4,14,1000,429,152,581,Sunday
2019,4,14,900,429,88,517,Sunday
2019,4,14,800,184,41,225,Sunday
2019,4,14,700,75,21,96,Sunday
2019,4,14,600,33,22,55,Sunday
2019,4,14,500,15,13,28,Sunday
2019,4,14,400,20,12,32,Sunday
2019,4,14,300,16,13,29,Sunday
2019,4,14,200,33,30,63,Sunday
2019,4,14,100,30,27,57,Sunday
2019,4,13,2400,35,46,81,Saturday
2019,4,13,2300,41,87,128,Saturday
2019,4,13,2200,88,145,233,Saturday
2019,4,13,2100,111,159,270,Saturday
2019,4,13,2000,125,206,331,Saturday
2019,4,13,1900,136,401,537,Saturday
2019,4,13,1800,195,581,776,Saturday
2019,4,13,1700,210,717,927,Saturday
2019,4,13,1600,292,511,803,Saturday
2019,4,13,1500,301,401,702,Saturday
2019,4,13,1400,315,341,656,Saturday
2019,4,13,1300,428,328,756,Saturday
2019,4,13,1200,493,283,776,Saturday
2019,4,13,1100,533,216,749,Saturday
2019,4,13,1000,602,158,760,Saturday
2019,4,13,900,551,120,671,Saturday
2019,4,13,800,290,75,365,Saturday
2019,4,13,700,125,48,173,Saturday
2019,4,13,600,43,26,69,Saturday
2019,4,13,500,16,23,39,Saturday
2019,4,13,400,28,29,57,Saturday
2019,4,13,300,27,31,58,Saturday
2019,4,13,200,27,34,61,Saturday
2019,4,13,100,45,44,89,Saturday
2019,4,12,2400,60,62,122,Friday
2019,4,12,2300,97,90,187,Friday
2019,4,12,2200,128,153,281,Friday
2019,4,12,2100,205,148,353,Friday
2019,4,12,2000,290,235,525,Friday
2019,4,12,1900,404,301,705,Friday
2019,4,12,1800,480,473,953,Friday
2019,4,12,1700,469,568,1037,Friday
2019,4,12,1600,467,405,872,Friday
2019,4,12,1500,426,400,826,Friday
2019,4,12,1400,396,355,751,Friday
2019,4,12,1300,400,314,714,Friday
2019,4,12,1200,492,254,746,Friday
2019,4,12,1100,471,208,679,Friday
2019,4,12,1000,438,159,597,Friday
2019,4,12,900,389,138,527,Friday
2019,4,12,800,230,70,300,Friday
2019,4,12,700,83,53,136,Friday
2019,4,12,600,56,33,89,Friday
2019,4,12,500,27,29,56,Friday
2019,4,12,400,20,31,51,Friday
2019,4,12,300,40,35,75,Friday
2019,4,12,200,34,38,72,Friday
2019,4,12,100,49,74,123,Friday
2019,4,11,2400,50,71,121,Thursday
2019,4,11,2300,73,79,152,Thursday
2019,4,11,2200,108,126,234,Thursday
2019,4,11,2100,142,147,289,Thursday
2019,4,11,2000,169,201,370,Thursday
2019,4,11,1900,202,304,506,Thursday
2019,4,11,1800,241,364,605,Thursday
2019,4,11,1700,276,446,722,Thursday
2019,4,11,1600,271,307,578,Thursday
2019,4,11,1500,291,343,634,Thursday
2019,4,11,1400,287,306,593,Thursday
2019,4,11,1300,308,312,620,Thursday
2019,4,11,1200,353,226,579,Thursday
2019,4,11,1100,384,166,550,Thursday
2019,4,11,1000,316,150,466,Thursday
2019,4,11,900,241,123,364,Thursday
2019,4,11,800,212,55,267,Thursday
2019,4,11,700,107,49,156,Thursday
2019,4,11,600,45,48,93,Thursday
2019,4,11,500,27,55,82,Thursday
2019,4,11,400,23,34,57,Thursday
2019,4,11,300,25,26,51,Thursday
2019,4,11,200,37,37,74,Thursday
2019,4,11,100,44,61,105,Thursday
2019,4,10,2400,60,78,138,Wednesday
2019,4,10,2300,82,81,163,Wednesday
2019,4,10,2200,105,135,240,Wednesday
2019,4,10,2100,128,154,282,Wednesday
2019,4,10,2000,145,239,384,Wednesday
2019,4,10,1900,195,210,405,Wednesday
2019,4,10,1800,197,399,596,Wednesday
2019,4,10,1700,247,350,597,Wednesday
2019,4,10,1600,230,382,612,Wednesday
2019,4,10,1500,264,282,546,Wednesday
2019,4,10,1400,263,238,501,Wednesday
2019,4,10,1300,280,238,518,Wednesday
2019,4,10,1200,296,221,517,Wednesday
2019,4,10,1100,356,188,544,Wednesday
2019,4,10,1000,304,137,441,Wednesday
2019,4,10,900,237,99,336,Wednesday
2019,4,10,800,178,51,229,Wednesday
2019,4,10,700,99,47,146,Wednesday
2019,4,10,600,48,35,83,Wednesday
2019,4,10,500,32,37,69,Wednesday
2019,4,10,400,24,29,53,Wednesday
2019,4,10,300,27,37,64,Wednesday
2019,4,10,200,31,52,83,Wednesday
2019,4,10,100,39,55,94,Wednesday
2019,4,9,2400,58,67,125,Tuesday
2019,4,9,2300,62,60,122,Tuesday
2019,4,9,2200,89,93,182,Tuesday
2019,4,9,2100,90,153,243,Tuesday
2019,4,9,2000,141,188,329,Tuesday
2019,4,9,1900,128,248,376,Tuesday
2019,4,9,1800,187,371,558,Tuesday
2019,4,9,1700,235,368,603,Tuesday
2019,4,9,1600,240,331,571,Tuesday
2019,4,9,1500,260,292,552,Tuesday
2019,4,9,1400,237,267,504,Tuesday
2019,4,9,1300,295,271,566,Tuesday
2019,4,9,1200,313,212,525,Tuesday
2019,4,9,1100,333,176,509,Tuesday
2019,4,9,1000,297,163,460,Tuesday
2019,4,9,900,212,102,314,Tuesday
2019,4,9,800,196,61,257,Tuesday
2019,4,9,700,90,50,140,Tuesday
2019,4,9,600,39,34,73,Tuesday
2019,4,9,500,24,34,58,Tuesday
2019,4,9,400,26,30,56,Tuesday
2019,4,9,300,22,38,60,Tuesday
2019,4,9,200,29,43,72,Tuesday
2019,4,9,100,35,47,82,Tuesday
2019,4,8,2400,58,66,124,Monday
2019,4,8,2300,78,92,170,Monday
2019,4,8,2200,98,112,210,Monday
2019,4,8,2100,110,183,293,Monday
2019,4,8,2000,131,270,401,Monday
2019,4,8,1900,161,363,524,Monday
2019,4,8,1800,218,468,686,Monday
2019,4,8,1700,248,412,660,Monday
2019,4,8,1600,266,390,656,Monday
2019,4,8,1500,282,363,645,Monday
2019,4,8,1400,295,275,570,Monday
2019,4,8,1300,354,249,603,Monday
2019,4,8,1200,418,215,633,Monday
2019,4,8,1100,410,199,609,Monday
2019,4,8,1000,389,135,524,Monday
2019,4,8,900,298,108,406,Monday
2019,4,8,800,226,52,278,Monday
2019,4,8,700,67,52,119,Monday
2019,4,8,600,55,19,74,Monday
2019,4,8,500,22,14,36,Monday
2019,4,8,400,14,21,35,Monday
2019,4,8,300,18,15,33,Monday
2019,4,8,200,29,33,62,Monday
2019,4,8,100,22,50,72,Monday
2019,4,7,2400,42,68,110,Sunday
2019,4,7,2300,56,104,160,Sunday
2019,4,7,2200,80,148,228,Sunday
2019,4,7,2100,111,212,323,Sunday
2019,4,7,2000,135,328,463,Sunday
2019,4,7,1900,161,545,706,Sunday
2019,4,7,1800,200,687,887,Sunday
2019,4,7,1700,248,1203,1451,Sunday
2019,4,7,1600,278,860,1138,Sunday
2019,4,7,1500,310,675,985,Sunday
2019,4,7,1400,347,609,956,Sunday
2019,4,7,1300,388,469,857,Sunday
2019,4,7,1200,430,337,767,Sunday
2019,4,7,1100,494,254,748,Sunday
2019,4,7,1000,480,130,610,Sunday
2019,4,7,900,386,89,475,Sunday
2019,4,7,800,274,31,305,Sunday
2019,4,7,700,121,20,141,Sunday
2019,4,7,600,35,11,46,Sunday
2019,4,7,500,11,7,18,Sunday
2019,4,7,400,15,17,32,Sunday
2019,4,7,300,11,21,32,Sunday
2019,4,7,200,22,24,46,Sunday
2019,4,7,100,23,26,49,Sunday
2019,4,6,2400,35,45,80,Saturday
2019,4,6,2300,42,76,118,Saturday
2019,4,6,2200,84,88,172,Saturday
2019,4,6,2100,91,137,228,Saturday
2019,4,6,2000,125,227,352,Saturday
2019,4,6,1900,155,346,501,Saturday
2019,4,6,1800,199,612,811,Saturday
2019,4,6,1700,225,859,1084,Saturday
2019,4,6,1600,251,493,744,Saturday
2019,4,6,1500,288,493,781,Saturday
2019,4,6,1400,351,370,721,Saturday
2019,4,6,1300,393,329,722,Saturday
2019,4,6,1200,470,252,722,Saturday
2019,4,6,1100,468,185,653,Saturday
2019,4,6,1000,525,169,694,Saturday
2019,4,6,900,569,98,667,Saturday
2019,4,6,800,326,73,399,Saturday
2019,4,6,700,178,29,207,Saturday
2019,4,6,600,50,33,83,Saturday
2019,4,6,500,18,30,48,Saturday
2019,4,6,400,22,22,44,Saturday
2019,4,6,300,27,30,57,Saturday
2019,4,6,200,35,26,61,Saturday
2019,4,6,100,30,50,80,Saturday
2019,4,5,2400,58,71,129,Friday
2019,4,5,2300,107,84,191,Friday
2019,4,5,2200,145,116,261,Friday
2019,4,5,2100,223,146,369,Friday
2019,4,5,2000,334,217,551,Friday
2019,4,5,1900,450,285,735,Friday
2019,4,5,1800,442,499,941,Friday
2019,4,5,1700,429,582,1011,Friday
2019,4,5,1600,427,408,835,Friday
2019,4,5,1500,443,425,868,Friday
2019,4,5,1400,364,392,756,Friday
2019,4,5,1300,397,295,692,Friday
2019,4,5,1200,420,260,680,Friday
2019,4,5,1100,518,216,734,Friday
2019,4,5,1000,425,157,582,Friday
2019,4,5,900,345,118,463,Friday
2019,4,5,800,245,74,319,Friday
2019,4,5,700,108,40,148,Friday
2019,4,5,600,49,34,83,Friday
2019,4,5,500,27,27,54,Friday
2019,4,5,400,47,31,78,Friday
2019,4,5,300,26,23,49,Friday
2019,4,5,200,39,64,103,Friday
2019,4,5,100,45,53,98,Friday
2019,4,4,2400,65,65,130,Thursday
2019,4,4,2300,87,94,181,Thursday
2019,4,4,2200,127,135,262,Thursday
2019,4,4,2100,144,158,302,Thursday
2019,4,4,2000,217,229,446,Thursday
2019,4,4,1900,240,244,484,Thursday
2019,4,4,1800,269,379,648,Thursday
2019,4,4,1700,316,425,741,Thursday
2019,4,4,1600,333,428,761,Thursday
2019,4,4,1500,317,371,688,Thursday
2019,4,4,1400,350,295,645,Thursday
2019,4,4,1300,344,238,582,Thursday
2019,4,4,1200,385,251,636,Thursday
2019,4,4,1100,416,198,614,Thursday
2019,4,4,1000,372,177,549,Thursday
2019,4,4,900,339,120,459,Thursday
2019,4,4,800,231,59,290,Thursday
2019,4,4,700,115,56,171,Thursday
2019,4,4,600,47,40,87,Thursday
2019,4,4,500,27,30,57,Thursday
2019,4,4,400,26,39,65,Thursday
2019,4,4,300,31,34,65,Thursday
2019,4,4,200,41,36,77,Thursday
2019,4,4,100,50,46,96,Thursday
2019,4,3,2400,58,74,132,Wednesday
2019,4,3,2300,94,65,159,Wednesday
2019,4,3,2200,103,94,197,Wednesday
2019,4,3,2100,150,148,298,Wednesday
2019,4,3,2000,193,188,381,Wednesday
2019,4,3,1900,189,260,449,Wednesday
2019,4,3,1800,244,367,611,Wednesday
2019,4,3,1700,232,438,670,Wednesday
2019,4,3,1600,248,368,616,Wednesday
2019,4,3,1500,274,336,610,Wednesday
2019,4,3,1400,272,273,545,Wednesday
2019,4,3,1300,299,261,560,Wednesday
2019,4,3,1200,311,223,534,Wednesday
2019,4,3,1100,379,218,597,Wednesday
2019,4,3,1000,355,175,530,Wednesday
2019,4,3,900,246,109,355,Wednesday
2019,4,3,800,192,60,252,Wednesday
2019,4,3,700,79,48,127,Wednesday
2019,4,3,600,47,41,88,Wednesday
2019,4,3,500,33,36,69,Wednesday
2019,4,3,400,24,37,61,Wednesday
2019,4,3,300,30,35,65,Wednesday
2019,4,3,200,30,34,64,Wednesday
2019,4,3,100,44,45,89,Wednesday
2019,4,2,2400,68,42,110,Tuesday
2019,4,2,2300,73,102,175,Tuesday
2019,4,2,2200,91,122,213,Tuesday
2019,4,2,2100,120,148,268,Tuesday
2019,4,2,2000,117,201,318,Tuesday
2019,4,2,1900,156,286,442,Tuesday
2019,4,2,1800,195,410,605,Tuesday
2019,4,2,1700,229,457,686,Tuesday
2019,4,2,1600,233,358,591,Tuesday
2019,4,2,1500,253,333,586,Tuesday
2019,4,2,1400,237,273,510,Tuesday
2019,4,2,1300,311,259,570,Tuesday
2019,4,2,1200,337,184,521,Tuesday
2019,4,2,1100,339,170,509,Tuesday
2019,4,2,1000,335,159,494,Tuesday
2019,4,2,900,276,96,372,Tuesday
2019,4,2,800,184,65,249,Tuesday
2019,4,2,700,96,50,146,Tuesday
2019,4,2,600,45,33,78,Tuesday
2019,4,2,500,27,27,54,Tuesday
2019,4,2,400,28,43,71,Tuesday
2019,4,2,300,30,26,56,Tuesday
2019,4,2,200,36,36,72,Tuesday
2019,4,2,100,37,59,96,Tuesday
2019,4,1,2400,56,68,124,Monday
2019,4,1,2300,78,87,165,Monday
2019,4,1,2200,79,110,189,Monday
2019,4,1,2100,105,154,259,Monday
2019,4,1,2000,128,219,347,Monday
2019,4,1,1900,160,307,467,Monday
2019,4,1,1800,194,467,661,Monday
2019,4,1,1700,216,490,706,Monday
2019,4,1,1600,255,380,635,Monday
2019,4,1,1500,304,421,725,Monday
2019,4,1,1400,321,337,658,Monday
2019,4,1,1300,347,294,641,Monday
2019,4,1,1200,414,260,674,Monday
2019,4,1,1100,412,206,618,Monday
2019,4,1,1000,381,157,538,Monday
2019,4,1,900,312,112,424,Monday
2019,4,1,800,204,52,256,Monday
2019,4,1,700,86,35,121,Monday
2019,4,1,600,39,21,60,Monday
2019,4,1,500,20,19,39,Monday
2019,4,1,400,25,22,47,Monday
2019,4,1,300,11,27,38,Monday
2019,4,1,200,33,31,64,Monday
2019,4,1,100,28,39,67,Monday
2019,3,31,2400,38,85,123,Sunday
2019,3,31,2300,54,113,167,Sunday
2019,3,31,2200,63,151,214,Sunday
2019,3,31,2100,104,277,381,Sunday
2019,3,31,2000,140,364,504,Sunday
2019,3,31,1900,155,611,766,Sunday
2019,3,31,1800,199,949,1148,Sunday
2019,3,31,1700,254,1250,1504,Sunday
2019,3,31,1600,331,1054,1385,Sunday
2019,3,31,1500,385,970,1355,Sunday
2019,3,31,1400,405,878,1283,Sunday
2019,3,31,1300,480,743,1223,Sunday
2019,3,31,1200,506,567,1073,Sunday
2019,3,31,1100,492,268,760,Sunday
2019,3,31,1000,493,173,666,Sunday
2019,3,31,900,450,76,526,Sunday
2019,3,31,800,235,37,272,Sunday
2019,3,31,700,82,24,106,Sunday
2019,3,31,600,45,17,62,Sunday
2019,3,31,500,23,15,38,Sunday
2019,3,31,400,18,18,36,Sunday
2019,3,31,300,20,23,43,Sunday
2019,3,31,200,30,27,57,Sunday
2019,3,31,100,27,41,68,Sunday
2019,3,30,2400,34,61,95,Saturday
2019,3,30,2300,38,101,139,Saturday
2019,3,30,2200,80,147,227,Saturday
2019,3,30,2100,87,247,334,Saturday
2019,3,30,2000,126,349,475,Saturday
2019,3,30,1900,161,598,759,Saturday
2019,3,30,1800,245,1089,1334,Saturday
2019,3,30,1700,295,1183,1478,Saturday
2019,3,30,1600,385,952,1337,Saturday
2019,3,30,1500,447,707,1154,Saturday
2019,3,30,1400,510,541,1051,Saturday
2019,3,30,1300,652,484,1136,Saturday
2019,3,30,1200,731,404,1135,Saturday
2019,3,30,1100,745,290,1035,Saturday
2019,3,30,1000,764,202,966,Saturday
2019,3,30,900,866,112,978,Saturday
2019,3,30,800,328,66,394,Saturday
2019,3,30,700,123,29,152,Saturday
2019,3,30,600,58,27,85,Saturday
2019,3,30,500,17,36,53,Saturday
2019,3,30,400,22,30,52,Saturday
2019,3,30,300,34,27,61,Saturday
2019,3,30,200,33,33,66,Saturday
2019,3,30,100,28,62,90,Saturday
2019,3,29,2400,65,80,145,Friday
2019,3,29,2300,89,124,213,Friday
2019,3,29,2200,180,133,313,Friday
2019,3,29,2100,234,183,417,Friday
2019,3,29,2000,348,266,614,Friday
2019,3,29,1900,426,464,890,Friday
2019,3,29,1800,474,830,1304,Friday
2019,3,29,1700,510,970,1480,Friday
2019,3,29,1600,519,702,1221,Friday
2019,3,29,1500,507,541,1048,Friday
2019,3,29,1400,526,555,1081,Friday
2019,3,29,1300,552,483,1035,Friday
2019,3,29,1200,615,394,1009,Friday
2019,3,29,1100,654,259,913,Friday
2019,3,29,1000,658,205,863,Friday
2019,3,29,900,571,145,716,Friday
2019,3,29,800,331,76,407,Friday
2019,3,29,700,130,54,184,Friday
2019,3,29,600,50,43,93,Friday
2019,3,29,500,27,34,61,Friday
2019,3,29,400,35,28,63,Friday
2019,3,29,300,34,48,82,Friday
2019,3,29,200,33,48,81,Friday
2019,3,29,100,60,52,112,Friday
2019,3,28,2400,72,82,154,Thursday
2019,3,28,2300,118,111,229,Thursday
2019,3,28,2200,103,144,247,Thursday
2019,3,28,2100,168,212,380,Thursday
2019,3,28,2000,239,285,524,Thursday
2019,3,28,1900,304,419,723,Thursday
2019,3,28,1800,371,714,1085,Thursday
2019,3,28,1700,361,819,1180,Thursday
2019,3,28,1600,447,616,1063,Thursday
2019,3,28,1500,416,483,899,Thursday
2019,3,28,1400,491,462,953,Thursday
2019,3,28,1300,437,425,862,Thursday
2019,3,28,1200,609,297,906,Thursday
2019,3,28,1100,612,220,832,Thursday
2019,3,28,1000,578,163,741,Thursday
2019,3,28,900,589,129,718,Thursday
2019,3,28,800,280,59,339,Thursday
2019,3,28,700,100,47,147,Thursday
2019,3,28,600,49,53,102,Thursday
2019,3,28,500,30,26,56,Thursday
2019,3,28,400,28,42,70,Thursday
2019,3,28,300,30,38,68,Thursday
2019,3,28,200,39,29,68,Thursday
2019,3,28,100,56,56,112,Thursday
2019,3,27,2400,56,71,127,Wednesday
2019,3,27,2300,89,81,170,Wednesday
2019,3,27,2200,120,114,234,Wednesday
2019,3,27,2100,143,187,330,Wednesday
2019,3,27,2000,180,217,397,Wednesday
2019,3,27,1900,204,335,539,Wednesday
2019,3,27,1800,252,554,806,Wednesday
2019,3,27,1700,359,650,1009,Wednesday
2019,3,27,1600,320,512,832,Wednesday
2019,3,27,1500,396,435,831,Wednesday
2019,3,27,1400,431,428,859,Wednesday
2019,3,27,1300,414,383,797,Wednesday
2019,3,27,1200,477,308,785,Wednesday
2019,3,27,1100,518,259,777,Wednesday
2019,3,27,1000,475,163,638,Wednesday
2019,3,27,900,432,123,555,Wednesday
2019,3,27,800,235,61,296,Wednesday
2019,3,27,700,80,41,121,Wednesday
2019,3,27,600,38,35,73,Wednesday
2019,3,27,500,22,31,53,Wednesday
2019,3,27,400,27,36,63,Wednesday
2019,3,27,300,31,51,82,Wednesday
2019,3,27,200,38,96,134,Wednesday
2019,3,27,100,42,47,89,Wednesday
2019,3,26,2400,57,67,124,Tuesday
2019,3,26,2300,76,30,106,Tuesday
2019,3,26,2200,78,45,123,Tuesday
2019,3,26,2100,108,134,242,Tuesday
2019,3,26,2000,170,190,360,Tuesday
2019,3,26,1900,194,294,488,Tuesday
2019,3,26,1800,235,538,773,Tuesday
2019,3,26,1700,275,622,897,Tuesday
2019,3,26,1600,351,576,927,Tuesday
2019,3,26,1500,343,500,843,Tuesday
2019,3,26,1400,430,490,920,Tuesday
2019,3,26,1300,446,392,838,Tuesday
2019,3,26,1200,554,308,862,Tuesday
2019,3,26,1100,504,222,726,Tuesday
2019,3,26,1000,497,173,670,Tuesday
2019,3,26,900,396,128,524,Tuesday
2019,3,26,800,239,77,316,Tuesday
2019,3,26,700,106,45,151,Tuesday
2019,3,26,600,47,38,85,Tuesday
2019,3,26,500,16,41,57,Tuesday
2019,3,26,400,26,27,53,Tuesday
2019,3,26,300,27,48,75,Tuesday
2019,3,26,200,24,49,73,Tuesday
2019,3,26,100,33,68,101,Tuesday
2019,3,25,2400,51,52,103,Monday
2019,3,25,2300,69,82,151,Monday
2019,3,25,2200,94,106,200,Monday
2019,3,25,2100,122,136,258,Monday
2019,3,25,2000,166,238,404,Monday
2019,3,25,1900,206,345,551,Monday
2019,3,25,1800,282,594,876,Monday
2019,3,25,1700,312,766,1078,Monday
2019,3,25,1600,374,610,984,Monday
2019,3,25,1500,452,518,970,Monday
2019,3,25,1400,491,423,914,Monday
2019,3,25,1300,528,388,916,Monday
2019,3,25,1200,589,334,923,Monday
2019,3,25,1100,623,214,837,Monday
2019,3,25,1000,570,175,745,Monday
2019,3,25,900,498,113,611,Monday
2019,3,25,800,268,54,322,Monday
2019,3,25,700,113,33,146,Monday
2019,3,25,600,55,23,78,Monday
2019,3,25,500,27,20,47,Monday
2019,3,25,400,18,29,47,Monday
2019,3,25,300,21,13,34,Monday
2019,3,25,200,24,32,56,Monday
2019,3,25,100,21,55,76,Monday
2019,3,24,2400,34,66,100,Sunday
2019,3,24,2300,57,109,166,Sunday
2019,3,24,2200,73,161,234,Sunday
2019,3,24,2100,116,262,378,Sunday
2019,3,24,2000,164,331,495,Sunday
2019,3,24,1900,210,612,822,Sunday
2019,3,24,1800,275,974,1249,Sunday
2019,3,24,1700,382,1102,1484,Sunday
2019,3,24,1600,461,874,1335,Sunday
2019,3,24,1500,546,791,1337,Sunday
2019,3,24,1400,601,656,1257,Sunday
2019,3,24,1300,577,616,1193,Sunday
2019,3,24,1200,690,430,1120,Sunday
2019,3,24,1100,657,229,886,Sunday
2019,3,24,1000,618,146,764,Sunday
2019,3,24,900,576,81,657,Sunday
2019,3,24,800,236,31,267,Sunday
2019,3,24,700,91,20,111,Sunday
2019,3,24,600,35,20,55,Sunday
2019,3,24,500,24,20,44,Sunday
2019,3,24,400,23,17,40,Sunday
2019,3,24,300,12,27,39,Sunday
2019,3,24,200,23,32,55,Sunday
2019,3,24,100,39,29,68,Sunday
2019,3,23,2400,32,54,86,Saturday
2019,3,23,2300,50,72,122,Saturday
2019,3,23,2200,67,114,181,Saturday
2019,3,23,2100,124,189,313,Saturday
2019,3,23,2000,146,292,438,Saturday
2019,3,23,1900,198,438,636,Saturday
2019,3,23,1800,286,899,1185,Saturday
2019,3,23,1700,364,1066,1430,Saturday
2019,3,23,1600,495,731,1226,Saturday
2019,3,23,1500,570,570,1140,Saturday
2019,3,23,1400,620,458,1078,Saturday
2019,3,23,1300,724,361,1085,Saturday
2019,3,23,1200,832,323,1155,Saturday
2019,3,23,1100,814,217,1031,Saturday
2019,3,23,1000,813,166,979,Saturday
2019,3,23,900,813,115,928,Saturday
2019,3,23,800,383,62,445,Saturday
2019,3,23,700,157,50,207,Saturday
2019,3,23,600,55,28,83,Saturday
2019,3,23,500,41,35,76,Saturday
2019,3,23,400,24,29,53,Saturday
2019,3,23,300,18,25,43,Saturday
2019,3,23,200,24,42,66,Saturday
2019,3,23,100,49,48,97,Saturday
2019,3,22,2400,59,69,128,Friday
2019,3,22,2300,110,98,208,Friday
2019,3,22,2200,171,115,286,Friday
2019,3,22,2100,262,180,442,Friday
2019,3,22,2000,457,271,728,Friday
2019,3,22,1900,515,421,936,Friday
2019,3,22,1800,588,584,1172,Friday
2019,3,22,1700,593,759,1352,Friday
2019,3,22,1600,627,603,1230,Friday
2019,3,22,1500,610,450,1060,Friday
2019,3,22,1400,526,394,920,Friday
2019,3,22,1300,546,382,928,Friday
2019,3,22,1200,573,360,933,Friday
2019,3,22,1100,688,214,902,Friday
2019,3,22,1000,608,189,797,Friday
2019,3,22,900,520,130,650,Friday
2019,3,22,800,282,68,350,Friday
2019,3,22,700,147,64,211,Friday
2019,3,22,600,59,45,104,Friday
2019,3,22,500,40,22,62,Friday
2019,3,22,400,31,44,75,Friday
2019,3,22,300,37,33,70,Friday
2019,3,22,200,50,52,102,Friday
2019,3,22,100,34,60,94,Friday
2019,3,21,2400,58,83,141,Thursday
2019,3,21,2300,100,84,184,Thursday
2019,3,21,2200,145,112,257,Thursday
2019,3,21,2100,194,238,432,Thursday
2019,3,21,2000,260,160,420,Thursday
2019,3,21,1900,294,349,643,Thursday
2019,3,21,1800,339,491,830,Thursday
2019,3,21,1700,362,613,975,Thursday
2019,3,21,1600,397,482,879,Thursday
2019,3,21,1500,347,399,746,Thursday
2019,3,21,1400,392,332,724,Thursday
2019,3,21,1300,370,310,680,Thursday
2019,3,21,1200,461,236,697,Thursday
2019,3,21,1100,447,182,629,Thursday
2019,3,21,1000,466,155,621,Thursday
2019,3,21,900,412,124,536,Thursday
2019,3,21,800,222,56,278,Thursday
2019,3,21,700,114,56,170,Thursday
2019,3,21,600,50,39,89,Thursday
2019,3,21,500,39,54,93,Thursday
2019,3,21,400,30,31,61,Thursday
2019,3,21,300,29,37,66,Thursday
2019,3,21,200,33,48,81,Thursday
2019,3,21,100,45,54,99,Thursday
2019,3,20,2400,75,85,160,Wednesday
2019,3,20,2300,74,71,145,Wednesday
2019,3,20,2200,81,118,199,Wednesday
2019,3,20,2100,129,160,289,Wednesday
2019,3,20,2000,144,207,351,Wednesday
2019,3,20,1900,185,339,524,Wednesday
2019,3,20,1800,226,521,747,Wednesday
2019,3,20,1700,253,592,845,Wednesday
2019,3,20,1600,284,362,646,Wednesday
2019,3,20,1500,291,366,657,Wednesday
2019,3,20,1400,296,321,617,Wednesday
2019,3,20,1300,362,249,611,Wednesday
2019,3,20,1200,402,259,661,Wednesday
2019,3,20,1100,456,186,642,Wednesday
2019,3,20,1000,422,179,601,Wednesday
2019,3,20,900,338,112,450,Wednesday
2019,3,20,800,216,70,286,Wednesday
2019,3,20,700,113,56,169,Wednesday
2019,3,20,600,39,38,77,Wednesday
2019,3,20,500,28,35,63,Wednesday
2019,3,20,400,36,38,74,Wednesday
2019,3,20,300,27,38,65,Wednesday
2019,3,20,200,32,48,80,Wednesday
2019,3,20,100,51,53,104,Wednesday
2019,3,19,2400,68,73,141,Tuesday
2019,3,19,2300,66,90,156,Tuesday
2019,3,19,2200,97,118,215,Tuesday
2019,3,19,2100,111,158,269,Tuesday
2019,3,19,2000,127,194,321,Tuesday
2019,3,19,1900,154,257,411,Tuesday
2019,3,19,1800,209,480,689,Tuesday
2019,3,19,1700,257,551,808,Tuesday
2019,3,19,1600,262,463,725,Tuesday
2019,3,19,1500,269,363,632,Tuesday
2019,3,19,1400,264,299,563,Tuesday
2019,3,19,1300,333,250,583,Tuesday
2019,3,19,1200,384,222,606,Tuesday
2019,3,19,1100,430,203,633,Tuesday
2019,3,19,1000,424,171,595,Tuesday
2019,3,19,900,324,147,471,Tuesday
2019,3,19,800,184,65,249,Tuesday
2019,3,19,700,129,42,171,Tuesday
2019,3,19,600,37,44,81,Tuesday
2019,3,19,500,19,21,40,Tuesday
2019,3,19,400,24,28,52,Tuesday
2019,3,19,300,27,46,73,Tuesday
2019,3,19,200,30,45,75,Tuesday
2019,3,19,100,30,48,78,Tuesday
2019,3,18,2400,65,71,136,Monday
2019,3,18,2300,73,83,156,Monday
2019,3,18,2200,85,106,191,Monday
2019,3,18,2100,125,195,320,Monday
2019,3,18,2000,159,287,446,Monday
2019,3,18,1900,179,230,409,Monday
2019,3,18,1800,217,490,707,Monday
2019,3,18,1700,244,719,963,Monday
2019,3,18,1600,289,471,760,Monday
2019,3,18,1500,305,369,674,Monday
2019,3,18,1400,322,370,692,Monday
2019,3,18,1300,376,335,711,Monday
2019,3,18,1200,424,271,695,Monday
2019,3,18,1100,439,199,638,Monday
2019,3,18,1000,460,185,645,Monday
2019,3,18,900,414,114,528,Monday
2019,3,18,800,250,70,320,Monday
2019,3,18,700,75,39,114,Monday
2019,3,18,600,37,31,68,Monday
2019,3,18,500,24,17,41,Monday
2019,3,18,400,18,30,48,Monday
2019,3,18,300,20,28,48,Monday
2019,3,18,200,19,35,54,Monday
2019,3,18,100,36,53,89,Monday
2019,3,17,2400,33,95,128,Sunday
2019,3,17,2300,58,266,324,Sunday
2019,3,17,2200,68,586,654,Sunday
2019,3,17,2100,92,227,319,Sunday
2019,3,17,2000,117,234,351,Sunday
2019,3,17,1900,153,402,555,Sunday
2019,3,17,1800,205,917,1122,Sunday
2019,3,17,1700,251,1339,1590,Sunday
2019,3,17,1600,289,843,1132,Sunday
2019,3,17,1500,352,824,1176,Sunday
2019,3,17,1400,447,710,1157,Sunday
2019,3,17,1300,531,581,1112,Sunday
2019,3,17,1200,554,423,977,Sunday
2019,3,17,1100,589,264,853,Sunday
2019,3,17,1000,655,161,816,Sunday
2019,3,17,900,712,97,809,Sunday
2019,3,17,800,297,37,334,Sunday
2019,3,17,700,82,16,98,Sunday
2019,3,17,600,31,15,46,Sunday
2019,3,17,500,12,20,32,Sunday
2019,3,17,400,13,12,25,Sunday
2019,3,17,300,15,15,30,Sunday
2019,3,17,200,26,30,56,Sunday
2019,3,17,100,35,30,65,Sunday
2019,3,16,2400,24,64,88,Saturday
2019,3,16,2300,58,70,128,Saturday
2019,3,16,2200,88,95,183,Saturday
2019,3,16,2100,100,157,257,Saturday
2019,3,16,2000,108,288,396,Saturday
2019,3,16,1900,136,491,627,Saturday
2019,3,16,1800,227,1151,1378,Saturday
2019,3,16,1700,270,1201,1471,Saturday
2019,3,16,1600,359,774,1133,Saturday
2019,3,16,1500,377,649,1026,Saturday
2019,3,16,1400,461,464,925,Saturday
2019,3,16,1300,533,381,914,Saturday
2019,3,16,1200,646,319,965,Saturday
2019,3,16,1100,675,226,901,Saturday
2019,3,16,1000,802,173,975,Saturday
2019,3,16,900,988,99,1087,Saturday
2019,3,16,800,389,61,450,Saturday
2019,3,16,700,113,34,147,Saturday
2019,3,16,600,43,33,76,Saturday
2019,3,16,500,22,36,58,Saturday
2019,3,16,400,22,28,50,Saturday
2019,3,16,300,31,26,57,Saturday
2019,3,16,200,30,38,68,Saturday
2019,3,16,100,43,58,101,Saturday
2019,3,15,2400,59,90,149,Friday
2019,3,15,2300,92,86,178,Friday
2019,3,15,2200,147,108,255,Friday
2019,3,15,2100,237,140,377,Friday
2019,3,15,2000,395,226,621,Friday
2019,3,15,1900,461,388,849,Friday
2019,3,15,1800,528,666,1194,Friday
2019,3,15,1700,487,726,1213,Friday
2019,3,15,1600,459,552,1011,Friday
2019,3,15,1500,468,411,879,Friday
2019,3,15,1400,424,384,808,Friday
2019,3,15,1300,394,360,754,Friday
2019,3,15,1200,530,310,840,Friday
2019,3,15,1100,520,217,737,Friday
2019,3,15,1000,544,169,713,Friday
2019,3,15,900,572,120,692,Friday
2019,3,15,800,301,59,360,Friday
2019,3,15,700,106,46,152,Friday
2019,3,15,600,46,44,90,Friday
2019,3,15,500,20,25,45,Friday
2019,3,15,400,40,36,76,Friday
2019,3,15,300,21,39,60,Friday
2019,3,15,200,44,38,82,Friday
2019,3,15,100,47,50,97,Friday
2019,3,14,2400,68,54,122,Thursday
2019,3,14,2300,79,70,149,Thursday
2019,3,14,2200,114,84,198,Thursday
2019,3,14,2100,170,161,331,Thursday
2019,3,14,2000,237,258,495,Thursday
2019,3,14,1900,252,321,573,Thursday
2019,3,14,1800,305,554,859,Thursday
2019,3,14,1700,293,649,942,Thursday
2019,3,14,1600,314,404,718,Thursday
2019,3,14,1500,390,384,774,Thursday
2019,3,14,1400,341,276,617,Thursday
2019,3,14,1300,356,251,607,Thursday
2019,3,14,1200,387,239,626,Thursday
2019,3,14,1100,431,185,616,Thursday
2019,3,14,1000,491,177,668,Thursday
2019,3,14,900,485,105,590,Thursday
2019,3,14,800,284,58,342,Thursday
2019,3,14,700,105,43,148,Thursday
2019,3,14,600,52,31,83,Thursday
2019,3,14,500,26,47,73,Thursday
2019,3,14,400,36,30,66,Thursday
2019,3,14,300,26,44,70,Thursday
2019,3,14,200,33,39,72,Thursday
2019,3,14,100,40,48,88,Thursday
2019,3,13,2400,64,64,128,Wednesday
2019,3,13,2300,76,70,146,Wednesday
2019,3,13,2200,117,115,232,Wednesday
2019,3,13,2100,132,130,262,Wednesday
2019,3,13,2000,164,190,354,Wednesday
2019,3,13,1900,162,322,484,Wednesday
2019,3,13,1800,227,645,872,Wednesday
2019,3,13,1700,249,435,684,Wednesday
2019,3,13,1600,268,356,624,Wednesday
2019,3,13,1500,251,354,605,Wednesday
2019,3,13,1400,302,298,600,Wednesday
2019,3,13,1300,285,265,550,Wednesday
2019,3,13,1200,334,197,531,Wednesday
2019,3,13,1100,396,214,610,Wednesday
2019,3,13,1000,466,142,608,Wednesday
2019,3,13,900,426,105,531,Wednesday
2019,3,13,800,240,66,306,Wednesday
2019,3,13,700,77,33,110,Wednesday
2019,3,13,600,36,27,63,Wednesday
2019,3,13,500,21,29,50,Wednesday
2019,3,13,400,29,30,59,Wednesday
2019,3,13,300,23,37,60,Wednesday
2019,3,13,200,44,43,87,Wednesday
2019,3,13,100,39,45,84,Wednesday
2019,3,12,2400,60,61,121,Tuesday
2019,3,12,2300,67,64,131,Tuesday
2019,3,12,2200,104,82,186,Tuesday
2019,3,12,2100,74,110,184,Tuesday
2019,3,12,2000,97,173,270,Tuesday
2019,3,12,1900,137,285,422,Tuesday
2019,3,12,1800,152,424,576,Tuesday
2019,3,12,1700,215,512,727,Tuesday
2019,3,12,1600,220,409,629,Tuesday
2019,3,12,1500,229,344,573,Tuesday
2019,3,12,1400,267,277,544,Tuesday
2019,3,12,1300,258,231,489,Tuesday
2019,3,12,1200,330,189,519,Tuesday
2019,3,12,1100,346,162,508,Tuesday
2019,3,12,1000,399,128,527,Tuesday
2019,3,12,900,371,107,478,Tuesday
2019,3,12,800,214,61,275,Tuesday
2019,3,12,700,70,39,109,Tuesday
2019,3,12,600,34,35,69,Tuesday
2019,3,12,500,28,33,61,Tuesday
2019,3,12,400,24,16,40,Tuesday
2019,3,12,300,29,33,62,Tuesday
2019,3,12,200,37,49,86,Tuesday
2019,3,12,100,36,59,95,Tuesday
2019,3,11,2400,59,32,91,Monday
2019,3,11,2300,58,86,144,Monday
2019,3,11,2200,87,71,158,Monday
2019,3,11,2100,138,123,261,Monday
2019,3,11,2000,132,165,297,Monday
2019,3,11,1900,156,293,449,Monday
2019,3,11,1800,197,471,668,Monday
2019,3,11,1700,233,596,829,Monday
2019,3,11,1600,281,463,744,Monday
2019,3,11,1500,305,410,715,Monday
2019,3,11,1400,315,299,614,Monday
2019,3,11,1300,344,323,667,Monday
2019,3,11,1200,384,209,593,Monday
2019,3,11,1100,431,186,617,Monday
2019,3,11,1000,451,151,602,Monday
2019,3,11,900,414,116,530,Monday
2019,3,11,800,215,56,271,Monday
2019,3,11,700,76,27,103,Monday
2019,3,11,600,43,22,65,Monday
2019,3,11,500,18,13,31,Monday
2019,3,11,400,28,23,51,Monday
2019,3,11,300,23,35,58,Monday
2019,3,11,200,22,33,55,Monday
2019,3,11,100,31,45,76,Monday
2019,3,10,2400,27,61,88,Sunday
2019,3,10,2300,41,123,164,Sunday
2019,3,10,2200,67,157,224,Sunday
2019,3,10,2100,101,228,329,Sunday
2019,3,10,2000,116,384,500,Sunday
2019,3,10,1900,144,684,828,Sunday
2019,3,10,1800,221,1218,1439,Sunday
2019,3,10,1700,299,1343,1642,Sunday
2019,3,10,1600,337,934,1271,Sunday
2019,3,10,1500,395,803,1198,Sunday
2019,3,10,1400,445,704,1149,Sunday
2019,3,10,1300,564,529,1093,Sunday
2019,3,10,1200,600,353,953,Sunday
2019,3,10,1100,524,224,748,Sunday
2019,3,10,1000,655,116,771,Sunday
2019,3,10,900,694,80,774,Sunday
2019,3,10,800,299,35,334,Sunday
2019,3,10,700,60,20,80,Sunday
2019,3,10,600,38,15,53,Sunday
2019,3,10,500,10,19,29,Sunday
2019,3,10,400,19,14,33,Sunday
2019,3,10,300,0,0,0,Sunday
2019,3,10,200,18,25,43,Sunday
2019,3,10,100,28,35,63,Sunday
2019,3,9,2400,30,45,75,Saturday
2019,3,9,2300,57,68,125,Saturday
2019,3,9,2200,72,70,142,Saturday
2019,3,9,2100,77,120,197,Saturday
2019,3,9,2000,106,197,303,Saturday
2019,3,9,1900,130,382,512,Saturday
2019,3,9,1800,185,987,1172,Saturday
2019,3,9,1700,279,1139,1418,Saturday
2019,3,9,1600,298,745,1043,Saturday
2019,3,9,1500,373,502,875,Saturday
2019,3,9,1400,428,400,828,Saturday
2019,3,9,1300,441,330,771,Saturday
2019,3,9,1200,553,236,789,Saturday
2019,3,9,1100,595,217,812,Saturday
2019,3,9,1000,728,182,910,Saturday
2019,3,9,900,1019,105,1124,Saturday
2019,3,9,800,412,60,472,Saturday
2019,3,9,700,118,47,165,Saturday
2019,3,9,600,45,22,67,Saturday
2019,3,9,500,21,19,40,Saturday
2019,3,9,400,31,20,51,Saturday
2019,3,9,300,23,33,56,Saturday
2019,3,9,200,22,19,41,Saturday
2019,3,9,100,32,47,79,Saturday
2019,3,8,2400,58,64,122,Friday
2019,3,8,2300,76,60,136,Friday
2019,3,8,2200,136,83,219,Friday
2019,3,8,2100,193,134,327,Friday
2019,3,8,2000,311,162,473,Friday
2019,3,8,1900,409,313,722,Friday
2019,3,8,1800,486,499,985,Friday
2019,3,8,1700,458,630,1088,Friday
2019,3,8,1600,470,470,940,Friday
2019,3,8,1500,442,333,775,Friday
2019,3,8,1400,385,312,697,Friday
2019,3,8,1300,314,321,635,Friday
2019,3,8,1200,412,230,642,Friday
2019,3,8,1100,417,223,640,Friday
2019,3,8,1000,493,160,653,Friday
2019,3,8,900,517,127,644,Friday
2019,3,8,800,283,71,354,Friday
2019,3,8,700,95,38,133,Friday
2019,3,8,600,49,36,85,Friday
2019,3,8,500,30,28,58,Friday
2019,3,8,400,25,25,50,Friday
2019,3,8,300,22,44,66,Friday
2019,3,8,200,38,28,66,Friday
2019,3,8,100,46,53,99,Friday
2019,3,7,2400,49,75,124,Thursday
2019,3,7,2300,69,76,145,Thursday
2019,3,7,2200,94,78,172,Thursday
2019,3,7,2100,142,105,247,Thursday
2019,3,7,2000,230,137,367,Thursday
2019,3,7,1900,227,253,480,Thursday
2019,3,7,1800,267,435,702,Thursday
2019,3,7,1700,303,505,808,Thursday
2019,3,7,1600,271,428,699,Thursday
2019,3,7,1500,299,317,616,Thursday
2019,3,7,1400,285,268,553,Thursday
2019,3,7,1300,312,216,528,Thursday
2019,3,7,1200,340,195,535,Thursday
2019,3,7,1100,401,188,589,Thursday
2019,3,7,1000,412,127,539,Thursday
2019,3,7,900,421,126,547,Thursday
2019,3,7,800,240,86,326,Thursday
2019,3,7,700,92,34,126,Thursday
2019,3,7,600,32,23,55,Thursday
2019,3,7,500,25,19,44,Thursday
2019,3,7,400,29,31,60,Thursday
2019,3,7,300,39,28,67,Thursday
2019,3,7,200,34,42,76,Thursday
2019,3,7,100,43,50,93,Thursday
2019,3,6,2400,58,56,114,Wednesday
2019,3,6,2300,83,64,147,Wednesday
2019,3,6,2200,79,84,163,Wednesday
2019,3,6,2100,101,106,207,Wednesday
2019,3,6,2000,146,172,318,Wednesday
2019,3,6,1900,164,259,423,Wednesday
2019,3,6,1800,202,474,676,Wednesday
2019,3,6,1700,250,491,741,Wednesday
2019,3,6,1600,245,352,597,Wednesday
2019,3,6,1500,277,263,540,Wednesday
2019,3,6,1400,269,269,538,Wednesday
2019,3,6,1300,266,235,501,Wednesday
2019,3,6,1200,331,195,526,Wednesday
2019,3,6,1100,380,183,563,Wednesday
2019,3,6,1000,424,154,578,Wednesday
2019,3,6,900,369,127,496,Wednesday
2019,3,6,800,223,90,313,Wednesday
2019,3,6,700,85,57,142,Wednesday
2019,3,6,600,32,39,71,Wednesday
2019,3,6,500,27,47,74,Wednesday
2019,3,6,400,29,25,54,Wednesday
2019,3,6,300,33,32,65,Wednesday
2019,3,6,200,35,32,67,Wednesday
2019,3,6,100,38,62,100,Wednesday
2019,3,5,2400,57,54,111,Tuesday
2019,3,5,2300,60,67,127,Tuesday
2019,3,5,2200,80,66,146,Tuesday
2019,3,5,2100,93,111,204,Tuesday
2019,3,5,2000,121,177,298,Tuesday
2019,3,5,1900,154,285,439,Tuesday
2019,3,5,1800,185,517,702,Tuesday
2019,3,5,1700,222,521,743,Tuesday
2019,3,5,1600,221,376,597,Tuesday
2019,3,5,1500,276,307,583,Tuesday
2019,3,5,1400,305,240,545,Tuesday
2019,3,5,1300,298,240,538,Tuesday
2019,3,5,1200,343,197,540,Tuesday
2019,3,5,1100,362,176,538,Tuesday
2019,3,5,1000,434,162,596,Tuesday
2019,3,5,900,335,96,431,Tuesday
2019,3,5,800,223,59,282,Tuesday
2019,3,5,700,87,53,140,Tuesday
2019,3,5,600,36,41,77,Tuesday
2019,3,5,500,31,27,58,Tuesday
2019,3,5,400,22,39,61,Tuesday
2019,3,5,300,28,33,61,Tuesday
2019,3,5,200,26,33,59,Tuesday
2019,3,5,100,41,47,88,Tuesday
2019,3,4,2400,57,39,96,Monday
2019,3,4,2300,69,63,132,Monday
2019,3,4,2200,97,90,187,Monday
2019,3,4,2100,98,104,202,Monday
2019,3,4,2000,123,164,287,Monday
2019,3,4,1900,126,278,404,Monday
2019,3,4,1800,174,474,648,Monday
2019,3,4,1700,208,536,744,Monday
2019,3,4,1600,255,389,644,Monday
2019,3,4,1500,280,345,625,Monday
2019,3,4,1400,266,316,582,Monday
2019,3,4,1300,304,314,618,Monday
2019,3,4,1200,396,265,661,Monday
2019,3,4,1100,399,219,618,Monday
2019,3,4,1000,414,135,549,Monday
2019,3,4,900,318,102,420,Monday
2019,3,4,800,187,49,236,Monday
2019,3,4,700,65,37,102,Monday
2019,3,4,600,37,14,51,Monday
2019,3,4,500,21,22,43,Monday
2019,3,4,400,19,29,48,Monday
2019,3,4,300,18,39,57,Monday
2019,3,4,200,17,38,55,Monday
2019,3,4,100,28,41,69,Monday
2019,3,3,2400,38,50,88,Sunday
2019,3,3,2300,61,83,144,Sunday
2019,3,3,2200,59,121,180,Sunday
2019,3,3,2100,85,192,277,Sunday
2019,3,3,2000,117,296,413,Sunday
2019,3,3,1900,113,524,637,Sunday
2019,3,3,1800,188,1004,1192,Sunday
2019,3,3,1700,237,1076,1313,Sunday
2019,3,3,1600,274,839,1113,Sunday
2019,3,3,1500,306,716,1022,Sunday
2019,3,3,1400,343,619,962,Sunday
2019,3,3,1300,404,611,1015,Sunday
2019,3,3,1200,482,455,937,Sunday
2019,3,3,1100,533,272,805,Sunday
2019,3,3,1000,549,158,707,Sunday
2019,3,3,900,376,74,450,Sunday
2019,3,3,800,203,31,234,Sunday
2019,3,3,700,71,27,98,Sunday
2019,3,3,600,31,17,48,Sunday
2019,3,3,500,13,14,27,Sunday
2019,3,3,400,14,10,24,Sunday
2019,3,3,300,14,11,25,Sunday
2019,3,3,200,27,22,49,Sunday
2019,3,3,100,30,27,57,Sunday
2019,3,2,2400,38,39,77,Saturday
2019,3,2,2300,54,52,106,Saturday
2019,3,2,2200,76,73,149,Saturday
2019,3,2,2100,84,95,179,Saturday
2019,3,2,2000,106,160,266,Saturday
2019,3,2,1900,143,301,444,Saturday
2019,3,2,1800,177,608,785,Saturday
2019,3,2,1700,266,667,933,Saturday
2019,3,2,1600,298,496,794,Saturday
2019,3,2,1500,314,351,665,Saturday
2019,3,2,1400,357,312,669,Saturday
2019,3,2,1300,420,315,735,Saturday
2019,3,2,1200,460,258,718,Saturday
2019,3,2,1100,479,215,694,Saturday
2019,3,2,1000,435,191,626,Saturday
2019,3,2,900,408,100,508,Saturday
2019,3,2,800,197,47,244,Saturday
2019,3,2,700,106,33,139,Saturday
2019,3,2,600,43,18,61,Saturday
2019,3,2,500,20,23,43,Saturday
2019,3,2,400,17,24,41,Saturday
2019,3,2,300,12,24,36,Saturday
2019,3,2,200,25,35,60,Saturday
2019,3,2,100,35,45,80,Saturday
2019,3,1,2400,63,55,118,Friday
2019,3,1,2300,84,59,143,Friday
2019,3,1,2200,131,86,217,Friday
2019,3,1,2100,205,99,304,Friday
2019,3,1,2000,284,155,439,Friday
2019,3,1,1900,389,284,673,Friday
2019,3,1,1800,420,447,867,Friday
2019,3,1,1700,487,542,1029,Friday
2019,3,1,1600,473,444,917,Friday
2019,3,1,1500,432,334,766,Friday
2019,3,1,1400,401,327,728,Friday
2019,3,1,1300,426,305,731,Friday
2019,3,1,1200,405,271,676,Friday
2019,3,1,1100,401,218,619,Friday
2019,3,1,1000,436,157,593,Friday
2019,3,1,900,384,112,496,Friday
2019,3,1,800,225,73,298,Friday
2019,3,1,700,91,55,146,Friday
2019,3,1,600,40,40,80,Friday
2019,3,1,500,36,39,75,Friday
2019,3,1,400,35,33,68,Friday
2019,3,1,300,34,49,83,Friday
2019,3,1,200,43,50,93,Friday
2019,3,1,100,42,84,126,Friday
2019,2,28,2400,70,84,154,Thursday
2019,2,28,2300,104,72,176,Thursday
2019,2,28,2200,125,102,227,Thursday
2019,2,28,2100,161,97,258,Thursday
2019,2,28,2000,215,158,373,Thursday
2019,2,28,1900,248,248,496,Thursday
2019,2,28,1800,310,444,754,Thursday
2019,2,28,1700,287,528,815,Thursday
2019,2,28,1600,338,394,732,Thursday
2019,2,28,1500,318,311,629,Thursday
2019,2,28,1400,319,270,589,Thursday
2019,2,28,1300,322,243,565,Thursday
2019,2,28,1200,333,213,546,Thursday
2019,2,28,1100,376,188,564,Thursday
2019,2,28,1000,450,133,583,Thursday
2019,2,28,900,393,113,506,Thursday
2019,2,28,800,229,62,291,Thursday
2019,2,28,700,90,59,149,Thursday
2019,2,28,600,48,37,85,Thursday
2019,2,28,500,29,32,61,Thursday
2019,2,28,400,25,30,55,Thursday
2019,2,28,300,29,56,85,Thursday
2019,2,28,200,35,37,72,Thursday
2019,2,28,100,38,57,95,Thursday
2019,2,27,2400,73,45,118,Wednesday
2019,2,27,2300,71,66,137,Wednesday
2019,2,27,2200,80,78,158,Wednesday
2019,2,27,2100,132,116,248,Wednesday
2019,2,27,2000,111,153,264,Wednesday
2019,2,27,1900,142,228,370,Wednesday
2019,2,27,1800,205,439,644,Wednesday
2019,2,27,1700,220,534,754,Wednesday
2019,2,27,1600,239,394,633,Wednesday
2019,2,27,1500,244,255,499,Wednesday
2019,2,27,1400,256,239,495,Wednesday
2019,2,27,1300,268,210,478,Wednesday
2019,2,27,1200,323,209,532,Wednesday
2019,2,27,1100,360,187,547,Wednesday
2019,2,27,1000,371,156,527,Wednesday
2019,2,27,900,347,106,453,Wednesday
2019,2,27,800,210,81,291,Wednesday
2019,2,27,700,82,42,124,Wednesday
2019,2,27,600,43,33,76,Wednesday
2019,2,27,500,22,26,48,Wednesday
2019,2,27,400,21,32,53,Wednesday
2019,2,27,300,38,37,75,Wednesday
2019,2,27,200,35,34,69,Wednesday
2019,2,27,100,37,47,84,Wednesday
2019,2,26,2400,61,54,115,Tuesday
2019,2,26,2300,60,148,208,Tuesday
2019,2,26,2200,72,16,88,Tuesday
2019,2,26,2100,98,97,195,Tuesday
2019,2,26,2000,120,126,246,Tuesday
2019,2,26,1900,126,219,345,Tuesday
2019,2,26,1800,140,385,525,Tuesday
2019,2,26,1700,236,470,706,Tuesday
2019,2,26,1600,135,319,454,Tuesday
2019,2,26,1500,181,208,389,Tuesday
2019,2,26,1400,205,154,359,Tuesday
2019,2,26,1300,274,191,465,Tuesday
2019,2,26,1200,253,169,422,Tuesday
2019,2,26,1100,255,165,420,Tuesday
2019,2,26,1000,297,137,434,Tuesday
2019,2,26,900,248,109,357,Tuesday
2019,2,26,800,194,57,251,Tuesday
2019,2,26,700,57,37,94,Tuesday
2019,2,26,600,35,49,84,Tuesday
2019,2,26,500,13,40,53,Tuesday
2019,2,26,400,26,34,60,Tuesday
2019,2,26,300,20,32,52,Tuesday
2019,2,26,200,27,29,56,Tuesday
2019,2,26,100,34,39,73,Tuesday
2019,2,25,2400,53,47,100,Monday
2019,2,25,2300,54,62,116,Monday
2019,2,25,2200,58,72,130,Monday
2019,2,25,2100,81,90,171,Monday
2019,2,25,2000,122,164,286,Monday
2019,2,25,1900,125,214,339,Monday
2019,2,25,1800,173,434,607,Monday
2019,2,25,1700,233,409,642,Monday
2019,2,25,1600,272,290,562,Monday
2019,2,25,1500,261,287,548,Monday
2019,2,25,1400,251,268,519,Monday
2019,2,25,1300,264,238,502,Monday
2019,2,25,1200,299,208,507,Monday
2019,2,25,1100,324,201,525,Monday
2019,2,25,1000,308,139,447,Monday
2019,2,25,900,222,96,318,Monday
2019,2,25,800,213,58,271,Monday
2019,2,25,700,82,16,98,Monday
2019,2,25,600,29,17,46,Monday
2019,2,25,500,19,21,40,Monday
2019,2,25,400,26,29,55,Monday
2019,2,25,300,17,21,38,Monday
2019,2,25,200,18,22,40,Monday
2019,2,25,100,32,39,71,Monday
2019,2,24,2400,32,54,86,Sunday
2019,2,24,2300,48,70,118,Sunday
2019,2,24,2200,50,108,158,Sunday
2019,2,24,2100,80,174,254,Sunday
2019,2,24,2000,110,256,366,Sunday
2019,2,24,1900,109,418,527,Sunday
2019,2,24,1800,174,818,992,Sunday
2019,2,24,1700,236,1059,1295,Sunday
2019,2,24,1600,263,797,1060,Sunday
2019,2,24,1500,268,665,933,Sunday
2019,2,24,1400,337,629,966,Sunday
2019,2,24,1300,343,618,961,Sunday
2019,2,24,1200,428,458,886,Sunday
2019,2,24,1100,374,274,648,Sunday
2019,2,24,1000,440,173,613,Sunday
2019,2,24,900,537,88,625,Sunday
2019,2,24,800,264,34,298,Sunday
2019,2,24,700,75,25,100,Sunday
2019,2,24,600,28,13,41,Sunday
2019,2,24,500,18,21,39,Sunday
2019,2,24,400,19,7,26,Sunday
2019,2,24,300,20,15,35,Sunday
2019,2,24,200,14,27,41,Sunday
2019,2,24,100,25,31,56,Sunday
2019,2,23,2400,25,45,70,Saturday
2019,2,23,2300,43,66,109,Saturday
2019,2,23,2200,56,50,106,Saturday
2019,2,23,2100,83,114,197,Saturday
2019,2,23,2000,106,184,290,Saturday
2019,2,23,1900,113,329,442,Saturday
2019,2,23,1800,188,816,1004,Saturday
2019,2,23,1700,259,1065,1324,Saturday
2019,2,23,1600,268,619,887,Saturday
2019,2,23,1500,270,484,754,Saturday
2019,2,23,1400,301,375,676,Saturday
2019,2,23,1300,360,334,694,Saturday
2019,2,23,1200,418,267,685,Saturday
2019,2,23,1100,407,233,640,Saturday
2019,2,23,1000,625,162,787,Saturday
2019,2,23,900,832,107,939,Saturday
2019,2,23,800,346,82,428,Saturday
2019,2,23,700,65,42,107,Saturday
2019,2,23,600,44,29,73,Saturday
2019,2,23,500,21,29,50,Saturday
2019,2,23,400,24,23,47,Saturday
2019,2,23,300,20,25,45,Saturday
2019,2,23,200,19,19,38,Saturday
2019,2,23,100,33,25,58,Saturday
2019,2,22,2400,49,35,84,Friday
2019,2,22,2300,104,58,162,Friday
2019,2,22,2200,142,46,188,Friday
2019,2,22,2100,202,109,311,Friday
2019,2,22,2000,296,171,467,Friday
2019,2,22,1900,370,296,666,Friday
2019,2,22,1800,437,650,1087,Friday
2019,2,22,1700,436,737,1173,Friday
2019,2,22,1600,453,540,993,Friday
2019,2,22,1500,444,421,865,Friday
2019,2,22,1400,415,369,784,Friday
2019,2,22,1300,429,369,798,Friday
2019,2,22,1200,398,313,711,Friday
2019,2,22,1100,457,266,723,Friday
2019,2,22,1000,520,202,722,Friday
2019,2,22,900,519,118,637,Friday
2019,2,22,800,264,71,335,Friday
2019,2,22,700,88,41,129,Friday
2019,2,22,600,37,34,71,Friday
2019,2,22,500,35,21,56,Friday
2019,2,22,400,32,33,65,Friday
2019,2,22,300,30,39,69,Friday
2019,2,22,200,39,46,85,Friday
2019,2,22,100,46,49,95,Friday
2019,2,21,2400,55,73,128,Thursday
2019,2,21,2300,98,71,169,Thursday
2019,2,21,2200,116,74,190,Thursday
2019,2,21,2100,151,117,268,Thursday
2019,2,21,2000,199,159,358,Thursday
2019,2,21,1900,190,309,499,Thursday
2019,2,21,1800,232,776,1008,Thursday
2019,2,21,1700,280,634,914,Thursday
2019,2,21,1600,322,399,721,Thursday
2019,2,21,1500,321,376,697,Thursday
2019,2,21,1400,285,340,625,Thursday
2019,2,21,1300,314,275,589,Thursday
2019,2,21,1200,364,268,632,Thursday
2019,2,21,1100,416,178,594,Thursday
2019,2,21,1000,532,166,698,Thursday
2019,2,21,900,483,120,603,Thursday
2019,2,21,800,275,65,340,Thursday
2019,2,21,700,83,61,144,Thursday
2019,2,21,600,49,35,84,Thursday
2019,2,21,500,29,41,70,Thursday
2019,2,21,400,18,37,55,Thursday
2019,2,21,300,30,37,67,Thursday
2019,2,21,200,20,43,63,Thursday
2019,2,21,100,33,49,82,Thursday
2019,2,20,2400,53,54,107,Wednesday
2019,2,20,2300,54,77,131,Wednesday
2019,2,20,2200,84,98,182,Wednesday
2019,2,20,2100,200,115,315,Wednesday
2019,2,20,2000,128,176,304,Wednesday
2019,2,20,1900,135,270,405,Wednesday
2019,2,20,1800,115,507,622,Wednesday
2019,2,20,1700,124,687,811,Wednesday
2019,2,20,1600,266,491,757,Wednesday
2019,2,20,1500,243,394,637,Wednesday
2019,2,20,1400,243,331,574,Wednesday
2019,2,20,1300,268,294,562,Wednesday
2019,2,20,1200,385,217,602,Wednesday
2019,2,20,1100,383,167,550,Wednesday
2019,2,20,1000,439,167,606,Wednesday
2019,2,20,900,426,120,546,Wednesday
2019,2,20,800,223,57,280,Wednesday
2019,2,20,700,58,36,94,Wednesday
2019,2,20,600,34,26,60,Wednesday
2019,2,20,500,19,27,46,Wednesday
2019,2,20,400,21,42,63,Wednesday
2019,2,20,300,25,32,57,Wednesday
2019,2,20,200,25,22,47,Wednesday
2019,2,20,100,27,46,73,Wednesday
2019,2,19,2400,65,48,113,Tuesday
2019,2,19,2300,55,57,112,Tuesday
2019,2,19,2200,75,80,155,Tuesday
2019,2,19,2100,103,104,207,Tuesday
2019,2,19,2000,154,164,318,Tuesday
2019,2,19,1900,143,279,422,Tuesday
2019,2,19,1800,190,567,757,Tuesday
2019,2,19,1700,278,672,950,Tuesday
2019,2,19,1600,285,571,856,Tuesday
2019,2,19,1500,307,412,719,Tuesday
2019,2,19,1400,315,346,661,Tuesday
2019,2,19,1300,373,341,714,Tuesday
2019,2,19,1200,371,263,634,Tuesday
2019,2,19,1100,406,208,614,Tuesday
2019,2,19,1000,446,153,599,Tuesday
2019,2,19,900,492,104,596,Tuesday
2019,2,19,800,247,48,295,Tuesday
2019,2,19,700,67,34,101,Tuesday
2019,2,19,600,32,19,51,Tuesday
2019,2,19,500,17,16,33,Tuesday
2019,2,19,400,9,28,37,Tuesday
2019,2,19,300,20,25,45,Tuesday
2019,2,19,200,8,29,37,Tuesday
2019,2,19,100,19,42,61,Tuesday
2019,2,18,2400,30,44,74,Monday
2019,2,18,2300,52,58,110,Monday
2019,2,18,2200,67,112,179,Monday
2019,2,18,2100,88,191,279,Monday
2019,2,18,2000,106,326,432,Monday
2019,2,18,1900,136,593,729,Monday
2019,2,18,1800,198,1260,1458,Monday
2019,2,18,1700,283,1334,1617,Monday
2019,2,18,1600,357,1225,1582,Monday
2019,2,18,1500,466,1165,1631,Monday
2019,2,18,1400,498,1139,1637,Monday
2019,2,18,1300,555,1029,1584,Monday
2019,2,18,1200,598,761,1359,Monday
2019,2,18,1100,557,422,979,Monday
2019,2,18,1000,643,208,851,Monday
2019,2,18,900,610,107,717,Monday
2019,2,18,800,261,42,303,Monday
2019,2,18,700,83,30,113,Monday
2019,2,18,600,30,15,45,Monday
2019,2,18,500,20,14,34,Monday
2019,2,18,400,14,14,28,Monday
2019,2,18,300,14,12,26,Monday
2019,2,18,200,15,19,34,Monday
2019,2,18,100,14,22,36,Monday
2019,2,17,2400,32,41,73,Sunday
2019,2,17,2300,39,62,101,Sunday
2019,2,17,2200,74,95,169,Sunday
2019,2,17,2100,67,135,202,Sunday
2019,2,17,2000,112,238,350,Sunday
2019,2,17,1900,140,432,572,Sunday
2019,2,17,1800,212,933,1145,Sunday
2019,2,17,1700,294,1088,1382,Sunday
2019,2,17,1600,297,758,1055,Sunday
2019,2,17,1500,395,590,985,Sunday
2019,2,17,1400,449,497,946,Sunday
2019,2,17,1300,477,391,868,Sunday
2019,2,17,1200,548,296,844,Sunday
2019,2,17,1100,542,192,734,Sunday
2019,2,17,1000,614,123,737,Sunday
2019,2,17,900,670,61,731,Sunday
2019,2,17,800,298,33,331,Sunday
2019,2,17,700,71,18,89,Sunday
2019,2,17,600,27,14,41,Sunday
2019,2,17,500,18,15,33,Sunday
2019,2,17,400,12,22,34,Sunday
2019,2,17,300,18,14,32,Sunday
2019,2,17,200,18,24,42,Sunday
2019,2,17,100,19,33,52,Sunday
2019,2,16,2400,33,45,78,Saturday
2019,2,16,2300,51,46,97,Saturday
2019,2,16,2200,60,74,134,Saturday
2019,2,16,2100,96,106,202,Saturday
2019,2,16,2000,111,155,266,Saturday
2019,2,16,1900,159,335,494,Saturday
2019,2,16,1800,197,760,957,Saturday
2019,2,16,1700,309,858,1167,Saturday
2019,2,16,1600,398,606,1004,Saturday
2019,2,16,1500,467,352,819,Saturday
2019,2,16,1400,492,337,829,Saturday
2019,2,16,1300,516,307,823,Saturday
2019,2,16,1200,591,231,822,Saturday
2019,2,16,1100,579,159,738,Saturday
2019,2,16,1000,618,126,744,Saturday
2019,2,16,900,852,81,933,Saturday
2019,2,16,800,383,60,443,Saturday
2019,2,16,700,104,27,131,Saturday
2019,2,16,600,54,31,85,Saturday
2019,2,16,500,16,14,30,Saturday
2019,2,16,400,22,28,50,Saturday
2019,2,16,300,20,19,39,Saturday
2019,2,16,200,31,34,65,Saturday
2019,2,16,100,49,56,105,Saturday
2019,2,15,2400,71,45,116,Friday
2019,2,15,2300,107,69,176,Friday
2019,2,15,2200,178,103,281,Friday
2019,2,15,2100,301,141,442,Friday
2019,2,15,2000,440,151,591,Friday
2019,2,15,1900,513,255,768,Friday
2019,2,15,1800,605,509,1114,Friday
2019,2,15,1700,723,618,1341,Friday
2019,2,15,1600,737,457,1194,Friday
2019,2,15,1500,664,373,1037,Friday
2019,2,15,1400,527,289,816,Friday
2019,2,15,1300,543,258,801,Friday
2019,2,15,1200,532,213,745,Friday
2019,2,15,1100,516,160,676,Friday
2019,2,15,1000,480,139,619,Friday
2019,2,15,900,448,136,584,Friday
2019,2,15,800,260,41,301,Friday
2019,2,15,700,80,31,111,Friday
2019,2,15,600,44,32,76,Friday
2019,2,15,500,19,34,53,Friday
2019,2,15,400,25,13,38,Friday
2019,2,15,300,28,31,59,Friday
2019,2,15,200,39,31,70,Friday
2019,2,15,100,38,51,89,Friday
2019,2,14,2400,68,56,124,Thursday
2019,2,14,2300,99,73,172,Thursday
2019,2,14,2200,137,74,211,Thursday
2019,2,14,2100,207,95,302,Thursday
2019,2,14,2000,248,153,401,Thursday
2019,2,14,1900,326,256,582,Thursday
2019,2,14,1800,392,456,848,Thursday
2019,2,14,1700,407,558,965,Thursday
2019,2,14,1600,433,392,825,Thursday
2019,2,14,1500,430,340,770,Thursday
2019,2,14,1400,416,305,721,Thursday
2019,2,14,1300,417,218,635,Thursday
2019,2,14,1200,397,191,588,Thursday
2019,2,14,1100,437,164,601,Thursday
2019,2,14,1000,417,131,548,Thursday
2019,2,14,900,326,100,426,Thursday
2019,2,14,800,190,55,245,Thursday
2019,2,14,700,85,47,132,Thursday
2019,2,14,600,37,24,61,Thursday
2019,2,14,500,19,18,37,Thursday
2019,2,14,400,19,22,41,Thursday
2019,2,14,300,25,39,64,Thursday
2019,2,14,200,32,32,64,Thursday
2019,2,14,100,44,29,73,Thursday
2019,2,13,2400,51,59,110,Wednesday
2019,2,13,2300,95,92,187,Wednesday
2019,2,13,2200,107,72,179,Wednesday
2019,2,13,2100,131,119,250,Wednesday
2019,2,13,2000,183,128,311,Wednesday
2019,2,13,1900,142,177,319,Wednesday
2019,2,13,1800,229,348,577,Wednesday
2019,2,13,1700,228,457,685,Wednesday
2019,2,13,1600,231,299,530,Wednesday
2019,2,13,1500,230,261,491,Wednesday
2019,2,13,1400,208,177,385,Wednesday
2019,2,13,1300,251,175,426,Wednesday
2019,2,13,1200,291,193,484,Wednesday
2019,2,13,1100,285,166,451,Wednesday
2019,2,13,1000,307,125,432,Wednesday
2019,2,13,900,248,88,336,Wednesday
2019,2,13,800,224,56,280,Wednesday
2019,2,13,700,60,33,93,Wednesday
2019,2,13,600,33,20,53,Wednesday
2019,2,13,500,15,19,34,Wednesday
2019,2,13,400,19,30,49,Wednesday
2019,2,13,300,22,28,50,Wednesday
2019,2,13,200,16,29,45,Wednesday
2019,2,13,100,40,42,82,Wednesday
2019,2,12,2400,40,44,84,Tuesday
2019,2,12,2300,49,38,87,Tuesday
2019,2,12,2200,83,113,196,Tuesday
2019,2,12,2100,81,97,178,Tuesday
2019,2,12,2000,103,105,208,Tuesday
2019,2,12,1900,127,197,324,Tuesday
2019,2,12,1800,157,230,387,Tuesday
2019,2,12,1700,187,336,523,Tuesday
2019,2,12,1600,186,198,384,Tuesday
2019,2,12,1500,180,183,363,Tuesday
2019,2,12,1400,200,204,404,Tuesday
2019,2,12,1300,233,187,420,Tuesday
2019,2,12,1200,237,179,416,Tuesday
2019,2,12,1100,241,127,368,Tuesday
2019,2,12,1000,233,132,365,Tuesday
2019,2,12,900,214,85,299,Tuesday
2019,2,12,800,172,43,215,Tuesday
2019,2,12,700,66,32,98,Tuesday
2019,2,12,600,32,14,46,Tuesday
2019,2,12,500,18,26,44,Tuesday
2019,2,12,400,21,37,58,Tuesday
2019,2,12,300,22,33,55,Tuesday
2019,2,12,200,20,28,48,Tuesday
2019,2,12,100,27,46,73,Tuesday
2019,2,11,2400,43,61,104,Monday
2019,2,11,2300,59,44,103,Monday
2019,2,11,2200,67,67,134,Monday
2019,2,11,2100,89,90,179,Monday
2019,2,11,2000,116,126,242,Monday
2019,2,11,1900,154,205,359,Monday
2019,2,11,1800,174,354,528,Monday
2019,2,11,1700,192,441,633,Monday
2019,2,11,1600,242,287,529,Monday
2019,2,11,1500,237,253,490,Monday
2019,2,11,1400,272,245,517,Monday
2019,2,11,1300,271,226,497,Monday
2019,2,11,1200,322,208,530,Monday
2019,2,11,1100,311,187,498,Monday
2019,2,11,1000,263,124,387,Monday
2019,2,11,900,220,82,302,Monday
2019,2,11,800,167,45,212,Monday
2019,2,11,700,64,20,84,Monday
2019,2,11,600,19,14,33,Monday
2019,2,11,500,11,17,28,Monday
2019,2,11,400,24,25,49,Monday
2019,2,11,300,21,24,45,Monday
2019,2,11,200,17,29,46,Monday
2019,2,11,100,22,29,51,Monday
2019,2,10,2400,31,39,70,Sunday
2019,2,10,2300,43,74,117,Sunday
2019,2,10,2200,57,141,198,Sunday
2019,2,10,2100,67,156,223,Sunday
2019,2,10,2000,94,241,335,Sunday
2019,2,10,1900,107,373,480,Sunday
2019,2,10,1800,143,697,840,Sunday
2019,2,10,1700,216,814,1030,Sunday
2019,2,10,1600,284,611,895,Sunday
2019,2,10,1500,295,614,909,Sunday
2019,2,10,1400,313,495,808,Sunday
2019,2,10,1300,330,460,790,Sunday
2019,2,10,1200,370,368,738,Sunday
2019,2,10,1100,337,240,577,Sunday
2019,2,10,1000,393,136,529,Sunday
2019,2,10,900,297,74,371,Sunday
2019,2,10,800,153,36,189,Sunday
2019,2,10,700,56,21,77,Sunday
2019,2,10,600,22,14,36,Sunday
2019,2,10,500,24,10,34,Sunday
2019,2,10,400,10,19,29,Sunday
2019,2,10,300,11,14,25,Sunday
2019,2,10,200,30,24,54,Sunday
2019,2,10,100,27,27,54,Sunday
2019,2,9,2400,28,39,67,Saturday
2019,2,9,2300,54,43,97,Saturday
2019,2,9,2200,69,71,140,Saturday
2019,2,9,2100,70,80,150,Saturday
2019,2,9,2000,91,145,236,Saturday
2019,2,9,1900,108,252,360,Saturday
2019,2,9,1800,128,467,595,Saturday
2019,2,9,1700,189,512,701,Saturday
2019,2,9,1600,255,383,638,Saturday
2019,2,9,1500,282,340,622,Saturday
2019,2,9,1400,318,299,617,Saturday
2019,2,9,1300,321,258,579,Saturday
2019,2,9,1200,358,231,589,Saturday
2019,2,9,1100,338,188,526,Saturday
2019,2,9,1000,331,118,449,Saturday
2019,2,9,900,292,89,381,Saturday
2019,2,9,800,207,48,255,Saturday
2019,2,9,700,75,35,110,Saturday
2019,2,9,600,29,33,62,Saturday
2019,2,9,500,7,15,22,Saturday
2019,2,9,400,18,26,44,Saturday
2019,2,9,300,16,28,44,Saturday
2019,2,9,200,33,19,52,Saturday
2019,2,9,100,32,35,67,Saturday
2019,2,8,2400,53,58,111,Friday
2019,2,8,2300,79,190,269,Friday
2019,2,8,2200,107,21,128,Friday
2019,2,8,2100,157,94,251,Friday
2019,2,8,2000,258,95,353,Friday
2019,2,8,1900,324,225,549,Friday
2019,2,8,1800,375,363,738,Friday
2019,2,8,1700,385,498,883,Friday
2019,2,8,1600,381,310,691,Friday
2019,2,8,1500,335,258,593,Friday
2019,2,8,1400,308,235,543,Friday
2019,2,8,1300,311,267,578,Friday
2019,2,8,1200,320,231,551,Friday
2019,2,8,1100,311,165,476,Friday
2019,2,8,1000,350,124,474,Friday
2019,2,8,900,286,76,362,Friday
2019,2,8,800,191,67,258,Friday
2019,2,8,700,66,44,110,Friday
2019,2,8,600,25,37,62,Friday
2019,2,8,500,19,34,53,Friday
2019,2,8,400,22,30,52,Friday
2019,2,8,300,25,60,85,Friday
2019,2,8,200,42,28,70,Friday
2019,2,8,100,42,48,90,Friday
2019,2,7,2400,57,40,97,Thursday
2019,2,7,2300,85,66,151,Thursday
2019,2,7,2200,96,50,146,Thursday
2019,2,7,2100,121,111,232,Thursday
2019,2,7,2000,214,122,336,Thursday
2019,2,7,1900,221,163,384,Thursday
2019,2,7,1800,283,353,636,Thursday
2019,2,7,1700,285,466,751,Thursday
2019,2,7,1600,297,313,610,Thursday
2019,2,7,1500,242,279,521,Thursday
2019,2,7,1400,252,195,447,Thursday
2019,2,7,1300,262,269,531,Thursday
2019,2,7,1200,334,174,508,Thursday
2019,2,7,1100,335,157,492,Thursday
2019,2,7,1000,339,132,471,Thursday
2019,2,7,900,252,102,354,Thursday
2019,2,7,800,193,49,242,Thursday
2019,2,7,700,85,42,127,Thursday
2019,2,7,600,21,41,62,Thursday
2019,2,7,500,27,26,53,Thursday
2019,2,7,400,21,23,44,Thursday
2019,2,7,300,28,38,66,Thursday
2019,2,7,200,23,47,70,Thursday
2019,2,7,100,31,51,82,Thursday
2019,2,6,2400,69,61,130,Wednesday
2019,2,6,2300,68,62,130,Wednesday
2019,2,6,2200,76,82,158,Wednesday
2019,2,6,2100,112,122,234,Wednesday
2019,2,6,2000,134,166,300,Wednesday
2019,2,6,1900,153,207,360,Wednesday
2019,2,6,1800,168,399,567,Wednesday
2019,2,6,1700,201,393,594,Wednesday
2019,2,6,1600,218,282,500,Wednesday
2019,2,6,1500,252,232,484,Wednesday
2019,2,6,1400,243,240,483,Wednesday
2019,2,6,1300,216,189,405,Wednesday
2019,2,6,1200,257,159,416,Wednesday
2019,2,6,1100,283,136,419,Wednesday
2019,2,6,1000,305,152,457,Wednesday
2019,2,6,900,233,102,335,Wednesday
2019,2,6,800,191,55,246,Wednesday
2019,2,6,700,79,47,126,Wednesday
2019,2,6,600,29,31,60,Wednesday
2019,2,6,500,18,24,42,Wednesday
2019,2,6,400,26,35,61,Wednesday
2019,2,6,300,24,41,65,Wednesday
2019,2,6,200,25,39,64,Wednesday
2019,2,6,100,34,37,71,Wednesday
2019,2,5,2400,48,51,99,Tuesday
2019,2,5,2300,53,55,108,Tuesday
2019,2,5,2200,96,89,185,Tuesday
2019,2,5,2100,105,99,204,Tuesday
2019,2,5,2000,95,151,246,Tuesday
2019,2,5,1900,116,190,306,Tuesday
2019,2,5,1800,139,313,452,Tuesday
2019,2,5,1700,188,387,575,Tuesday
2019,2,5,1600,172,291,463,Tuesday
2019,2,5,1500,208,164,372,Tuesday
2019,2,5,1400,200,190,390,Tuesday
2019,2,5,1300,241,230,471,Tuesday
2019,2,5,1200,245,168,413,Tuesday
2019,2,5,1100,286,170,456,Tuesday
2019,2,5,1000,207,116,323,Tuesday
2019,2,5,900,184,75,259,Tuesday
2019,2,5,800,161,51,212,Tuesday
2019,2,5,700,65,42,107,Tuesday
2019,2,5,600,27,36,63,Tuesday
2019,2,5,500,26,22,48,Tuesday
2019,2,5,400,27,28,55,Tuesday
2019,2,5,300,17,42,59,Tuesday
2019,2,5,200,21,38,59,Tuesday
2019,2,5,100,37,47,84,Tuesday
2019,2,4,2400,59,40,99,Monday
2019,2,4,2300,65,74,139,Monday
2019,2,4,2200,84,75,159,Monday
2019,2,4,2100,94,83,177,Monday
2019,2,4,2000,121,121,242,Monday
2019,2,4,1900,108,183,291,Monday
2019,2,4,1800,151,343,494,Monday
2019,2,4,1700,170,316,486,Monday
2019,2,4,1600,220,319,539,Monday
2019,2,4,1500,227,280,507,Monday
2019,2,4,1400,228,223,451,Monday
2019,2,4,1300,241,252,493,Monday
2019,2,4,1200,257,184,441,Monday
2019,2,4,1100,297,154,451,Monday
2019,2,4,1000,241,108,349,Monday
2019,2,4,900,202,85,287,Monday
2019,2,4,800,148,42,190,Monday
2019,2,4,700,71,25,96,Monday
2019,2,4,600,31,13,44,Monday
2019,2,4,500,20,15,35,Monday
2019,2,4,400,21,19,40,Monday
2019,2,4,300,12,19,31,Monday
2019,2,4,200,15,28,43,Monday
2019,2,4,100,32,28,60,Monday
2019,2,3,2400,28,43,71,Sunday
2019,2,3,2300,33,61,94,Sunday
2019,2,3,2200,52,79,131,Sunday
2019,2,3,2100,67,94,161,Sunday
2019,2,3,2000,84,189,273,Sunday
2019,2,3,1900,91,302,393,Sunday
2019,2,3,1800,100,382,482,Sunday
2019,2,3,1700,150,503,653,Sunday
2019,2,3,1600,182,550,732,Sunday
2019,2,3,1500,238,604,842,Sunday
2019,2,3,1400,182,627,809,Sunday
2019,2,3,1300,225,623,848,Sunday
2019,2,3,1200,196,421,617,Sunday
2019,2,3,1100,207,276,483,Sunday
2019,2,3,1000,256,130,386,Sunday
2019,2,3,900,215,56,271,Sunday
2019,2,3,800,128,29,157,Sunday
2019,2,3,700,49,25,74,Sunday
2019,2,3,600,17,13,30,Sunday
2019,2,3,500,12,10,22,Sunday
2019,2,3,400,11,20,31,Sunday
2019,2,3,300,15,12,27,Sunday
2019,2,3,200,15,21,36,Sunday
2019,2,3,100,12,19,31,Sunday
2019,2,2,2400,29,31,60,Saturday
2019,2,2,2300,44,52,96,Saturday
2019,2,2,2200,54,53,107,Saturday
2019,2,2,2100,78,58,136,Saturday
2019,2,2,2000,73,145,218,Saturday
2019,2,2,1900,97,285,382,Saturday
2019,2,2,1800,119,833,952,Saturday
2019,2,2,1700,174,883,1057,Saturday
2019,2,2,1600,162,639,801,Saturday
2019,2,2,1500,225,463,688,Saturday
2019,2,2,1400,236,407,643,Saturday
2019,2,2,1300,301,257,558,Saturday
2019,2,2,1200,288,261,549,Saturday
2019,2,2,1100,380,168,548,Saturday
2019,2,2,1000,636,134,770,Saturday
2019,2,2,900,1065,89,1154,Saturday
2019,2,2,800,459,57,516,Saturday
2019,2,2,700,83,46,129,Saturday
2019,2,2,600,31,74,105,Saturday
2019,2,2,500,11,89,100,Saturday
2019,2,2,400,7,45,52,Saturday
2019,2,2,300,22,6,28,Saturday
2019,2,2,200,26,6,32,Saturday
2019,2,2,100,32,16,48,Saturday
2019,2,1,2400,40,20,60,Friday
2019,2,1,2300,76,11,87,Friday
2019,2,1,2200,110,16,126,Friday
2019,2,1,2100,182,36,218,Friday
2019,2,1,2000,246,71,317,Friday
2019,2,1,1900,303,139,442,Friday
2019,2,1,1800,367,384,751,Friday
2019,2,1,1700,391,525,916,Friday
2019,2,1,1600,380,355,735,Friday
2019,2,1,1500,340,317,657,Friday
2019,2,1,1400,328,256,584,Friday
2019,2,1,1300,367,222,589,Friday
2019,2,1,1200,422,179,601,Friday
2019,2,1,1100,449,144,593,Friday
2019,2,1,1000,491,106,597,Friday
2019,2,1,900,505,84,589,Friday
2019,2,1,800,260,43,303,Friday
2019,2,1,700,89,37,126,Friday
2019,2,1,600,31,41,72,Friday
2019,2,1,500,27,21,48,Friday
2019,2,1,400,26,30,56,Friday
2019,2,1,300,30,32,62,Friday
2019,2,1,200,29,38,67,Friday
2019,2,1,100,46,57,103,Friday
2019,1,31,2400,45,41,86,Thursday
2019,1,31,2300,94,93,187,Thursday
2019,1,31,2200,136,95,231,Thursday
2019,1,31,2100,162,93,255,Thursday
2019,1,31,2000,204,114,318,Thursday
2019,1,31,1900,260,206,466,Thursday
2019,1,31,1800,284,344,628,Thursday
2019,1,31,1700,315,469,784,Thursday
2019,1,31,1600,315,354,669,Thursday
2019,1,31,1500,322,328,650,Thursday
2019,1,31,1400,289,285,574,Thursday
2019,1,31,1300,309,269,578,Thursday
2019,1,31,1200,331,170,501,Thursday
2019,1,31,1100,328,187,515,Thursday
2019,1,31,1000,407,112,519,Thursday
2019,1,31,900,315,87,402,Thursday
2019,1,31,800,215,57,272,Thursday
2019,1,31,700,65,46,111,Thursday
2019,1,31,600,39,29,68,Thursday
2019,1,31,500,25,20,45,Thursday
2019,1,31,400,25,26,51,Thursday
2019,1,31,300,28,45,73,Thursday
2019,1,31,200,31,29,60,Thursday
2019,1,31,100,34,36,70,Thursday
2019,1,30,2400,43,60,103,Wednesday
2019,1,30,2300,74,71,145,Wednesday
2019,1,30,2200,104,63,167,Wednesday
2019,1,30,2100,115,95,210,Wednesday
2019,1,30,2000,138,113,251,Wednesday
2019,1,30,1900,143,210,353,Wednesday
2019,1,30,1800,181,328,509,Wednesday
2019,1,30,1700,223,435,658,Wednesday
2019,1,30,1600,234,361,595,Wednesday
2019,1,30,1500,232,320,552,Wednesday
2019,1,30,1400,225,246,471,Wednesday
2019,1,30,1300,252,217,469,Wednesday
2019,1,30,1200,321,163,484,Wednesday
2019,1,30,1100,314,183,497,Wednesday
2019,1,30,1000,353,139,492,Wednesday
2019,1,30,900,297,107,404,Wednesday
2019,1,30,800,212,50,262,Wednesday
2019,1,30,700,63,48,111,Wednesday
2019,1,30,600,31,34,65,Wednesday
2019,1,30,500,24,27,51,Wednesday
2019,1,30,400,16,32,48,Wednesday
2019,1,30,300,23,29,52,Wednesday
2019,1,30,200,26,33,59,Wednesday
2019,1,30,100,26,35,61,Wednesday
2019,1,29,2400,55,45,100,Tuesday
2019,1,29,2300,72,51,123,Tuesday
2019,1,29,2200,79,86,165,Tuesday
2019,1,29,2100,101,98,199,Tuesday
2019,1,29,2000,96,143,239,Tuesday
2019,1,29,1900,133,183,316,Tuesday
2019,1,29,1800,168,337,505,Tuesday
2019,1,29,1700,182,461,643,Tuesday
2019,1,29,1600,210,297,507,Tuesday
2019,1,29,1500,210,310,520,Tuesday
2019,1,29,1400,209,237,446,Tuesday
2019,1,29,1300,268,225,493,Tuesday
2019,1,29,1200,270,199,469,Tuesday
2019,1,29,1100,321,171,492,Tuesday
2019,1,29,1000,303,132,435,Tuesday
2019,1,29,900,296,88,384,Tuesday
2019,1,29,800,180,58,238,Tuesday
2019,1,29,700,68,30,98,Tuesday
2019,1,29,600,36,43,79,Tuesday
2019,1,29,500,22,17,39,Tuesday
2019,1,29,400,19,41,60,Tuesday
2019,1,29,300,15,29,44,Tuesday
2019,1,29,200,27,43,70,Tuesday
2019,1,29,100,30,51,81,Tuesday
2019,1,28,2400,48,45,93,Monday
2019,1,28,2300,52,49,101,Monday
2019,1,28,2200,68,77,145,Monday
2019,1,28,2100,89,80,169,Monday
2019,1,28,2000,114,115,229,Monday
2019,1,28,1900,123,185,308,Monday
2019,1,28,1800,170,418,588,Monday
2019,1,28,1700,257,501,758,Monday
2019,1,28,1600,205,406,611,Monday
2019,1,28,1500,197,349,546,Monday
2019,1,28,1400,245,250,495,Monday
2019,1,28,1300,281,262,543,Monday
2019,1,28,1200,338,188,526,Monday
2019,1,28,1100,331,160,491,Monday
2019,1,28,1000,346,156,502,Monday
2019,1,28,900,331,104,435,Monday
2019,1,28,800,193,51,244,Monday
2019,1,28,700,73,31,104,Monday
2019,1,28,600,30,18,48,Monday
2019,1,28,500,18,23,41,Monday
2019,1,28,400,17,13,30,Monday
2019,1,28,300,11,16,27,Monday
2019,1,28,200,10,33,43,Monday
2019,1,28,100,24,43,67,Monday
2019,1,27,2400,30,57,87,Sunday
2019,1,27,2300,43,92,135,Sunday
2019,1,27,2200,55,92,147,Sunday
2019,1,27,2100,71,179,250,Sunday
2019,1,27,2000,107,223,330,Sunday
2019,1,27,1900,113,431,544,Sunday
2019,1,27,1800,161,988,1149,Sunday
2019,1,27,1700,204,1290,1494,Sunday
2019,1,27,1600,237,1006,1243,Sunday
2019,1,27,1500,308,864,1172,Sunday
2019,1,27,1400,416,748,1164,Sunday
2019,1,27,1300,457,644,1101,Sunday
2019,1,27,1200,507,470,977,Sunday
2019,1,27,1100,451,269,720,Sunday
2019,1,27,1000,623,146,769,Sunday
2019,1,27,900,666,86,752,Sunday
2019,1,27,800,346,22,368,Sunday
2019,1,27,700,80,17,97,Sunday
2019,1,27,600,22,14,36,Sunday
2019,1,27,500,21,11,32,Sunday
2019,1,27,400,17,10,27,Sunday
2019,1,27,300,14,19,33,Sunday
2019,1,27,200,18,22,40,Sunday
2019,1,27,100,17,31,48,Sunday
2019,1,26,2400,21,36,57,Saturday
2019,1,26,2300,38,55,93,Saturday
2019,1,26,2200,40,87,127,Saturday
2019,1,26,2100,83,158,241,Saturday
2019,1,26,2000,105,246,351,Saturday
2019,1,26,1900,149,493,642,Saturday
2019,1,26,1800,200,1069,1269,Saturday
2019,1,26,1700,311,1455,1766,Saturday
2019,1,26,1600,402,881,1283,Saturday
2019,1,26,1500,447,675,1122,Saturday
2019,1,26,1400,550,552,1102,Saturday
2019,1,26,1300,723,433,1156,Saturday
2019,1,26,1200,672,320,992,Saturday
2019,1,26,1100,664,209,873,Saturday
2019,1,26,1000,950,135,1085,Saturday
2019,1,26,900,1121,79,1200,Saturday
2019,1,26,800,508,68,576,Saturday
2019,1,26,700,113,35,148,Saturday
2019,1,26,600,38,29,67,Saturday
2019,1,26,500,19,17,36,Saturday
2019,1,26,400,14,14,28,Saturday
2019,1,26,300,17,34,51,Saturday
2019,1,26,200,27,25,52,Saturday
2019,1,26,100,33,36,69,Saturday
2019,1,25,2400,46,63,109,Friday
2019,1,25,2300,85,80,165,Friday
2019,1,25,2200,138,80,218,Friday
2019,1,25,2100,203,141,344,Friday
2019,1,25,2000,374,234,608,Friday
2019,1,25,1900,440,302,742,Friday
2019,1,25,1800,456,512,968,Friday
2019,1,25,1700,540,680,1220,Friday
2019,1,25,1600,584,503,1087,Friday
2019,1,25,1500,549,457,1006,Friday
2019,1,25,1400,528,345,873,Friday
2019,1,25,1300,426,277,703,Friday
2019,1,25,1200,513,216,729,Friday
2019,1,25,1100,501,175,676,Friday
2019,1,25,1000,489,117,606,Friday
2019,1,25,900,463,81,544,Friday
2019,1,25,800,268,69,337,Friday
2019,1,25,700,94,60,154,Friday
2019,1,25,600,50,19,69,Friday
2019,1,25,500,31,30,61,Friday
2019,1,25,400,16,36,52,Friday
2019,1,25,300,32,25,57,Friday
2019,1,25,200,31,34,65,Friday
2019,1,25,100,35,44,79,Friday
2019,1,24,2400,61,57,118,Thursday
2019,1,24,2300,82,73,155,Thursday
2019,1,24,2200,130,85,215,Thursday
2019,1,24,2100,154,130,284,Thursday
2019,1,24,2000,211,185,396,Thursday
2019,1,24,1900,228,221,449,Thursday
2019,1,24,1800,266,365,631,Thursday
2019,1,24,1700,300,552,852,Thursday
2019,1,24,1600,292,404,696,Thursday
2019,1,24,1500,321,355,676,Thursday
2019,1,24,1400,299,291,590,Thursday
2019,1,24,1300,285,249,534,Thursday
2019,1,24,1200,354,203,557,Thursday
2019,1,24,1100,360,197,557,Thursday
2019,1,24,1000,404,117,521,Thursday
2019,1,24,900,364,92,456,Thursday
2019,1,24,800,214,51,265,Thursday
2019,1,24,700,73,39,112,Thursday
2019,1,24,600,33,26,59,Thursday
2019,1,24,500,31,20,51,Thursday
2019,1,24,400,23,27,50,Thursday
2019,1,24,300,32,41,73,Thursday
2019,1,24,200,26,36,62,Thursday
2019,1,24,100,36,39,75,Thursday
2019,1,23,2400,45,50,95,Wednesday
2019,1,23,2300,69,68,137,Wednesday
2019,1,23,2200,76,87,163,Wednesday
2019,1,23,2100,95,101,196,Wednesday
2019,1,23,2000,123,130,253,Wednesday
2019,1,23,1900,129,170,299,Wednesday
2019,1,23,1800,168,321,489,Wednesday
2019,1,23,1700,208,374,582,Wednesday
2019,1,23,1600,202,352,554,Wednesday
2019,1,23,1500,231,297,528,Wednesday
2019,1,23,1400,240,203,443,Wednesday
2019,1,23,1300,225,204,429,Wednesday
2019,1,23,1200,260,177,437,Wednesday
2019,1,23,1100,282,168,450,Wednesday
2019,1,23,1000,275,105,380,Wednesday
2019,1,23,900,286,81,367,Wednesday
2019,1,23,800,220,50,270,Wednesday
2019,1,23,700,63,61,124,Wednesday
2019,1,23,600,26,5,31,Wednesday
2019,1,23,500,21,6,27,Wednesday
2019,1,23,400,30,22,52,Wednesday
2019,1,23,300,25,23,48,Wednesday
2019,1,23,200,32,25,57,Wednesday
2019,1,23,100,29,46,75,Wednesday
2019,1,22,2400,63,41,104,Tuesday
2019,1,22,2300,65,52,117,Tuesday
2019,1,22,2200,78,76,154,Tuesday
2019,1,22,2100,73,103,176,Tuesday
2019,1,22,2000,110,123,233,Tuesday
2019,1,22,1900,128,206,334,Tuesday
2019,1,22,1800,130,302,432,Tuesday
2019,1,22,1700,198,408,606,Tuesday
2019,1,22,1600,221,351,572,Tuesday
2019,1,22,1500,248,358,606,Tuesday
2019,1,22,1400,240,296,536,Tuesday
2019,1,22,1300,262,226,488,Tuesday
2019,1,22,1200,324,183,507,Tuesday
2019,1,22,1100,358,163,521,Tuesday
2019,1,22,1000,293,137,430,Tuesday
2019,1,22,900,278,91,369,Tuesday
2019,1,22,800,201,73,274,Tuesday
2019,1,22,700,67,42,109,Tuesday
2019,1,22,600,35,33,68,Tuesday
2019,1,22,500,22,29,51,Tuesday
2019,1,22,400,30,41,71,Tuesday
2019,1,22,300,17,31,48,Tuesday
2019,1,22,200,22,30,52,Tuesday
2019,1,22,100,25,38,63,Tuesday
2019,1,21,2400,62,54,116,Monday
2019,1,21,2300,64,46,110,Monday
2019,1,21,2200,84,77,161,Monday
2019,1,21,2100,98,111,209,Monday
2019,1,21,2000,115,172,287,Monday
2019,1,21,1900,124,240,364,Monday
2019,1,21,1800,149,377,526,Monday
2019,1,21,1700,206,519,725,Monday
2019,1,21,1600,246,485,731,Monday
2019,1,21,1500,235,385,620,Monday
2019,1,21,1400,304,312,616,Monday
2019,1,21,1300,344,253,597,Monday
2019,1,21,1200,358,219,577,Monday
2019,1,21,1100,395,185,580,Monday
2019,1,21,1000,375,155,530,Monday
2019,1,21,900,363,92,455,Monday
2019,1,21,800,194,60,254,Monday
2019,1,21,700,72,33,105,Monday
2019,1,21,600,31,15,46,Monday
2019,1,21,500,13,20,33,Monday
2019,1,21,400,14,15,29,Monday
2019,1,21,300,17,24,41,Monday
2019,1,21,200,29,25,54,Monday
2019,1,21,100,25,47,72,Monday
2019,1,20,2400,28,70,98,Sunday
2019,1,20,2300,41,89,130,Sunday
2019,1,20,2200,61,129,190,Sunday
2019,1,20,2100,84,222,306,Sunday
2019,1,20,2000,129,337,466,Sunday
2019,1,20,1900,140,558,698,Sunday
2019,1,20,1800,159,979,1138,Sunday
2019,1,20,1700,250,1377,1627,Sunday
2019,1,20,1600,286,1043,1329,Sunday
2019,1,20,1500,361,894,1255,Sunday
2019,1,20,1400,402,769,1171,Sunday
2019,1,20,1300,472,616,1088,Sunday
2019,1,20,1200,542,420,962,Sunday
2019,1,20,1100,506,254,760,Sunday
2019,1,20,1000,665,143,808,Sunday
2019,1,20,900,853,69,922,Sunday
2019,1,20,800,401,41,442,Sunday
2019,1,20,700,84,22,106,Sunday
2019,1,20,600,17,9,26,Sunday
2019,1,20,500,11,15,26,Sunday
2019,1,20,400,7,7,14,Sunday
2019,1,20,300,19,17,36,Sunday
2019,1,20,200,18,20,38,Sunday
2019,1,20,100,18,29,47,Sunday
2019,1,19,2400,32,26,58,Saturday
2019,1,19,2300,40,48,88,Saturday
2019,1,19,2200,42,74,116,Saturday
2019,1,19,2100,77,114,191,Saturday
2019,1,19,2000,104,206,310,Saturday
2019,1,19,1900,131,359,490,Saturday
2019,1,19,1800,178,891,1069,Saturday
2019,1,19,1700,252,1102,1354,Saturday
2019,1,19,1600,270,718,988,Saturday
2019,1,19,1500,351,570,921,Saturday
2019,1,19,1400,374,409,783,Saturday
2019,1,19,1300,472,338,810,Saturday
2019,1,19,1200,556,269,825,Saturday
2019,1,19,1100,528,164,692,Saturday
2019,1,19,1000,762,121,883,Saturday
2019,1,19,900,982,75,1057,Saturday
2019,1,19,800,397,60,457,Saturday
2019,1,19,700,81,28,109,Saturday
2019,1,19,600,31,17,48,Saturday
2019,1,19,500,21,27,48,Saturday
2019,1,19,400,15,15,30,Saturday
2019,1,19,300,29,37,66,Saturday
2019,1,19,200,22,31,53,Saturday
2019,1,19,100,41,36,77,Saturday
2019,1,18,2400,53,52,105,Friday
2019,1,18,2300,65,49,114,Friday
2019,1,18,2200,138,109,247,Friday
2019,1,18,2100,202,134,336,Friday
2019,1,18,2000,298,183,481,Friday
2019,1,18,1900,389,276,665,Friday
2019,1,18,1800,456,409,865,Friday
2019,1,18,1700,471,538,1009,Friday
2019,1,18,1600,528,465,993,Friday
2019,1,18,1500,431,343,774,Friday
2019,1,18,1400,389,316,705,Friday
2019,1,18,1300,372,247,619,Friday
2019,1,18,1200,354,192,546,Friday
2019,1,18,1100,359,150,509,Friday
2019,1,18,1000,419,122,541,Friday
2019,1,18,900,377,88,465,Friday
2019,1,18,800,228,56,284,Friday
2019,1,18,700,91,37,128,Friday
2019,1,18,600,35,31,66,Friday
2019,1,18,500,27,25,52,Friday
2019,1,18,400,26,31,57,Friday
2019,1,18,300,30,30,60,Friday
2019,1,18,200,28,29,57,Friday
2019,1,18,100,33,57,90,Friday
2019,1,17,2400,66,38,104,Thursday
2019,1,17,2300,82,64,146,Thursday
2019,1,17,2200,96,74,170,Thursday
2019,1,17,2100,171,97,268,Thursday
2019,1,17,2000,193,120,313,Thursday
2019,1,17,1900,210,178,388,Thursday
2019,1,17,1800,211,272,483,Thursday
2019,1,17,1700,244,403,647,Thursday
2019,1,17,1600,280,309,589,Thursday
2019,1,17,1500,235,268,503,Thursday
2019,1,17,1400,262,234,496,Thursday
2019,1,17,1300,225,217,442,Thursday
2019,1,17,1200,277,170,447,Thursday
2019,1,17,1100,277,164,441,Thursday
2019,1,17,1000,298,104,402,Thursday
2019,1,17,900,275,85,360,Thursday
2019,1,17,800,224,58,282,Thursday
2019,1,17,700,79,39,118,Thursday
2019,1,17,600,28,35,63,Thursday
2019,1,17,500,20,29,49,Thursday
2019,1,17,400,30,44,74,Thursday
2019,1,17,300,21,24,45,Thursday
2019,1,17,200,28,43,71,Thursday
2019,1,17,100,30,31,61,Thursday
2019,1,16,2400,59,59,118,Wednesday
2019,1,16,2300,74,69,143,Wednesday
2019,1,16,2200,73,63,136,Wednesday
2019,1,16,2100,111,88,199,Wednesday
2019,1,16,2000,124,139,263,Wednesday
2019,1,16,1900,155,209,364,Wednesday
2019,1,16,1800,206,321,527,Wednesday
2019,1,16,1700,196,447,643,Wednesday
2019,1,16,1600,226,339,565,Wednesday
2019,1,16,1500,215,315,530,Wednesday
2019,1,16,1400,206,238,444,Wednesday
2019,1,16,1300,221,152,373,Wednesday
2019,1,16,1200,308,196,504,Wednesday
2019,1,16,1100,308,146,454,Wednesday
2019,1,16,1000,310,127,437,Wednesday
2019,1,16,900,248,87,335,Wednesday
2019,1,16,800,229,69,298,Wednesday
2019,1,16,700,66,59,125,Wednesday
2019,1,16,600,36,29,65,Wednesday
2019,1,16,500,17,32,49,Wednesday
2019,1,16,400,24,24,48,Wednesday
2019,1,16,300,27,35,62,Wednesday
2019,1,16,200,32,31,63,Wednesday
2019,1,16,100,38,43,81,Wednesday
2019,1,15,2400,53,42,95,Tuesday
2019,1,15,2300,58,54,112,Tuesday
2019,1,15,2200,68,82,150,Tuesday
2019,1,15,2100,73,88,161,Tuesday
2019,1,15,2000,110,115,225,Tuesday
2019,1,15,1900,113,207,320,Tuesday
2019,1,15,1800,134,354,488,Tuesday
2019,1,15,1700,159,440,599,Tuesday
2019,1,15,1600,192,349,541,Tuesday
2019,1,15,1500,214,263,477,Tuesday
2019,1,15,1400,186,219,405,Tuesday
2019,1,15,1300,257,226,483,Tuesday
2019,1,15,1200,255,161,416,Tuesday
2019,1,15,1100,280,155,435,Tuesday
2019,1,15,1000,309,114,423,Tuesday
2019,1,15,900,290,112,402,Tuesday
2019,1,15,800,200,64,264,Tuesday
2019,1,15,700,68,39,107,Tuesday
2019,1,15,600,31,33,64,Tuesday
2019,1,15,500,16,32,48,Tuesday
2019,1,15,400,21,38,59,Tuesday
2019,1,15,300,24,27,51,Tuesday
2019,1,15,200,29,36,65,Tuesday
2019,1,15,100,25,59,84,Tuesday
2019,1,14,2400,43,38,81,Monday
2019,1,14,2300,72,53,125,Monday
2019,1,14,2200,77,73,150,Monday
2019,1,14,2100,88,91,179,Monday
2019,1,14,2000,104,124,228,Monday
2019,1,14,1900,126,197,323,Monday
2019,1,14,1800,147,372,519,Monday
2019,1,14,1700,185,439,624,Monday
2019,1,14,1600,208,447,655,Monday
2019,1,14,1500,223,256,479,Monday
2019,1,14,1400,261,273,534,Monday
2019,1,14,1300,246,206,452,Monday
2019,1,14,1200,263,185,448,Monday
2019,1,14,1100,303,160,463,Monday
2019,1,14,1000,323,123,446,Monday
2019,1,14,900,324,91,415,Monday
2019,1,14,800,227,50,277,Monday
2019,1,14,700,91,32,123,Monday
2019,1,14,600,27,10,37,Monday
2019,1,14,500,21,15,36,Monday
2019,1,14,400,11,25,36,Monday
2019,1,14,300,26,21,47,Monday
2019,1,14,200,24,14,38,Monday
2019,1,14,100,30,38,68,Monday
2019,1,13,2400,23,42,65,Sunday
2019,1,13,2300,36,78,114,Sunday
2019,1,13,2200,53,111,164,Sunday
2019,1,13,2100,90,157,247,Sunday
2019,1,13,2000,95,250,345,Sunday
2019,1,13,1900,118,411,529,Sunday
2019,1,13,1800,132,851,983,Sunday
2019,1,13,1700,168,1258,1426,Sunday
2019,1,13,1600,237,876,1113,Sunday
2019,1,13,1500,263,720,983,Sunday
2019,1,13,1400,310,593,903,Sunday
2019,1,13,1300,367,510,877,Sunday
2019,1,13,1200,456,355,811,Sunday
2019,1,13,1100,408,226,634,Sunday
2019,1,13,1000,492,139,631,Sunday
2019,1,13,900,655,79,734,Sunday
2019,1,13,800,317,32,349,Sunday
2019,1,13,700,69,14,83,Sunday
2019,1,13,600,20,13,33,Sunday
2019,1,13,500,17,18,35,Sunday
2019,1,13,400,10,14,24,Sunday
2019,1,13,300,12,16,28,Sunday
2019,1,13,200,22,25,47,Sunday
2019,1,13,100,24,23,47,Sunday
2019,1,12,2400,26,35,61,Saturday
2019,1,12,2300,39,61,100,Saturday
2019,1,12,2200,46,69,115,Saturday
2019,1,12,2100,73,96,169,Saturday
2019,1,12,2000,94,141,235,Saturday
2019,1,12,1900,117,292,409,Saturday
2019,1,12,1800,129,801,930,Saturday
2019,1,12,1700,221,1088,1309,Saturday
2019,1,12,1600,207,692,899,Saturday
2019,1,12,1500,307,469,776,Saturday
2019,1,12,1400,306,306,612,Saturday
2019,1,12,1300,421,259,680,Saturday
2019,1,12,1200,432,225,657,Saturday
2019,1,12,1100,475,160,635,Saturday
2019,1,12,1000,628,137,765,Saturday
2019,1,12,900,970,68,1038,Saturday
2019,1,12,800,457,50,507,Saturday
2019,1,12,700,108,34,142,Saturday
2019,1,12,600,34,23,57,Saturday
2019,1,12,500,22,22,44,Saturday
2019,1,12,400,18,20,38,Saturday
2019,1,12,300,22,21,43,Saturday
2019,1,12,200,19,22,41,Saturday
2019,1,12,100,37,47,84,Saturday
2019,1,11,2400,52,53,105,Friday
2019,1,11,2300,76,48,124,Friday
2019,1,11,2200,128,58,186,Friday
2019,1,11,2100,200,116,316,Friday
2019,1,11,2000,329,176,505,Friday
2019,1,11,1900,386,204,590,Friday
2019,1,11,1800,427,420,847,Friday
2019,1,11,1700,467,536,1003,Friday
2019,1,11,1600,442,421,863,Friday
2019,1,11,1500,368,337,705,Friday
2019,1,11,1400,334,291,625,Friday
2019,1,11,1300,292,209,501,Friday
2019,1,11,1200,339,183,522,Friday
2019,1,11,1100,381,149,530,Friday
2019,1,11,1000,369,122,491,Friday
2019,1,11,900,397,78,475,Friday
2019,1,11,800,256,60,316,Friday
2019,1,11,700,88,37,125,Friday
2019,1,11,600,42,22,64,Friday
2019,1,11,500,30,19,49,Friday
2019,1,11,400,25,34,59,Friday
2019,1,11,300,24,45,69,Friday
2019,1,11,200,26,27,53,Friday
2019,1,11,100,38,49,87,Friday
2019,1,10,2400,51,59,110,Thursday
2019,1,10,2300,78,60,138,Thursday
2019,1,10,2200,96,80,176,Thursday
2019,1,10,2100,134,87,221,Thursday
2019,1,10,2000,159,114,273,Thursday
2019,1,10,1900,196,220,416,Thursday
2019,1,10,1800,208,389,597,Thursday
2019,1,10,1700,264,429,693,Thursday
2019,1,10,1600,256,412,668,Thursday
2019,1,10,1500,235,347,582,Thursday
2019,1,10,1400,247,209,456,Thursday
2019,1,10,1300,251,180,431,Thursday
2019,1,10,1200,270,179,449,Thursday
2019,1,10,1100,293,168,461,Thursday
2019,1,10,1000,331,102,433,Thursday
2019,1,10,900,336,88,424,Thursday
2019,1,10,800,207,54,261,Thursday
2019,1,10,700,85,27,112,Thursday
2019,1,10,600,36,26,62,Thursday
2019,1,10,500,24,24,48,Thursday
2019,1,10,400,31,42,73,Thursday
2019,1,10,300,25,49,74,Thursday
2019,1,10,200,20,42,62,Thursday
2019,1,10,100,33,26,59,Thursday
2019,1,9,2400,48,35,83,Wednesday
2019,1,9,2300,68,41,109,Wednesday
2019,1,9,2200,66,73,139,Wednesday
2019,1,9,2100,108,98,206,Wednesday
2019,1,9,2000,95,126,221,Wednesday
2019,1,9,1900,123,154,277,Wednesday
2019,1,9,1800,151,310,461,Wednesday
2019,1,9,1700,165,438,603,Wednesday
2019,1,9,1600,200,352,552,Wednesday
2019,1,9,1500,205,255,460,Wednesday
2019,1,9,1400,196,196,392,Wednesday
2019,1,9,1300,206,219,425,Wednesday
2019,1,9,1200,242,108,350,Wednesday
2019,1,9,1100,245,129,374,Wednesday
2019,1,9,1000,288,108,396,Wednesday
2019,1,9,900,313,84,397,Wednesday
2019,1,9,800,189,61,250,Wednesday
2019,1,9,700,66,44,110,Wednesday
2019,1,9,600,33,23,56,Wednesday
2019,1,9,500,18,20,38,Wednesday
2019,1,9,400,17,21,38,Wednesday
2019,1,9,300,15,22,37,Wednesday
2019,1,9,200,29,25,54,Wednesday
2019,1,9,100,37,46,83,Wednesday
2019,1,8,2400,43,63,106,Tuesday
2019,1,8,2300,64,51,115,Tuesday
2019,1,8,2200,77,82,159,Tuesday
2019,1,8,2100,92,98,190,Tuesday
2019,1,8,2000,109,114,223,Tuesday
2019,1,8,1900,116,203,319,Tuesday
2019,1,8,1800,141,347,488,Tuesday
2019,1,8,1700,175,411,586,Tuesday
2019,1,8,1600,197,382,579,Tuesday
2019,1,8,1500,222,270,492,Tuesday
2019,1,8,1400,216,260,476,Tuesday
2019,1,8,1300,230,196,426,Tuesday
2019,1,8,1200,268,185,453,Tuesday
2019,1,8,1100,258,174,432,Tuesday
2019,1,8,1000,291,136,427,Tuesday
2019,1,8,900,298,87,385,Tuesday
2019,1,8,800,188,56,244,Tuesday
2019,1,8,700,58,56,114,Tuesday
2019,1,8,600,43,28,71,Tuesday
2019,1,8,500,16,22,38,Tuesday
2019,1,8,400,21,36,57,Tuesday
2019,1,8,300,14,31,45,Tuesday
2019,1,8,200,20,44,64,Tuesday
2019,1,8,100,41,62,103,Tuesday
2019,1,7,2400,33,60,93,Monday
2019,1,7,2300,59,61,120,Monday
2019,1,7,2200,62,79,141,Monday
2019,1,7,2100,92,90,182,Monday
2019,1,7,2000,120,93,213,Monday
2019,1,7,1900,134,179,313,Monday
2019,1,7,1800,147,353,500,Monday
2019,1,7,1700,179,445,624,Monday
2019,1,7,1600,171,427,598,Monday
2019,1,7,1500,222,352,574,Monday
2019,1,7,1400,218,251,469,Monday
2019,1,7,1300,264,205,469,Monday
2019,1,7,1200,277,173,450,Monday
2019,1,7,1100,287,159,446,Monday
2019,1,7,1000,328,106,434,Monday
2019,1,7,900,349,57,406,Monday
2019,1,7,800,178,48,226,Monday
2019,1,7,700,65,25,90,Monday
2019,1,7,600,34,19,53,Monday
2019,1,7,500,16,11,27,Monday
2019,1,7,400,13,27,40,Monday
2019,1,7,300,16,28,44,Monday
2019,1,7,200,28,33,61,Monday
2019,1,7,100,16,48,64,Monday
2019,1,6,2400,23,74,97,Sunday
2019,1,6,2300,45,86,131,Sunday
2019,1,6,2200,49,79,128,Sunday
2019,1,6,2100,66,132,198,Sunday
2019,1,6,2000,97,204,301,Sunday
2019,1,6,1900,100,358,458,Sunday
2019,1,6,1800,122,769,891,Sunday
2019,1,6,1700,171,1219,1390,Sunday
2019,1,6,1600,204,783,987,Sunday
2019,1,6,1500,270,717,987,Sunday
2019,1,6,1400,300,622,922,Sunday
2019,1,6,1300,327,541,868,Sunday
2019,1,6,1200,368,405,773,Sunday
2019,1,6,1100,379,238,617,Sunday
2019,1,6,1000,400,136,536,Sunday
2019,1,6,900,735,83,818,Sunday
2019,1,6,800,368,33,401,Sunday
2019,1,6,700,80,26,106,Sunday
2019,1,6,600,28,23,51,Sunday
2019,1,6,500,16,24,40,Sunday
2019,1,6,400,14,13,27,Sunday
2019,1,6,300,21,22,43,Sunday
2019,1,6,200,19,25,44,Sunday
2019,1,6,100,22,31,53,Sunday
2019,1,5,2400,20,45,65,Saturday
2019,1,5,2300,40,54,94,Saturday
2019,1,5,2200,55,97,152,Saturday
2019,1,5,2100,77,133,210,Saturday
2019,1,5,2000,86,200,286,Saturday
2019,1,5,1900,105,472,577,Saturday
2019,1,5,1800,145,1314,1459,Saturday
2019,1,5,1700,177,1307,1484,Saturday
2019,1,5,1600,239,1096,1335,Saturday
2019,1,5,1500,315,968,1283,Saturday
2019,1,5,1400,363,501,864,Saturday
2019,1,5,1300,439,408,847,Saturday
2019,1,5,1200,450,331,781,Saturday
2019,1,5,1100,444,397,841,Saturday
2019,1,5,1000,616,238,854,Saturday
2019,1,5,900,1322,119,1441,Saturday
2019,1,5,800,998,49,1047,Saturday
2019,1,5,700,130,25,155,Saturday
2019,1,5,600,34,30,64,Saturday
2019,1,5,500,22,37,59,Saturday
2019,1,5,400,22,21,43,Saturday
2019,1,5,300,26,28,54,Saturday
2019,1,5,200,24,29,53,Saturday
2019,1,5,100,31,40,71,Saturday
2019,1,4,2400,47,42,89,Friday
2019,1,4,2300,69,76,145,Friday
2019,1,4,2200,97,93,190,Friday
2019,1,4,2100,140,82,222,Friday
2019,1,4,2000,182,172,354,Friday
2019,1,4,1900,211,421,632,Friday
2019,1,4,1800,224,1051,1275,Friday
2019,1,4,1700,308,1115,1423,Friday
2019,1,4,1600,307,996,1303,Friday
2019,1,4,1500,330,886,1216,Friday
2019,1,4,1400,337,630,967,Friday
2019,1,4,1300,365,593,958,Friday
2019,1,4,1200,423,613,1036,Friday
2019,1,4,1100,432,231,663,Friday
2019,1,4,1000,633,185,818,Friday
2019,1,4,900,1340,120,1460,Friday
2019,1,4,800,647,27,674,Friday
2019,1,4,700,94,8,102,Friday
2019,1,4,600,38,10,48,Friday
2019,1,4,500,17,9,26,Friday
2019,1,4,400,12,3,15,Friday
2019,1,4,300,17,25,42,Friday
2019,1,4,200,17,7,24,Friday
2019,1,4,100,34,14,48,Friday
2019,1,3,2400,36,14,50,Thursday
2019,1,3,2300,50,28,78,Thursday
2019,1,3,2200,63,37,100,Thursday
2019,1,3,2100,81,57,138,Thursday
2019,1,3,2000,93,91,184,Thursday
2019,1,3,1900,127,261,388,Thursday
2019,1,3,1800,169,738,907,Thursday
2019,1,3,1700,200,715,915,Thursday
2019,1,3,1600,205,455,660,Thursday
2019,1,3,1500,247,380,627,Thursday
2019,1,3,1400,271,358,629,Thursday
2019,1,3,1300,294,252,546,Thursday
2019,1,3,1200,367,212,579,Thursday
2019,1,3,1100,412,133,545,Thursday
2019,1,3,1000,564,78,642,Thursday
2019,1,3,900,794,58,852,Thursday
2019,1,3,800,293,25,318,Thursday
2019,1,3,700,76,24,100,Thursday
2019,1,3,600,34,16,50,Thursday
2019,1,3,500,24,21,45,Thursday
2019,1,3,400,16,24,40,Thursday
2019,1,3,300,26,106,132,Thursday
2019,1,3,200,20,164,184,Thursday
2019,1,3,100,30,69,99,Thursday
2019,1,2,2400,55,18,73,Wednesday
2019,1,2,2300,60,40,100,Wednesday
2019,1,2,2200,85,60,145,Wednesday
2019,1,2,2100,93,91,184,Wednesday
2019,1,2,2000,152,150,302,Wednesday
2019,1,2,1900,162,378,540,Wednesday
2019,1,2,1800,208,923,1131,Wednesday
2019,1,2,1700,324,1028,1352,Wednesday
2019,1,2,1600,400,857,1257,Wednesday
2019,1,2,1500,481,772,1253,Wednesday
2019,1,2,1400,490,671,1161,Wednesday
2019,1,2,1300,577,651,1228,Wednesday
2019,1,2,1200,593,561,1154,Wednesday
2019,1,2,1100,614,198,812,Wednesday
2019,1,2,1000,657,157,814,Wednesday
2019,1,2,900,599,98,697,Wednesday
2019,1,2,800,292,59,351,Wednesday
2019,1,2,700,80,40,120,Wednesday
2019,1,2,600,36,18,54,Wednesday
2019,1,2,500,10,10,20,Wednesday
2019,1,2,400,21,16,37,Wednesday
2019,1,2,300,13,15,28,Wednesday
2019,1,2,200,12,21,33,Wednesday
2019,1,2,100,21,40,61,Wednesday
2019,1,1,2400,22,48,70,Tuesday
2019,1,1,2300,30,94,124,Tuesday
2019,1,1,2200,57,125,182,Tuesday
2019,1,1,2100,67,163,230,Tuesday
2019,1,1,2000,109,300,409,Tuesday
2019,1,1,1900,93,537,630,Tuesday
2019,1,1,1800,163,1083,1246,Tuesday
2019,1,1,1700,260,1361,1621,Tuesday
2019,1,1,1600,391,1343,1734,Tuesday
2019,1,1,1500,481,1274,1755,Tuesday
2019,1,1,1400,553,1103,1656,Tuesday
2019,1,1,1300,574,825,1399,Tuesday
2019,1,1,1200,659,491,1150,Tuesday
2019,1,1,1100,531,244,775,Tuesday
2019,1,1,1000,468,128,596,Tuesday
2019,1,1,900,462,71,533,Tuesday
2019,1,1,800,205,35,240,Tuesday
2019,1,1,700,52,12,64,Tuesday
2019,1,1,600,24,10,34,Tuesday
2019,1,1,500,21,12,33,Tuesday
2019,1,1,400,14,11,25,Tuesday
2019,1,1,300,12,16,28,Tuesday
2019,1,1,200,17,22,39,Tuesday
2019,1,1,100,24,40,64,Tuesday
2018,12,31,2400,20,46,66,Monday
2018,12,31,2300,32,62,94,Monday
2018,12,31,2200,46,69,115,Monday
2018,12,31,2100,51,96,147,Monday
2018,12,31,2000,80,152,232,Monday
2018,12,31,1900,96,276,372,Monday
2018,12,31,1800,170,658,828,Monday
2018,12,31,1700,258,989,1247,Monday
2018,12,31,1600,314,913,1227,Monday
2018,12,31,1500,405,766,1171,Monday
2018,12,31,1400,510,591,1101,Monday
2018,12,31,1300,518,486,1004,Monday
2018,12,31,1200,663,329,992,Monday
2018,12,31,1100,569,252,821,Monday
2018,12,31,1000,563,127,690,Monday
2018,12,31,900,662,83,745,Monday
2018,12,31,800,254,44,298,Monday
2018,12,31,700,77,24,101,Monday
2018,12,31,600,41,14,55,Monday
2018,12,31,500,12,13,25,Monday
2018,12,31,400,15,20,35,Monday
2018,12,31,300,17,20,37,Monday
2018,12,31,200,15,24,39,Monday
2018,12,31,100,29,45,74,Monday
2018,12,30,2400,22,57,79,Sunday
2018,12,30,2300,50,101,151,Sunday
2018,12,30,2200,61,153,214,Sunday
2018,12,30,2100,93,215,308,Sunday
2018,12,30,2000,111,243,354,Sunday
2018,12,30,1900,140,639,779,Sunday
2018,12,30,1800,216,1479,1695,Sunday
2018,12,30,1700,369,1517,1886,Sunday
2018,12,30,1600,546,1274,1820,Sunday
2018,12,30,1500,637,939,1576,Sunday
2018,12,30,1400,649,754,1403,Sunday
2018,12,30,1300,820,574,1394,Sunday
2018,12,30,1200,872,402,1274,Sunday
2018,12,30,1100,914,310,1224,Sunday
2018,12,30,1000,938,155,1093,Sunday
2018,12,30,900,1158,84,1242,Sunday
2018,12,30,800,536,51,587,Sunday
2018,12,30,700,91,21,112,Sunday
2018,12,30,600,36,10,46,Sunday
2018,12,30,500,27,19,46,Sunday
2018,12,30,400,16,19,35,Sunday
2018,12,30,300,15,56,71,Sunday
2018,12,30,200,22,6,28,Sunday
2018,12,30,100,23,12,35,Sunday
2018,12,29,2400,34,26,60,Saturday
2018,12,29,2300,50,93,143,Saturday
2018,12,29,2200,55,123,178,Saturday
2018,12,29,2100,85,189,274,Saturday
2018,12,29,2000,137,189,326,Saturday
2018,12,29,1900,141,370,511,Saturday
2018,12,29,1800,229,1219,1448,Saturday
2018,12,29,1700,407,1112,1519,Saturday
2018,12,29,1600,540,836,1376,Saturday
2018,12,29,1500,641,715,1356,Saturday
2018,12,29,1400,755,648,1403,Saturday
2018,12,29,1300,804,480,1284,Saturday
2018,12,29,1200,867,399,1266,Saturday
2018,12,29,1100,762,236,998,Saturday
2018,12,29,1000,817,134,951,Saturday
2018,12,29,900,907,90,997,Saturday
2018,12,29,800,400,44,444,Saturday
2018,12,29,700,100,22,122,Saturday
2018,12,29,600,40,15,55,Saturday
2018,12,29,500,27,24,51,Saturday
2018,12,29,400,21,22,43,Saturday
2018,12,29,300,19,39,58,Saturday
2018,12,29,200,37,26,63,Saturday
2018,12,29,100,30,40,70,Saturday
2018,12,28,2400,50,48,98,Friday
2018,12,28,2300,87,66,153,Friday
2018,12,28,2200,138,91,229,Friday
2018,12,28,2100,163,163,326,Friday
2018,12,28,2000,247,230,477,Friday
2018,12,28,1900,269,455,724,Friday
2018,12,28,1800,403,958,1361,Friday
2018,12,28,1700,543,1354,1897,Friday
2018,12,28,1600,718,1091,1809,Friday
2018,12,28,1500,854,892,1746,Friday
2018,12,28,1400,878,669,1547,Friday
2018,12,28,1300,932,556,1488,Friday
2018,12,28,1200,974,392,1366,Friday
2018,12,28,1100,921,258,1179,Friday
2018,12,28,1000,925,163,1088,Friday
2018,12,28,900,874,104,978,Friday
2018,12,28,800,410,54,464,Friday
2018,12,28,700,124,36,160,Friday
2018,12,28,600,58,24,82,Friday
2018,12,28,500,24,25,49,Friday
2018,12,28,400,27,24,51,Friday
2018,12,28,300,38,35,73,Friday
2018,12,28,200,36,43,79,Friday
2018,12,28,100,39,49,88,Friday
2018,12,27,2400,56,67,123,Thursday
2018,12,27,2300,72,74,146,Thursday
2018,12,27,2200,94,90,184,Thursday
2018,12,27,2100,116,150,266,Thursday
2018,12,27,2000,177,220,397,Thursday
2018,12,27,1900,267,391,658,Thursday
2018,12,27,1800,318,1032,1350,Thursday
2018,12,27,1700,500,1309,1809,Thursday
2018,12,27,1600,736,1008,1744,Thursday
2018,12,27,1500,904,808,1712,Thursday
2018,12,27,1400,1008,654,1662,Thursday
2018,12,27,1300,1064,535,1599,Thursday
2018,12,27,1200,1035,354,1389,Thursday
2018,12,27,1100,941,195,1136,Thursday
2018,12,27,1000,1007,122,1129,Thursday
2018,12,27,900,915,90,1005,Thursday
2018,12,27,800,387,39,426,Thursday
2018,12,27,700,120,20,140,Thursday
2018,12,27,600,54,19,73,Thursday
2018,12,27,500,19,19,38,Thursday
2018,12,27,400,16,20,36,Thursday
2018,12,27,300,18,15,33,Thursday
2018,12,27,200,21,24,45,Thursday
2018,12,27,100,25,25,50,Thursday
2018,12,26,2400,30,46,76,Wednesday
2018,12,26,2300,48,63,111,Wednesday
2018,12,26,2200,87,80,167,Wednesday
2018,12,26,2100,107,118,225,Wednesday
2018,12,26,2000,168,173,341,Wednesday
2018,12,26,1900,196,311,507,Wednesday
2018,12,26,1800,324,719,1043,Wednesday
2018,12,26,1700,463,910,1373,Wednesday
2018,12,26,1600,660,754,1414,Wednesday
2018,12,26,1500,825,638,1463,Wednesday
2018,12,26,1400,838,609,1447,Wednesday
2018,12,26,1300,860,463,1323,Wednesday
2018,12,26,1200,797,393,1190,Wednesday
2018,12,26,1100,653,188,841,Wednesday
2018,12,26,1000,600,107,707,Wednesday
2018,12,26,900,547,64,611,Wednesday
2018,12,26,800,223,25,248,Wednesday
2018,12,26,700,104,13,117,Wednesday
2018,12,26,600,31,8,39,Wednesday
2018,12,26,500,19,16,35,Wednesday
2018,12,26,400,14,7,21,Wednesday
2018,12,26,300,7,6,13,Wednesday
2018,12,26,200,9,19,28,Wednesday
2018,12,26,100,13,19,32,Wednesday
2018,12,25,2400,24,29,53,Tuesday
2018,12,25,2300,24,33,57,Tuesday
2018,12,25,2200,33,48,81,Tuesday
2018,12,25,2100,50,71,121,Tuesday
2018,12,25,2000,52,110,162,Tuesday
2018,12,25,1900,76,253,329,Tuesday
2018,12,25,1800,91,566,657,Tuesday
2018,12,25,1700,159,655,814,Tuesday
2018,12,25,1600,275,516,791,Tuesday
2018,12,25,1500,351,357,708,Tuesday
2018,12,25,1400,442,286,728,Tuesday
2018,12,25,1300,464,217,681,Tuesday
2018,12,25,1200,463,141,604,Tuesday
2018,12,25,1100,369,78,447,Tuesday
2018,12,25,1000,334,54,388,Tuesday
2018,12,25,900,262,30,292,Tuesday
2018,12,25,800,113,12,125,Tuesday
2018,12,25,700,38,11,49,Tuesday
2018,12,25,600,9,20,29,Tuesday
2018,12,25,500,10,9,19,Tuesday
2018,12,25,400,3,10,13,Tuesday
2018,12,25,300,8,13,21,Tuesday
2018,12,25,200,11,18,29,Tuesday
2018,12,25,100,15,18,33,Tuesday
2018,12,24,2400,19,32,51,Monday
2018,12,24,2300,31,35,66,Monday
2018,12,24,2200,41,66,107,Monday
2018,12,24,2100,49,83,132,Monday
2018,12,24,2000,63,96,159,Monday
2018,12,24,1900,105,165,270,Monday
2018,12,24,1800,157,444,601,Monday
2018,12,24,1700,203,630,833,Monday
2018,12,24,1600,336,552,888,Monday
2018,12,24,1500,402,486,888,Monday
2018,12,24,1400,450,430,880,Monday
2018,12,24,1300,451,365,816,Monday
2018,12,24,1200,508,269,777,Monday
2018,12,24,1100,489,192,681,Monday
2018,12,24,1000,435,122,557,Monday
2018,12,24,900,422,54,476,Monday
2018,12,24,800,192,39,231,Monday
2018,12,24,700,55,24,79,Monday
2018,12,24,600,33,13,46,Monday
2018,12,24,500,20,21,41,Monday
2018,12,24,400,8,22,30,Monday
2018,12,24,300,15,10,25,Monday
2018,12,24,200,17,29,46,Monday
2018,12,24,100,28,45,73,Monday
2018,12,23,2400,32,46,78,Sunday
2018,12,23,2300,52,74,126,Sunday
2018,12,23,2200,63,93,156,Sunday
2018,12,23,2100,89,126,215,Sunday
2018,12,23,2000,120,218,338,Sunday
2018,12,23,1900,152,365,517,Sunday
2018,12,23,1800,230,760,990,Sunday
2018,12,23,1700,358,1076,1434,Sunday
2018,12,23,1600,431,862,1293,Sunday
2018,12,23,1500,626,698,1324,Sunday
2018,12,23,1400,674,543,1217,Sunday
2018,12,23,1300,718,438,1156,Sunday
2018,12,23,1200,739,327,1066,Sunday
2018,12,23,1100,702,179,881,Sunday
2018,12,23,1000,659,137,796,Sunday
2018,12,23,900,677,73,750,Sunday
2018,12,23,800,335,29,364,Sunday
2018,12,23,700,88,24,112,Sunday
2018,12,23,600,29,11,40,Sunday
2018,12,23,500,21,14,35,Sunday
2018,12,23,400,18,13,31,Sunday
2018,12,23,300,17,18,35,Sunday
2018,12,23,200,33,29,62,Sunday
2018,12,23,100,30,36,66,Sunday
2018,12,22,2400,43,58,101,Saturday
2018,12,22,2300,52,70,122,Saturday
2018,12,22,2200,71,118,189,Saturday
2018,12,22,2100,106,154,260,Saturday
2018,12,22,2000,162,190,352,Saturday
2018,12,22,1900,208,312,520,Saturday
2018,12,22,1800,276,673,949,Saturday
2018,12,22,1700,353,1070,1423,Saturday
2018,12,22,1600,488,894,1382,Saturday
2018,12,22,1500,700,736,1436,Saturday
2018,12,22,1400,750,600,1350,Saturday
2018,12,22,1300,832,486,1318,Saturday
2018,12,22,1200,835,399,1234,Saturday
2018,12,22,1100,836,252,1088,Saturday
2018,12,22,1000,849,169,1018,Saturday
2018,12,22,900,862,96,958,Saturday
2018,12,22,800,447,61,508,Saturday
2018,12,22,700,194,37,231,Saturday
2018,12,22,600,70,42,112,Saturday
2018,12,22,500,30,31,61,Saturday
2018,12,22,400,35,27,62,Saturday
2018,12,22,300,21,38,59,Saturday
2018,12,22,200,30,41,71,Saturday
2018,12,22,100,46,44,90,Saturday
2018,12,21,2400,66,55,121,Friday
2018,12,21,2300,85,93,178,Friday
2018,12,21,2200,140,114,254,Friday
2018,12,21,2100,185,138,323,Friday
2018,12,21,2000,267,227,494,Friday
2018,12,21,1900,307,292,599,Friday
2018,12,21,1800,394,540,934,Friday
2018,12,21,1700,503,775,1278,Friday
2018,12,21,1600,507,679,1186,Friday
2018,12,21,1500,539,554,1093,Friday
2018,12,21,1400,483,461,944,Friday
2018,12,21,1300,471,374,845,Friday
2018,12,21,1200,506,268,774,Friday
2018,12,21,1100,467,239,706,Friday
2018,12,21,1000,578,184,762,Friday
2018,12,21,900,677,111,788,Friday
2018,12,21,800,321,49,370,Friday
2018,12,21,700,119,61,180,Friday
2018,12,21,600,65,117,182,Friday
2018,12,21,500,31,51,82,Friday
2018,12,21,400,30,51,81,Friday
2018,12,21,300,38,49,87,Friday
2018,12,21,200,30,29,59,Friday
2018,12,21,100,48,58,106,Friday
2018,12,20,2400,55,47,102,Thursday
2018,12,20,2300,72,15,87,Thursday
2018,12,20,2200,117,25,142,Thursday
2018,12,20,2100,140,43,183,Thursday
2018,12,20,2000,171,60,231,Thursday
2018,12,20,1900,172,103,275,Thursday
2018,12,20,1800,198,262,460,Thursday
2018,12,20,1700,233,546,779,Thursday
2018,12,20,1600,254,609,863,Thursday
2018,12,20,1500,319,224,543,Thursday
2018,12,20,1400,303,234,537,Thursday
2018,12,20,1300,327,254,581,Thursday
2018,12,20,1200,320,216,536,Thursday
2018,12,20,1100,378,193,571,Thursday
2018,12,20,1000,388,138,526,Thursday
2018,12,20,900,385,117,502,Thursday
2018,12,20,800,211,54,265,Thursday
2018,12,20,700,102,28,130,Thursday
2018,12,20,600,48,24,72,Thursday
2018,12,20,500,36,39,75,Thursday
2018,12,20,400,27,40,67,Thursday
2018,12,20,300,28,38,66,Thursday
2018,12,20,200,45,33,78,Thursday
2018,12,20,100,45,56,101,Thursday
2018,12,19,2400,73,80,153,Wednesday
2018,12,19,2300,91,147,238,Wednesday
2018,12,19,2200,98,145,243,Wednesday
2018,12,19,2100,127,123,250,Wednesday
2018,12,19,2000,148,152,300,Wednesday
2018,12,19,1900,165,202,367,Wednesday
2018,12,19,1800,201,367,568,Wednesday
2018,12,19,1700,225,520,745,Wednesday
2018,12,19,1600,262,539,801,Wednesday
2018,12,19,1500,297,447,744,Wednesday
2018,12,19,1400,318,342,660,Wednesday
2018,12,19,1300,330,276,606,Wednesday
2018,12,19,1200,320,250,570,Wednesday
2018,12,19,1100,349,198,547,Wednesday
2018,12,19,1000,422,133,555,Wednesday
2018,12,19,900,416,109,525,Wednesday
2018,12,19,800,223,49,272,Wednesday
2018,12,19,700,72,46,118,Wednesday
2018,12,19,600,50,27,77,Wednesday
2018,12,19,500,30,55,85,Wednesday
2018,12,19,400,31,59,90,Wednesday
2018,12,19,300,28,20,48,Wednesday
2018,12,19,200,30,8,38,Wednesday
2018,12,19,100,37,58,95,Wednesday
2018,12,18,2400,51,58,109,Tuesday
2018,12,18,2300,69,43,112,Tuesday
2018,12,18,2200,75,113,188,Tuesday
2018,12,18,2100,102,116,218,Tuesday
2018,12,18,2000,110,99,209,Tuesday
2018,12,18,1900,127,173,300,Tuesday
2018,12,18,1800,176,301,477,Tuesday
2018,12,18,1700,183,462,645,Tuesday
2018,12,18,1600,220,402,622,Tuesday
2018,12,18,1500,231,328,559,Tuesday
2018,12,18,1400,239,289,528,Tuesday
2018,12,18,1300,263,291,554,Tuesday
2018,12,18,1200,332,244,576,Tuesday
2018,12,18,1100,292,95,387,Tuesday
2018,12,18,1000,350,120,470,Tuesday
2018,12,18,900,345,90,435,Tuesday
2018,12,18,800,201,60,261,Tuesday
2018,12,18,700,67,46,113,Tuesday
2018,12,18,600,27,25,52,Tuesday
2018,12,18,500,26,20,46,Tuesday
2018,12,18,400,12,28,40,Tuesday
2018,12,18,300,17,39,56,Tuesday
2018,12,18,200,26,33,59,Tuesday
2018,12,18,100,38,41,79,Tuesday
2018,12,17,2400,47,65,112,Monday
2018,12,17,2300,74,70,144,Monday
2018,12,17,2200,73,87,160,Monday
2018,12,17,2100,94,103,197,Monday
2018,12,17,2000,113,142,255,Monday
2018,12,17,1900,137,186,323,Monday
2018,12,17,1800,197,328,525,Monday
2018,12,17,1700,280,522,802,Monday
2018,12,17,1600,252,400,652,Monday
2018,12,17,1500,273,315,588,Monday
2018,12,17,1400,268,273,541,Monday
2018,12,17,1300,324,252,576,Monday
2018,12,17,1200,366,235,601,Monday
2018,12,17,1100,352,142,494,Monday
2018,12,17,1000,357,141,498,Monday
2018,12,17,900,323,102,425,Monday
2018,12,17,800,203,53,256,Monday
2018,12,17,700,80,27,107,Monday
2018,12,17,600,37,26,63,Monday
2018,12,17,500,22,23,45,Monday
2018,12,17,400,9,20,29,Monday
2018,12,17,300,27,23,50,Monday
2018,12,17,200,20,38,58,Monday
2018,12,17,100,22,47,69,Monday
2018,12,16,2400,36,48,84,Sunday
2018,12,16,2300,40,75,115,Sunday
2018,12,16,2200,60,94,154,Sunday
2018,12,16,2100,93,194,287,Sunday
2018,12,16,2000,121,227,348,Sunday
2018,12,16,1900,114,411,525,Sunday
2018,12,16,1800,169,625,794,Sunday
2018,12,16,1700,219,962,1181,Sunday
2018,12,16,1600,268,752,1020,Sunday
2018,12,16,1500,289,616,905,Sunday
2018,12,16,1400,312,471,783,Sunday
2018,12,16,1300,342,416,758,Sunday
2018,12,16,1200,376,308,684,Sunday
2018,12,16,1100,383,222,605,Sunday
2018,12,16,1000,473,156,629,Sunday
2018,12,16,900,525,95,620,Sunday
2018,12,16,800,277,30,307,Sunday
2018,12,16,700,82,22,104,Sunday
2018,12,16,600,30,16,46,Sunday
2018,12,16,500,19,17,36,Sunday
2018,12,16,400,25,15,40,Sunday
2018,12,16,300,16,19,35,Sunday
2018,12,16,200,22,26,48,Sunday
2018,12,16,100,26,31,57,Sunday
2018,12,15,2400,24,58,82,Saturday
2018,12,15,2300,51,37,88,Saturday
2018,12,15,2200,49,65,114,Saturday
2018,12,15,2100,92,120,212,Saturday
2018,12,15,2000,85,146,231,Saturday
2018,12,15,1900,127,195,322,Saturday
2018,12,15,1800,136,549,685,Saturday
2018,12,15,1700,200,794,994,Saturday
2018,12,15,1600,261,597,858,Saturday
2018,12,15,1500,306,423,729,Saturday
2018,12,15,1400,315,352,667,Saturday
2018,12,15,1300,347,277,624,Saturday
2018,12,15,1200,369,212,581,Saturday
2018,12,15,1100,382,167,549,Saturday
2018,12,15,1000,496,145,641,Saturday
2018,12,15,900,780,59,839,Saturday
2018,12,15,800,362,53,415,Saturday
2018,12,15,700,118,44,162,Saturday
2018,12,15,600,45,39,84,Saturday
2018,12,15,500,24,43,67,Saturday
2018,12,15,400,27,6,33,Saturday
2018,12,15,300,22,29,51,Saturday
2018,12,15,200,24,39,63,Saturday
2018,12,15,100,30,31,61,Saturday
2018,12,14,2400,63,50,113,Friday
2018,12,14,2300,83,62,145,Friday
2018,12,14,2200,114,73,187,Friday
2018,12,14,2100,177,97,274,Friday
2018,12,14,2000,244,132,376,Friday
2018,12,14,1900,275,191,466,Friday
2018,12,14,1800,334,382,716,Friday
2018,12,14,1700,345,534,879,Friday
2018,12,14,1600,392,519,911,Friday
2018,12,14,1500,355,381,736,Friday
2018,12,14,1400,300,341,641,Friday
2018,12,14,1300,320,342,662,Friday
2018,12,14,1200,306,203,509,Friday
2018,12,14,1100,374,187,561,Friday
2018,12,14,1000,451,142,593,Friday
2018,12,14,900,510,121,631,Friday
2018,12,14,800,269,78,347,Friday
2018,12,14,700,75,43,118,Friday
2018,12,14,600,32,28,60,Friday
2018,12,14,500,20,29,49,Friday
2018,12,14,400,23,35,58,Friday
2018,12,14,300,41,72,113,Friday
2018,12,14,200,29,17,46,Friday
2018,12,14,100,36,52,88,Friday
2018,12,13,2400,58,117,175,Thursday
2018,12,13,2300,80,43,123,Thursday
2018,12,13,2200,94,109,203,Thursday
2018,12,13,2100,139,85,224,Thursday
2018,12,13,2000,124,135,259,Thursday
2018,12,13,1900,154,204,358,Thursday
2018,12,13,1800,186,185,371,Thursday
2018,12,13,1700,241,237,478,Thursday
2018,12,13,1600,222,242,464,Thursday
2018,12,13,1500,243,238,481,Thursday
2018,12,13,1400,195,226,421,Thursday
2018,12,13,1300,230,223,453,Thursday
2018,12,13,1200,219,170,389,Thursday
2018,12,13,1100,260,171,431,Thursday
2018,12,13,1000,264,117,381,Thursday
2018,12,13,900,289,89,378,Thursday
2018,12,13,800,191,82,273,Thursday
2018,12,13,700,72,46,118,Thursday
2018,12,13,600,34,28,62,Thursday
2018,12,13,500,24,42,66,Thursday
2018,12,13,400,26,21,47,Thursday
2018,12,13,300,25,36,61,Thursday
2018,12,13,200,30,35,65,Thursday
2018,12,13,100,41,146,187,Thursday
2018,12,12,2400,68,140,208,Wednesday
2018,12,12,2300,76,15,91,Wednesday
2018,12,12,2200,92,21,113,Wednesday
2018,12,12,2100,109,32,141,Wednesday
2018,12,12,2000,110,62,172,Wednesday
2018,12,12,1900,141,131,272,Wednesday
2018,12,12,1800,158,298,456,Wednesday
2018,12,12,1700,191,360,551,Wednesday
2018,12,12,1600,186,340,526,Wednesday
2018,12,12,1500,171,295,466,Wednesday
2018,12,12,1400,195,236,431,Wednesday
2018,12,12,1300,195,223,418,Wednesday
2018,12,12,1200,218,177,395,Wednesday
2018,12,12,1100,247,147,394,Wednesday
2018,12,12,1000,250,130,380,Wednesday
2018,12,12,900,253,103,356,Wednesday
2018,12,12,800,195,90,285,Wednesday
2018,12,12,700,78,52,130,Wednesday
2018,12,12,600,34,35,69,Wednesday
2018,12,12,500,20,43,63,Wednesday
2018,12,12,400,26,26,52,Wednesday
2018,12,12,300,21,31,52,Wednesday
2018,12,12,200,19,43,62,Wednesday
2018,12,12,100,41,126,167,Wednesday
2018,12,11,2400,49,30,79,Tuesday
2018,12,11,2300,61,27,88,Tuesday
2018,12,11,2200,70,43,113,Tuesday
2018,12,11,2100,85,28,113,Tuesday
2018,12,11,2000,121,48,169,Tuesday
2018,12,11,1900,110,159,269,Tuesday
2018,12,11,1800,138,222,360,Tuesday
2018,12,11,1700,169,345,514,Tuesday
2018,12,11,1600,200,255,455,Tuesday
2018,12,11,1500,190,245,435,Tuesday
2018,12,11,1400,210,215,425,Tuesday
2018,12,11,1300,206,216,422,Tuesday
2018,12,11,1200,247,186,433,Tuesday
2018,12,11,1100,242,155,397,Tuesday
2018,12,11,1000,246,128,374,Tuesday
2018,12,11,900,205,92,297,Tuesday
2018,12,11,800,192,60,252,Tuesday
2018,12,11,700,59,27,86,Tuesday
2018,12,11,600,33,44,77,Tuesday
2018,12,11,500,20,17,37,Tuesday
2018,12,11,400,24,46,70,Tuesday
2018,12,11,300,17,32,49,Tuesday
2018,12,11,200,25,48,73,Tuesday
2018,12,11,100,35,56,91,Tuesday
2018,12,10,2400,41,48,89,Monday
2018,12,10,2300,65,89,154,Monday
2018,12,10,2200,68,58,126,Monday
2018,12,10,2100,110,78,188,Monday
2018,12,10,2000,129,110,239,Monday
2018,12,10,1900,116,141,257,Monday
2018,12,10,1800,144,292,436,Monday
2018,12,10,1700,216,355,571,Monday
2018,12,10,1600,227,332,559,Monday
2018,12,10,1500,212,261,473,Monday
2018,12,10,1400,268,208,476,Monday
2018,12,10,1300,240,212,452,Monday
2018,12,10,1200,278,181,459,Monday
2018,12,10,1100,240,152,392,Monday
2018,12,10,1000,264,114,378,Monday
2018,12,10,900,218,98,316,Monday
2018,12,10,800,164,43,207,Monday
2018,12,10,700,71,24,95,Monday
2018,12,10,600,30,18,48,Monday
2018,12,10,500,21,8,29,Monday
2018,12,10,400,19,13,32,Monday
2018,12,10,300,20,14,34,Monday
2018,12,10,200,17,29,46,Monday
2018,12,10,100,31,42,73,Monday
2018,12,9,2400,27,58,85,Sunday
2018,12,9,2300,32,79,111,Sunday
2018,12,9,2200,56,116,172,Sunday
2018,12,9,2100,73,174,247,Sunday
2018,12,9,2000,93,186,279,Sunday
2018,12,9,1900,142,260,402,Sunday
2018,12,9,1800,151,555,706,Sunday
2018,12,9,1700,214,884,1098,Sunday
2018,12,9,1600,216,746,962,Sunday
2018,12,9,1500,256,605,861,Sunday
2018,12,9,1400,304,533,837,Sunday
2018,12,9,1300,311,453,764,Sunday
2018,12,9,1200,324,347,671,Sunday
2018,12,9,1100,387,187,574,Sunday
2018,12,9,1000,383,140,523,Sunday
2018,12,9,900,449,74,523,Sunday
2018,12,9,800,240,25,265,Sunday
2018,12,9,700,53,20,73,Sunday
2018,12,9,600,27,13,40,Sunday
2018,12,9,500,15,19,34,Sunday
2018,12,9,400,15,15,30,Sunday
2018,12,9,300,15,14,29,Sunday
2018,12,9,200,8,18,26,Sunday
2018,12,9,100,21,24,45,Sunday
2018,12,8,2400,31,29,60,Saturday
2018,12,8,2300,37,38,75,Saturday
2018,12,8,2200,61,58,119,Saturday
2018,12,8,2100,84,76,160,Saturday
2018,12,8,2000,87,100,187,Saturday
2018,12,8,1900,134,219,353,Saturday
2018,12,8,1800,148,426,574,Saturday
2018,12,8,1700,221,654,875,Saturday
2018,12,8,1600,248,482,730,Saturday
2018,12,8,1500,269,384,653,Saturday
2018,12,8,1400,299,280,579,Saturday
2018,12,8,1300,289,259,548,Saturday
2018,12,8,1200,349,220,569,Saturday
2018,12,8,1100,380,173,553,Saturday
2018,12,8,1000,425,136,561,Saturday
2018,12,8,900,463,74,537,Saturday
2018,12,8,800,287,44,331,Saturday
2018,12,8,700,86,47,133,Saturday
2018,12,8,600,36,29,65,Saturday
2018,12,8,500,26,22,48,Saturday
2018,12,8,400,23,23,46,Saturday
2018,12,8,300,14,20,34,Saturday
2018,12,8,200,21,30,51,Saturday
2018,12,8,100,44,39,83,Saturday
2018,12,7,2400,41,55,96,Friday
2018,12,7,2300,67,55,122,Friday
2018,12,7,2200,98,67,165,Friday
2018,12,7,2100,164,87,251,Friday
2018,12,7,2000,232,112,344,Friday
2018,12,7,1900,266,201,467,Friday
2018,12,7,1800,310,340,650,Friday
2018,12,7,1700,372,461,833,Friday
2018,12,7,1600,373,412,785,Friday
2018,12,7,1500,352,339,691,Friday
2018,12,7,1400,329,313,642,Friday
2018,12,7,1300,327,278,605,Friday
2018,12,7,1200,334,209,543,Friday
2018,12,7,1100,349,183,532,Friday
2018,12,7,1000,326,149,475,Friday
2018,12,7,900,295,92,387,Friday
2018,12,7,800,196,61,257,Friday
2018,12,7,700,102,40,142,Friday
2018,12,7,600,41,42,83,Friday
2018,12,7,500,31,33,64,Friday
2018,12,7,400,27,31,58,Friday
2018,12,7,300,32,34,66,Friday
2018,12,7,200,29,38,67,Friday
2018,12,7,100,51,43,94,Friday
2018,12,6,2400,57,53,110,Thursday
2018,12,6,2300,85,71,156,Thursday
2018,12,6,2200,100,83,183,Thursday
2018,12,6,2100,137,105,242,Thursday
2018,12,6,2000,179,118,297,Thursday
2018,12,6,1900,206,143,349,Thursday
2018,12,6,1800,223,249,472,Thursday
2018,12,6,1700,254,323,577,Thursday
2018,12,6,1600,285,295,580,Thursday
2018,12,6,1500,238,282,520,Thursday
2018,12,6,1400,252,239,491,Thursday
2018,12,6,1300,236,204,440,Thursday
2018,12,6,1200,236,167,403,Thursday
2018,12,6,1100,260,173,433,Thursday
2018,12,6,1000,236,119,355,Thursday
2018,12,6,900,263,85,348,Thursday
2018,12,6,800,155,59,214,Thursday
2018,12,6,700,84,35,119,Thursday
2018,12,6,600,40,34,74,Thursday
2018,12,6,500,21,23,44,Thursday
2018,12,6,400,21,43,64,Thursday
2018,12,6,300,30,37,67,Thursday
2018,12,6,200,31,37,68,Thursday
2018,12,6,100,38,50,88,Thursday
2018,12,5,2400,65,57,122,Wednesday
2018,12,5,2300,83,71,154,Wednesday
2018,12,5,2200,95,114,209,Wednesday
2018,12,5,2100,102,99,201,Wednesday
2018,12,5,2000,137,99,236,Wednesday
2018,12,5,1900,120,159,279,Wednesday
2018,12,5,1800,161,267,428,Wednesday
2018,12,5,1700,221,366,587,Wednesday
2018,12,5,1600,206,272,478,Wednesday
2018,12,5,1500,219,236,455,Wednesday
2018,12,5,1400,224,210,434,Wednesday
2018,12,5,1300,196,199,395,Wednesday
2018,12,5,1200,249,186,435,Wednesday
2018,12,5,1100,221,136,357,Wednesday
2018,12,5,1000,219,128,347,Wednesday
2018,12,5,900,209,108,317,Wednesday
2018,12,5,800,184,56,240,Wednesday
2018,12,5,700,70,40,110,Wednesday
2018,12,5,600,30,35,65,Wednesday
2018,12,5,500,19,29,48,Wednesday
2018,12,5,400,25,38,63,Wednesday
2018,12,5,300,29,30,59,Wednesday
2018,12,5,200,20,50,70,Wednesday
2018,12,5,100,51,41,92,Wednesday
2018,12,4,2400,66,47,113,Tuesday
2018,12,4,2300,64,68,132,Tuesday
2018,12,4,2200,80,71,151,Tuesday
2018,12,4,2100,101,117,218,Tuesday
2018,12,4,2000,122,107,229,Tuesday
2018,12,4,1900,99,134,233,Tuesday
2018,12,4,1800,157,266,423,Tuesday
2018,12,4,1700,168,312,480,Tuesday
2018,12,4,1600,233,269,502,Tuesday
2018,12,4,1500,194,232,426,Tuesday
2018,12,4,1400,205,224,429,Tuesday
2018,12,4,1300,230,193,423,Tuesday
2018,12,4,1200,242,177,419,Tuesday
2018,12,4,1100,243,156,399,Tuesday
2018,12,4,1000,204,134,338,Tuesday
2018,12,4,900,188,95,283,Tuesday
2018,12,4,800,172,61,233,Tuesday
2018,12,4,700,58,36,94,Tuesday
2018,12,4,600,38,17,55,Tuesday
2018,12,4,500,13,20,33,Tuesday
2018,12,4,400,25,34,59,Tuesday
2018,12,4,300,27,29,56,Tuesday
2018,12,4,200,33,34,67,Tuesday
2018,12,4,100,24,30,54,Tuesday
2018,12,3,2400,56,46,102,Monday
2018,12,3,2300,54,63,117,Monday
2018,12,3,2200,79,68,147,Monday
2018,12,3,2100,91,108,199,Monday
2018,12,3,2000,136,110,246,Monday
2018,12,3,1900,104,131,235,Monday
2018,12,3,1800,170,285,455,Monday
2018,12,3,1700,189,350,539,Monday
2018,12,3,1600,189,303,492,Monday
2018,12,3,1500,216,290,506,Monday
2018,12,3,1400,229,227,456,Monday
2018,12,3,1300,235,206,441,Monday
2018,12,3,1200,256,185,441,Monday
2018,12,3,1100,280,172,452,Monday
2018,12,3,1000,268,128,396,Monday
2018,12,3,900,246,98,344,Monday
2018,12,3,800,161,91,252,Monday
2018,12,3,700,86,20,106,Monday
2018,12,3,600,31,7,38,Monday
2018,12,3,500,22,12,34,Monday
2018,12,3,400,16,12,28,Monday
2018,12,3,300,22,22,44,Monday
2018,12,3,200,22,21,43,Monday
2018,12,3,100,26,21,47,Monday
2018,12,2,2400,36,35,71,Sunday
2018,12,2,2300,47,54,101,Sunday
2018,12,2,2200,59,123,182,Sunday
2018,12,2,2100,86,127,213,Sunday
2018,12,2,2000,89,210,299,Sunday
2018,12,2,1900,110,282,392,Sunday
2018,12,2,1800,132,512,644,Sunday
2018,12,2,1700,197,828,1025,Sunday
2018,12,2,1600,242,687,929,Sunday
2018,12,2,1500,259,666,925,Sunday
2018,12,2,1400,242,485,727,Sunday
2018,12,2,1300,288,397,685,Sunday
2018,12,2,1200,330,270,600,Sunday
2018,12,2,1100,346,172,518,Sunday
2018,12,2,1000,376,113,489,Sunday
2018,12,2,900,372,62,434,Sunday
2018,12,2,800,213,32,245,Sunday
2018,12,2,700,61,18,79,Sunday
2018,12,2,600,21,18,39,Sunday
2018,12,2,500,12,14,26,Sunday
2018,12,2,400,11,16,27,Sunday
2018,12,2,300,12,22,34,Sunday
2018,12,2,200,15,24,39,Sunday
2018,12,2,100,17,32,49,Sunday
2018,12,1,2400,32,43,75,Saturday
2018,12,1,2300,43,56,99,Saturday
2018,12,1,2200,58,56,114,Saturday
2018,12,1,2100,75,96,171,Saturday
2018,12,1,2000,67,91,158,Saturday
2018,12,1,1900,92,205,297,Saturday
2018,12,1,1800,124,384,508,Saturday
2018,12,1,1700,174,651,825,Saturday
2018,12,1,1600,207,576,783,Saturday
2018,12,1,1500,208,393,601,Saturday
2018,12,1,1400,254,337,591,Saturday
2018,12,1,1300,305,216,521,Saturday
2018,12,1,1200,366,199,565,Saturday
2018,12,1,1100,424,150,574,Saturday
2018,12,1,1000,469,126,595,Saturday
2018,12,1,900,557,90,647,Saturday
2018,12,1,800,317,57,374,Saturday
2018,12,1,700,109,30,139,Saturday
2018,12,1,600,30,19,49,Saturday
2018,12,1,500,26,21,47,Saturday
2018,12,1,400,17,18,35,Saturday
2018,12,1,300,20,20,40,Saturday
2018,12,1,200,19,25,44,Saturday
2018,12,1,100,36,40,76,Saturday
2018,11,30,2400,56,51,107,Friday
2018,11,30,2300,82,55,137,Friday
2018,11,30,2200,111,81,192,Friday
2018,11,30,2100,166,118,284,Friday
2018,11,30,2000,259,100,359,Friday
2018,11,30,1900,290,221,511,Friday
2018,11,30,1800,319,274,593,Friday
2018,11,30,1700,390,404,794,Friday
2018,11,30,1600,436,377,813,Friday
2018,11,30,1500,358,333,691,Friday
2018,11,30,1400,345,280,625,Friday
2018,11,30,1300,342,209,551,Friday
2018,11,30,1200,301,221,522,Friday
2018,11,30,1100,346,180,526,Friday
2018,11,30,1000,307,141,448,Friday
2018,11,30,900,269,102,371,Friday
2018,11,30,800,198,48,246,Friday
2018,11,30,700,89,27,116,Friday
2018,11,30,600,41,26,67,Friday
2018,11,30,500,25,31,56,Friday
2018,11,30,400,33,22,55,Friday
2018,11,30,300,27,29,56,Friday
2018,11,30,200,28,43,71,Friday
2018,11,30,100,50,40,90,Friday
2018,11,29,2400,69,66,135,Thursday
2018,11,29,2300,77,81,158,Thursday
2018,11,29,2200,93,77,170,Thursday
2018,11,29,2100,113,99,212,Thursday
2018,11,29,2000,136,117,253,Thursday
2018,11,29,1900,149,171,320,Thursday
2018,11,29,1800,211,281,492,Thursday
2018,11,29,1700,218,331,549,Thursday
2018,11,29,1600,239,321,560,Thursday
2018,11,29,1500,228,303,531,Thursday
2018,11,29,1400,228,254,482,Thursday
2018,11,29,1300,231,210,441,Thursday
2018,11,29,1200,294,169,463,Thursday
2018,11,29,1100,281,177,458,Thursday
2018,11,29,1000,238,133,371,Thursday
2018,11,29,900,245,90,335,Thursday
2018,11,29,800,177,50,227,Thursday
2018,11,29,700,70,55,125,Thursday
2018,11,29,600,38,28,66,Thursday
2018,11,29,500,25,31,56,Thursday
2018,11,29,400,24,25,49,Thursday
2018,11,29,300,37,23,60,Thursday
2018,11,29,200,25,26,51,Thursday
2018,11,29,100,55,42,97,Thursday
2018,11,28,2400,68,63,131,Wednesday
2018,11,28,2300,70,67,137,Wednesday
2018,11,28,2200,85,98,183,Wednesday
2018,11,28,2100,108,103,211,Wednesday
2018,11,28,2000,102,126,228,Wednesday
2018,11,28,1900,123,133,256,Wednesday
2018,11,28,1800,164,262,426,Wednesday
2018,11,28,1700,209,331,540,Wednesday
2018,11,28,1600,170,351,521,Wednesday
2018,11,28,1500,182,260,442,Wednesday
2018,11,28,1400,195,259,454,Wednesday
2018,11,28,1300,244,218,462,Wednesday
2018,11,28,1200,234,180,414,Wednesday
2018,11,28,1100,265,144,409,Wednesday
2018,11,28,1000,232,119,351,Wednesday
2018,11,28,900,215,106,321,Wednesday
2018,11,28,800,219,57,276,Wednesday
2018,11,28,700,67,37,104,Wednesday
2018,11,28,600,35,30,65,Wednesday
2018,11,28,500,21,30,51,Wednesday
2018,11,28,400,30,36,66,Wednesday
2018,11,28,300,22,31,53,Wednesday
2018,11,28,200,31,41,72,Wednesday
2018,11,28,100,29,36,65,Wednesday
2018,11,27,2400,51,47,98,Tuesday
2018,11,27,2300,67,78,145,Tuesday
2018,11,27,2200,71,100,171,Tuesday
2018,11,27,2100,83,81,164,Tuesday
2018,11,27,2000,96,79,175,Tuesday
2018,11,27,1900,85,123,208,Tuesday
2018,11,27,1800,141,238,379,Tuesday
2018,11,27,1700,151,299,450,Tuesday
2018,11,27,1600,197,288,485,Tuesday
2018,11,27,1500,205,241,446,Tuesday
2018,11,27,1400,207,211,418,Tuesday
2018,11,27,1300,201,197,398,Tuesday
2018,11,27,1200,229,173,402,Tuesday
2018,11,27,1100,262,138,400,Tuesday
2018,11,27,1000,243,126,369,Tuesday
2018,11,27,900,225,98,323,Tuesday
2018,11,27,800,160,75,235,Tuesday
2018,11,27,700,62,50,112,Tuesday
2018,11,27,600,31,18,49,Tuesday
2018,11,27,500,16,26,42,Tuesday
2018,11,27,400,17,27,44,Tuesday
2018,11,27,300,27,36,63,Tuesday
2018,11,27,200,25,36,61,Tuesday
2018,11,27,100,39,38,77,Tuesday
2018,11,26,2400,68,53,121,Monday
2018,11,26,2300,72,73,145,Monday
2018,11,26,2200,54,62,116,Monday
2018,11,26,2100,115,71,186,Monday
2018,11,26,2000,125,96,221,Monday
2018,11,26,1900,124,135,259,Monday
2018,11,26,1800,151,266,417,Monday
2018,11,26,1700,165,292,457,Monday
2018,11,26,1600,203,311,514,Monday
2018,11,26,1500,262,249,511,Monday
2018,11,26,1400,206,211,417,Monday
2018,11,26,1300,228,192,420,Monday
2018,11,26,1200,272,183,455,Monday
2018,11,26,1100,269,147,416,Monday
2018,11,26,1000,234,96,330,Monday
2018,11,26,900,220,89,309,Monday
2018,11,26,800,158,46,204,Monday
2018,11,26,700,74,34,108,Monday
2018,11,26,600,32,11,43,Monday
2018,11,26,500,17,16,33,Monday
2018,11,26,400,21,18,39,Monday
2018,11,26,300,20,30,50,Monday
2018,11,26,200,11,27,38,Monday
2018,11,26,100,21,36,57,Monday
2018,11,25,2400,24,42,66,Sunday
2018,11,25,2300,38,69,107,Sunday
2018,11,25,2200,60,79,139,Sunday
2018,11,25,2100,66,124,190,Sunday
2018,11,25,2000,111,153,264,Sunday
2018,11,25,1900,106,280,386,Sunday
2018,11,25,1800,158,529,687,Sunday
2018,11,25,1700,235,817,1052,Sunday
2018,11,25,1600,248,878,1126,Sunday
2018,11,25,1500,292,658,950,Sunday
2018,11,25,1400,325,487,812,Sunday
2018,11,25,1300,358,364,722,Sunday
2018,11,25,1200,423,254,677,Sunday
2018,11,25,1100,437,210,647,Sunday
2018,11,25,1000,413,138,551,Sunday
2018,11,25,900,376,75,451,Sunday
2018,11,25,800,244,41,285,Sunday
2018,11,25,700,75,22,97,Sunday
2018,11,25,600,23,11,34,Sunday
2018,11,25,500,17,17,34,Sunday
2018,11,25,400,19,14,33,Sunday
2018,11,25,300,16,19,35,Sunday
2018,11,25,200,15,21,36,Sunday
2018,11,25,100,19,35,54,Sunday
2018,11,24,2400,21,33,54,Saturday
2018,11,24,2300,35,46,81,Saturday
2018,11,24,2200,42,58,100,Saturday
2018,11,24,2100,56,128,184,Saturday
2018,11,24,2000,94,142,236,Saturday
2018,11,24,1900,108,221,329,Saturday
2018,11,24,1800,161,427,588,Saturday
2018,11,24,1700,183,645,828,Saturday
2018,11,24,1600,214,673,887,Saturday
2018,11,24,1500,280,472,752,Saturday
2018,11,24,1400,344,342,686,Saturday
2018,11,24,1300,334,258,592,Saturday
2018,11,24,1200,481,214,695,Saturday
2018,11,24,1100,500,174,674,Saturday
2018,11,24,1000,453,119,572,Saturday
2018,11,24,900,515,83,598,Saturday
2018,11,24,800,292,37,329,Saturday
2018,11,24,700,83,28,111,Saturday
2018,11,24,600,32,24,56,Saturday
2018,11,24,500,12,21,33,Saturday
2018,11,24,400,13,19,32,Saturday
2018,11,24,300,16,42,58,Saturday
2018,11,24,200,28,25,53,Saturday
2018,11,24,100,35,27,62,Saturday
2018,11,23,2400,38,42,80,Friday
2018,11,23,2300,49,77,126,Friday
2018,11,23,2200,103,87,190,Friday
2018,11,23,2100,133,100,233,Friday
2018,11,23,2000,209,134,343,Friday
2018,11,23,1900,181,228,409,Friday
2018,11,23,1800,274,391,665,Friday
2018,11,23,1700,305,476,781,Friday
2018,11,23,1600,342,386,728,Friday
2018,11,23,1500,299,408,707,Friday
2018,11,23,1400,322,191,513,Friday
2018,11,23,1300,336,220,556,Friday
2018,11,23,1200,321,233,554,Friday
2018,11,23,1100,367,152,519,Friday
2018,11,23,1000,334,128,462,Friday
2018,11,23,900,286,97,383,Friday
2018,11,23,800,215,65,280,Friday
2018,11,23,700,76,33,109,Friday
2018,11,23,600,35,42,77,Friday
2018,11,23,500,23,24,47,Friday
2018,11,23,400,28,34,62,Friday
2018,11,23,300,23,35,58,Friday
2018,11,23,200,27,34,61,Friday
2018,11,23,100,49,43,92,Friday
2018,11,22,2400,50,66,116,Thursday
2018,11,22,2300,64,93,157,Thursday
2018,11,22,2200,108,85,193,Thursday
2018,11,22,2100,133,92,225,Thursday
2018,11,22,2000,157,175,332,Thursday
2018,11,22,1900,191,170,361,Thursday
2018,11,22,1800,255,345,600,Thursday
2018,11,22,1700,279,405,684,Thursday
2018,11,22,1600,279,360,639,Thursday
2018,11,22,1500,244,357,601,Thursday
2018,11,22,1400,259,288,547,Thursday
2018,11,22,1300,276,196,472,Thursday
2018,11,22,1200,292,184,476,Thursday
2018,11,22,1100,279,139,418,Thursday
2018,11,22,1000,277,107,384,Thursday
2018,11,22,900,268,73,341,Thursday
2018,11,22,800,214,56,270,Thursday
2018,11,22,700,69,49,118,Thursday
2018,11,22,600,49,27,76,Thursday
2018,11,22,500,25,31,56,Thursday
2018,11,22,400,33,28,61,Thursday
2018,11,22,300,32,30,62,Thursday
2018,11,22,200,27,34,61,Thursday
2018,11,22,100,42,57,99,Thursday
2018,11,21,2400,62,56,118,Wednesday
2018,11,21,2300,79,73,152,Wednesday
2018,11,21,2200,93,82,175,Wednesday
2018,11,21,2100,106,93,199,Wednesday
2018,11,21,2000,107,124,231,Wednesday
2018,11,21,1900,108,179,287,Wednesday
2018,11,21,1800,130,328,458,Wednesday
2018,11,21,1700,223,418,641,Wednesday
2018,11,21,1600,271,334,605,Wednesday
2018,11,21,1500,208,307,515,Wednesday
2018,11,21,1400,228,230,458,Wednesday
2018,11,21,1300,268,227,495,Wednesday
2018,11,21,1200,269,173,442,Wednesday
2018,11,21,1100,317,171,488,Wednesday
2018,11,21,1000,216,126,342,Wednesday
2018,11,21,900,240,95,335,Wednesday
2018,11,21,800,207,77,284,Wednesday
2018,11,21,700,73,40,113,Wednesday
2018,11,21,600,23,28,51,Wednesday
2018,11,21,500,23,34,57,Wednesday
2018,11,21,400,25,29,54,Wednesday
2018,11,21,300,25,38,63,Wednesday
2018,11,21,200,24,37,61,Wednesday
2018,11,21,100,45,53,98,Wednesday
2018,11,20,2400,50,51,101,Tuesday
2018,11,20,2300,76,69,145,Tuesday
2018,11,20,2200,80,98,178,Tuesday
2018,11,20,2100,110,116,226,Tuesday
2018,11,20,2000,113,106,219,Tuesday
2018,11,20,1900,128,165,293,Tuesday
2018,11,20,1800,161,287,448,Tuesday
2018,11,20,1700,186,321,507,Tuesday
2018,11,20,1600,220,363,583,Tuesday
2018,11,20,1500,214,248,462,Tuesday
2018,11,20,1400,225,248,473,Tuesday
2018,11,20,1300,240,235,475,Tuesday
2018,11,20,1200,263,191,454,Tuesday
2018,11,20,1100,305,176,481,Tuesday
2018,11,20,1000,283,148,431,Tuesday
2018,11,20,900,207,77,284,Tuesday
2018,11,20,800,171,58,229,Tuesday
2018,11,20,700,78,28,106,Tuesday
2018,11,20,600,26,32,58,Tuesday
2018,11,20,500,21,23,44,Tuesday
2018,11,20,400,23,31,54,Tuesday
2018,11,20,300,22,24,46,Tuesday
2018,11,20,200,27,41,68,Tuesday
2018,11,20,100,26,34,60,Tuesday
2018,11,19,2400,55,40,95,Monday
2018,11,19,2300,54,58,112,Monday
2018,11,19,2200,71,69,140,Monday
2018,11,19,2100,91,98,189,Monday
2018,11,19,2000,118,110,228,Monday
2018,11,19,1900,120,174,294,Monday
2018,11,19,1800,189,274,463,Monday
2018,11,19,1700,217,365,582,Monday
2018,11,19,1600,263,300,563,Monday
2018,11,19,1500,238,296,534,Monday
2018,11,19,1400,294,231,525,Monday
2018,11,19,1300,310,223,533,Monday
2018,11,19,1200,299,194,493,Monday
2018,11,19,1100,308,153,461,Monday
2018,11,19,1000,282,121,403,Monday
2018,11,19,900,234,69,303,Monday
2018,11,19,800,180,56,236,Monday
2018,11,19,700,78,21,99,Monday
2018,11,19,600,30,11,41,Monday
2018,11,19,500,15,12,27,Monday
2018,11,19,400,16,23,39,Monday
2018,11,19,300,19,21,40,Monday
2018,11,19,200,20,32,52,Monday
2018,11,19,100,17,43,60,Monday
2018,11,18,2400,34,47,81,Sunday
2018,11,18,2300,36,64,100,Sunday
2018,11,18,2200,72,92,164,Sunday
2018,11,18,2100,78,111,189,Sunday
2018,11,18,2000,108,193,301,Sunday
2018,11,18,1900,117,277,394,Sunday
2018,11,18,1800,166,491,657,Sunday
2018,11,18,1700,231,679,910,Sunday
2018,11,18,1600,233,669,902,Sunday
2018,11,18,1500,262,576,838,Sunday
2018,11,18,1400,303,477,780,Sunday
2018,11,18,1300,351,387,738,Sunday
2018,11,18,1200,380,245,625,Sunday
2018,11,18,1100,373,168,541,Sunday
2018,11,18,1000,350,121,471,Sunday
2018,11,18,900,310,61,371,Sunday
2018,11,18,800,194,27,221,Sunday
2018,11,18,700,66,13,79,Sunday
2018,11,18,600,22,12,34,Sunday
2018,11,18,500,20,15,35,Sunday
2018,11,18,400,18,14,32,Sunday
2018,11,18,300,16,15,31,Sunday
2018,11,18,200,19,19,38,Sunday
2018,11,18,100,16,30,46,Sunday
2018,11,17,2400,27,41,68,Saturday
2018,11,17,2300,40,39,79,Saturday
2018,11,17,2200,64,75,139,Saturday
2018,11,17,2100,75,91,166,Saturday
2018,11,17,2000,106,120,226,Saturday
2018,11,17,1900,98,200,298,Saturday
2018,11,17,1800,150,361,511,Saturday
2018,11,17,1700,191,584,775,Saturday
2018,11,17,1600,233,527,760,Saturday
2018,11,17,1500,260,375,635,Saturday
2018,11,17,1400,341,356,697,Saturday
2018,11,17,1300,348,281,629,Saturday
2018,11,17,1200,425,194,619,Saturday
2018,11,17,1100,359,157,516,Saturday
2018,11,17,1000,413,131,544,Saturday
2018,11,17,900,408,102,510,Saturday
2018,11,17,800,187,48,235,Saturday
2018,11,17,700,71,33,104,Saturday
2018,11,17,600,35,30,65,Saturday
2018,11,17,500,26,25,51,Saturday
2018,11,17,400,15,18,33,Saturday
2018,11,17,300,21,29,50,Saturday
2018,11,17,200,33,35,68,Saturday
2018,11,17,100,33,33,66,Saturday
2018,11,16,2400,56,55,111,Friday
2018,11,16,2300,62,64,126,Friday
2018,11,16,2200,81,82,163,Friday
2018,11,16,2100,122,101,223,Friday
2018,11,16,2000,208,120,328,Friday
2018,11,16,1900,258,197,455,Friday
2018,11,16,1800,206,311,517,Friday
2018,11,16,1700,295,365,660,Friday
2018,11,16,1600,301,364,665,Friday
2018,11,16,1500,335,358,693,Friday
2018,11,16,1400,264,261,525,Friday
2018,11,16,1300,280,249,529,Friday
2018,11,16,1200,308,268,576,Friday
2018,11,16,1100,309,157,466,Friday
2018,11,16,1000,250,129,379,Friday
2018,11,16,900,237,78,315,Friday
2018,11,16,800,178,79,257,Friday
2018,11,16,700,56,57,113,Friday
2018,11,16,600,29,46,75,Friday
2018,11,16,500,23,55,78,Friday
2018,11,16,400,22,74,96,Friday
2018,11,16,300,23,96,119,Friday
2018,11,16,200,31,17,48,Friday
2018,11,16,100,42,68,110,Friday
2018,11,15,2400,58,37,95,Thursday
2018,11,15,2300,76,53,129,Thursday
2018,11,15,2200,70,61,131,Thursday
2018,11,15,2100,122,70,192,Thursday
2018,11,15,2000,135,105,240,Thursday
2018,11,15,1900,126,180,306,Thursday
2018,11,15,1800,203,251,454,Thursday
2018,11,15,1700,213,299,512,Thursday
2018,11,15,1600,226,319,545,Thursday
2018,11,15,1500,243,308,551,Thursday
2018,11,15,1400,242,322,564,Thursday
2018,11,15,1300,245,295,540,Thursday
2018,11,15,1200,256,232,488,Thursday
2018,11,15,1100,271,201,472,Thursday
2018,11,15,1000,203,160,363,Thursday
2018,11,15,900,262,157,419,Thursday
2018,11,15,800,161,171,332,Thursday
2018,11,15,700,71,38,109,Thursday
2018,11,15,600,44,37,81,Thursday
2018,11,15,500,32,113,145,Thursday
2018,11,15,400,18,20,38,Thursday
2018,11,15,300,25,10,35,Thursday
2018,11,15,200,35,11,46,Thursday
2018,11,15,100,37,15,52,Thursday
2018,11,14,2400,59,38,97,Wednesday
2018,11,14,2300,62,162,224,Wednesday
2018,11,14,2200,77,62,139,Wednesday
2018,11,14,2100,85,60,145,Wednesday
2018,11,14,2000,117,75,192,Wednesday
2018,11,14,1900,111,151,262,Wednesday
2018,11,14,1800,146,214,360,Wednesday
2018,11,14,1700,186,271,457,Wednesday
2018,11,14,1600,191,225,416,Wednesday
2018,11,14,1500,245,262,507,Wednesday
2018,11,14,1400,246,231,477,Wednesday
2018,11,14,1300,204,230,434,Wednesday
2018,11,14,1200,250,201,451,Wednesday
2018,11,14,1100,224,195,419,Wednesday
2018,11,14,1000,216,140,356,Wednesday
2018,11,14,900,172,110,282,Wednesday
2018,11,14,800,188,69,257,Wednesday
2018,11,14,700,63,40,103,Wednesday
2018,11,14,600,34,29,63,Wednesday
2018,11,14,500,16,20,36,Wednesday
2018,11,14,400,18,26,44,Wednesday
2018,11,14,300,27,21,48,Wednesday
2018,11,14,200,20,38,58,Wednesday
2018,11,14,100,35,54,89,Wednesday
2018,11,13,2400,45,64,109,Tuesday
2018,11,13,2300,61,57,118,Tuesday
2018,11,13,2200,78,78,156,Tuesday
2018,11,13,2100,103,107,210,Tuesday
2018,11,13,2000,109,133,242,Tuesday
2018,11,13,1900,121,200,321,Tuesday
2018,11,13,1800,157,292,449,Tuesday
2018,11,13,1700,241,351,592,Tuesday
2018,11,13,1600,256,321,577,Tuesday
2018,11,13,1500,235,349,584,Tuesday
2018,11,13,1400,279,289,568,Tuesday
2018,11,13,1300,310,238,548,Tuesday
2018,11,13,1200,346,202,548,Tuesday
2018,11,13,1100,336,164,500,Tuesday
2018,11,13,1000,261,129,390,Tuesday
2018,11,13,900,188,90,278,Tuesday
2018,11,13,800,180,54,234,Tuesday
2018,11,13,700,63,40,103,Tuesday
2018,11,13,600,29,18,47,Tuesday
2018,11,13,500,16,24,40,Tuesday
2018,11,13,400,16,20,36,Tuesday
2018,11,13,300,16,23,39,Tuesday
2018,11,13,200,19,30,49,Tuesday
2018,11,13,100,20,45,65,Tuesday
2018,11,12,2400,36,50,86,Monday
2018,11,12,2300,51,76,127,Monday
2018,11,12,2200,59,100,159,Monday
2018,11,12,2100,88,156,244,Monday
2018,11,12,2000,90,214,304,Monday
2018,11,12,1900,138,330,468,Monday
2018,11,12,1800,167,509,676,Monday
2018,11,12,1700,248,688,936,Monday
2018,11,12,1600,307,752,1059,Monday
2018,11,12,1500,357,695,1052,Monday
2018,11,12,1400,420,567,987,Monday
2018,11,12,1300,470,503,973,Monday
2018,11,12,1200,559,349,908,Monday
2018,11,12,1100,566,264,830,Monday
2018,11,12,1000,412,129,541,Monday
2018,11,12,900,268,65,333,Monday
2018,11,12,800,163,37,200,Monday
2018,11,12,700,77,23,100,Monday
2018,11,12,600,35,15,50,Monday
2018,11,12,500,21,14,35,Monday
2018,11,12,400,20,19,39,Monday
2018,11,12,300,17,11,28,Monday
2018,11,12,200,21,18,39,Monday
2018,11,12,100,18,42,60,Monday
2018,11,11,2400,29,43,72,Sunday
2018,11,11,2300,41,63,104,Sunday
2018,11,11,2200,60,65,125,Sunday
2018,11,11,2100,80,120,200,Sunday
2018,11,11,2000,74,162,236,Sunday
2018,11,11,1900,119,303,422,Sunday
2018,11,11,1800,161,607,768,Sunday
2018,11,11,1700,265,753,1018,Sunday
2018,11,11,1600,283,739,1022,Sunday
2018,11,11,1500,316,592,908,Sunday
2018,11,11,1400,395,575,970,Sunday
2018,11,11,1300,437,428,865,Sunday
2018,11,11,1200,444,293,737,Sunday
2018,11,11,1100,448,181,629,Sunday
2018,11,11,1000,335,134,469,Sunday
2018,11,11,900,286,55,341,Sunday
2018,11,11,800,166,32,198,Sunday
2018,11,11,700,54,13,67,Sunday
2018,11,11,600,28,12,40,Sunday
2018,11,11,500,18,14,32,Sunday
2018,11,11,400,15,19,34,Sunday
2018,11,11,300,10,17,27,Sunday
2018,11,11,200,23,16,39,Sunday
2018,11,11,100,17,31,48,Sunday
2018,11,10,2400,35,38,73,Saturday
2018,11,10,2300,58,41,99,Saturday
2018,11,10,2200,51,56,107,Saturday
2018,11,10,2100,70,91,161,Saturday
2018,11,10,2000,112,131,243,Saturday
2018,11,10,1900,135,218,353,Saturday
2018,11,10,1800,179,389,568,Saturday
2018,11,10,1700,286,569,855,Saturday
2018,11,10,1600,307,545,852,Saturday
2018,11,10,1500,388,463,851,Saturday
2018,11,10,1400,438,435,873,Saturday
2018,11,10,1300,502,327,829,Saturday
2018,11,10,1200,588,256,844,Saturday
2018,11,10,1100,520,187,707,Saturday
2018,11,10,1000,436,166,602,Saturday
2018,11,10,900,371,91,462,Saturday
2018,11,10,800,194,43,237,Saturday
2018,11,10,700,91,36,127,Saturday
2018,11,10,600,22,30,52,Saturday
2018,11,10,500,17,29,46,Saturday
2018,11,10,400,19,20,39,Saturday
2018,11,10,300,19,29,48,Saturday
2018,11,10,200,31,45,76,Saturday
2018,11,10,100,39,50,89,Saturday
2018,11,9,2400,49,64,113,Friday
2018,11,9,2300,97,84,181,Friday
2018,11,9,2200,104,96,200,Friday
2018,11,9,2100,175,138,313,Friday
2018,11,9,2000,287,171,458,Friday
2018,11,9,1900,362,230,592,Friday
2018,11,9,1800,411,321,732,Friday
2018,11,9,1700,498,408,906,Friday
2018,11,9,1600,473,413,886,Friday
2018,11,9,1500,438,371,809,Friday
2018,11,9,1400,430,322,752,Friday
2018,11,9,1300,419,281,700,Friday
2018,11,9,1200,447,227,674,Friday
2018,11,9,1100,390,170,560,Friday
2018,11,9,1000,321,173,494,Friday
2018,11,9,900,307,110,417,Friday
2018,11,9,800,228,57,285,Friday
2018,11,9,700,92,40,132,Friday
2018,11,9,600,40,40,80,Friday
2018,11,9,500,21,26,47,Friday
2018,11,9,400,28,28,56,Friday
2018,11,9,300,24,37,61,Friday
2018,11,9,200,33,41,74,Friday
2018,11,9,100,45,48,93,Friday
2018,11,8,2400,67,65,132,Thursday
2018,11,8,2300,71,88,159,Thursday
2018,11,8,2200,104,114,218,Thursday
2018,11,8,2100,155,126,281,Thursday
2018,11,8,2000,166,163,329,Thursday
2018,11,8,1900,189,213,402,Thursday
2018,11,8,1800,199,310,509,Thursday
2018,11,8,1700,279,333,612,Thursday
2018,11,8,1600,283,292,575,Thursday
2018,11,8,1500,275,275,550,Thursday
2018,11,8,1400,276,293,569,Thursday
2018,11,8,1300,305,314,619,Thursday
2018,11,8,1200,298,259,557,Thursday
2018,11,8,1100,285,148,433,Thursday
2018,11,8,1000,200,145,345,Thursday
2018,11,8,900,188,98,286,Thursday
2018,11,8,800,192,60,252,Thursday
2018,11,8,700,86,35,121,Thursday
2018,11,8,600,29,40,69,Thursday
2018,11,8,500,27,28,55,Thursday
2018,11,8,400,29,26,55,Thursday
2018,11,8,300,25,30,55,Thursday
2018,11,8,200,28,27,55,Thursday
2018,11,8,100,33,47,80,Thursday
2018,11,7,2400,62,71,133,Wednesday
2018,11,7,2300,60,55,115,Wednesday
2018,11,7,2200,91,91,182,Wednesday
2018,11,7,2100,104,95,199,Wednesday
2018,11,7,2000,121,160,281,Wednesday
2018,11,7,1900,127,196,323,Wednesday
2018,11,7,1800,153,244,397,Wednesday
2018,11,7,1700,195,268,463,Wednesday
2018,11,7,1600,211,247,458,Wednesday
2018,11,7,1500,222,294,516,Wednesday
2018,11,7,1400,218,252,470,Wednesday
2018,11,7,1300,248,219,467,Wednesday
2018,11,7,1200,236,190,426,Wednesday
2018,11,7,1100,265,152,417,Wednesday
2018,11,7,1000,176,172,348,Wednesday
2018,11,7,900,158,122,280,Wednesday
2018,11,7,800,195,87,282,Wednesday
2018,11,7,700,68,44,112,Wednesday
2018,11,7,600,26,29,55,Wednesday
2018,11,7,500,23,51,74,Wednesday
2018,11,7,400,28,91,119,Wednesday
2018,11,7,300,21,24,45,Wednesday
2018,11,7,200,27,36,63,Wednesday
2018,11,7,100,42,16,58,Wednesday
2018,11,6,2400,49,18,67,Tuesday
2018,11,6,2300,67,11,78,Tuesday
2018,11,6,2200,76,60,136,Tuesday
2018,11,6,2100,86,56,142,Tuesday
2018,11,6,2000,94,120,214,Tuesday
2018,11,6,1900,99,162,261,Tuesday
2018,11,6,1800,131,231,362,Tuesday
2018,11,6,1700,197,226,423,Tuesday
2018,11,6,1600,180,242,422,Tuesday
2018,11,6,1500,201,218,419,Tuesday
2018,11,6,1400,201,218,419,Tuesday
2018,11,6,1300,196,206,402,Tuesday
2018,11,6,1200,238,185,423,Tuesday
2018,11,6,1100,225,171,396,Tuesday
2018,11,6,1000,181,138,319,Tuesday
2018,11,6,900,142,91,233,Tuesday
2018,11,6,800,160,83,243,Tuesday
2018,11,6,700,56,48,104,Tuesday
2018,11,6,600,21,29,50,Tuesday
2018,11,6,500,19,43,62,Tuesday
2018,11,6,400,17,52,69,Tuesday
2018,11,6,300,28,33,61,Tuesday
2018,11,6,200,30,37,67,Tuesday
2018,11,6,100,35,56,91,Tuesday
2018,11,5,2400,53,55,108,Monday
2018,11,5,2300,44,66,110,Monday
2018,11,5,2200,70,81,151,Monday
2018,11,5,2100,128,78,206,Monday
2018,11,5,2000,141,132,273,Monday
2018,11,5,1900,106,183,289,Monday
2018,11,5,1800,80,277,357,Monday
2018,11,5,1700,199,284,483,Monday
2018,11,5,1600,284,263,547,Monday
2018,11,5,1500,339,235,574,Monday
2018,11,5,1400,310,234,544,Monday
2018,11,5,1300,296,201,497,Monday
2018,11,5,1200,309,183,492,Monday
2018,11,5,1100,303,165,468,Monday
2018,11,5,1000,256,125,381,Monday
2018,11,5,900,178,72,250,Monday
2018,11,5,800,156,50,206,Monday
2018,11,5,700,84,28,112,Monday
2018,11,5,600,37,13,50,Monday
2018,11,5,500,30,27,57,Monday
2018,11,5,400,19,19,38,Monday
2018,11,5,300,21,26,47,Monday
2018,11,5,200,21,29,50,Monday
2018,11,5,100,40,40,80,Monday
2018,11,4,2400,36,72,108,Sunday
2018,11,4,2300,51,60,111,Sunday
2018,11,4,2200,54,99,153,Sunday
2018,11,4,2100,67,130,197,Sunday
2018,11,4,2000,91,151,242,Sunday
2018,11,4,1900,136,414,550,Sunday
2018,11,4,1800,165,303,468,Sunday
2018,11,4,1700,242,539,781,Sunday
2018,11,4,1600,241,521,762,Sunday
2018,11,4,1500,264,526,790,Sunday
2018,11,4,1400,339,468,807,Sunday
2018,11,4,1300,393,377,770,Sunday
2018,11,4,1200,353,299,652,Sunday
2018,11,4,1100,325,218,543,Sunday
2018,11,4,1000,254,116,370,Sunday
2018,11,4,900,197,57,254,Sunday
2018,11,4,800,94,32,126,Sunday
2018,11,4,700,54,21,75,Sunday
2018,11,4,600,24,8,32,Sunday
2018,11,4,500,16,17,33,Sunday
2018,11,4,400,16,14,30,Sunday
2018,11,4,300,16,9,25,Sunday
2018,11,4,200,15,26,41,Sunday
2018,11,4,100,26,24,50,Sunday
2018,11,3,2400,36,37,73,Saturday
2018,11,3,2300,47,77,124,Saturday
2018,11,3,2200,51,62,113,Saturday
2018,11,3,2100,81,80,161,Saturday
2018,11,3,2000,103,167,270,Saturday
2018,11,3,1900,125,197,322,Saturday
2018,11,3,1800,161,322,483,Saturday
2018,11,3,1700,182,387,569,Saturday
2018,11,3,1600,248,463,711,Saturday
2018,11,3,1500,268,290,558,Saturday
2018,11,3,1400,326,299,625,Saturday
2018,11,3,1300,341,233,574,Saturday
2018,11,3,1200,352,218,570,Saturday
2018,11,3,1100,307,179,486,Saturday
2018,11,3,1000,208,138,346,Saturday
2018,11,3,900,165,74,239,Saturday
2018,11,3,800,129,53,182,Saturday
2018,11,3,700,74,29,103,Saturday
2018,11,3,600,39,33,72,Saturday
2018,11,3,500,17,19,36,Saturday
2018,11,3,400,29,28,57,Saturday
2018,11,3,300,14,33,47,Saturday
2018,11,3,200,21,42,63,Saturday
2018,11,3,100,28,43,71,Saturday
2018,11,2,2400,64,51,115,Friday
2018,11,2,2300,58,73,131,Friday
2018,11,2,2200,99,90,189,Friday
2018,11,2,2100,136,104,240,Friday
2018,11,2,2000,206,144,350,Friday
2018,11,2,1900,232,227,459,Friday
2018,11,2,1800,295,317,612,Friday
2018,11,2,1700,302,322,624,Friday
2018,11,2,1600,292,305,597,Friday
2018,11,2,1500,336,315,651,Friday
2018,11,2,1400,283,296,579,Friday
2018,11,2,1300,314,253,567,Friday
2018,11,2,1200,309,193,502,Friday
2018,11,2,1100,303,204,507,Friday
2018,11,2,1000,233,119,352,Friday
2018,11,2,900,151,52,203,Friday
2018,11,2,800,126,38,164,Friday
2018,11,2,700,72,34,106,Friday
2018,11,2,600,47,24,71,Friday
2018,11,2,500,21,45,66,Friday
2018,11,2,400,30,28,58,Friday
2018,11,2,300,39,35,74,Friday
2018,11,2,200,34,35,69,Friday
2018,11,2,100,32,59,91,Friday
2018,11,1,2400,65,52,117,Thursday
2018,11,1,2300,61,69,130,Thursday
2018,11,1,2200,95,82,177,Thursday
2018,11,1,2100,104,113,217,Thursday
2018,11,1,2000,136,179,315,Thursday
2018,11,1,1900,174,182,356,Thursday
2018,11,1,1800,189,270,459,Thursday
2018,11,1,1700,231,287,518,Thursday
2018,11,1,1600,273,255,528,Thursday
2018,11,1,1500,266,290,556,Thursday
2018,11,1,1400,278,239,517,Thursday
2018,11,1,1300,280,217,497,Thursday
2018,11,1,1200,276,215,491,Thursday
2018,11,1,1100,291,152,443,Thursday
2018,11,1,1000,244,134,378,Thursday
2018,11,1,900,193,80,273,Thursday
2018,11,1,800,167,61,228,Thursday
2018,11,1,700,72,39,111,Thursday
2018,11,1,600,36,26,62,Thursday
2018,11,1,500,23,30,53,Thursday
2018,11,1,400,21,31,52,Thursday
2018,11,1,300,26,28,54,Thursday
2018,11,1,200,26,38,64,Thursday
2018,11,1,100,29,38,67,Thursday
2018,10,31,2400,64,63,127,Wednesday
2018,10,31,2300,74,70,144,Wednesday
2018,10,31,2200,73,97,170,Wednesday
2018,10,31,2100,111,126,237,Wednesday
2018,10,31,2000,126,140,266,Wednesday
2018,10,31,1900,120,185,305,Wednesday
2018,10,31,1800,180,350,530,Wednesday
2018,10,31,1700,178,250,428,Wednesday
2018,10,31,1600,240,241,481,Wednesday
2018,10,31,1500,239,268,507,Wednesday
2018,10,31,1400,252,236,488,Wednesday
2018,10,31,1300,223,220,443,Wednesday
2018,10,31,1200,291,187,478,Wednesday
2018,10,31,1100,231,191,422,Wednesday
2018,10,31,1000,189,126,315,Wednesday
2018,10,31,900,166,83,249,Wednesday
2018,10,31,800,156,67,223,Wednesday
2018,10,31,700,72,46,118,Wednesday
2018,10,31,600,36,26,62,Wednesday
2018,10,31,500,23,33,56,Wednesday
2018,10,31,400,25,39,64,Wednesday
2018,10,31,300,27,41,68,Wednesday
2018,10,31,200,33,38,71,Wednesday
2018,10,31,100,47,52,99,Wednesday
2018,10,30,2400,55,76,131,Tuesday
2018,10,30,2300,80,83,163,Tuesday
2018,10,30,2200,88,86,174,Tuesday
2018,10,30,2100,118,124,242,Tuesday
2018,10,30,2000,109,152,261,Tuesday
2018,10,30,1900,136,242,378,Tuesday
2018,10,30,1800,127,309,436,Tuesday
2018,10,30,1700,181,340,521,Tuesday
2018,10,30,1600,225,293,518,Tuesday
2018,10,30,1500,261,272,533,Tuesday
2018,10,30,1400,250,238,488,Tuesday
2018,10,30,1300,291,240,531,Tuesday
2018,10,30,1200,261,213,474,Tuesday
2018,10,30,1100,276,165,441,Tuesday
2018,10,30,1000,245,138,383,Tuesday
2018,10,30,900,183,85,268,Tuesday
2018,10,30,800,196,67,263,Tuesday
2018,10,30,700,71,48,119,Tuesday
2018,10,30,600,33,42,75,Tuesday
2018,10,30,500,21,26,47,Tuesday
2018,10,30,400,18,36,54,Tuesday
2018,10,30,300,25,36,61,Tuesday
2018,10,30,200,25,36,61,Tuesday
2018,10,30,100,30,46,76,Tuesday
2018,10,29,2400,62,49,111,Monday
2018,10,29,2300,78,89,167,Monday
2018,10,29,2200,90,70,160,Monday
2018,10,29,2100,98,108,206,Monday
2018,10,29,2000,126,154,280,Monday
2018,10,29,1900,123,243,366,Monday
2018,10,29,1800,184,373,557,Monday
2018,10,29,1700,227,360,587,Monday
2018,10,29,1600,237,316,553,Monday
2018,10,29,1500,260,306,566,Monday
2018,10,29,1400,306,253,559,Monday
2018,10,29,1300,343,278,621,Monday
2018,10,29,1200,353,202,555,Monday
2018,10,29,1100,355,181,536,Monday
2018,10,29,1000,291,136,427,Monday
2018,10,29,900,167,105,272,Monday
2018,10,29,800,169,55,224,Monday
2018,10,29,700,79,31,110,Monday
2018,10,29,600,33,20,53,Monday
2018,10,29,500,22,17,39,Monday
2018,10,29,400,17,23,40,Monday
2018,10,29,300,20,23,43,Monday
2018,10,29,200,19,27,46,Monday
2018,10,29,100,25,56,81,Monday
2018,10,28,2400,36,118,154,Sunday
2018,10,28,2300,34,125,159,Sunday
2018,10,28,2200,64,147,211,Sunday
2018,10,28,2100,80,220,300,Sunday
2018,10,28,2000,112,312,424,Sunday
2018,10,28,1900,149,287,436,Sunday
2018,10,28,1800,177,498,675,Sunday
2018,10,28,1700,220,641,861,Sunday
2018,10,28,1600,297,648,945,Sunday
2018,10,28,1500,316,346,662,Sunday
2018,10,28,1400,340,354,694,Sunday
2018,10,28,1300,409,422,831,Sunday
2018,10,28,1200,357,339,696,Sunday
2018,10,28,1100,343,162,505,Sunday
2018,10,28,1000,281,119,400,Sunday
2018,10,28,900,151,68,219,Sunday
2018,10,28,800,139,28,167,Sunday
2018,10,28,700,50,21,71,Sunday
2018,10,28,600,30,49,79,Sunday
2018,10,28,500,20,17,37,Sunday
2018,10,28,400,18,5,23,Sunday
2018,10,28,300,17,5,22,Sunday
2018,10,28,200,17,6,23,Sunday
2018,10,28,100,26,24,50,Sunday
2018,10,27,2400,39,52,91,Saturday
2018,10,27,2300,42,63,105,Saturday
2018,10,27,2200,50,102,152,Saturday
2018,10,27,2100,88,140,228,Saturday
2018,10,27,2000,87,250,337,Saturday
2018,10,27,1900,131,340,471,Saturday
2018,10,27,1800,196,602,798,Saturday
2018,10,27,1700,247,401,648,Saturday
2018,10,27,1600,292,470,762,Saturday
2018,10,27,1500,366,387,753,Saturday
2018,10,27,1400,415,352,767,Saturday
2018,10,27,1300,441,290,731,Saturday
2018,10,27,1200,511,272,783,Saturday
2018,10,27,1100,420,212,632,Saturday
2018,10,27,1000,326,138,464,Saturday
2018,10,27,900,261,95,356,Saturday
2018,10,27,800,162,56,218,Saturday
2018,10,27,700,79,53,132,Saturday
2018,10,27,600,35,32,67,Saturday
2018,10,27,500,25,28,53,Saturday
2018,10,27,400,20,14,34,Saturday
2018,10,27,300,28,31,59,Saturday
2018,10,27,200,21,51,72,Saturday
2018,10,27,100,32,66,98,Saturday
2018,10,26,2400,49,47,96,Friday
2018,10,26,2300,83,93,176,Friday
2018,10,26,2200,78,96,174,Friday
2018,10,26,2100,163,138,301,Friday
2018,10,26,2000,213,197,410,Friday
2018,10,26,1900,269,282,551,Friday
2018,10,26,1800,332,454,786,Friday
2018,10,26,1700,381,390,771,Friday
2018,10,26,1600,404,408,812,Friday
2018,10,26,1500,408,484,892,Friday
2018,10,26,1400,357,342,699,Friday
2018,10,26,1300,422,280,702,Friday
2018,10,26,1200,389,259,648,Friday
2018,10,26,1100,410,219,629,Friday
2018,10,26,1000,287,129,416,Friday
2018,10,26,900,214,99,313,Friday
2018,10,26,800,182,86,268,Friday
2018,10,26,700,89,47,136,Friday
2018,10,26,600,53,39,92,Friday
2018,10,26,500,25,27,52,Friday
2018,10,26,400,24,49,73,Friday
2018,10,26,300,33,25,58,Friday
2018,10,26,200,39,44,83,Friday
2018,10,26,100,37,58,95,Friday
2018,10,25,2400,66,70,136,Thursday
2018,10,25,2300,77,106,183,Thursday
2018,10,25,2200,112,86,198,Thursday
2018,10,25,2100,137,139,276,Thursday
2018,10,25,2000,167,249,416,Thursday
2018,10,25,1900,193,262,455,Thursday
2018,10,25,1800,234,371,605,Thursday
2018,10,25,1700,250,314,564,Thursday
2018,10,25,1600,274,357,631,Thursday
2018,10,25,1500,297,305,602,Thursday
2018,10,25,1400,310,298,608,Thursday
2018,10,25,1300,308,298,606,Thursday
2018,10,25,1200,356,200,556,Thursday
2018,10,25,1100,352,160,512,Thursday
2018,10,25,1000,282,148,430,Thursday
2018,10,25,900,203,107,310,Thursday
2018,10,25,800,180,75,255,Thursday
2018,10,25,700,76,40,116,Thursday
2018,10,25,600,44,40,84,Thursday
2018,10,25,500,31,24,55,Thursday
2018,10,25,400,19,38,57,Thursday
2018,10,25,300,28,30,58,Thursday
2018,10,25,200,22,39,61,Thursday
2018,10,25,100,39,59,98,Thursday
2018,10,24,2400,64,77,141,Wednesday
2018,10,24,2300,80,139,219,Wednesday
2018,10,24,2200,94,166,260,Wednesday
2018,10,24,2100,119,150,269,Wednesday
2018,10,24,2000,147,221,368,Wednesday
2018,10,24,1900,147,283,430,Wednesday
2018,10,24,1800,185,268,453,Wednesday
2018,10,24,1700,230,354,584,Wednesday
2018,10,24,1600,295,255,550,Wednesday
2018,10,24,1500,287,497,784,Wednesday
2018,10,24,1400,337,272,609,Wednesday
2018,10,24,1300,298,172,470,Wednesday
2018,10,24,1200,341,173,514,Wednesday
2018,10,24,1100,300,102,402,Wednesday
2018,10,24,1000,277,106,383,Wednesday
2018,10,24,900,199,103,302,Wednesday
2018,10,24,800,163,95,258,Wednesday
2018,10,24,700,86,40,126,Wednesday
2018,10,24,600,40,32,72,Wednesday
2018,10,24,500,37,51,88,Wednesday
2018,10,24,400,21,37,58,Wednesday
2018,10,24,300,34,42,76,Wednesday
2018,10,24,200,27,32,59,Wednesday
2018,10,24,100,40,60,100,Wednesday
2018,10,23,2400,57,50,107,Tuesday
2018,10,23,2300,63,89,152,Tuesday
2018,10,23,2200,82,122,204,Tuesday
2018,10,23,2100,91,138,229,Tuesday
2018,10,23,2000,121,226,347,Tuesday
2018,10,23,1900,124,303,427,Tuesday
2018,10,23,1800,184,394,578,Tuesday
2018,10,23,1700,232,394,626,Tuesday
2018,10,23,1600,247,362,609,Tuesday
2018,10,23,1500,291,331,622,Tuesday
2018,10,23,1400,293,264,557,Tuesday
2018,10,23,1300,308,233,541,Tuesday
2018,10,23,1200,384,226,610,Tuesday
2018,10,23,1100,377,180,557,Tuesday
2018,10,23,1000,281,175,456,Tuesday
2018,10,23,900,195,102,297,Tuesday
2018,10,23,800,179,75,254,Tuesday
2018,10,23,700,81,55,136,Tuesday
2018,10,23,600,38,30,68,Tuesday
2018,10,23,500,21,41,62,Tuesday
2018,10,23,400,30,41,71,Tuesday
2018,10,23,300,25,38,63,Tuesday
2018,10,23,200,23,36,59,Tuesday
2018,10,23,100,41,44,85,Tuesday
2018,10,22,2400,56,64,120,Monday
2018,10,22,2300,70,92,162,Monday
2018,10,22,2200,83,103,186,Monday
2018,10,22,2100,109,153,262,Monday
2018,10,22,2000,127,232,359,Monday
2018,10,22,1900,143,331,474,Monday
2018,10,22,1800,198,449,647,Monday
2018,10,22,1700,253,426,679,Monday
2018,10,22,1600,286,433,719,Monday
2018,10,22,1500,304,372,676,Monday
2018,10,22,1400,319,278,597,Monday
2018,10,22,1300,392,295,687,Monday
2018,10,22,1200,454,248,702,Monday
2018,10,22,1100,453,178,631,Monday
2018,10,22,1000,330,124,454,Monday
2018,10,22,900,235,89,324,Monday
2018,10,22,800,179,69,248,Monday
2018,10,22,700,80,37,117,Monday
2018,10,22,600,44,31,75,Monday
2018,10,22,500,26,18,44,Monday
2018,10,22,400,21,25,46,Monday
2018,10,22,300,20,21,41,Monday
2018,10,22,200,20,42,62,Monday
2018,10,22,100,38,65,103,Monday
2018,10,21,2400,43,87,130,Sunday
2018,10,21,2300,54,140,194,Sunday
2018,10,21,2200,76,138,214,Sunday
2018,10,21,2100,108,277,385,Sunday
2018,10,21,2000,163,443,606,Sunday
2018,10,21,1900,178,679,857,Sunday
2018,10,21,1800,240,725,965,Sunday
2018,10,21,1700,310,791,1101,Sunday
2018,10,21,1600,355,789,1144,Sunday
2018,10,21,1500,408,739,1147,Sunday
2018,10,21,1400,515,600,1115,Sunday
2018,10,21,1300,522,524,1046,Sunday
2018,10,21,1200,556,316,872,Sunday
2018,10,21,1100,514,219,733,Sunday
2018,10,21,1000,414,142,556,Sunday
2018,10,21,900,242,62,304,Sunday
2018,10,21,800,134,35,169,Sunday
2018,10,21,700,63,20,83,Sunday
2018,10,21,600,43,18,61,Sunday
2018,10,21,500,19,16,35,Sunday
2018,10,21,400,14,23,37,Sunday
2018,10,21,300,26,16,42,Sunday
2018,10,21,200,15,32,47,Sunday
2018,10,21,100,22,36,58,Sunday
2018,10,20,2400,52,46,98,Saturday
2018,10,20,2300,41,99,140,Saturday
2018,10,20,2200,83,105,188,Saturday
2018,10,20,2100,90,188,278,Saturday
2018,10,20,2000,103,382,485,Saturday
2018,10,20,1900,135,433,568,Saturday
2018,10,20,1800,183,508,691,Saturday
2018,10,20,1700,283,627,910,Saturday
2018,10,20,1600,356,543,899,Saturday
2018,10,20,1500,401,509,910,Saturday
2018,10,20,1400,491,383,874,Saturday
2018,10,20,1300,570,330,900,Saturday
2018,10,20,1200,634,274,908,Saturday
2018,10,20,1100,630,227,857,Saturday
2018,10,20,1000,484,139,623,Saturday
2018,10,20,900,311,101,412,Saturday
2018,10,20,800,185,64,249,Saturday
2018,10,20,700,86,47,133,Saturday
2018,10,20,600,37,20,57,Saturday
2018,10,20,500,31,38,69,Saturday
2018,10,20,400,23,26,49,Saturday
2018,10,20,300,22,37,59,Saturday
2018,10,20,200,22,39,61,Saturday
2018,10,20,100,48,41,89,Saturday
2018,10,19,2400,53,71,124,Friday
2018,10,19,2300,62,97,159,Friday
2018,10,19,2200,135,153,288,Friday
2018,10,19,2100,177,195,372,Friday
2018,10,19,2000,301,280,581,Friday
2018,10,19,1900,358,414,772,Friday
2018,10,19,1800,443,496,939,Friday
2018,10,19,1700,438,485,923,Friday
2018,10,19,1600,488,435,923,Friday
2018,10,19,1500,483,410,893,Friday
2018,10,19,1400,438,389,827,Friday
2018,10,19,1300,474,340,814,Friday
2018,10,19,1200,498,297,795,Friday
2018,10,19,1100,502,191,693,Friday
2018,10,19,1000,380,140,520,Friday
2018,10,19,900,286,121,407,Friday
2018,10,19,800,154,69,223,Friday
2018,10,19,700,113,56,169,Friday
2018,10,19,600,54,37,91,Friday
2018,10,19,500,28,40,68,Friday
2018,10,19,400,35,33,68,Friday
2018,10,19,300,27,34,61,Friday
2018,10,19,200,24,49,73,Friday
2018,10,19,100,44,61,105,Friday
2018,10,18,2400,64,75,139,Thursday
2018,10,18,2300,94,116,210,Thursday
2018,10,18,2200,135,104,239,Thursday
2018,10,18,2100,138,187,325,Thursday
2018,10,18,2000,167,280,447,Thursday
2018,10,18,1900,190,358,548,Thursday
2018,10,18,1800,264,428,692,Thursday
2018,10,18,1700,304,392,696,Thursday
2018,10,18,1600,278,427,705,Thursday
2018,10,18,1500,331,358,689,Thursday
2018,10,18,1400,328,327,655,Thursday
2018,10,18,1300,388,265,653,Thursday
2018,10,18,1200,419,265,684,Thursday
2018,10,18,1100,433,169,602,Thursday
2018,10,18,1000,344,137,481,Thursday
2018,10,18,900,285,100,385,Thursday
2018,10,18,800,191,74,265,Thursday
2018,10,18,700,82,65,147,Thursday
2018,10,18,600,52,32,84,Thursday
2018,10,18,500,42,28,70,Thursday
2018,10,18,400,36,35,71,Thursday
2018,10,18,300,24,46,70,Thursday
2018,10,18,200,33,42,75,Thursday
2018,10,18,100,37,66,103,Thursday
2018,10,17,2400,64,83,147,Wednesday
2018,10,17,2300,77,85,162,Wednesday
2018,10,17,2200,93,109,202,Wednesday
2018,10,17,2100,118,154,272,Wednesday
2018,10,17,2000,130,300,430,Wednesday
2018,10,17,1900,176,308,484,Wednesday
2018,10,17,1800,230,644,874,Wednesday
2018,10,17,1700,241,280,521,Wednesday
2018,10,17,1600,281,350,631,Wednesday
2018,10,17,1500,301,347,648,Wednesday
2018,10,17,1400,339,282,621,Wednesday
2018,10,17,1300,356,255,611,Wednesday
2018,10,17,1200,383,233,616,Wednesday
2018,10,17,1100,428,194,622,Wednesday
2018,10,17,1000,321,155,476,Wednesday
2018,10,17,900,261,120,381,Wednesday
2018,10,17,800,200,87,287,Wednesday
2018,10,17,700,100,45,145,Wednesday
2018,10,17,600,49,32,81,Wednesday
2018,10,17,500,21,36,57,Wednesday
2018,10,17,400,32,45,77,Wednesday
2018,10,17,300,30,35,65,Wednesday
2018,10,17,200,25,53,78,Wednesday
2018,10,17,100,35,50,85,Wednesday
2018,10,16,2400,76,75,151,Tuesday
2018,10,16,2300,67,91,158,Tuesday
2018,10,16,2200,92,114,206,Tuesday
2018,10,16,2100,122,187,309,Tuesday
2018,10,16,2000,97,269,366,Tuesday
2018,10,16,1900,152,343,495,Tuesday
2018,10,16,1800,206,457,663,Tuesday
2018,10,16,1700,261,517,778,Tuesday
2018,10,16,1600,281,318,599,Tuesday
2018,10,16,1500,283,358,641,Tuesday
2018,10,16,1400,307,348,655,Tuesday
2018,10,16,1300,362,262,624,Tuesday
2018,10,16,1200,429,193,622,Tuesday
2018,10,16,1100,423,172,595,Tuesday
2018,10,16,1000,334,162,496,Tuesday
2018,10,16,900,261,100,361,Tuesday
2018,10,16,800,192,95,287,Tuesday
2018,10,16,700,76,33,109,Tuesday
2018,10,16,600,45,38,83,Tuesday
2018,10,16,500,27,29,56,Tuesday
2018,10,16,400,29,39,68,Tuesday
2018,10,16,300,20,42,62,Tuesday
2018,10,16,200,26,36,62,Tuesday
2018,10,16,100,37,39,76,Tuesday
2018,10,15,2400,58,88,146,Monday
2018,10,15,2300,49,79,128,Monday
2018,10,15,2200,105,120,225,Monday
2018,10,15,2100,100,167,267,Monday
2018,10,15,2000,155,316,471,Monday
2018,10,15,1900,169,649,818,Monday
2018,10,15,1800,193,344,537,Monday
2018,10,15,1700,257,457,714,Monday
2018,10,15,1600,340,371,711,Monday
2018,10,15,1500,341,421,762,Monday
2018,10,15,1400,365,318,683,Monday
2018,10,15,1300,429,265,694,Monday
2018,10,15,1200,446,198,644,Monday
2018,10,15,1100,475,189,664,Monday
2018,10,15,1000,351,148,499,Monday
2018,10,15,900,268,103,371,Monday
2018,10,15,800,213,40,253,Monday
2018,10,15,700,91,43,134,Monday
2018,10,15,600,46,20,66,Monday
2018,10,15,500,21,22,43,Monday
2018,10,15,400,29,24,53,Monday
2018,10,15,300,20,23,43,Monday
2018,10,15,200,21,25,46,Monday
2018,10,15,100,24,56,80,Monday
2018,10,14,2400,46,87,133,Sunday
2018,10,14,2300,43,104,147,Sunday
2018,10,14,2200,92,194,286,Sunday
2018,10,14,2100,102,262,364,Sunday
2018,10,14,2000,142,458,600,Sunday
2018,10,14,1900,171,613,784,Sunday
2018,10,14,1800,222,797,1019,Sunday
2018,10,14,1700,301,789,1090,Sunday
2018,10,14,1600,345,748,1093,Sunday
2018,10,14,1500,359,592,951,Sunday
2018,10,14,1400,447,577,1024,Sunday
2018,10,14,1300,490,498,988,Sunday
2018,10,14,1200,533,383,916,Sunday
2018,10,14,1100,472,229,701,Sunday
2018,10,14,1000,420,141,561,Sunday
2018,10,14,900,297,65,362,Sunday
2018,10,14,800,162,40,202,Sunday
2018,10,14,700,77,23,100,Sunday
2018,10,14,600,39,23,62,Sunday
2018,10,14,500,23,12,35,Sunday
2018,10,14,400,17,13,30,Sunday
2018,10,14,300,13,25,38,Sunday
2018,10,14,200,25,20,45,Sunday
2018,10,14,100,17,53,70,Sunday
2018,10,13,2400,31,54,85,Saturday
2018,10,13,2300,50,77,127,Saturday
2018,10,13,2200,60,129,189,Saturday
2018,10,13,2100,101,171,272,Saturday
2018,10,13,2000,99,293,392,Saturday
2018,10,13,1900,133,374,507,Saturday
2018,10,13,1800,159,527,686,Saturday
2018,10,13,1700,246,495,741,Saturday
2018,10,13,1600,279,458,737,Saturday
2018,10,13,1500,364,402,766,Saturday
2018,10,13,1400,375,369,744,Saturday
2018,10,13,1300,436,332,768,Saturday
2018,10,13,1200,507,263,770,Saturday
2018,10,13,1100,499,194,693,Saturday
2018,10,13,1000,416,148,564,Saturday
2018,10,13,900,321,86,407,Saturday
2018,10,13,800,204,81,285,Saturday
2018,10,13,700,80,36,116,Saturday
2018,10,13,600,34,27,61,Saturday
2018,10,13,500,29,25,54,Saturday
2018,10,13,400,18,34,52,Saturday
2018,10,13,300,24,30,54,Saturday
2018,10,13,200,19,42,61,Saturday
2018,10,13,100,38,45,83,Saturday
2018,10,12,2400,61,79,140,Friday
2018,10,12,2300,95,125,220,Friday
2018,10,12,2200,103,70,173,Friday
2018,10,12,2100,197,179,376,Friday
2018,10,12,2000,288,293,581,Friday
2018,10,12,1900,336,464,800,Friday
2018,10,12,1800,406,544,950,Friday
2018,10,12,1700,451,454,905,Friday
2018,10,12,1600,503,500,1003,Friday
2018,10,12,1500,497,455,952,Friday
2018,10,12,1400,440,366,806,Friday
2018,10,12,1300,491,330,821,Friday
2018,10,12,1200,509,349,858,Friday
2018,10,12,1100,515,246,761,Friday
2018,10,12,1000,440,152,592,Friday
2018,10,12,900,286,154,440,Friday
2018,10,12,800,206,88,294,Friday
2018,10,12,700,93,40,133,Friday
2018,10,12,600,46,44,90,Friday
2018,10,12,500,31,35,66,Friday
2018,10,12,400,28,34,62,Friday
2018,10,12,300,36,57,93,Friday
2018,10,12,200,33,56,89,Friday
2018,10,12,100,38,72,110,Friday
2018,10,11,2400,69,103,172,Thursday
2018,10,11,2300,94,135,229,Thursday
2018,10,11,2200,86,368,454,Thursday
2018,10,11,2100,132,283,415,Thursday
2018,10,11,2000,191,168,359,Thursday
2018,10,11,1900,177,298,475,Thursday
2018,10,11,1800,247,376,623,Thursday
2018,10,11,1700,318,425,743,Thursday
2018,10,11,1600,344,425,769,Thursday
2018,10,11,1500,336,414,750,Thursday
2018,10,11,1400,365,373,738,Thursday
2018,10,11,1300,394,308,702,Thursday
2018,10,11,1200,495,242,737,Thursday
2018,10,11,1100,481,184,665,Thursday
2018,10,11,1000,438,154,592,Thursday
2018,10,11,900,299,116,415,Thursday
2018,10,11,800,208,64,272,Thursday
2018,10,11,700,94,39,133,Thursday
2018,10,11,600,32,31,63,Thursday
2018,10,11,500,35,39,74,Thursday
2018,10,11,400,23,27,50,Thursday
2018,10,11,300,23,31,54,Thursday
2018,10,11,200,24,44,68,Thursday
2018,10,11,100,38,59,97,Thursday
2018,10,10,2400,60,66,126,Wednesday
2018,10,10,2300,59,97,156,Wednesday
2018,10,10,2200,74,131,205,Wednesday
2018,10,10,2100,119,173,292,Wednesday
2018,10,10,2000,132,326,458,Wednesday
2018,10,10,1900,149,456,605,Wednesday
2018,10,10,1800,210,585,795,Wednesday
2018,10,10,1700,236,383,619,Wednesday
2018,10,10,1600,292,466,758,Wednesday
2018,10,10,1500,310,337,647,Wednesday
2018,10,10,1400,316,291,607,Wednesday
2018,10,10,1300,385,276,661,Wednesday
2018,10,10,1200,470,222,692,Wednesday
2018,10,10,1100,488,192,680,Wednesday
2018,10,10,1000,394,141,535,Wednesday
2018,10,10,900,250,119,369,Wednesday
2018,10,10,800,207,63,270,Wednesday
2018,10,10,700,84,49,133,Wednesday
2018,10,10,600,38,45,83,Wednesday
2018,10,10,500,26,38,64,Wednesday
2018,10,10,400,27,30,57,Wednesday
2018,10,10,300,30,34,64,Wednesday
2018,10,10,200,28,48,76,Wednesday
2018,10,10,100,33,55,88,Wednesday
2018,10,9,2400,53,62,115,Tuesday
2018,10,9,2300,49,74,123,Tuesday
2018,10,9,2200,89,115,204,Tuesday
2018,10,9,2100,104,203,307,Tuesday
2018,10,9,2000,129,320,449,Tuesday
2018,10,9,1900,149,473,622,Tuesday
2018,10,9,1800,225,541,766,Tuesday
2018,10,9,1700,247,508,755,Tuesday
2018,10,9,1600,298,538,836,Tuesday
2018,10,9,1500,312,370,682,Tuesday
2018,10,9,1400,348,322,670,Tuesday
2018,10,9,1300,427,315,742,Tuesday
2018,10,9,1200,475,247,722,Tuesday
2018,10,9,1100,478,181,659,Tuesday
2018,10,9,1000,391,138,529,Tuesday
2018,10,9,900,227,107,334,Tuesday
2018,10,9,800,173,48,221,Tuesday
2018,10,9,700,50,34,84,Tuesday
2018,10,9,600,31,26,57,Tuesday
2018,10,9,500,22,21,43,Tuesday
2018,10,9,400,13,18,31,Tuesday
2018,10,9,300,17,32,49,Tuesday
2018,10,9,200,14,33,47,Tuesday
2018,10,9,100,31,55,86,Tuesday
2018,10,8,2400,33,85,118,Monday
2018,10,8,2300,34,141,175,Monday
2018,10,8,2200,66,264,330,Monday
2018,10,8,2100,91,325,416,Monday
2018,10,8,2000,111,595,706,Monday
2018,10,8,1900,164,992,1156,Monday
2018,10,8,1800,217,1200,1417,Monday
2018,10,8,1700,290,1314,1604,Monday
2018,10,8,1600,356,1408,1764,Monday
2018,10,8,1500,444,1311,1755,Monday
2018,10,8,1400,525,1162,1687,Monday
2018,10,8,1300,634,1065,1699,Monday
2018,10,8,1200,703,778,1481,Monday
2018,10,8,1100,649,367,1016,Monday
2018,10,8,1000,533,214,747,Monday
2018,10,8,900,359,90,449,Monday
2018,10,8,800,163,42,205,Monday
2018,10,8,700,82,32,114,Monday
2018,10,8,600,49,13,62,Monday
2018,10,8,500,26,16,42,Monday
2018,10,8,400,18,21,39,Monday
2018,10,8,300,17,38,55,Monday
2018,10,8,200,18,36,54,Monday
2018,10,8,100,36,37,73,Monday
2018,10,7,2400,40,67,107,Sunday
2018,10,7,2300,61,108,169,Sunday
2018,10,7,2200,86,195,281,Sunday
2018,10,7,2100,93,300,393,Sunday
2018,10,7,2000,124,480,604,Sunday
2018,10,7,1900,153,726,879,Sunday
2018,10,7,1800,231,799,1030,Sunday
2018,10,7,1700,267,878,1145,Sunday
2018,10,7,1600,347,771,1118,Sunday
2018,10,7,1500,415,673,1088,Sunday
2018,10,7,1400,534,578,1112,Sunday
2018,10,7,1300,627,418,1045,Sunday
2018,10,7,1200,701,353,1054,Sunday
2018,10,7,1100,701,224,925,Sunday
2018,10,7,1000,574,115,689,Sunday
2018,10,7,900,345,67,412,Sunday
2018,10,7,800,156,38,194,Sunday
2018,10,7,700,78,33,111,Sunday
2018,10,7,600,35,23,58,Sunday
2018,10,7,500,13,10,23,Sunday
2018,10,7,400,12,18,30,Sunday
2018,10,7,300,15,24,39,Sunday
2018,10,7,200,24,24,48,Sunday
2018,10,7,100,23,49,72,Sunday
2018,10,6,2400,38,58,96,Saturday
2018,10,6,2300,52,87,139,Saturday
2018,10,6,2200,62,121,183,Saturday
2018,10,6,2100,88,218,306,Saturday
2018,10,6,2000,120,404,524,Saturday
2018,10,6,1900,181,641,822,Saturday
2018,10,6,1800,270,759,1029,Saturday
2018,10,6,1700,346,805,1151,Saturday
2018,10,6,1600,460,628,1088,Saturday
2018,10,6,1500,626,623,1249,Saturday
2018,10,6,1400,691,519,1210,Saturday
2018,10,6,1300,871,428,1299,Saturday
2018,10,6,1200,1104,361,1465,Saturday
2018,10,6,1100,1012,237,1249,Saturday
2018,10,6,1000,779,169,948,Saturday
2018,10,6,900,530,91,621,Saturday
2018,10,6,800,280,46,326,Saturday
2018,10,6,700,165,41,206,Saturday
2018,10,6,600,66,23,89,Saturday
2018,10,6,500,31,28,59,Saturday
2018,10,6,400,28,28,56,Saturday
2018,10,6,300,29,33,62,Saturday
2018,10,6,200,30,51,81,Saturday
2018,10,6,100,55,75,130,Saturday
2018,10,5,2400,77,81,158,Friday
2018,10,5,2300,125,124,249,Friday
2018,10,5,2200,201,184,385,Friday
2018,10,5,2100,378,273,651,Friday
2018,10,5,2000,564,444,1008,Friday
2018,10,5,1900,709,562,1271,Friday
2018,10,5,1800,930,695,1625,Friday
2018,10,5,1700,905,775,1680,Friday
2018,10,5,1600,883,903,1786,Friday
2018,10,5,1500,898,399,1297,Friday
2018,10,5,1400,845,512,1357,Friday
2018,10,5,1300,855,442,1297,Friday
2018,10,5,1200,1023,380,1403,Friday
2018,10,5,1100,943,293,1236,Friday
2018,10,5,1000,781,182,963,Friday
2018,10,5,900,569,126,695,Friday
2018,10,5,800,322,81,403,Friday
2018,10,5,700,150,58,208,Friday
2018,10,5,600,68,37,105,Friday
2018,10,5,500,38,29,67,Friday
2018,10,5,400,35,40,75,Friday
2018,10,5,300,28,38,66,Friday
2018,10,5,200,34,40,74,Friday
2018,10,5,100,40,65,105,Friday
2018,10,4,2400,80,99,179,Thursday
2018,10,4,2300,94,117,211,Thursday
2018,10,4,2200,141,166,307,Thursday
2018,10,4,2100,188,262,450,Thursday
2018,10,4,2000,297,390,687,Thursday
2018,10,4,1900,343,514,857,Thursday
2018,10,4,1800,385,565,950,Thursday
2018,10,4,1700,442,590,1032,Thursday
2018,10,4,1600,456,575,1031,Thursday
2018,10,4,1500,527,427,954,Thursday
2018,10,4,1400,488,392,880,Thursday
2018,10,4,1300,537,365,902,Thursday
2018,10,4,1200,644,269,913,Thursday
2018,10,4,1100,678,224,902,Thursday
2018,10,4,1000,569,164,733,Thursday
2018,10,4,900,377,110,487,Thursday
2018,10,4,800,262,68,330,Thursday
2018,10,4,700,121,41,162,Thursday
2018,10,4,600,54,25,79,Thursday
2018,10,4,500,36,45,81,Thursday
2018,10,4,400,27,17,44,Thursday
2018,10,4,300,24,11,35,Thursday
2018,10,4,200,29,23,52,Thursday
2018,10,4,100,54,41,95,Thursday
2018,10,3,2400,63,80,143,Wednesday
2018,10,3,2300,73,81,154,Wednesday
2018,10,3,2200,98,96,194,Wednesday
2018,10,3,2100,118,146,264,Wednesday
2018,10,3,2000,149,297,446,Wednesday
2018,10,3,1900,177,410,587,Wednesday
2018,10,3,1800,278,510,788,Wednesday
2018,10,3,1700,294,520,814,Wednesday
2018,10,3,1600,299,559,858,Wednesday
2018,10,3,1500,368,438,806,Wednesday
2018,10,3,1400,425,310,735,Wednesday
2018,10,3,1300,498,286,784,Wednesday
2018,10,3,1200,576,269,845,Wednesday
2018,10,3,1100,583,219,802,Wednesday
2018,10,3,1000,467,141,608,Wednesday
2018,10,3,900,313,84,397,Wednesday
2018,10,3,800,194,73,267,Wednesday
2018,10,3,700,162,36,198,Wednesday
2018,10,3,600,61,27,88,Wednesday
2018,10,3,500,28,19,47,Wednesday
2018,10,3,400,26,20,46,Wednesday
2018,10,3,300,22,26,48,Wednesday
2018,10,3,200,14,28,42,Wednesday
2018,10,3,100,6,46,52,Wednesday
2018,10,2,2400,21,117,138,Tuesday
2018,10,2,2300,37,87,124,Tuesday
2018,10,2,2200,23,66,89,Tuesday
2018,10,2,2100,79,137,216,Tuesday
2018,10,2,2000,148,202,350,Tuesday
2018,10,2,1900,82,309,391,Tuesday
2018,10,2,1800,128,383,511,Tuesday
2018,10,2,1700,104,290,394,Tuesday
2018,10,2,1600,170,232,402,Tuesday
2018,10,2,1500,122,207,329,Tuesday
2018,10,2,1400,95,230,325,Tuesday
2018,10,2,1300,171,244,415,Tuesday
2018,10,2,1200,281,220,501,Tuesday
2018,10,2,1100,275,192,467,Tuesday
2018,10,2,1000,273,171,444,Tuesday
2018,10,2,900,202,119,321,Tuesday
2018,10,2,800,99,55,154,Tuesday
2018,10,2,700,62,50,112,Tuesday
2018,10,2,600,29,41,70,Tuesday
2018,10,2,500,17,32,49,Tuesday
2018,10,2,400,14,32,46,Tuesday
2018,10,2,300,15,24,39,Tuesday
2018,10,2,200,16,62,78,Tuesday
2018,10,2,100,33,81,114,Tuesday
2018,10,1,2400,39,105,144,Monday
2018,10,1,2300,53,154,207,Monday
2018,10,1,2200,72,105,177,Monday
2018,10,1,2100,118,196,314,Monday
2018,10,1,2000,144,262,406,Monday
2018,10,1,1900,146,439,585,Monday
2018,10,1,1800,209,733,942,Monday
2018,10,1,1700,285,546,831,Monday
2018,10,1,1600,337,602,939,Monday
2018,10,1,1500,390,571,961,Monday
2018,10,1,1400,385,484,869,Monday
2018,10,1,1300,490,472,962,Monday
2018,10,1,1200,585,342,927,Monday
2018,10,1,1100,651,228,879,Monday
2018,10,1,1000,570,163,733,Monday
2018,10,1,900,403,116,519,Monday
2018,10,1,800,263,45,308,Monday
2018,10,1,700,114,42,156,Monday
2018,10,1,600,51,31,82,Monday
2018,10,1,500,24,24,48,Monday
2018,10,1,400,18,35,53,Monday
2018,10,1,300,20,41,61,Monday
2018,10,1,200,21,50,71,Monday
2018,10,1,100,32,53,85,Monday
2018,9,30,2400,45,72,117,Sunday
2018,9,30,2300,57,128,185,Sunday
2018,9,30,2200,81,224,305,Sunday
2018,9,30,2100,102,446,548,Sunday
2018,9,30,2000,137,635,772,Sunday
2018,9,30,1900,188,862,1050,Sunday
2018,9,30,1800,268,1163,1431,Sunday
2018,9,30,1700,342,1203,1545,Sunday
2018,9,30,1600,424,987,1411,Sunday
2018,9,30,1500,506,1005,1511,Sunday
2018,9,30,1400,500,762,1262,Sunday
2018,9,30,1300,587,676,1263,Sunday
2018,9,30,1200,720,445,1165,Sunday
2018,9,30,1100,786,282,1068,Sunday
2018,9,30,1000,640,175,815,Sunday
2018,9,30,900,421,81,502,Sunday
2018,9,30,800,257,49,306,Sunday
2018,9,30,700,125,19,144,Sunday
2018,9,30,600,54,24,78,Sunday
2018,9,30,500,29,21,50,Sunday
2018,9,30,400,21,19,40,Sunday
2018,9,30,300,16,18,34,Sunday
2018,9,30,200,27,26,53,Sunday
2018,9,30,100,21,37,58,Sunday
2018,9,29,2400,41,65,106,Saturday
2018,9,29,2300,64,124,188,Saturday
2018,9,29,2200,83,161,244,Saturday
2018,9,29,2100,114,340,454,Saturday
2018,9,29,2000,133,511,644,Saturday
2018,9,29,1900,181,726,907,Saturday
2018,9,29,1800,236,887,1123,Saturday
2018,9,29,1700,279,846,1125,Saturday
2018,9,29,1600,349,682,1031,Saturday
2018,9,29,1500,477,630,1107,Saturday
2018,9,29,1400,561,541,1102,Saturday
2018,9,29,1300,708,427,1135,Saturday
2018,9,29,1200,820,334,1154,Saturday
2018,9,29,1100,887,248,1135,Saturday
2018,9,29,1000,768,194,962,Saturday
2018,9,29,900,538,119,657,Saturday
2018,9,29,800,358,66,424,Saturday
2018,9,29,700,236,50,286,Saturday
2018,9,29,600,72,33,105,Saturday
2018,9,29,500,37,23,60,Saturday
2018,9,29,400,25,23,48,Saturday
2018,9,29,300,35,28,63,Saturday
2018,9,29,200,28,56,84,Saturday
2018,9,29,100,43,56,99,Saturday
2018,9,28,2400,64,78,142,Friday
2018,9,28,2300,88,122,210,Friday
2018,9,28,2200,159,156,315,Friday
2018,9,28,2100,257,387,644,Friday
2018,9,28,2000,379,512,891,Friday
2018,9,28,1900,475,649,1124,Friday
2018,9,28,1800,525,898,1423,Friday
2018,9,28,1700,552,795,1347,Friday
2018,9,28,1600,587,814,1401,Friday
2018,9,28,1500,575,602,1177,Friday
2018,9,28,1400,569,500,1069,Friday
2018,9,28,1300,577,451,1028,Friday
2018,9,28,1200,764,326,1090,Friday
2018,9,28,1100,862,265,1127,Friday
2018,9,28,1000,719,196,915,Friday
2018,9,28,900,670,141,811,Friday
2018,9,28,800,387,101,488,Friday
2018,9,28,700,226,63,289,Friday
2018,9,28,600,104,37,141,Friday
2018,9,28,500,25,47,72,Friday
2018,9,28,400,34,35,69,Friday
2018,9,28,300,41,47,88,Friday
2018,9,28,200,45,52,97,Friday
2018,9,28,100,54,67,121,Friday
2018,9,27,2400,70,94,164,Thursday
2018,9,27,2300,97,141,238,Thursday
2018,9,27,2200,134,158,292,Thursday
2018,9,27,2100,178,499,677,Thursday
2018,9,27,2000,209,247,456,Thursday
2018,9,27,1900,301,527,828,Thursday
2018,9,27,1800,366,650,1016,Thursday
2018,9,27,1700,370,614,984,Thursday
2018,9,27,1600,403,625,1028,Thursday
2018,9,27,1500,422,407,829,Thursday
2018,9,27,1400,462,417,879,Thursday
2018,9,27,1300,489,377,866,Thursday
2018,9,27,1200,593,336,929,Thursday
2018,9,27,1100,684,289,973,Thursday
2018,9,27,1000,613,164,777,Thursday
2018,9,27,900,481,110,591,Thursday
2018,9,27,800,313,91,404,Thursday
2018,9,27,700,138,73,211,Thursday
2018,9,27,600,83,40,123,Thursday
2018,9,27,500,26,34,60,Thursday
2018,9,27,400,35,36,71,Thursday
2018,9,27,300,44,49,93,Thursday
2018,9,27,200,31,39,70,Thursday
2018,9,27,100,42,74,116,Thursday
2018,9,26,2400,66,97,163,Wednesday
2018,9,26,2300,92,81,173,Wednesday
2018,9,26,2200,122,173,295,Wednesday
2018,9,26,2100,160,313,473,Wednesday
2018,9,26,2000,192,472,664,Wednesday
2018,9,26,1900,210,671,881,Wednesday
2018,9,26,1800,269,717,986,Wednesday
2018,9,26,1700,322,712,1034,Wednesday
2018,9,26,1600,349,688,1037,Wednesday
2018,9,26,1500,363,500,863,Wednesday
2018,9,26,1400,446,470,916,Wednesday
2018,9,26,1300,505,363,868,Wednesday
2018,9,26,1200,639,314,953,Wednesday
2018,9,26,1100,697,250,947,Wednesday
2018,9,26,1000,737,193,930,Wednesday
2018,9,26,900,507,129,636,Wednesday
2018,9,26,800,366,107,473,Wednesday
2018,9,26,700,182,62,244,Wednesday
2018,9,26,600,77,44,121,Wednesday
2018,9,26,500,32,38,70,Wednesday
2018,9,26,400,33,41,74,Wednesday
2018,9,26,300,34,43,77,Wednesday
2018,9,26,200,24,32,56,Wednesday
2018,9,26,100,45,78,123,Wednesday
2018,9,25,2400,59,77,136,Tuesday
2018,9,25,2300,84,91,175,Tuesday
2018,9,25,2200,114,174,288,Tuesday
2018,9,25,2100,161,336,497,Tuesday
2018,9,25,2000,148,503,651,Tuesday
2018,9,25,1900,173,790,963,Tuesday
2018,9,25,1800,255,923,1178,Tuesday
2018,9,25,1700,350,842,1192,Tuesday
2018,9,25,1600,342,670,1012,Tuesday
2018,9,25,1500,405,598,1003,Tuesday
2018,9,25,1400,447,446,893,Tuesday
2018,9,25,1300,540,413,953,Tuesday
2018,9,25,1200,707,311,1018,Tuesday
2018,9,25,1100,814,220,1034,Tuesday
2018,9,25,1000,800,219,1019,Tuesday
2018,9,25,900,618,118,736,Tuesday
2018,9,25,800,426,85,511,Tuesday
2018,9,25,700,201,55,256,Tuesday
2018,9,25,600,85,42,127,Tuesday
2018,9,25,500,37,40,77,Tuesday
2018,9,25,400,27,36,63,Tuesday
2018,9,25,300,22,48,70,Tuesday
2018,9,25,200,36,42,78,Tuesday
2018,9,25,100,36,58,94,Tuesday
2018,9,24,2400,55,83,138,Monday
2018,9,24,2300,70,113,183,Monday
2018,9,24,2200,98,192,290,Monday
2018,9,24,2100,151,331,482,Monday
2018,9,24,2000,163,508,671,Monday
2018,9,24,1900,205,750,955,Monday
2018,9,24,1800,227,818,1045,Monday
2018,9,24,1700,326,853,1179,Monday
2018,9,24,1600,367,712,1079,Monday
2018,9,24,1500,469,593,1062,Monday
2018,9,24,1400,460,485,945,Monday
2018,9,24,1300,572,384,956,Monday
2018,9,24,1200,720,370,1090,Monday
2018,9,24,1100,823,240,1063,Monday
2018,9,24,1000,740,163,903,Monday
2018,9,24,900,485,113,598,Monday
2018,9,24,800,346,84,430,Monday
2018,9,24,700,167,49,216,Monday
2018,9,24,600,58,32,90,Monday
2018,9,24,500,27,17,44,Monday
2018,9,24,400,45,31,76,Monday
2018,9,24,300,23,37,60,Monday
2018,9,24,200,37,47,84,Monday
2018,9,24,100,30,62,92,Monday
2018,9,23,2400,42,105,147,Sunday
2018,9,23,2300,60,117,177,Sunday
2018,9,23,2200,82,255,337,Sunday
2018,9,23,2100,130,533,663,Sunday
2018,9,23,2000,163,821,984,Sunday
2018,9,23,1900,213,915,1128,Sunday
2018,9,23,1800,279,1224,1503,Sunday
2018,9,23,1700,378,1286,1664,Sunday
2018,9,23,1600,446,1158,1604,Sunday
2018,9,23,1500,506,1007,1513,Sunday
2018,9,23,1400,582,801,1383,Sunday
2018,9,23,1300,698,652,1350,Sunday
2018,9,23,1200,853,566,1419,Sunday
2018,9,23,1100,878,318,1196,Sunday
2018,9,23,1000,841,198,1039,Sunday
2018,9,23,900,532,103,635,Sunday
2018,9,23,800,314,37,351,Sunday
2018,9,23,700,150,24,174,Sunday
2018,9,23,600,63,22,85,Sunday
2018,9,23,500,20,13,33,Sunday
2018,9,23,400,12,16,28,Sunday
2018,9,23,300,17,31,48,Sunday
2018,9,23,200,22,33,55,Sunday
2018,9,23,100,34,49,83,Sunday
2018,9,22,2400,29,62,91,Saturday
2018,9,22,2300,65,89,154,Saturday
2018,9,22,2200,83,159,242,Saturday
2018,9,22,2100,108,242,350,Saturday
2018,9,22,2000,148,392,540,Saturday
2018,9,22,1900,175,586,761,Saturday
2018,9,22,1800,245,685,930,Saturday
2018,9,22,1700,322,727,1049,Saturday
2018,9,22,1600,383,648,1031,Saturday
2018,9,22,1500,501,572,1073,Saturday
2018,9,22,1400,452,521,973,Saturday
2018,9,22,1300,600,426,1026,Saturday
2018,9,22,1200,713,370,1083,Saturday
2018,9,22,1100,708,310,1018,Saturday
2018,9,22,1000,660,187,847,Saturday
2018,9,22,900,463,113,576,Saturday
2018,9,22,800,243,50,293,Saturday
2018,9,22,700,160,42,202,Saturday
2018,9,22,600,59,28,87,Saturday
2018,9,22,500,32,41,73,Saturday
2018,9,22,400,27,26,53,Saturday
2018,9,22,300,31,71,102,Saturday
2018,9,22,200,29,65,94,Saturday
2018,9,22,100,46,16,62,Saturday
2018,9,21,2400,54,25,79,Friday
2018,9,21,2300,84,77,161,Friday
2018,9,21,2200,187,147,334,Friday
2018,9,21,2100,255,263,518,Friday
2018,9,21,2000,374,365,739,Friday
2018,9,21,1900,471,613,1084,Friday
2018,9,21,1800,526,700,1226,Friday
2018,9,21,1700,609,771,1380,Friday
2018,9,21,1600,601,750,1351,Friday
2018,9,21,1500,643,682,1325,Friday
2018,9,21,1400,556,473,1029,Friday
2018,9,21,1300,686,476,1162,Friday
2018,9,21,1200,799,413,1212,Friday
2018,9,21,1100,826,322,1148,Friday
2018,9,21,1000,721,195,916,Friday
2018,9,21,900,511,128,639,Friday
2018,9,21,800,304,104,408,Friday
2018,9,21,700,154,59,213,Friday
2018,9,21,600,77,40,117,Friday
2018,9,21,500,31,31,62,Friday
2018,9,21,400,29,39,68,Friday
2018,9,21,300,27,44,71,Friday
2018,9,21,200,44,43,87,Friday
2018,9,21,100,49,74,123,Friday
2018,9,20,2400,78,88,166,Thursday
2018,9,20,2300,122,108,230,Thursday
2018,9,20,2200,148,216,364,Thursday
2018,9,20,2100,185,260,445,Thursday
2018,9,20,2000,268,448,716,Thursday
2018,9,20,1900,305,617,922,Thursday
2018,9,20,1800,381,716,1097,Thursday
2018,9,20,1700,397,720,1117,Thursday
2018,9,20,1600,411,776,1187,Thursday
2018,9,20,1500,491,705,1196,Thursday
2018,9,20,1400,535,463,998,Thursday
2018,9,20,1300,517,289,806,Thursday
2018,9,20,1200,677,297,974,Thursday
2018,9,20,1100,750,291,1041,Thursday
2018,9,20,1000,755,201,956,Thursday
2018,9,20,900,589,111,700,Thursday
2018,9,20,800,303,82,385,Thursday
2018,9,20,700,170,58,228,Thursday
2018,9,20,600,76,45,121,Thursday
2018,9,20,500,33,33,66,Thursday
2018,9,20,400,37,42,79,Thursday
2018,9,20,300,30,28,58,Thursday
2018,9,20,200,29,50,79,Thursday
2018,9,20,100,47,73,120,Thursday
2018,9,19,2400,78,97,175,Wednesday
2018,9,19,2300,79,118,197,Wednesday
2018,9,19,2200,127,243,370,Wednesday
2018,9,19,2100,166,424,590,Wednesday
2018,9,19,2000,190,643,833,Wednesday
2018,9,19,1900,241,779,1020,Wednesday
2018,9,19,1800,284,904,1188,Wednesday
2018,9,19,1700,363,723,1086,Wednesday
2018,9,19,1600,406,626,1032,Wednesday
2018,9,19,1500,430,522,952,Wednesday
2018,9,19,1400,486,442,928,Wednesday
2018,9,19,1300,565,377,942,Wednesday
2018,9,19,1200,704,335,1039,Wednesday
2018,9,19,1100,844,255,1099,Wednesday
2018,9,19,1000,744,157,901,Wednesday
2018,9,19,900,582,126,708,Wednesday
2018,9,19,800,392,92,484,Wednesday
2018,9,19,700,211,55,266,Wednesday
2018,9,19,600,76,45,121,Wednesday
2018,9,19,500,38,32,70,Wednesday
2018,9,19,400,30,28,58,Wednesday
2018,9,19,300,26,31,57,Wednesday
2018,9,19,200,32,41,73,Wednesday
2018,9,19,100,44,68,112,Wednesday
2018,9,18,2400,61,102,163,Tuesday
2018,9,18,2300,89,105,194,Tuesday
2018,9,18,2200,119,226,345,Tuesday
2018,9,18,2100,138,328,466,Tuesday
2018,9,18,2000,132,488,620,Tuesday
2018,9,18,1900,172,650,822,Tuesday
2018,9,18,1800,278,828,1106,Tuesday
2018,9,18,1700,294,844,1138,Tuesday
2018,9,18,1600,336,674,1010,Tuesday
2018,9,18,1500,405,513,918,Tuesday
2018,9,18,1400,414,440,854,Tuesday
2018,9,18,1300,576,361,937,Tuesday
2018,9,18,1200,687,338,1025,Tuesday
2018,9,18,1100,816,247,1063,Tuesday
2018,9,18,1000,688,186,874,Tuesday
2018,9,18,900,556,116,672,Tuesday
2018,9,18,800,395,80,475,Tuesday
2018,9,18,700,184,47,231,Tuesday
2018,9,18,600,89,48,137,Tuesday
2018,9,18,500,34,45,79,Tuesday
2018,9,18,400,32,35,67,Tuesday
2018,9,18,300,27,39,66,Tuesday
2018,9,18,200,26,48,74,Tuesday
2018,9,18,100,37,59,96,Tuesday
2018,9,17,2400,55,104,159,Monday
2018,9,17,2300,76,92,168,Monday
2018,9,17,2200,106,225,331,Monday
2018,9,17,2100,123,422,545,Monday
2018,9,17,2000,179,495,674,Monday
2018,9,17,1900,239,718,957,Monday
2018,9,17,1800,280,992,1272,Monday
2018,9,17,1700,350,816,1166,Monday
2018,9,17,1600,430,719,1149,Monday
2018,9,17,1500,502,691,1193,Monday
2018,9,17,1400,544,492,1036,Monday
2018,9,17,1300,611,484,1095,Monday
2018,9,17,1200,821,381,1202,Monday
2018,9,17,1100,939,268,1207,Monday
2018,9,17,1000,795,185,980,Monday
2018,9,17,900,592,132,724,Monday
2018,9,17,800,327,70,397,Monday
2018,9,17,700,176,41,217,Monday
2018,9,17,600,78,27,105,Monday
2018,9,17,500,30,13,43,Monday
2018,9,17,400,21,34,55,Monday
2018,9,17,300,28,43,71,Monday
2018,9,17,200,24,28,52,Monday
2018,9,17,100,26,67,93,Monday
2018,9,16,2400,36,104,140,Sunday
2018,9,16,2300,55,142,197,Sunday
2018,9,16,2200,97,221,318,Sunday
2018,9,16,2100,137,348,485,Sunday
2018,9,16,2000,159,627,786,Sunday
2018,9,16,1900,216,806,1022,Sunday
2018,9,16,1800,281,1057,1338,Sunday
2018,9,16,1700,360,1146,1506,Sunday
2018,9,16,1600,433,1065,1498,Sunday
2018,9,16,1500,496,1024,1520,Sunday
2018,9,16,1400,550,965,1515,Sunday
2018,9,16,1300,595,807,1402,Sunday
2018,9,16,1200,765,680,1445,Sunday
2018,9,16,1100,748,480,1228,Sunday
2018,9,16,1000,661,239,900,Sunday
2018,9,16,900,461,109,570,Sunday
2018,9,16,800,210,36,246,Sunday
2018,9,16,700,110,32,142,Sunday
2018,9,16,600,68,30,98,Sunday
2018,9,16,500,10,13,23,Sunday
2018,9,16,400,21,19,40,Sunday
2018,9,16,300,15,16,31,Sunday
2018,9,16,200,18,35,53,Sunday
2018,9,16,100,17,53,70,Sunday
2018,9,15,2400,34,45,79,Saturday
2018,9,15,2300,50,85,135,Saturday
2018,9,15,2200,97,149,246,Saturday
2018,9,15,2100,117,257,374,Saturday
2018,9,15,2000,138,462,600,Saturday
2018,9,15,1900,183,745,928,Saturday
2018,9,15,1800,205,843,1048,Saturday
2018,9,15,1700,289,877,1166,Saturday
2018,9,15,1600,366,727,1093,Saturday
2018,9,15,1500,450,595,1045,Saturday
2018,9,15,1400,503,589,1092,Saturday
2018,9,15,1300,675,506,1181,Saturday
2018,9,15,1200,844,411,1255,Saturday
2018,9,15,1100,909,337,1246,Saturday
2018,9,15,1000,791,219,1010,Saturday
2018,9,15,900,582,116,698,Saturday
2018,9,15,800,323,53,376,Saturday
2018,9,15,700,178,28,206,Saturday
2018,9,15,600,61,29,90,Saturday
2018,9,15,500,33,34,67,Saturday
2018,9,15,400,31,23,54,Saturday
2018,9,15,300,14,30,44,Saturday
2018,9,15,200,23,42,65,Saturday
2018,9,15,100,32,58,90,Saturday
2018,9,14,2400,66,76,142,Friday
2018,9,14,2300,81,109,190,Friday
2018,9,14,2200,153,152,305,Friday
2018,9,14,2100,269,285,554,Friday
2018,9,14,2000,408,450,858,Friday
2018,9,14,1900,524,572,1096,Friday
2018,9,14,1800,581,854,1435,Friday
2018,9,14,1700,635,964,1599,Friday
2018,9,14,1600,683,749,1432,Friday
2018,9,14,1500,713,664,1377,Friday
2018,9,14,1400,664,608,1272,Friday
2018,9,14,1300,760,362,1122,Friday
2018,9,14,1200,910,310,1220,Friday
2018,9,14,1100,897,226,1123,Friday
2018,9,14,1000,845,177,1022,Friday
2018,9,14,900,652,97,749,Friday
2018,9,14,800,304,80,384,Friday
2018,9,14,700,187,49,236,Friday
2018,9,14,600,69,39,108,Friday
2018,9,14,500,33,37,70,Friday
2018,9,14,400,38,35,73,Friday
2018,9,14,300,30,53,83,Friday
2018,9,14,200,33,60,93,Friday
2018,9,14,100,53,62,115,Friday
2018,9,13,2400,76,65,141,Thursday
2018,9,13,2300,97,97,194,Thursday
2018,9,13,2200,144,168,312,Thursday
2018,9,13,2100,198,257,455,Thursday
2018,9,13,2000,243,342,585,Thursday
2018,9,13,1900,278,490,768,Thursday
2018,9,13,1800,361,642,1003,Thursday
2018,9,13,1700,469,716,1185,Thursday
2018,9,13,1600,464,678,1142,Thursday
2018,9,13,1500,535,726,1261,Thursday
2018,9,13,1400,507,478,985,Thursday
2018,9,13,1300,571,571,1142,Thursday
2018,9,13,1200,716,510,1226,Thursday
2018,9,13,1100,750,395,1145,Thursday
2018,9,13,1000,706,217,923,Thursday
2018,9,13,900,552,153,705,Thursday
2018,9,13,800,301,99,400,Thursday
2018,9,13,700,147,47,194,Thursday
2018,9,13,600,67,36,103,Thursday
2018,9,13,500,33,31,64,Thursday
2018,9,13,400,36,33,69,Thursday
2018,9,13,300,49,48,97,Thursday
2018,9,13,200,71,41,112,Thursday
2018,9,13,100,23,80,103,Thursday
2018,9,12,2400,61,68,129,Wednesday
2018,9,12,2300,97,109,206,Wednesday
2018,9,12,2200,90,184,274,Wednesday
2018,9,12,2100,146,290,436,Wednesday
2018,9,12,2000,212,402,614,Wednesday
2018,9,12,1900,216,612,828,Wednesday
2018,9,12,1800,308,748,1056,Wednesday
2018,9,12,1700,356,855,1211,Wednesday
2018,9,12,1600,361,726,1087,Wednesday
2018,9,12,1500,427,578,1005,Wednesday
2018,9,12,1400,428,526,954,Wednesday
2018,9,12,1300,513,496,1009,Wednesday
2018,9,12,1200,647,400,1047,Wednesday
2018,9,12,1100,766,404,1170,Wednesday
2018,9,12,1000,672,193,865,Wednesday
2018,9,12,900,592,96,688,Wednesday
2018,9,12,800,343,62,405,Wednesday
2018,9,12,700,204,39,243,Wednesday
2018,9,12,600,84,17,101,Wednesday
2018,9,12,500,31,12,43,Wednesday
2018,9,12,400,39,9,48,Wednesday
2018,9,12,300,31,11,42,Wednesday
2018,9,12,200,28,22,50,Wednesday
2018,9,12,100,51,51,102,Wednesday
2018,9,11,2400,52,98,150,Tuesday
2018,9,11,2300,92,127,219,Tuesday
2018,9,11,2200,121,215,336,Tuesday
2018,9,11,2100,153,380,533,Tuesday
2018,9,11,2000,188,472,660,Tuesday
2018,9,11,1900,221,754,975,Tuesday
2018,9,11,1800,280,790,1070,Tuesday
2018,9,11,1700,395,886,1281,Tuesday
2018,9,11,1600,433,709,1142,Tuesday
2018,9,11,1500,437,618,1055,Tuesday
2018,9,11,1400,467,509,976,Tuesday
2018,9,11,1300,548,430,978,Tuesday
2018,9,11,1200,690,408,1098,Tuesday
2018,9,11,1100,798,269,1067,Tuesday
2018,9,11,1000,837,209,1046,Tuesday
2018,9,11,900,666,146,812,Tuesday
2018,9,11,800,377,89,466,Tuesday
2018,9,11,700,170,60,230,Tuesday
2018,9,11,600,86,58,144,Tuesday
2018,9,11,500,29,49,78,Tuesday
2018,9,11,400,27,44,71,Tuesday
2018,9,11,300,27,37,64,Tuesday
2018,9,11,200,25,58,83,Tuesday
2018,9,11,100,32,61,93,Tuesday
2018,9,10,2400,68,81,149,Monday
2018,9,10,2300,77,128,205,Monday
2018,9,10,2200,120,228,348,Monday
2018,9,10,2100,139,336,475,Monday
2018,9,10,2000,182,495,677,Monday
2018,9,10,1900,229,957,1186,Monday
2018,9,10,1800,273,1178,1451,Monday
2018,9,10,1700,335,800,1135,Monday
2018,9,10,1600,396,536,932,Monday
2018,9,10,1500,433,564,997,Monday
2018,9,10,1400,548,508,1056,Monday
2018,9,10,1300,601,497,1098,Monday
2018,9,10,1200,788,415,1203,Monday
2018,9,10,1100,921,305,1226,Monday
2018,9,10,1000,824,212,1036,Monday
2018,9,10,900,623,135,758,Monday
2018,9,10,800,359,75,434,Monday
2018,9,10,700,176,31,207,Monday
2018,9,10,600,79,22,101,Monday
2018,9,10,500,30,24,54,Monday
2018,9,10,400,27,30,57,Monday
2018,9,10,300,22,35,57,Monday
2018,9,10,200,23,42,65,Monday
2018,9,10,100,28,86,114,Monday
2018,9,9,2400,45,139,184,Sunday
2018,9,9,2300,65,240,305,Sunday
2018,9,9,2200,103,314,417,Sunday
2018,9,9,2100,147,547,694,Sunday
2018,9,9,2000,169,831,1000,Sunday
2018,9,9,1900,236,1049,1285,Sunday
2018,9,9,1800,373,1332,1705,Sunday
2018,9,9,1700,374,1317,1691,Sunday
2018,9,9,1600,478,1262,1740,Sunday
2018,9,9,1500,556,981,1537,Sunday
2018,9,9,1400,629,930,1559,Sunday
2018,9,9,1300,731,757,1488,Sunday
2018,9,9,1200,848,594,1442,Sunday
2018,9,9,1100,918,361,1279,Sunday
2018,9,9,1000,814,231,1045,Sunday
2018,9,9,900,668,125,793,Sunday
2018,9,9,800,380,61,441,Sunday
2018,9,9,700,197,35,232,Sunday
2018,9,9,600,120,19,139,Sunday
2018,9,9,500,32,11,43,Sunday
2018,9,9,400,25,26,51,Sunday
2018,9,9,300,20,30,50,Sunday
2018,9,9,200,27,32,59,Sunday
2018,9,9,100,32,60,92,Sunday
2018,9,8,2400,51,84,135,Saturday
2018,9,8,2300,75,143,218,Saturday
2018,9,8,2200,106,300,406,Saturday
2018,9,8,2100,157,513,670,Saturday
2018,9,8,2000,180,740,920,Saturday
2018,9,8,1900,219,942,1161,Saturday
2018,9,8,1800,294,1039,1333,Saturday
2018,9,8,1700,365,1020,1385,Saturday
2018,9,8,1600,454,987,1441,Saturday
2018,9,8,1500,521,549,1070,Saturday
2018,9,8,1400,685,558,1243,Saturday
2018,9,8,1300,803,496,1299,Saturday
2018,9,8,1200,957,459,1416,Saturday
2018,9,8,1100,997,350,1347,Saturday
2018,9,8,1000,903,253,1156,Saturday
2018,9,8,900,747,162,909,Saturday
2018,9,8,800,433,62,495,Saturday
2018,9,8,700,243,45,288,Saturday
2018,9,8,600,112,41,153,Saturday
2018,9,8,500,29,28,57,Saturday
2018,9,8,400,31,40,71,Saturday
2018,9,8,300,23,27,50,Saturday
2018,9,8,200,34,54,88,Saturday
2018,9,8,100,53,80,133,Saturday
2018,9,7,2400,97,116,213,Friday
2018,9,7,2300,121,165,286,Friday
2018,9,7,2200,156,247,403,Friday
2018,9,7,2100,284,393,677,Friday
2018,9,7,2000,473,666,1139,Friday
2018,9,7,1900,545,766,1311,Friday
2018,9,7,1800,598,987,1585,Friday
2018,9,7,1700,678,923,1601,Friday
2018,9,7,1600,656,875,1531,Friday
2018,9,7,1500,689,685,1374,Friday
2018,9,7,1400,684,566,1250,Friday
2018,9,7,1300,710,597,1307,Friday
2018,9,7,1200,896,363,1259,Friday
2018,9,7,1100,964,325,1289,Friday
2018,9,7,1000,841,222,1063,Friday
2018,9,7,900,713,134,847,Friday
2018,9,7,800,414,80,494,Friday
2018,9,7,700,258,59,317,Friday
2018,9,7,600,131,47,178,Friday
2018,9,7,500,47,43,90,Friday
2018,9,7,400,34,50,84,Friday
2018,9,7,300,36,51,87,Friday
2018,9,7,200,32,65,97,Friday
2018,9,7,100,57,87,144,Friday
2018,9,6,2400,93,99,192,Thursday
2018,9,6,2300,120,142,262,Thursday
2018,9,6,2200,157,273,430,Thursday
2018,9,6,2100,236,402,638,Thursday
2018,9,6,2000,265,601,866,Thursday
2018,9,6,1900,339,699,1038,Thursday
2018,9,6,1800,404,876,1280,Thursday
2018,9,6,1700,475,916,1391,Thursday
2018,9,6,1600,482,727,1209,Thursday
2018,9,6,1500,499,588,1087,Thursday
2018,9,6,1400,540,403,943,Thursday
2018,9,6,1300,593,393,986,Thursday
2018,9,6,1200,801,345,1146,Thursday
2018,9,6,1100,903,304,1207,Thursday
2018,9,6,1000,813,228,1041,Thursday
2018,9,6,900,639,143,782,Thursday
2018,9,6,800,404,96,500,Thursday
2018,9,6,700,233,68,301,Thursday
2018,9,6,600,108,45,153,Thursday
2018,9,6,500,39,45,84,Thursday
2018,9,6,400,26,34,60,Thursday
2018,9,6,300,39,45,84,Thursday
2018,9,6,200,24,69,93,Thursday
2018,9,6,100,39,85,124,Thursday
2018,9,5,2400,66,125,191,Wednesday
2018,9,5,2300,107,140,247,Wednesday
2018,9,5,2200,141,275,416,Wednesday
2018,9,5,2100,158,416,574,Wednesday
2018,9,5,2000,187,600,787,Wednesday
2018,9,5,1900,241,780,1021,Wednesday
2018,9,5,1800,320,976,1296,Wednesday
2018,9,5,1700,386,843,1229,Wednesday
2018,9,5,1600,400,793,1193,Wednesday
2018,9,5,1500,434,598,1032,Wednesday
2018,9,5,1400,509,433,942,Wednesday
2018,9,5,1300,563,423,986,Wednesday
2018,9,5,1200,788,354,1142,Wednesday
2018,9,5,1100,823,271,1094,Wednesday
2018,9,5,1000,715,235,950,Wednesday
2018,9,5,900,583,155,738,Wednesday
2018,9,5,800,413,90,503,Wednesday
2018,9,5,700,206,65,271,Wednesday
2018,9,5,600,109,51,160,Wednesday
2018,9,5,500,41,39,80,Wednesday
2018,9,5,400,29,51,80,Wednesday
2018,9,5,300,35,44,79,Wednesday
2018,9,5,200,30,56,86,Wednesday
2018,9,5,100,44,99,143,Wednesday
2018,9,4,2400,61,84,145,Tuesday
2018,9,4,2300,104,190,294,Tuesday
2018,9,4,2200,114,319,433,Tuesday
2018,9,4,2100,152,496,648,Tuesday
2018,9,4,2000,188,758,946,Tuesday
2018,9,4,1900,262,853,1115,Tuesday
2018,9,4,1800,289,1026,1315,Tuesday
2018,9,4,1700,353,1030,1383,Tuesday
2018,9,4,1600,436,865,1301,Tuesday
2018,9,4,1500,477,685,1162,Tuesday
2018,9,4,1400,572,557,1129,Tuesday
2018,9,4,1300,657,538,1195,Tuesday
2018,9,4,1200,802,431,1233,Tuesday
2018,9,4,1100,883,364,1247,Tuesday
2018,9,4,1000,803,229,1032,Tuesday
2018,9,4,900,638,177,815,Tuesday
2018,9,4,800,419,110,529,Tuesday
2018,9,4,700,222,76,298,Tuesday
2018,9,4,600,110,31,141,Tuesday
2018,9,4,500,40,24,64,Tuesday
2018,9,4,400,23,37,60,Tuesday
2018,9,4,300,26,40,66,Tuesday
2018,9,4,200,18,63,81,Tuesday
2018,9,4,100,23,114,137,Tuesday
2018,9,3,2400,43,167,210,Monday
2018,9,3,2300,80,302,382,Monday
2018,9,3,2200,113,552,665,Monday
2018,9,3,2100,157,845,1002,Monday
2018,9,3,2000,199,1227,1426,Monday
2018,9,3,1900,243,1574,1817,Monday
2018,9,3,1800,319,1593,1912,Monday
2018,9,3,1700,448,1783,2231,Monday
2018,9,3,1600,492,1781,2273,Monday
2018,9,3,1500,613,1662,2275,Monday
2018,9,3,1400,690,1684,2374,Monday
2018,9,3,1300,835,1561,2396,Monday
2018,9,3,1200,949,1303,2252,Monday
2018,9,3,1100,862,745,1607,Monday
2018,9,3,1000,767,381,1148,Monday
2018,9,3,900,598,219,817,Monday
2018,9,3,800,386,96,482,Monday
2018,9,3,700,187,44,231,Monday
2018,9,3,600,93,30,123,Monday
2018,9,3,500,46,34,80,Monday
2018,9,3,400,14,39,53,Monday
2018,9,3,300,18,49,67,Monday
2018,9,3,200,25,61,86,Monday
2018,9,3,100,30,108,138,Monday
2018,9,2,2400,52,192,244,Sunday
2018,9,2,2300,73,349,422,Sunday
2018,9,2,2200,113,668,781,Sunday
2018,9,2,2100,168,990,1158,Sunday
2018,9,2,2000,228,1329,1557,Sunday
2018,9,2,1900,294,1626,1920,Sunday
2018,9,2,1800,398,1708,2106,Sunday
2018,9,2,1700,539,1712,2251,Sunday
2018,9,2,1600,584,1498,2082,Sunday
2018,9,2,1500,769,1273,2042,Sunday
2018,9,2,1400,940,1071,2011,Sunday
2018,9,2,1300,1106,865,1971,Sunday
2018,9,2,1200,1275,608,1883,Sunday
2018,9,2,1100,1190,390,1580,Sunday
2018,9,2,1000,1100,227,1327,Sunday
2018,9,2,900,846,144,990,Sunday
2018,9,2,800,558,72,630,Sunday
2018,9,2,700,316,43,359,Sunday
2018,9,2,600,182,24,206,Sunday
2018,9,2,500,70,23,93,Sunday
2018,9,2,400,23,67,90,Sunday
2018,9,2,300,20,41,61,Sunday
2018,9,2,200,23,23,46,Sunday
2018,9,2,100,39,73,112,Sunday
2018,9,1,2400,68,107,175,Saturday
2018,9,1,2300,106,182,288,Saturday
2018,9,1,2200,154,414,568,Saturday
2018,9,1,2100,186,761,947,Saturday
2018,9,1,2000,250,997,1247,Saturday
2018,9,1,1900,333,1450,1783,Saturday
2018,9,1,1800,461,1340,1801,Saturday
2018,9,1,1700,584,1200,1784,Saturday
2018,9,1,1600,782,1190,1972,Saturday
2018,9,1,1500,911,896,1807,Saturday
2018,9,1,1400,1082,766,1848,Saturday
2018,9,1,1300,1204,671,1875,Saturday
2018,9,1,1200,1580,522,2102,Saturday
2018,9,1,1100,1483,406,1889,Saturday
2018,9,1,1000,1441,279,1720,Saturday
2018,9,1,900,1137,182,1319,Saturday
2018,9,1,800,691,106,797,Saturday
2018,9,1,700,407,65,472,Saturday
2018,9,1,600,208,45,253,Saturday
2018,9,1,500,82,45,127,Saturday
2018,9,1,400,36,37,73,Saturday
2018,9,1,300,30,102,132,Saturday
2018,9,1,200,56,96,152,Saturday
2018,9,1,100,109,119,228,Saturday
2018,8,31,2400,141,161,302,Friday
2018,8,31,2300,228,215,443,Friday
2018,8,31,2200,376,348,724,Friday
2018,8,31,2100,616,563,1179,Friday
2018,8,31,2000,935,714,1649,Friday
2018,8,31,1900,1061,858,1919,Friday
2018,8,31,1800,1121,1127,2248,Friday
2018,8,31,1700,1140,1035,2175,Friday
2018,8,31,1600,1180,1060,2240,Friday
2018,8,31,1500,1269,873,2142,Friday
2018,8,31,1400,1173,678,1851,Friday
2018,8,31,1300,1197,641,1838,Friday
2018,8,31,1200,1301,488,1789,Friday
2018,8,31,1100,1369,399,1768,Friday
2018,8,31,1000,1223,251,1474,Friday
2018,8,31,900,1055,153,1208,Friday
2018,8,31,800,656,96,752,Friday
2018,8,31,700,327,64,391,Friday
2018,8,31,600,225,47,272,Friday
2018,8,31,500,65,50,115,Friday
2018,8,31,400,45,61,106,Friday
2018,8,31,300,48,78,126,Friday
2018,8,31,200,54,79,133,Friday
2018,8,31,100,76,107,183,Friday
2018,8,30,2400,118,119,237,Thursday
2018,8,30,2300,177,185,362,Thursday
2018,8,30,2200,268,249,517,Thursday
2018,8,30,2100,357,355,712,Thursday
2018,8,30,2000,553,603,1156,Thursday
2018,8,30,1900,615,907,1522,Thursday
2018,8,30,1800,620,1026,1646,Thursday
2018,8,30,1700,689,1027,1716,Thursday
2018,8,30,1600,740,985,1725,Thursday
2018,8,30,1500,789,768,1557,Thursday
2018,8,30,1400,781,681,1462,Thursday
2018,8,30,1300,983,556,1539,Thursday
2018,8,30,1200,1059,418,1477,Thursday
2018,8,30,1100,1105,361,1466,Thursday
2018,8,30,1000,1002,208,1210,Thursday
2018,8,30,900,738,163,901,Thursday
2018,8,30,800,545,83,628,Thursday
2018,8,30,700,262,65,327,Thursday
2018,8,30,600,137,52,189,Thursday
2018,8,30,500,48,27,75,Thursday
2018,8,30,400,45,47,92,Thursday
2018,8,30,300,32,44,76,Thursday
2018,8,30,200,40,75,115,Thursday
2018,8,30,100,53,97,150,Thursday
2018,8,29,2400,110,93,203,Wednesday
2018,8,29,2300,125,158,283,Wednesday
2018,8,29,2200,171,253,424,Wednesday
2018,8,29,2100,235,437,672,Wednesday
2018,8,29,2000,268,659,927,Wednesday
2018,8,29,1900,337,826,1163,Wednesday
2018,8,29,1800,413,1061,1474,Wednesday
2018,8,29,1700,457,1111,1568,Wednesday
2018,8,29,1600,520,911,1431,Wednesday
2018,8,29,1500,591,793,1384,Wednesday
2018,8,29,1400,655,569,1224,Wednesday
2018,8,29,1300,746,506,1252,Wednesday
2018,8,29,1200,926,426,1352,Wednesday
2018,8,29,1100,952,350,1302,Wednesday
2018,8,29,1000,857,222,1079,Wednesday
2018,8,29,900,745,167,912,Wednesday
2018,8,29,800,429,113,542,Wednesday
2018,8,29,700,217,64,281,Wednesday
2018,8,29,600,112,38,150,Wednesday
2018,8,29,500,39,34,73,Wednesday
2018,8,29,400,33,48,81,Wednesday
2018,8,29,300,32,55,87,Wednesday
2018,8,29,200,41,62,103,Wednesday
2018,8,29,100,42,87,129,Wednesday
2018,8,28,2400,75,132,207,Tuesday
2018,8,28,2300,113,157,270,Tuesday
2018,8,28,2200,143,352,495,Tuesday
2018,8,28,2100,159,518,677,Tuesday
2018,8,28,2000,221,715,936,Tuesday
2018,8,28,1900,254,927,1181,Tuesday
2018,8,28,1800,314,1154,1468,Tuesday
2018,8,28,1700,411,1022,1433,Tuesday
2018,8,28,1600,504,927,1431,Tuesday
2018,8,28,1500,537,755,1292,Tuesday
2018,8,28,1400,611,624,1235,Tuesday
2018,8,28,1300,738,516,1254,Tuesday
2018,8,28,1200,901,425,1326,Tuesday
2018,8,28,1100,994,307,1301,Tuesday
2018,8,28,1000,868,232,1100,Tuesday
2018,8,28,900,675,157,832,Tuesday
2018,8,28,800,439,83,522,Tuesday
2018,8,28,700,211,57,268,Tuesday
2018,8,28,600,123,39,162,Tuesday
2018,8,28,500,45,37,82,Tuesday
2018,8,28,400,38,45,83,Tuesday
2018,8,28,300,21,41,62,Tuesday
2018,8,28,200,36,63,99,Tuesday
2018,8,28,100,37,103,140,Tuesday
2018,8,27,2400,76,118,194,Monday
2018,8,27,2300,109,237,346,Monday
2018,8,27,2200,160,410,570,Monday
2018,8,27,2100,174,633,807,Monday
2018,8,27,2000,238,848,1086,Monday
2018,8,27,1900,309,1360,1669,Monday
2018,8,27,1800,368,1135,1503,Monday
2018,8,27,1700,474,985,1459,Monday
2018,8,27,1600,512,929,1441,Monday
2018,8,27,1500,682,814,1496,Monday
2018,8,27,1400,709,609,1318,Monday
2018,8,27,1300,860,558,1418,Monday
2018,8,27,1200,1014,402,1416,Monday
2018,8,27,1100,945,324,1269,Monday
2018,8,27,1000,891,222,1113,Monday
2018,8,27,900,715,128,843,Monday
2018,8,27,800,451,83,534,Monday
2018,8,27,700,189,63,252,Monday
2018,8,27,600,113,29,142,Monday
2018,8,27,500,37,21,58,Monday
2018,8,27,400,17,45,62,Monday
2018,8,27,300,35,37,72,Monday
2018,8,27,200,36,72,108,Monday
2018,8,27,100,44,96,140,Monday
2018,8,26,2400,64,123,187,Sunday
2018,8,26,2300,90,229,319,Sunday
2018,8,26,2200,129,410,539,Sunday
2018,8,26,2100,162,696,858,Sunday
2018,8,26,2000,209,1031,1240,Sunday
2018,8,26,1900,288,1282,1570,Sunday
2018,8,26,1800,365,1565,1930,Sunday
2018,8,26,1700,496,1622,2118,Sunday
2018,8,26,1600,620,1579,2199,Sunday
2018,8,26,1500,671,1535,2206,Sunday
2018,8,26,1400,778,1042,1820,Sunday
2018,8,26,1300,897,876,1773,Sunday
2018,8,26,1200,987,656,1643,Sunday
2018,8,26,1100,904,434,1338,Sunday
2018,8,26,1000,815,239,1054,Sunday
2018,8,26,900,614,135,749,Sunday
2018,8,26,800,347,61,408,Sunday
2018,8,26,700,181,38,219,Sunday
2018,8,26,600,94,21,115,Sunday
2018,8,26,500,36,21,57,Sunday
2018,8,26,400,25,31,56,Sunday
2018,8,26,300,20,40,60,Sunday
2018,8,26,200,28,45,73,Sunday
2018,8,26,100,27,101,128,Sunday
2018,8,25,2400,43,107,150,Saturday
2018,8,25,2300,73,191,264,Saturday
2018,8,25,2200,124,365,489,Saturday
2018,8,25,2100,173,888,1061,Saturday
2018,8,25,2000,205,1274,1479,Saturday
2018,8,25,1900,275,1417,1692,Saturday
2018,8,25,1800,355,1482,1837,Saturday
2018,8,25,1700,436,1404,1840,Saturday
2018,8,25,1600,532,1024,1556,Saturday
2018,8,25,1500,726,1035,1761,Saturday
2018,8,25,1400,849,735,1584,Saturday
2018,8,25,1300,979,515,1494,Saturday
2018,8,25,1200,1084,415,1499,Saturday
2018,8,25,1100,1185,348,1533,Saturday
2018,8,25,1000,1096,257,1353,Saturday
2018,8,25,900,894,152,1046,Saturday
2018,8,25,800,550,76,626,Saturday
2018,8,25,700,296,52,348,Saturday
2018,8,25,600,157,36,193,Saturday
2018,8,25,500,72,32,104,Saturday
2018,8,25,400,40,49,89,Saturday
2018,8,25,300,32,101,133,Saturday
2018,8,25,200,35,252,287,Saturday
2018,8,25,100,63,266,329,Saturday
2018,8,24,2400,84,231,315,Friday
2018,8,24,2300,123,164,287,Friday
2018,8,24,2200,205,227,432,Friday
2018,8,24,2100,326,270,596,Friday
2018,8,24,2000,498,424,922,Friday
2018,8,24,1900,662,571,1233,Friday
2018,8,24,1800,655,929,1584,Friday
2018,8,24,1700,739,1023,1762,Friday
2018,8,24,1600,768,955,1723,Friday
2018,8,24,1500,813,903,1716,Friday
2018,8,24,1400,815,835,1650,Friday
2018,8,24,1300,921,711,1632,Friday
2018,8,24,1200,1041,537,1578,Friday
2018,8,24,1100,1117,396,1513,Friday
2018,8,24,1000,924,270,1194,Friday
2018,8,24,900,674,156,830,Friday
2018,8,24,800,449,121,570,Friday
2018,8,24,700,225,55,280,Friday
2018,8,24,600,126,45,171,Friday
2018,8,24,500,51,49,100,Friday
2018,8,24,400,46,34,80,Friday
2018,8,24,300,34,60,94,Friday
2018,8,24,200,46,78,124,Friday
2018,8,24,100,59,94,153,Friday
2018,8,23,2400,79,161,240,Thursday
2018,8,23,2300,126,205,331,Thursday
2018,8,23,2200,199,344,543,Thursday
2018,8,23,2100,263,613,876,Thursday
2018,8,23,2000,354,764,1118,Thursday
2018,8,23,1900,472,995,1467,Thursday
2018,8,23,1800,523,1097,1620,Thursday
2018,8,23,1700,528,1127,1655,Thursday
2018,8,23,1600,616,1033,1649,Thursday
2018,8,23,1500,707,883,1590,Thursday
2018,8,23,1400,809,745,1554,Thursday
2018,8,23,1300,897,665,1562,Thursday
2018,8,23,1200,1058,454,1512,Thursday
2018,8,23,1100,1115,370,1485,Thursday
2018,8,23,1000,964,247,1211,Thursday
2018,8,23,900,880,167,1047,Thursday
2018,8,23,800,564,98,662,Thursday
2018,8,23,700,296,60,356,Thursday
2018,8,23,600,146,41,187,Thursday
2018,8,23,500,71,44,115,Thursday
2018,8,23,400,40,48,88,Thursday
2018,8,23,300,36,47,83,Thursday
2018,8,23,200,52,52,104,Thursday
2018,8,23,100,60,97,157,Thursday
2018,8,22,2400,78,140,218,Wednesday
2018,8,22,2300,121,246,367,Wednesday
2018,8,22,2200,163,426,589,Wednesday
2018,8,22,2100,205,529,734,Wednesday
2018,8,22,2000,299,860,1159,Wednesday
2018,8,22,1900,305,1014,1319,Wednesday
2018,8,22,1800,437,1202,1639,Wednesday
2018,8,22,1700,485,1064,1549,Wednesday
2018,8,22,1600,509,985,1494,Wednesday
2018,8,22,1500,629,778,1407,Wednesday
2018,8,22,1400,736,647,1383,Wednesday
2018,8,22,1300,801,537,1338,Wednesday
2018,8,22,1200,993,489,1482,Wednesday
2018,8,22,1100,1081,342,1423,Wednesday
2018,8,22,1000,922,220,1142,Wednesday
2018,8,22,900,775,194,969,Wednesday
2018,8,22,800,599,166,765,Wednesday
2018,8,22,700,321,58,379,Wednesday
2018,8,22,600,158,22,180,Wednesday
2018,8,22,500,52,24,76,Wednesday
2018,8,22,400,37,34,71,Wednesday
2018,8,22,300,32,73,105,Wednesday
2018,8,22,200,26,63,89,Wednesday
2018,8,22,100,52,155,207,Wednesday
2018,8,21,2400,73,83,156,Tuesday
2018,8,21,2300,110,132,242,Tuesday
2018,8,21,2200,143,402,545,Tuesday
2018,8,21,2100,184,622,806,Tuesday
2018,8,21,2000,246,788,1034,Tuesday
2018,8,21,1900,289,1077,1366,Tuesday
2018,8,21,1800,342,1162,1504,Tuesday
2018,8,21,1700,419,1125,1544,Tuesday
2018,8,21,1600,529,1001,1530,Tuesday
2018,8,21,1500,555,723,1278,Tuesday
2018,8,21,1400,662,673,1335,Tuesday
2018,8,21,1300,806,552,1358,Tuesday
2018,8,21,1200,1017,402,1419,Tuesday
2018,8,21,1100,1048,326,1374,Tuesday
2018,8,21,1000,967,251,1218,Tuesday
2018,8,21,900,733,181,914,Tuesday
2018,8,21,800,536,112,648,Tuesday
2018,8,21,700,250,55,305,Tuesday
2018,8,21,600,156,46,202,Tuesday
2018,8,21,500,47,46,93,Tuesday
2018,8,21,400,37,51,88,Tuesday
2018,8,21,300,29,40,69,Tuesday
2018,8,21,200,46,75,121,Tuesday
2018,8,21,100,46,100,146,Tuesday
2018,8,20,2400,81,142,223,Monday
2018,8,20,2300,106,289,395,Monday
2018,8,20,2200,163,432,595,Monday
2018,8,20,2100,185,812,997,Monday
2018,8,20,2000,233,1050,1283,Monday
2018,8,20,1900,299,1198,1497,Monday
2018,8,20,1800,406,1348,1754,Monday
2018,8,20,1700,440,1349,1789,Monday
2018,8,20,1600,603,1023,1626,Monday
2018,8,20,1500,737,872,1609,Monday
2018,8,20,1400,782,735,1517,Monday
2018,8,20,1300,949,642,1591,Monday
2018,8,20,1200,1165,525,1690,Monday
2018,8,20,1100,1167,338,1505,Monday
2018,8,20,1000,995,241,1236,Monday
2018,8,20,900,765,176,941,Monday
2018,8,20,800,509,123,632,Monday
2018,8,20,700,243,71,314,Monday
2018,8,20,600,130,37,167,Monday
2018,8,20,500,53,35,88,Monday
2018,8,20,400,29,38,67,Monday
2018,8,20,300,27,43,70,Monday
2018,8,20,200,31,72,103,Monday
2018,8,20,100,47,306,353,Monday
2018,8,19,2400,52,370,422,Sunday
2018,8,19,2300,92,320,412,Sunday
2018,8,19,2200,151,522,673,Sunday
2018,8,19,2100,181,620,801,Sunday
2018,8,19,2000,235,1117,1352,Sunday
2018,8,19,1900,285,1509,1794,Sunday
2018,8,19,1800,452,1610,2062,Sunday
2018,8,19,1700,458,1844,2302,Sunday
2018,8,19,1600,621,1609,2230,Sunday
2018,8,19,1500,728,1437,2165,Sunday
2018,8,19,1400,851,1305,2156,Sunday
2018,8,19,1300,1105,1120,2225,Sunday
2018,8,19,1200,1115,810,1925,Sunday
2018,8,19,1100,1113,542,1655,Sunday
2018,8,19,1000,885,288,1173,Sunday
2018,8,19,900,678,158,836,Sunday
2018,8,19,800,435,76,511,Sunday
2018,8,19,700,201,34,235,Sunday
2018,8,19,600,100,25,125,Sunday
2018,8,19,500,47,29,76,Sunday
2018,8,19,400,28,39,67,Sunday
2018,8,19,300,19,46,65,Sunday
2018,8,19,200,24,52,76,Sunday
2018,8,19,100,38,157,195,Sunday
2018,8,18,2400,47,90,137,Saturday
2018,8,18,2300,74,165,239,Saturday
2018,8,18,2200,155,483,638,Saturday
2018,8,18,2100,169,960,1129,Saturday
2018,8,18,2000,210,996,1206,Saturday
2018,8,18,1900,264,1025,1289,Saturday
2018,8,18,1800,375,1522,1897,Saturday
2018,8,18,1700,492,1504,1996,Saturday
2018,8,18,1600,581,1279,1860,Saturday
2018,8,18,1500,741,957,1698,Saturday
2018,8,18,1400,810,826,1636,Saturday
2018,8,18,1300,1060,757,1817,Saturday
2018,8,18,1200,1287,638,1925,Saturday
2018,8,18,1100,1354,417,1771,Saturday
2018,8,18,1000,1161,279,1440,Saturday
2018,8,18,900,945,201,1146,Saturday
2018,8,18,800,621,104,725,Saturday
2018,8,18,700,310,57,367,Saturday
2018,8,18,600,168,29,197,Saturday
2018,8,18,500,76,36,112,Saturday
2018,8,18,400,28,53,81,Saturday
2018,8,18,300,45,47,92,Saturday
2018,8,18,200,45,78,123,Saturday
2018,8,18,100,44,105,149,Saturday
2018,8,17,2400,99,168,267,Friday
2018,8,17,2300,155,234,389,Friday
2018,8,17,2200,212,432,644,Friday
2018,8,17,2100,384,659,1043,Friday
2018,8,17,2000,587,835,1422,Friday
2018,8,17,1900,792,1037,1829,Friday
2018,8,17,1800,805,1229,2034,Friday
2018,8,17,1700,810,1241,2051,Friday
2018,8,17,1600,857,1085,1942,Friday
2018,8,17,1500,1002,954,1956,Friday
2018,8,17,1400,1046,845,1891,Friday
2018,8,17,1300,1131,702,1833,Friday
2018,8,17,1200,1353,593,1946,Friday
2018,8,17,1100,1354,418,1772,Friday
2018,8,17,1000,1132,295,1427,Friday
2018,8,17,900,917,212,1129,Friday
2018,8,17,800,627,116,743,Friday
2018,8,17,700,371,72,443,Friday
2018,8,17,600,155,31,186,Friday
2018,8,17,500,89,34,123,Friday
2018,8,17,400,57,48,105,Friday
2018,8,17,300,42,66,108,Friday
2018,8,17,200,48,78,126,Friday
2018,8,17,100,69,99,168,Friday
2018,8,16,2400,101,186,287,Thursday
2018,8,16,2300,133,233,366,Thursday
2018,8,16,2200,188,475,663,Thursday
2018,8,16,2100,289,643,932,Thursday
2018,8,16,2000,431,783,1214,Thursday
2018,8,16,1900,486,989,1475,Thursday
2018,8,16,1800,519,1109,1628,Thursday
2018,8,16,1700,608,1123,1731,Thursday
2018,8,16,1600,696,1014,1710,Thursday
2018,8,16,1500,753,868,1621,Thursday
2018,8,16,1400,800,729,1529,Thursday
2018,8,16,1300,939,637,1576,Thursday
2018,8,16,1200,1121,552,1673,Thursday
2018,8,16,1100,1194,395,1589,Thursday
2018,8,16,1000,1061,249,1310,Thursday
2018,8,16,900,853,178,1031,Thursday
2018,8,16,800,591,112,703,Thursday
2018,8,16,700,360,85,445,Thursday
2018,8,16,600,173,39,212,Thursday
2018,8,16,500,57,42,99,Thursday
2018,8,16,400,41,52,93,Thursday
2018,8,16,300,42,62,104,Thursday
2018,8,16,200,41,69,110,Thursday
2018,8,16,100,57,122,179,Thursday
2018,8,15,2400,94,114,208,Wednesday
2018,8,15,2300,131,257,388,Wednesday
2018,8,15,2200,162,465,627,Wednesday
2018,8,15,2100,241,578,819,Wednesday
2018,8,15,2000,285,781,1066,Wednesday
2018,8,15,1900,343,935,1278,Wednesday
2018,8,15,1800,413,1152,1565,Wednesday
2018,8,15,1700,485,1034,1519,Wednesday
2018,8,15,1600,573,892,1465,Wednesday
2018,8,15,1500,657,874,1531,Wednesday
2018,8,15,1400,670,681,1351,Wednesday
2018,8,15,1300,870,667,1537,Wednesday
2018,8,15,1200,1029,519,1548,Wednesday
2018,8,15,1100,1108,420,1528,Wednesday
2018,8,15,1000,988,268,1256,Wednesday
2018,8,15,900,814,218,1032,Wednesday
2018,8,15,800,570,123,693,Wednesday
2018,8,15,700,305,66,371,Wednesday
2018,8,15,600,197,40,237,Wednesday
2018,8,15,500,83,40,123,Wednesday
2018,8,15,400,35,38,73,Wednesday
2018,8,15,300,44,61,105,Wednesday
2018,8,15,200,39,59,98,Wednesday
2018,8,15,100,55,93,148,Wednesday
2018,8,14,2400,84,151,235,Tuesday
2018,8,14,2300,102,242,344,Tuesday
2018,8,14,2200,162,373,535,Tuesday
2018,8,14,2100,192,605,797,Tuesday
2018,8,14,2000,239,901,1140,Tuesday
2018,8,14,1900,310,1092,1402,Tuesday
2018,8,14,1800,409,1343,1752,Tuesday
2018,8,14,1700,470,1301,1771,Tuesday
2018,8,14,1600,523,1137,1660,Tuesday
2018,8,14,1500,550,920,1470,Tuesday
2018,8,14,1400,715,735,1450,Tuesday
2018,8,14,1300,922,574,1496,Tuesday
2018,8,14,1200,978,484,1462,Tuesday
2018,8,14,1100,1094,377,1471,Tuesday
2018,8,14,1000,1097,262,1359,Tuesday
2018,8,14,900,837,181,1018,Tuesday
2018,8,14,800,655,125,780,Tuesday
2018,8,14,700,328,73,401,Tuesday
2018,8,14,600,182,58,240,Tuesday
2018,8,14,500,83,40,123,Tuesday
2018,8,14,400,32,42,74,Tuesday
2018,8,14,300,38,67,105,Tuesday
2018,8,14,200,28,70,98,Tuesday
2018,8,14,100,49,139,188,Tuesday
2018,8,13,2400,69,188,257,Monday
2018,8,13,2300,109,337,446,Monday
2018,8,13,2200,157,621,778,Monday
2018,8,13,2100,204,991,1195,Monday
2018,8,13,2000,249,1160,1409,Monday
2018,8,13,1900,364,1490,1854,Monday
2018,8,13,1800,443,1338,1781,Monday
2018,8,13,1700,506,1136,1642,Monday
2018,8,13,1600,627,1003,1630,Monday
2018,8,13,1500,696,908,1604,Monday
2018,8,13,1400,837,767,1604,Monday
2018,8,13,1300,963,654,1617,Monday
2018,8,13,1200,1239,546,1785,Monday
2018,8,13,1100,1260,440,1700,Monday
2018,8,13,1000,1092,299,1391,Monday
2018,8,13,900,943,175,1118,Monday
2018,8,13,800,592,123,715,Monday
2018,8,13,700,314,64,378,Monday
2018,8,13,600,171,43,214,Monday
2018,8,13,500,60,42,102,Monday
2018,8,13,400,29,29,58,Monday
2018,8,13,300,23,41,64,Monday
2018,8,13,200,27,62,89,Monday
2018,8,13,100,48,123,171,Monday
2018,8,12,2400,55,176,231,Sunday
2018,8,12,2300,100,426,526,Sunday
2018,8,12,2200,149,621,770,Sunday
2018,8,12,2100,180,1006,1186,Sunday
2018,8,12,2000,242,1393,1635,Sunday
2018,8,12,1900,327,1533,1860,Sunday
2018,8,12,1800,383,1489,1872,Sunday
2018,8,12,1700,568,1587,2155,Sunday
2018,8,12,1600,685,1558,2243,Sunday
2018,8,12,1500,787,1535,2322,Sunday
2018,8,12,1400,909,1536,2445,Sunday
2018,8,12,1300,1047,1183,2230,Sunday
2018,8,12,1200,1182,857,2039,Sunday
2018,8,12,1100,1197,425,1622,Sunday
2018,8,12,1000,981,334,1315,Sunday
2018,8,12,900,775,173,948,Sunday
2018,8,12,800,497,70,567,Sunday
2018,8,12,700,243,48,291,Sunday
2018,8,12,600,104,17,121,Sunday
2018,8,12,500,57,24,81,Sunday
2018,8,12,400,21,32,53,Sunday
2018,8,12,300,24,45,69,Sunday
2018,8,12,200,23,61,84,Sunday
2018,8,12,100,34,93,127,Sunday
2018,8,11,2400,50,134,184,Saturday
2018,8,11,2300,88,259,347,Saturday
2018,8,11,2200,117,487,604,Saturday
2018,8,11,2100,129,654,783,Saturday
2018,8,11,2000,191,1094,1285,Saturday
2018,8,11,1900,249,1451,1700,Saturday
2018,8,11,1800,389,1450,1839,Saturday
2018,8,11,1700,495,1517,2012,Saturday
2018,8,11,1600,607,1344,1951,Saturday
2018,8,11,1500,689,1031,1720,Saturday
2018,8,11,1400,827,960,1787,Saturday
2018,8,11,1300,1010,774,1784,Saturday
2018,8,11,1200,1240,517,1757,Saturday
2018,8,11,1100,1252,372,1624,Saturday
2018,8,11,1000,1129,264,1393,Saturday
2018,8,11,900,948,170,1118,Saturday
2018,8,11,800,677,94,771,Saturday
2018,8,11,700,312,60,372,Saturday
2018,8,11,600,187,43,230,Saturday
2018,8,11,500,63,48,111,Saturday
2018,8,11,400,41,42,83,Saturday
2018,8,11,300,41,60,101,Saturday
2018,8,11,200,43,70,113,Saturday
2018,8,11,100,64,113,177,Saturday
2018,8,10,2400,106,212,318,Friday
2018,8,10,2300,129,361,490,Friday
2018,8,10,2200,241,454,695,Friday
2018,8,10,2100,359,644,1003,Friday
2018,8,10,2000,541,978,1519,Friday
2018,8,10,1900,684,1179,1863,Friday
2018,8,10,1800,710,1340,2050,Friday
2018,8,10,1700,833,1320,2153,Friday
2018,8,10,1600,881,1302,2183,Friday
2018,8,10,1500,975,1147,2122,Friday
2018,8,10,1400,960,1016,1976,Friday
2018,8,10,1300,1163,575,1738,Friday
2018,8,10,1200,1321,446,1767,Friday
2018,8,10,1100,1363,424,1787,Friday
2018,8,10,1000,1251,295,1546,Friday
2018,8,10,900,1058,174,1232,Friday
2018,8,10,800,743,110,853,Friday
2018,8,10,700,393,62,455,Friday
2018,8,10,600,216,44,260,Friday
2018,8,10,500,117,32,149,Friday
2018,8,10,400,52,51,103,Friday
2018,8,10,300,58,65,123,Friday
2018,8,10,200,55,89,144,Friday
2018,8,10,100,71,128,199,Friday
2018,8,9,2400,114,165,279,Thursday
2018,8,9,2300,174,325,499,Thursday
2018,8,9,2200,222,444,666,Thursday
2018,8,9,2100,307,714,1021,Thursday
2018,8,9,2000,384,892,1276,Thursday
2018,8,9,1900,418,1094,1512,Thursday
2018,8,9,1800,538,1311,1849,Thursday
2018,8,9,1700,624,1193,1817,Thursday
2018,8,9,1600,674,1107,1781,Thursday
2018,8,9,1500,716,936,1652,Thursday
2018,8,9,1400,902,987,1889,Thursday
2018,8,9,1300,961,521,1482,Thursday
2018,8,9,1200,1169,437,1606,Thursday
2018,8,9,1100,1279,342,1621,Thursday
2018,8,9,1000,1139,323,1462,Thursday
2018,8,9,900,1006,147,1153,Thursday
2018,8,9,800,729,107,836,Thursday
2018,8,9,700,409,52,461,Thursday
2018,8,9,600,209,106,315,Thursday
2018,8,9,500,98,53,151,Thursday
2018,8,9,400,46,5,51,Thursday
2018,8,9,300,37,8,45,Thursday
2018,8,9,200,49,66,115,Thursday
2018,8,9,100,60,123,183,Thursday
2018,8,8,2400,107,187,294,Wednesday
2018,8,8,2300,126,372,498,Wednesday
2018,8,8,2200,170,498,668,Wednesday
2018,8,8,2100,218,727,945,Wednesday
2018,8,8,2000,300,1032,1332,Wednesday
2018,8,8,1900,335,1127,1462,Wednesday
2018,8,8,1800,420,1295,1715,Wednesday
2018,8,8,1700,498,1217,1715,Wednesday
2018,8,8,1600,587,1193,1780,Wednesday
2018,8,8,1500,679,843,1522,Wednesday
2018,8,8,1400,753,777,1530,Wednesday
2018,8,8,1300,920,513,1433,Wednesday
2018,8,8,1200,1191,478,1669,Wednesday
2018,8,8,1100,1165,341,1506,Wednesday
2018,8,8,1000,1096,269,1365,Wednesday
2018,8,8,900,943,153,1096,Wednesday
2018,8,8,800,609,120,729,Wednesday
2018,8,8,700,389,58,447,Wednesday
2018,8,8,600,178,52,230,Wednesday
2018,8,8,500,90,54,144,Wednesday
2018,8,8,400,40,56,96,Wednesday
2018,8,8,300,49,45,94,Wednesday
2018,8,8,200,35,107,142,Wednesday
2018,8,8,100,66,123,189,Wednesday
2018,8,7,2400,96,197,293,Tuesday
2018,8,7,2300,118,381,499,Tuesday
2018,8,7,2200,169,605,774,Tuesday
2018,8,7,2100,198,850,1048,Tuesday
2018,8,7,2000,277,1199,1476,Tuesday
2018,8,7,1900,307,1521,1828,Tuesday
2018,8,7,1800,454,1697,2151,Tuesday
2018,8,7,1700,541,1467,2008,Tuesday
2018,8,7,1600,634,1200,1834,Tuesday
2018,8,7,1500,718,1008,1726,Tuesday
2018,8,7,1400,888,749,1637,Tuesday
2018,8,7,1300,1041,821,1862,Tuesday
2018,8,7,1200,1218,715,1933,Tuesday
2018,8,7,1100,1352,527,1879,Tuesday
2018,8,7,1000,1231,366,1597,Tuesday
2018,8,7,900,1040,253,1293,Tuesday
2018,8,7,800,673,165,838,Tuesday
2018,8,7,700,375,120,495,Tuesday
2018,8,7,600,192,43,235,Tuesday
2018,8,7,500,94,38,132,Tuesday
2018,8,7,400,45,36,81,Tuesday
2018,8,7,300,27,63,90,Tuesday
2018,8,7,200,25,86,111,Tuesday
2018,8,7,100,50,145,195,Tuesday
2018,8,6,2400,59,320,379,Monday
2018,8,6,2300,97,544,641,Monday
2018,8,6,2200,165,1123,1288,Monday
2018,8,6,2100,194,1391,1585,Monday
2018,8,6,2000,295,1986,2281,Monday
2018,8,6,1900,381,2168,2549,Monday
2018,8,6,1800,516,2267,2783,Monday
2018,8,6,1700,664,2087,2751,Monday
2018,8,6,1600,798,1978,2776,Monday
2018,8,6,1500,988,1699,2687,Monday
2018,8,6,1400,1236,1498,2734,Monday
2018,8,6,1300,1293,1512,2805,Monday
2018,8,6,1200,1412,1166,2578,Monday
2018,8,6,1100,1485,757,2242,Monday
2018,8,6,1000,1243,506,1749,Monday
2018,8,6,900,1001,281,1282,Monday
2018,8,6,800,741,129,870,Monday
2018,8,6,700,373,57,430,Monday
2018,8,6,600,229,40,269,Monday
2018,8,6,500,82,33,115,Monday
2018,8,6,400,38,37,75,Monday
2018,8,6,300,24,68,92,Monday
2018,8,6,200,30,104,134,Monday
2018,8,6,100,48,172,220,Monday
2018,8,5,2400,74,279,353,Sunday
2018,8,5,2300,133,576,709,Sunday
2018,8,5,2200,151,790,941,Sunday
2018,8,5,2100,205,1063,1268,Sunday
2018,8,5,2000,257,1375,1632,Sunday
2018,8,5,1900,336,1694,2030,Sunday
2018,8,5,1800,425,1859,2284,Sunday
2018,8,5,1700,581,1569,2150,Sunday
2018,8,5,1600,755,1486,2241,Sunday
2018,8,5,1500,995,1214,2209,Sunday
2018,8,5,1400,1194,915,2109,Sunday
2018,8,5,1300,1346,689,2035,Sunday
2018,8,5,1200,1330,516,1846,Sunday
2018,8,5,1100,1392,372,1764,Sunday
2018,8,5,1000,1259,248,1507,Sunday
2018,8,5,900,1068,130,1198,Sunday
2018,8,5,800,718,102,820,Sunday
2018,8,5,700,327,52,379,Sunday
2018,8,5,600,168,25,193,Sunday
2018,8,5,500,68,32,100,Sunday
2018,8,5,400,24,43,67,Sunday
2018,8,5,300,29,25,54,Sunday
2018,8,5,200,42,63,105,Sunday
2018,8,5,100,53,88,141,Sunday
2018,8,4,2400,75,192,267,Saturday
2018,8,4,2300,118,284,402,Saturday
2018,8,4,2200,167,497,664,Saturday
2018,8,4,2100,220,713,933,Saturday
2018,8,4,2000,228,967,1195,Saturday
2018,8,4,1900,336,1286,1622,Saturday
2018,8,4,1800,481,1277,1758,Saturday
2018,8,4,1700,535,1288,1823,Saturday
2018,8,4,1600,713,1237,1950,Saturday
2018,8,4,1500,831,889,1720,Saturday
2018,8,4,1400,1118,749,1867,Saturday
2018,8,4,1300,1232,643,1875,Saturday
2018,8,4,1200,1535,478,2013,Saturday
2018,8,4,1100,1688,350,2038,Saturday
2018,8,4,1000,1676,333,2009,Saturday
2018,8,4,900,1462,419,1881,Saturday
2018,8,4,800,967,103,1070,Saturday
2018,8,4,700,607,21,628,Saturday
2018,8,4,600,286,16,302,Saturday
2018,8,4,500,126,9,135,Saturday
2018,8,4,400,65,12,77,Saturday
2018,8,4,300,58,11,69,Saturday
2018,8,4,200,74,24,98,Saturday
2018,8,4,100,104,104,208,Saturday
2018,8,3,2400,128,180,308,Friday
2018,8,3,2300,226,247,473,Friday
2018,8,3,2200,366,467,833,Friday
2018,8,3,2100,613,625,1238,Friday
2018,8,3,2000,899,867,1766,Friday
2018,8,3,1900,998,984,1982,Friday
2018,8,3,1800,1142,1285,2427,Friday
2018,8,3,1700,1211,1358,2569,Friday
2018,8,3,1600,1285,1196,2481,Friday
2018,8,3,1500,1360,1092,2452,Friday
2018,8,3,1400,1275,874,2149,Friday
2018,8,3,1300,1332,701,2033,Friday
2018,8,3,1200,1727,638,2365,Friday
2018,8,3,1100,1787,421,2208,Friday
2018,8,3,1000,1707,294,2001,Friday
2018,8,3,900,1358,219,1577,Friday
2018,8,3,800,984,143,1127,Friday
2018,8,3,700,591,77,668,Friday
2018,8,3,600,305,69,374,Friday
2018,8,3,500,116,56,172,Friday
2018,8,3,400,73,71,144,Friday
2018,8,3,300,58,82,140,Friday
2018,8,3,200,75,71,146,Friday
2018,8,3,100,94,100,194,Friday
2018,8,2,2400,121,541,662,Thursday
2018,8,2,2300,200,738,938,Thursday
2018,8,2,2200,335,932,1267,Thursday
2018,8,2,2100,490,873,1363,Thursday
2018,8,2,2000,682,902,1584,Thursday
2018,8,2,1900,672,923,1595,Thursday
2018,8,2,1800,657,848,1505,Thursday
2018,8,2,1700,776,805,1581,Thursday
2018,8,2,1600,849,651,1500,Thursday
2018,8,2,1500,950,569,1519,Thursday
2018,8,2,1400,959,678,1637,Thursday
2018,8,2,1300,1053,602,1655,Thursday
2018,8,2,1200,1293,472,1765,Thursday
2018,8,2,1100,1299,292,1591,Thursday
2018,8,2,1000,1302,228,1530,Thursday
2018,8,2,900,1014,177,1191,Thursday
2018,8,2,800,731,95,826,Thursday
2018,8,2,700,391,68,459,Thursday
2018,8,2,600,210,45,255,Thursday
2018,8,2,500,78,52,130,Thursday
2018,8,2,400,48,47,95,Thursday
2018,8,2,300,45,87,132,Thursday
2018,8,2,200,36,66,102,Thursday
2018,8,2,100,68,51,119,Thursday
2018,8,1,2400,100,128,228,Wednesday
2018,8,1,2300,152,276,428,Wednesday
2018,8,1,2200,202,479,681,Wednesday
2018,8,1,2100,246,625,871,Wednesday
2018,8,1,2000,316,803,1119,Wednesday
2018,8,1,1900,397,940,1337,Wednesday
2018,8,1,1800,501,1196,1697,Wednesday
2018,8,1,1700,616,1141,1757,Wednesday
2018,8,1,1600,653,976,1629,Wednesday
2018,8,1,1500,756,840,1596,Wednesday
2018,8,1,1400,686,672,1358,Wednesday
2018,8,1,1300,1032,513,1545,Wednesday
2018,8,1,1200,1206,422,1628,Wednesday
2018,8,1,1100,1302,282,1584,Wednesday
2018,8,1,1000,1082,262,1344,Wednesday
2018,8,1,900,928,213,1141,Wednesday
2018,8,1,800,650,110,760,Wednesday
2018,8,1,700,344,75,419,Wednesday
2018,8,1,600,174,50,224,Wednesday
2018,8,1,500,85,42,127,Wednesday
2018,8,1,400,49,50,99,Wednesday
2018,8,1,300,45,56,101,Wednesday
2018,8,1,200,43,81,124,Wednesday
2018,8,1,100,58,93,151,Wednesday
2018,7,31,2400,89,183,272,Tuesday
2018,7,31,2300,144,300,444,Tuesday
2018,7,31,2200,195,417,612,Tuesday
2018,7,31,2100,247,652,899,Tuesday
2018,7,31,2000,285,831,1116,Tuesday
2018,7,31,1900,342,1055,1397,Tuesday
2018,7,31,1800,455,1256,1711,Tuesday
2018,7,31,1700,543,1154,1697,Tuesday
2018,7,31,1600,600,1066,1666,Tuesday
2018,7,31,1500,708,767,1475,Tuesday
2018,7,31,1400,767,721,1488,Tuesday
2018,7,31,1300,864,614,1478,Tuesday
2018,7,31,1200,1111,506,1617,Tuesday
2018,7,31,1100,1093,383,1476,Tuesday
2018,7,31,1000,1039,255,1294,Tuesday
2018,7,31,900,847,182,1029,Tuesday
2018,7,31,800,626,133,759,Tuesday
2018,7,31,700,349,71,420,Tuesday
2018,7,31,600,170,31,201,Tuesday
2018,7,31,500,72,37,109,Tuesday
2018,7,31,400,41,52,93,Tuesday
2018,7,31,300,30,61,91,Tuesday
2018,7,31,200,38,74,112,Tuesday
2018,7,31,100,50,112,162,Tuesday
2018,7,30,2400,101,206,307,Monday
2018,7,30,2300,116,339,455,Monday
2018,7,30,2200,174,585,759,Monday
2018,7,30,2100,212,845,1057,Monday
2018,7,30,2000,256,978,1234,Monday
2018,7,30,1900,325,1314,1639,Monday
2018,7,30,1800,454,1455,1909,Monday
2018,7,30,1700,575,1352,1927,Monday
2018,7,30,1600,729,1173,1902,Monday
2018,7,30,1500,832,984,1816,Monday
2018,7,30,1400,926,879,1805,Monday
2018,7,30,1300,1107,734,1841,Monday
2018,7,30,1200,1357,655,2012,Monday
2018,7,30,1100,1286,431,1717,Monday
2018,7,30,1000,1242,306,1548,Monday
2018,7,30,900,974,223,1197,Monday
2018,7,30,800,693,148,841,Monday
2018,7,30,700,365,103,468,Monday
2018,7,30,600,188,45,233,Monday
2018,7,30,500,79,30,109,Monday
2018,7,30,400,30,45,75,Monday
2018,7,30,300,22,58,80,Monday
2018,7,30,200,32,132,164,Monday
2018,7,30,100,46,134,180,Monday
2018,7,29,2400,86,240,326,Sunday
2018,7,29,2300,102,436,538,Sunday
2018,7,29,2200,163,701,864,Sunday
2018,7,29,2100,245,1203,1448,Sunday
2018,7,29,2000,287,1558,1845,Sunday
2018,7,29,1900,401,1784,2185,Sunday
2018,7,29,1800,523,1991,2514,Sunday
2018,7,29,1700,603,1929,2532,Sunday
2018,7,29,1600,766,1799,2565,Sunday
2018,7,29,1500,953,1418,2371,Sunday
2018,7,29,1400,1077,1239,2316,Sunday
2018,7,29,1300,1231,1145,2376,Sunday
2018,7,29,1200,1399,713,2112,Sunday
2018,7,29,1100,1329,508,1837,Sunday
2018,7,29,1000,1285,330,1615,Sunday
2018,7,29,900,957,174,1131,Sunday
2018,7,29,800,637,97,734,Sunday
2018,7,29,700,289,45,334,Sunday
2018,7,29,600,183,25,208,Sunday
2018,7,29,500,90,16,106,Sunday
2018,7,29,400,32,25,57,Sunday
2018,7,29,300,30,47,77,Sunday
2018,7,29,200,36,67,103,Sunday
2018,7,29,100,58,110,168,Sunday
2018,7,28,2400,54,216,270,Saturday
2018,7,28,2300,104,446,550,Saturday
2018,7,28,2200,163,556,719,Saturday
2018,7,28,2100,209,836,1045,Saturday
2018,7,28,2000,265,1044,1309,Saturday
2018,7,28,1900,349,1437,1786,Saturday
2018,7,28,1800,471,1529,2000,Saturday
2018,7,28,1700,601,1463,2064,Saturday
2018,7,28,1600,921,1293,2214,Saturday
2018,7,28,1500,1208,1042,2250,Saturday
2018,7,28,1400,983,895,1878,Saturday
2018,7,28,1300,982,786,1768,Saturday
2018,7,28,1200,1448,634,2082,Saturday
2018,7,28,1100,1700,427,2127,Saturday
2018,7,28,1000,1573,275,1848,Saturday
2018,7,28,900,1286,185,1471,Saturday
2018,7,28,800,842,124,966,Saturday
2018,7,28,700,435,52,487,Saturday
2018,7,28,600,228,45,273,Saturday
2018,7,28,500,99,27,126,Saturday
2018,7,28,400,42,38,80,Saturday
2018,7,28,300,42,49,91,Saturday
2018,7,28,200,53,85,138,Saturday
2018,7,28,100,89,117,206,Saturday
2018,7,27,2400,105,180,285,Friday
2018,7,27,2300,161,294,455,Friday
2018,7,27,2200,315,443,758,Friday
2018,7,27,2100,516,679,1195,Friday
2018,7,27,2000,802,943,1745,Friday
2018,7,27,1900,954,1111,2065,Friday
2018,7,27,1800,1002,1298,2300,Friday
2018,7,27,1700,1101,1277,2378,Friday
2018,7,27,1600,1205,1155,2360,Friday
2018,7,27,1500,1223,989,2212,Friday
2018,7,27,1400,1196,905,2101,Friday
2018,7,27,1300,1355,810,2165,Friday
2018,7,27,1200,1384,575,1959,Friday
2018,7,27,1100,1472,426,1898,Friday
2018,7,27,1000,1311,274,1585,Friday
2018,7,27,900,1224,171,1395,Friday
2018,7,27,800,804,142,946,Friday
2018,7,27,700,431,60,491,Friday
2018,7,27,600,223,28,251,Friday
2018,7,27,500,108,36,144,Friday
2018,7,27,400,53,46,99,Friday
2018,7,27,300,39,55,94,Friday
2018,7,27,200,53,77,130,Friday
2018,7,27,100,74,116,190,Friday
2018,7,26,2400,120,155,275,Thursday
2018,7,26,2300,180,314,494,Thursday
2018,7,26,2200,271,465,736,Thursday
2018,7,26,2100,412,627,1039,Thursday
2018,7,26,2000,503,774,1277,Thursday
2018,7,26,1900,588,965,1553,Thursday
2018,7,26,1800,636,1329,1965,Thursday
2018,7,26,1700,704,1137,1841,Thursday
2018,7,26,1600,762,1088,1850,Thursday
2018,7,26,1500,873,841,1714,Thursday
2018,7,26,1400,812,705,1517,Thursday
2018,7,26,1300,983,677,1660,Thursday
2018,7,26,1200,1189,519,1708,Thursday
2018,7,26,1100,1291,324,1615,Thursday
2018,7,26,1000,1115,285,1400,Thursday
2018,7,26,900,969,183,1152,Thursday
2018,7,26,800,645,117,762,Thursday
2018,7,26,700,329,78,407,Thursday
2018,7,26,600,188,44,232,Thursday
2018,7,26,500,92,24,116,Thursday
2018,7,26,400,40,52,92,Thursday
2018,7,26,300,33,42,75,Thursday
2018,7,26,200,36,68,104,Thursday
2018,7,26,100,61,91,152,Thursday
2018,7,25,2400,99,182,281,Wednesday
2018,7,25,2300,125,344,469,Wednesday
2018,7,25,2200,191,496,687,Wednesday
2018,7,25,2100,295,662,957,Wednesday
2018,7,25,2000,310,849,1159,Wednesday
2018,7,25,1900,389,1037,1426,Wednesday
2018,7,25,1800,461,1185,1646,Wednesday
2018,7,25,1700,581,1142,1723,Wednesday
2018,7,25,1600,639,1025,1664,Wednesday
2018,7,25,1500,706,797,1503,Wednesday
2018,7,25,1400,785,779,1564,Wednesday
2018,7,25,1300,935,576,1511,Wednesday
2018,7,25,1200,1162,448,1610,Wednesday
2018,7,25,1100,1196,331,1527,Wednesday
2018,7,25,1000,1169,238,1407,Wednesday
2018,7,25,900,909,187,1096,Wednesday
2018,7,25,800,650,129,779,Wednesday
2018,7,25,700,382,72,454,Wednesday
2018,7,25,600,175,37,212,Wednesday
2018,7,25,500,83,32,115,Wednesday
2018,7,25,400,43,52,95,Wednesday
2018,7,25,300,42,43,85,Wednesday
2018,7,25,200,38,75,113,Wednesday
2018,7,25,100,46,108,154,Wednesday
2018,7,24,2400,90,170,260,Tuesday
2018,7,24,2300,105,312,417,Tuesday
2018,7,24,2200,147,448,595,Tuesday
2018,7,24,2100,212,601,813,Tuesday
2018,7,24,2000,266,811,1077,Tuesday
2018,7,24,1900,326,1033,1359,Tuesday
2018,7,24,1800,397,1150,1547,Tuesday
2018,7,24,1700,490,1026,1516,Tuesday
2018,7,24,1600,584,843,1427,Tuesday
2018,7,24,1500,688,761,1449,Tuesday
2018,7,24,1400,986,658,1644,Tuesday
2018,7,24,1300,764,489,1253,Tuesday
2018,7,24,1200,859,445,1304,Tuesday
2018,7,24,1100,1099,334,1433,Tuesday
2018,7,24,1000,939,233,1172,Tuesday
2018,7,24,900,792,151,943,Tuesday
2018,7,24,800,497,123,620,Tuesday
2018,7,24,700,290,71,361,Tuesday
2018,7,24,600,124,52,176,Tuesday
2018,7,24,500,57,35,92,Tuesday
2018,7,24,400,36,46,82,Tuesday
2018,7,24,300,30,66,96,Tuesday
2018,7,24,200,34,80,114,Tuesday
2018,7,24,100,61,85,146,Tuesday
2018,7,23,2400,79,143,222,Monday
2018,7,23,2300,116,328,444,Monday
2018,7,23,2200,165,469,634,Monday
2018,7,23,2100,225,636,861,Monday
2018,7,23,2000,307,863,1170,Monday
2018,7,23,1900,361,1365,1726,Monday
2018,7,23,1800,436,1264,1700,Monday
2018,7,23,1700,535,1117,1652,Monday
2018,7,23,1600,639,1198,1837,Monday
2018,7,23,1500,772,1035,1807,Monday
2018,7,23,1400,852,872,1724,Monday
2018,7,23,1300,1035,825,1860,Monday
2018,7,23,1200,1327,565,1892,Monday
2018,7,23,1100,1264,422,1686,Monday
2018,7,23,1000,1118,319,1437,Monday
2018,7,23,900,942,185,1127,Monday
2018,7,23,800,567,167,734,Monday
2018,7,23,700,317,104,421,Monday
2018,7,23,600,140,45,185,Monday
2018,7,23,500,72,36,108,Monday
2018,7,23,400,47,27,74,Monday
2018,7,23,300,29,42,71,Monday
2018,7,23,200,37,72,109,Monday
2018,7,23,100,46,127,173,Monday
2018,7,22,2400,71,250,321,Sunday
2018,7,22,2300,145,504,649,Sunday
2018,7,22,2200,152,855,1007,Sunday
2018,7,22,2100,214,1249,1463,Sunday
2018,7,22,2000,300,1573,1873,Sunday
2018,7,22,1900,419,1958,2377,Sunday
2018,7,22,1800,498,2037,2535,Sunday
2018,7,22,1700,628,1804,2432,Sunday
2018,7,22,1600,818,1810,2628,Sunday
2018,7,22,1500,924,1593,2517,Sunday
2018,7,22,1400,1060,1256,2316,Sunday
2018,7,22,1300,1189,1005,2194,Sunday
2018,7,22,1200,1309,708,2017,Sunday
2018,7,22,1100,1349,499,1848,Sunday
2018,7,22,1000,1131,271,1402,Sunday
2018,7,22,900,936,146,1082,Sunday
2018,7,22,800,636,94,730,Sunday
2018,7,22,700,315,42,357,Sunday
2018,7,22,600,156,19,175,Sunday
2018,7,22,500,88,18,106,Sunday
2018,7,22,400,17,30,47,Sunday
2018,7,22,300,25,39,64,Sunday
2018,7,22,200,31,55,86,Sunday
2018,7,22,100,45,73,118,Sunday
2018,7,21,2400,64,141,205,Saturday
2018,7,21,2300,105,281,386,Saturday
2018,7,21,2200,150,442,592,Saturday
2018,7,21,2100,203,671,874,Saturday
2018,7,21,2000,282,952,1234,Saturday
2018,7,21,1900,354,1431,1785,Saturday
2018,7,21,1800,418,1592,2010,Saturday
2018,7,21,1700,590,1431,2021,Saturday
2018,7,21,1600,798,1409,2207,Saturday
2018,7,21,1500,965,983,1948,Saturday
2018,7,21,1400,1157,848,2005,Saturday
2018,7,21,1300,1238,800,2038,Saturday
2018,7,21,1200,1531,586,2117,Saturday
2018,7,21,1100,1591,387,1978,Saturday
2018,7,21,1000,1472,272,1744,Saturday
2018,7,21,900,1218,207,1425,Saturday
2018,7,21,800,721,98,819,Saturday
2018,7,21,700,427,52,479,Saturday
2018,7,21,600,243,32,275,Saturday
2018,7,21,500,91,37,128,Saturday
2018,7,21,400,49,44,93,Saturday
2018,7,21,300,45,60,105,Saturday
2018,7,21,200,29,65,94,Saturday
2018,7,21,100,57,82,139,Saturday
2018,7,20,2400,123,166,289,Friday
2018,7,20,2300,202,315,517,Friday
2018,7,20,2200,315,433,748,Friday
2018,7,20,2100,536,595,1131,Friday
2018,7,20,2000,898,796,1694,Friday
2018,7,20,1900,949,1086,2035,Friday
2018,7,20,1800,1057,1220,2277,Friday
2018,7,20,1700,1081,1238,2319,Friday
2018,7,20,1600,1130,1179,2309,Friday
2018,7,20,1500,1142,1007,2149,Friday
2018,7,20,1400,1086,894,1980,Friday
2018,7,20,1300,1248,775,2023,Friday
2018,7,20,1200,1487,600,2087,Friday
2018,7,20,1100,1465,409,1874,Friday
2018,7,20,1000,1257,277,1534,Friday
2018,7,20,900,1033,165,1198,Friday
2018,7,20,800,769,126,895,Friday
2018,7,20,700,385,68,453,Friday
2018,7,20,600,198,47,245,Friday
2018,7,20,500,100,51,151,Friday
2018,7,20,400,58,42,100,Friday
2018,7,20,300,47,41,88,Friday
2018,7,20,200,42,76,118,Friday
2018,7,20,100,70,92,162,Friday
2018,7,19,2400,116,163,279,Thursday
2018,7,19,2300,148,272,420,Thursday
2018,7,19,2200,266,414,680,Thursday
2018,7,19,2100,358,562,920,Thursday
2018,7,19,2000,559,681,1240,Thursday
2018,7,19,1900,536,997,1533,Thursday
2018,7,19,1800,605,1163,1768,Thursday
2018,7,19,1700,650,1107,1757,Thursday
2018,7,19,1600,710,955,1665,Thursday
2018,7,19,1500,779,931,1710,Thursday
2018,7,19,1400,872,767,1639,Thursday
2018,7,19,1300,1026,695,1721,Thursday
2018,7,19,1200,1212,479,1691,Thursday
2018,7,19,1100,1290,372,1662,Thursday
2018,7,19,1000,1167,268,1435,Thursday
2018,7,19,900,938,183,1121,Thursday
2018,7,19,800,616,107,723,Thursday
2018,7,19,700,312,66,378,Thursday
2018,7,19,600,155,54,209,Thursday
2018,7,19,500,83,38,121,Thursday
2018,7,19,400,42,42,84,Thursday
2018,7,19,300,53,36,89,Thursday
2018,7,19,200,37,73,110,Thursday
2018,7,19,100,74,94,168,Thursday
2018,7,18,2400,81,152,233,Wednesday
2018,7,18,2300,152,276,428,Wednesday
2018,7,18,2200,170,393,563,Wednesday
2018,7,18,2100,270,545,815,Wednesday
2018,7,18,2000,334,803,1137,Wednesday
2018,7,18,1900,387,1056,1443,Wednesday
2018,7,18,1800,446,1094,1540,Wednesday
2018,7,18,1700,532,1348,1880,Wednesday
2018,7,18,1600,586,1037,1623,Wednesday
2018,7,18,1500,653,709,1362,Wednesday
2018,7,18,1400,736,623,1359,Wednesday
2018,7,18,1300,865,555,1420,Wednesday
2018,7,18,1200,1095,440,1535,Wednesday
2018,7,18,1100,1113,393,1506,Wednesday
2018,7,18,1000,1057,258,1315,Wednesday
2018,7,18,900,897,193,1090,Wednesday
2018,7,18,800,610,126,736,Wednesday
2018,7,18,700,325,66,391,Wednesday
2018,7,18,600,150,53,203,Wednesday
2018,7,18,500,72,39,111,Wednesday
2018,7,18,400,44,48,92,Wednesday
2018,7,18,300,31,54,85,Wednesday
2018,7,18,200,38,71,109,Wednesday
2018,7,18,100,41,89,130,Wednesday
2018,7,17,2400,92,154,246,Tuesday
2018,7,17,2300,134,284,418,Tuesday
2018,7,17,2200,153,427,580,Tuesday
2018,7,17,2100,213,638,851,Tuesday
2018,7,17,2000,270,858,1128,Tuesday
2018,7,17,1900,326,1035,1361,Tuesday
2018,7,17,1800,447,1201,1648,Tuesday
2018,7,17,1700,470,1148,1618,Tuesday
2018,7,17,1600,557,989,1546,Tuesday
2018,7,17,1500,595,807,1402,Tuesday
2018,7,17,1400,750,731,1481,Tuesday
2018,7,17,1300,911,569,1480,Tuesday
2018,7,17,1200,1084,459,1543,Tuesday
2018,7,17,1100,1207,349,1556,Tuesday
2018,7,17,1000,1032,266,1298,Tuesday
2018,7,17,900,871,187,1058,Tuesday
2018,7,17,800,619,145,764,Tuesday
2018,7,17,700,370,70,440,Tuesday
2018,7,17,600,174,33,207,Tuesday
2018,7,17,500,67,24,91,Tuesday
2018,7,17,400,33,45,78,Tuesday
2018,7,17,300,23,61,84,Tuesday
2018,7,17,200,36,74,110,Tuesday
2018,7,17,100,49,99,148,Tuesday
2018,7,16,2400,81,164,245,Monday
2018,7,16,2300,139,360,499,Monday
2018,7,16,2200,186,500,686,Monday
2018,7,16,2100,219,673,892,Monday
2018,7,16,2000,278,950,1228,Monday
2018,7,16,1900,348,1137,1485,Monday
2018,7,16,1800,487,1294,1781,Monday
2018,7,16,1700,637,1257,1894,Monday
2018,7,16,1600,760,1022,1782,Monday
2018,7,16,1500,891,925,1816,Monday
2018,7,16,1400,965,747,1712,Monday
2018,7,16,1300,1152,750,1902,Monday
2018,7,16,1200,1376,549,1925,Monday
2018,7,16,1100,1395,390,1785,Monday
2018,7,16,1000,1173,284,1457,Monday
2018,7,16,900,954,194,1148,Monday
2018,7,16,800,655,153,808,Monday
2018,7,16,700,339,81,420,Monday
2018,7,16,600,150,36,186,Monday
2018,7,16,500,61,34,95,Monday
2018,7,16,400,28,38,66,Monday
2018,7,16,300,34,70,104,Monday
2018,7,16,200,38,162,200,Monday
2018,7,16,100,41,115,156,Monday
2018,7,15,2400,56,172,228,Sunday
2018,7,15,2300,101,404,505,Sunday
2018,7,15,2200,164,678,842,Sunday
2018,7,15,2100,230,1036,1266,Sunday
2018,7,15,2000,293,1343,1636,Sunday
2018,7,15,1900,391,1629,2020,Sunday
2018,7,15,1800,557,1719,2276,Sunday
2018,7,15,1700,715,1684,2399,Sunday
2018,7,15,1600,1062,1568,2630,Sunday
2018,7,15,1500,744,1395,2139,Sunday
2018,7,15,1400,1077,1194,2271,Sunday
2018,7,15,1300,1235,983,2218,Sunday
2018,7,15,1200,1519,762,2281,Sunday
2018,7,15,1100,1191,468,1659,Sunday
2018,7,15,1000,1174,290,1464,Sunday
2018,7,15,900,918,172,1090,Sunday
2018,7,15,800,586,90,676,Sunday
2018,7,15,700,300,46,346,Sunday
2018,7,15,600,145,22,167,Sunday
2018,7,15,500,65,13,78,Sunday
2018,7,15,400,38,17,55,Sunday
2018,7,15,300,37,34,71,Sunday
2018,7,15,200,28,51,79,Sunday
2018,7,15,100,50,115,165,Sunday
2018,7,14,2400,68,195,263,Saturday
2018,7,14,2300,114,330,444,Saturday
2018,7,14,2200,154,556,710,Saturday
2018,7,14,2100,219,752,971,Saturday
2018,7,14,2000,299,987,1286,Saturday
2018,7,14,1900,385,1228,1613,Saturday
2018,7,14,1800,493,1432,1925,Saturday
2018,7,14,1700,603,1224,1827,Saturday
2018,7,14,1600,774,1072,1846,Saturday
2018,7,14,1500,917,912,1829,Saturday
2018,7,14,1400,1107,717,1824,Saturday
2018,7,14,1300,1344,698,2042,Saturday
2018,7,14,1200,1455,552,2007,Saturday
2018,7,14,1100,1485,397,1882,Saturday
2018,7,14,1000,1356,303,1659,Saturday
2018,7,14,900,1044,192,1236,Saturday
2018,7,14,800,595,90,685,Saturday
2018,7,14,700,363,53,416,Saturday
2018,7,14,600,146,39,185,Saturday
2018,7,14,500,70,42,112,Saturday
2018,7,14,400,41,40,81,Saturday
2018,7,14,300,49,49,98,Saturday
2018,7,14,200,36,87,123,Saturday
2018,7,14,100,86,92,178,Saturday
2018,7,13,2400,98,123,221,Friday
2018,7,13,2300,166,277,443,Friday
2018,7,13,2200,263,451,714,Friday
2018,7,13,2100,479,589,1068,Friday
2018,7,13,2000,642,877,1519,Friday
2018,7,13,1900,826,1087,1913,Friday
2018,7,13,1800,908,1205,2113,Friday
2018,7,13,1700,932,1265,2197,Friday
2018,7,13,1600,1050,1023,2073,Friday
2018,7,13,1500,1144,926,2070,Friday
2018,7,13,1400,1116,846,1962,Friday
2018,7,13,1300,1164,760,1924,Friday
2018,7,13,1200,1412,583,1995,Friday
2018,7,13,1100,1404,429,1833,Friday
2018,7,13,1000,1266,288,1554,Friday
2018,7,13,900,1000,206,1206,Friday
2018,7,13,800,662,128,790,Friday
2018,7,13,700,385,61,446,Friday
2018,7,13,600,186,44,230,Friday
2018,7,13,500,91,32,123,Friday
2018,7,13,400,45,45,90,Friday
2018,7,13,300,59,51,110,Friday
2018,7,13,200,43,76,119,Friday
2018,7,13,100,65,118,183,Friday
2018,7,12,2400,111,170,281,Thursday
2018,7,12,2300,147,288,435,Thursday
2018,7,12,2200,251,482,733,Thursday
2018,7,12,2100,337,701,1038,Thursday
2018,7,12,2000,439,895,1334,Thursday
2018,7,12,1900,533,1295,1828,Thursday
2018,7,12,1800,597,1096,1693,Thursday
2018,7,12,1700,605,1139,1744,Thursday
2018,7,12,1600,687,962,1649,Thursday
2018,7,12,1500,832,827,1659,Thursday
2018,7,12,1400,953,725,1678,Thursday
2018,7,12,1300,1002,613,1615,Thursday
2018,7,12,1200,1235,524,1759,Thursday
2018,7,12,1100,1324,387,1711,Thursday
2018,7,12,1000,1139,266,1405,Thursday
2018,7,12,900,910,171,1081,Thursday
2018,7,12,800,683,133,816,Thursday
2018,7,12,700,387,63,450,Thursday
2018,7,12,600,163,47,210,Thursday
2018,7,12,500,62,43,105,Thursday
2018,7,12,400,52,50,102,Thursday
2018,7,12,300,44,52,96,Thursday
2018,7,12,200,50,87,137,Thursday
2018,7,12,100,66,99,165,Thursday
2018,7,11,2400,90,154,244,Wednesday
2018,7,11,2300,158,263,421,Wednesday
2018,7,11,2200,185,462,647,Wednesday
2018,7,11,2100,248,679,927,Wednesday
2018,7,11,2000,345,743,1088,Wednesday
2018,7,11,1900,394,1009,1403,Wednesday
2018,7,11,1800,465,1181,1646,Wednesday
2018,7,11,1700,513,1019,1532,Wednesday
2018,7,11,1600,645,960,1605,Wednesday
2018,7,11,1500,689,786,1475,Wednesday
2018,7,11,1400,771,700,1471,Wednesday
2018,7,11,1300,920,594,1514,Wednesday
2018,7,11,1200,1052,488,1540,Wednesday
2018,7,11,1100,1147,328,1475,Wednesday
2018,7,11,1000,1032,231,1263,Wednesday
2018,7,11,900,858,161,1019,Wednesday
2018,7,11,800,577,128,705,Wednesday
2018,7,11,700,314,64,378,Wednesday
2018,7,11,600,134,41,175,Wednesday
2018,7,11,500,60,40,100,Wednesday
2018,7,11,400,44,49,93,Wednesday
2018,7,11,300,42,48,90,Wednesday
2018,7,11,200,48,69,117,Wednesday
2018,7,11,100,50,101,151,Wednesday
2018,7,10,2400,73,141,214,Tuesday
2018,7,10,2300,131,232,363,Tuesday
2018,7,10,2200,154,351,505,Tuesday
2018,7,10,2100,222,481,703,Tuesday
2018,7,10,2000,256,600,856,Tuesday
2018,7,10,1900,313,936,1249,Tuesday
2018,7,10,1800,396,993,1389,Tuesday
2018,7,10,1700,446,1185,1631,Tuesday
2018,7,10,1600,595,1051,1646,Tuesday
2018,7,10,1500,621,753,1374,Tuesday
2018,7,10,1400,632,642,1274,Tuesday
2018,7,10,1300,747,561,1308,Tuesday
2018,7,10,1200,965,511,1476,Tuesday
2018,7,10,1100,984,418,1402,Tuesday
2018,7,10,1000,831,291,1122,Tuesday
2018,7,10,900,677,167,844,Tuesday
2018,7,10,800,503,115,618,Tuesday
2018,7,10,700,248,96,344,Tuesday
2018,7,10,600,119,56,175,Tuesday
2018,7,10,500,53,25,78,Tuesday
2018,7,10,400,29,46,75,Tuesday
2018,7,10,300,30,48,78,Tuesday
2018,7,10,200,47,74,121,Tuesday
2018,7,10,100,54,116,170,Tuesday
2018,7,9,2400,88,205,293,Monday
2018,7,9,2300,137,324,461,Monday
2018,7,9,2200,163,496,659,Monday
2018,7,9,2100,238,794,1032,Monday
2018,7,9,2000,278,1040,1318,Monday
2018,7,9,1900,329,1393,1722,Monday
2018,7,9,1800,465,1333,1798,Monday
2018,7,9,1700,543,1254,1797,Monday
2018,7,9,1600,665,1164,1829,Monday
2018,7,9,1500,844,892,1736,Monday
2018,7,9,1400,914,818,1732,Monday
2018,7,9,1300,1073,775,1848,Monday
2018,7,9,1200,1304,505,1809,Monday
2018,7,9,1100,1253,380,1633,Monday
2018,7,9,1000,1155,288,1443,Monday
2018,7,9,900,881,199,1080,Monday
2018,7,9,800,647,140,787,Monday
2018,7,9,700,330,92,422,Monday
2018,7,9,600,133,37,170,Monday
2018,7,9,500,84,25,109,Monday
2018,7,9,400,23,42,65,Monday
2018,7,9,300,37,39,76,Monday
2018,7,9,200,41,90,131,Monday
2018,7,9,100,36,84,120,Monday
2018,7,8,2400,51,259,310,Sunday
2018,7,8,2300,122,419,541,Sunday
2018,7,8,2200,169,738,907,Sunday
2018,7,8,2100,214,1079,1293,Sunday
2018,7,8,2000,298,1330,1628,Sunday
2018,7,8,1900,358,1640,1998,Sunday
2018,7,8,1800,436,1833,2269,Sunday
2018,7,8,1700,585,1843,2428,Sunday
2018,7,8,1600,767,1627,2394,Sunday
2018,7,8,1500,914,1421,2335,Sunday
2018,7,8,1400,1030,1296,2326,Sunday
2018,7,8,1300,1109,909,2018,Sunday
2018,7,8,1200,1250,723,1973,Sunday
2018,7,8,1100,1236,457,1693,Sunday
2018,7,8,1000,1111,297,1408,Sunday
2018,7,8,900,830,156,986,Sunday
2018,7,8,800,571,93,664,Sunday
2018,7,8,700,284,46,330,Sunday
2018,7,8,600,129,27,156,Sunday
2018,7,8,500,55,25,80,Sunday
2018,7,8,400,22,29,51,Sunday
2018,7,8,300,36,48,84,Sunday
2018,7,8,200,36,56,92,Sunday
2018,7,8,100,34,115,149,Sunday
2018,7,7,2400,80,178,258,Saturday
2018,7,7,2300,114,300,414,Saturday
2018,7,7,2200,152,518,670,Saturday
2018,7,7,2100,186,770,956,Saturday
2018,7,7,2000,269,973,1242,Saturday
2018,7,7,1900,381,1288,1669,Saturday
2018,7,7,1800,436,1481,1917,Saturday
2018,7,7,1700,561,1380,1941,Saturday
2018,7,7,1600,666,1248,1914,Saturday
2018,7,7,1500,887,1135,2022,Saturday
2018,7,7,1400,966,912,1878,Saturday
2018,7,7,1300,1182,784,1966,Saturday
2018,7,7,1200,1389,630,2019,Saturday
2018,7,7,1100,1407,479,1886,Saturday
2018,7,7,1000,1238,277,1515,Saturday
2018,7,7,900,919,208,1127,Saturday
2018,7,7,800,591,98,689,Saturday
2018,7,7,700,352,67,419,Saturday
2018,7,7,600,137,60,197,Saturday
2018,7,7,500,53,41,94,Saturday
2018,7,7,400,33,45,78,Saturday
2018,7,7,300,43,36,79,Saturday
2018,7,7,200,49,66,115,Saturday
2018,7,7,100,49,93,142,Saturday
2018,7,6,2400,90,149,239,Friday
2018,7,6,2300,162,258,420,Friday
2018,7,6,2200,260,445,705,Friday
2018,7,6,2100,393,655,1048,Friday
2018,7,6,2000,538,842,1380,Friday
2018,7,6,1900,643,1146,1789,Friday
2018,7,6,1800,655,1371,2026,Friday
2018,7,6,1700,784,1395,2179,Friday
2018,7,6,1600,963,1262,2225,Friday
2018,7,6,1500,1049,1011,2060,Friday
2018,7,6,1400,946,859,1805,Friday
2018,7,6,1300,1119,743,1862,Friday
2018,7,6,1200,1295,570,1865,Friday
2018,7,6,1100,1352,422,1774,Friday
2018,7,6,1000,1143,334,1477,Friday
2018,7,6,900,1036,214,1250,Friday
2018,7,6,800,753,152,905,Friday
2018,7,6,700,478,94,572,Friday
2018,7,6,600,171,51,222,Friday
2018,7,6,500,94,32,126,Friday
2018,7,6,400,42,53,95,Friday
2018,7,6,300,51,66,117,Friday
2018,7,6,200,57,97,154,Friday
2018,7,6,100,77,153,230,Friday
2018,7,5,2400,99,225,324,Thursday
2018,7,5,2300,176,446,622,Thursday
2018,7,5,2200,252,642,894,Thursday
2018,7,5,2100,391,904,1295,Thursday
2018,7,5,2000,462,1060,1522,Thursday
2018,7,5,1900,547,1412,1959,Thursday
2018,7,5,1800,639,1563,2202,Thursday
2018,7,5,1700,624,1259,1883,Thursday
2018,7,5,1600,765,1127,1892,Thursday
2018,7,5,1500,888,941,1829,Thursday
2018,7,5,1400,957,795,1752,Thursday
2018,7,5,1300,1096,653,1749,Thursday
2018,7,5,1200,1303,517,1820,Thursday
2018,7,5,1100,1441,404,1845,Thursday
2018,7,5,1000,1221,326,1547,Thursday
2018,7,5,900,976,183,1159,Thursday
2018,7,5,800,838,106,944,Thursday
2018,7,5,700,438,73,511,Thursday
2018,7,5,600,166,45,211,Thursday
2018,7,5,500,81,30,111,Thursday
2018,7,5,400,50,52,102,Thursday
2018,7,5,300,40,73,113,Thursday
2018,7,5,200,42,74,116,Thursday
2018,7,5,100,61,122,183,Thursday
2018,7,4,2400,98,225,323,Wednesday
2018,7,4,2300,140,377,517,Wednesday
2018,7,4,2200,184,545,729,Wednesday
2018,7,4,2100,249,778,1027,Wednesday
2018,7,4,2000,272,1013,1285,Wednesday
2018,7,4,1900,363,1177,1540,Wednesday
2018,7,4,1800,507,1298,1805,Wednesday
2018,7,4,1700,548,1076,1624,Wednesday
2018,7,4,1600,636,870,1506,Wednesday
2018,7,4,1500,731,852,1583,Wednesday
2018,7,4,1400,795,660,1455,Wednesday
2018,7,4,1300,957,632,1589,Wednesday
2018,7,4,1200,1128,452,1580,Wednesday
2018,7,4,1100,1229,314,1543,Wednesday
2018,7,4,1000,1047,252,1299,Wednesday
2018,7,4,900,819,171,990,Wednesday
2018,7,4,800,596,121,717,Wednesday
2018,7,4,700,320,70,390,Wednesday
2018,7,4,600,99,45,144,Wednesday
2018,7,4,500,48,53,101,Wednesday
2018,7,4,400,40,46,86,Wednesday
2018,7,4,300,29,47,76,Wednesday
2018,7,4,200,42,76,118,Wednesday
2018,7,4,100,54,99,153,Wednesday
2018,7,3,2400,94,185,279,Tuesday
2018,7,3,2300,108,264,372,Tuesday
2018,7,3,2200,186,412,598,Tuesday
2018,7,3,2100,238,734,972,Tuesday
2018,7,3,2000,267,1085,1352,Tuesday
2018,7,3,1900,363,1164,1527,Tuesday
2018,7,3,1800,419,1185,1604,Tuesday
2018,7,3,1700,464,1040,1504,Tuesday
2018,7,3,1600,650,921,1571,Tuesday
2018,7,3,1500,647,846,1493,Tuesday
2018,7,3,1400,717,881,1598,Tuesday
2018,7,3,1300,856,770,1626,Tuesday
2018,7,3,1200,1049,614,1663,Tuesday
2018,7,3,1100,1116,498,1614,Tuesday
2018,7,3,1000,835,289,1124,Tuesday
2018,7,3,900,665,227,892,Tuesday
2018,7,3,800,441,181,622,Tuesday
2018,7,3,700,230,126,356,Tuesday
2018,7,3,600,84,51,135,Tuesday
2018,7,3,500,35,48,83,Tuesday
2018,7,3,400,23,42,65,Tuesday
2018,7,3,300,32,42,74,Tuesday
2018,7,3,200,20,93,113,Tuesday
2018,7,3,100,25,147,172,Tuesday
2018,7,2,2400,37,234,271,Monday
2018,7,2,2300,92,495,587,Monday
2018,7,2,2200,111,846,957,Monday
2018,7,2,2100,203,1188,1391,Monday
2018,7,2,2000,213,1720,1933,Monday
2018,7,2,1900,334,1861,2195,Monday
2018,7,2,1800,477,1880,2357,Monday
2018,7,2,1700,614,2180,2794,Monday
2018,7,2,1600,858,2177,3035,Monday
2018,7,2,1500,705,1989,2694,Monday
2018,7,2,1400,895,1659,2554,Monday
2018,7,2,1300,1159,1503,2662,Monday
2018,7,2,1200,1292,1132,2424,Monday
2018,7,2,1100,1182,652,1834,Monday
2018,7,2,1000,1051,337,1388,Monday
2018,7,2,900,788,135,923,Monday
2018,7,2,800,484,78,562,Monday
2018,7,2,700,237,44,281,Monday
2018,7,2,600,84,17,101,Monday
2018,7,2,500,45,22,67,Monday
2018,7,2,400,24,23,47,Monday
2018,7,2,300,29,37,66,Monday
2018,7,2,200,24,59,83,Monday
2018,7,2,100,47,113,160,Monday
2018,7,1,2400,64,191,255,Sunday
2018,7,1,2300,91,375,466,Sunday
2018,7,1,2200,139,596,735,Sunday
2018,7,1,2100,162,864,1026,Sunday
2018,7,1,2000,239,1013,1252,Sunday
2018,7,1,1900,326,1376,1702,Sunday
2018,7,1,1800,423,1522,1945,Sunday
2018,7,1,1700,535,1357,1892,Sunday
2018,7,1,1600,729,1128,1857,Sunday
2018,7,1,1500,840,1083,1923,Sunday
2018,7,1,1400,1029,938,1967,Sunday
2018,7,1,1300,1196,693,1889,Sunday
2018,7,1,1200,1205,572,1777,Sunday
2018,7,1,1100,1240,387,1627,Sunday
2018,7,1,1000,1164,260,1424,Sunday
2018,7,1,900,947,166,1113,Sunday
2018,7,1,800,637,68,705,Sunday
2018,7,1,700,344,40,384,Sunday
2018,7,1,600,125,33,158,Sunday
2018,7,1,500,55,22,77,Sunday
2018,7,1,400,35,25,60,Sunday
2018,7,1,300,31,24,55,Sunday
2018,7,1,200,26,46,72,Sunday
2018,7,1,100,47,102,149,Sunday
2018,6,30,2400,78,129,207,Saturday
2018,6,30,2300,140,252,392,Saturday
2018,6,30,2200,182,330,512,Saturday
2018,6,30,2100,248,445,693,Saturday
2018,6,30,2000,317,807,1124,Saturday
2018,6,30,1900,356,914,1270,Saturday
2018,6,30,1800,522,1060,1582,Saturday
2018,6,30,1700,692,1059,1751,Saturday
2018,6,30,1600,823,1106,1929,Saturday
2018,6,30,1500,1109,884,1993,Saturday
2018,6,30,1400,1353,763,2116,Saturday
2018,6,30,1300,1334,558,1892,Saturday
2018,6,30,1200,1645,461,2106,Saturday
2018,6,30,1100,1681,387,2068,Saturday
2018,6,30,1000,1494,256,1750,Saturday
2018,6,30,900,1146,152,1298,Saturday
2018,6,30,800,867,89,956,Saturday
2018,6,30,700,428,72,500,Saturday
2018,6,30,600,188,47,235,Saturday
2018,6,30,500,90,42,132,Saturday
2018,6,30,400,62,94,156,Saturday
2018,6,30,300,46,21,67,Saturday
2018,6,30,200,72,37,109,Saturday
2018,6,30,100,98,102,200,Saturday
2018,6,29,2400,150,143,293,Friday
2018,6,29,2300,292,226,518,Friday
2018,6,29,2200,491,358,849,Friday
2018,6,29,2100,781,458,1239,Friday
2018,6,29,2000,1292,615,1907,Friday
2018,6,29,1900,1034,967,2001,Friday
2018,6,29,1800,1327,868,2195,Friday
2018,6,29,1700,1492,847,2339,Friday
2018,6,29,1600,1561,810,2371,Friday
2018,6,29,1500,1593,746,2339,Friday
2018,6,29,1400,1489,632,2121,Friday
2018,6,29,1300,1564,602,2166,Friday
2018,6,29,1200,1594,512,2106,Friday
2018,6,29,1100,1563,358,1921,Friday
2018,6,29,1000,1486,281,1767,Friday
2018,6,29,900,1183,140,1323,Friday
2018,6,29,800,779,134,913,Friday
2018,6,29,700,461,76,537,Friday
2018,6,29,600,184,58,242,Friday
2018,6,29,500,101,36,137,Friday
2018,6,29,400,49,49,98,Friday
2018,6,29,300,58,53,111,Friday
2018,6,29,200,83,69,152,Friday
2018,6,29,100,90,102,192,Friday
2018,6,28,2400,155,181,336,Thursday
2018,6,28,2300,225,240,465,Thursday
2018,6,28,2200,368,323,691,Thursday
2018,6,28,2100,559,470,1029,Thursday
2018,6,28,2000,674,631,1305,Thursday
2018,6,28,1900,828,782,1610,Thursday
2018,6,28,1800,795,973,1768,Thursday
2018,6,28,1700,911,858,1769,Thursday
2018,6,28,1600,988,780,1768,Thursday
2018,6,28,1500,886,679,1565,Thursday
2018,6,28,1400,899,593,1492,Thursday
2018,6,28,1300,978,494,1472,Thursday
2018,6,28,1200,1177,389,1566,Thursday
2018,6,28,1100,1206,321,1527,Thursday
2018,6,28,1000,1067,246,1313,Thursday
2018,6,28,900,866,176,1042,Thursday
2018,6,28,800,544,117,661,Thursday
2018,6,28,700,291,69,360,Thursday
2018,6,28,600,135,43,178,Thursday
2018,6,28,500,60,34,94,Thursday
2018,6,28,400,31,47,78,Thursday
2018,6,28,300,37,47,84,Thursday
2018,6,28,200,47,77,124,Thursday
2018,6,28,100,69,74,143,Thursday
2018,6,27,2400,115,152,267,Wednesday
2018,6,27,2300,149,275,424,Wednesday
2018,6,27,2200,186,411,597,Wednesday
2018,6,27,2100,280,513,793,Wednesday
2018,6,27,2000,353,727,1080,Wednesday
2018,6,27,1900,409,868,1277,Wednesday
2018,6,27,1800,477,933,1410,Wednesday
2018,6,27,1700,516,830,1346,Wednesday
2018,6,27,1600,610,709,1319,Wednesday
2018,6,27,1500,605,641,1246,Wednesday
2018,6,27,1400,760,486,1246,Wednesday
2018,6,27,1300,716,491,1207,Wednesday
2018,6,27,1200,909,377,1286,Wednesday
2018,6,27,1100,1001,321,1322,Wednesday
2018,6,27,1000,900,234,1134,Wednesday
2018,6,27,900,766,173,939,Wednesday
2018,6,27,800,527,106,633,Wednesday
2018,6,27,700,312,52,364,Wednesday
2018,6,27,600,110,47,157,Wednesday
2018,6,27,500,67,46,113,Wednesday
2018,6,27,400,42,40,82,Wednesday
2018,6,27,300,33,44,77,Wednesday
2018,6,27,200,45,53,98,Wednesday
2018,6,27,100,64,83,147,Wednesday
2018,6,26,2400,85,122,207,Tuesday
2018,6,26,2300,109,205,314,Tuesday
2018,6,26,2200,164,315,479,Tuesday
2018,6,26,2100,201,438,639,Tuesday
2018,6,26,2000,249,586,835,Tuesday
2018,6,26,1900,276,844,1120,Tuesday
2018,6,26,1800,348,924,1272,Tuesday
2018,6,26,1700,426,824,1250,Tuesday
2018,6,26,1600,464,768,1232,Tuesday
2018,6,26,1500,513,691,1204,Tuesday
2018,6,26,1400,549,445,994,Tuesday
2018,6,26,1300,657,515,1172,Tuesday
2018,6,26,1200,788,426,1214,Tuesday
2018,6,26,1100,907,322,1229,Tuesday
2018,6,26,1000,800,218,1018,Tuesday
2018,6,26,900,640,170,810,Tuesday
2018,6,26,800,446,121,567,Tuesday
2018,6,26,700,262,55,317,Tuesday
2018,6,26,600,86,48,134,Tuesday
2018,6,26,500,46,33,79,Tuesday
2018,6,26,400,30,29,59,Tuesday
2018,6,26,300,24,49,73,Tuesday
2018,6,26,200,41,45,86,Tuesday
2018,6,26,100,51,81,132,Tuesday
2018,6,25,2400,65,133,198,Monday
2018,6,25,2300,116,202,318,Monday
2018,6,25,2200,160,472,632,Monday
2018,6,25,2100,199,554,753,Monday
2018,6,25,2000,246,702,948,Monday
2018,6,25,1900,286,792,1078,Monday
2018,6,25,1800,354,995,1349,Monday
2018,6,25,1700,414,900,1314,Monday
2018,6,25,1600,492,864,1356,Monday
2018,6,25,1500,601,703,1304,Monday
2018,6,25,1400,626,605,1231,Monday
2018,6,25,1300,763,540,1303,Monday
2018,6,25,1200,857,410,1267,Monday
2018,6,25,1100,869,367,1236,Monday
2018,6,25,1000,730,340,1070,Monday
2018,6,25,900,657,197,854,Monday
2018,6,25,800,524,127,651,Monday
2018,6,25,700,291,62,353,Monday
2018,6,25,600,117,37,154,Monday
2018,6,25,500,58,24,82,Monday
2018,6,25,400,20,32,52,Monday
2018,6,25,300,31,28,59,Monday
2018,6,25,200,43,68,111,Monday
2018,6,25,100,45,106,151,Monday
2018,6,24,2400,65,162,227,Sunday
2018,6,24,2300,106,366,472,Sunday
2018,6,24,2200,128,622,750,Sunday
2018,6,24,2100,165,876,1041,Sunday
2018,6,24,2000,293,1176,1469,Sunday
2018,6,24,1900,325,1439,1764,Sunday
2018,6,24,1800,394,1739,2133,Sunday
2018,6,24,1700,423,1592,2015,Sunday
2018,6,24,1600,619,1488,2107,Sunday
2018,6,24,1500,728,1165,1893,Sunday
2018,6,24,1400,662,1029,1691,Sunday
2018,6,24,1300,895,836,1731,Sunday
2018,6,24,1200,1112,683,1795,Sunday
2018,6,24,1100,1082,470,1552,Sunday
2018,6,24,1000,967,258,1225,Sunday
2018,6,24,900,861,145,1006,Sunday
2018,6,24,800,591,69,660,Sunday
2018,6,24,700,289,37,326,Sunday
2018,6,24,600,111,31,142,Sunday
2018,6,24,500,58,18,76,Sunday
2018,6,24,400,27,25,52,Sunday
2018,6,24,300,26,30,56,Sunday
2018,6,24,200,30,27,57,Sunday
2018,6,24,100,37,56,93,Sunday
2018,6,23,2400,63,142,205,Saturday
2018,6,23,2300,76,215,291,Saturday
2018,6,23,2200,127,318,445,Saturday
2018,6,23,2100,185,481,666,Saturday
2018,6,23,2000,224,573,797,Saturday
2018,6,23,1900,266,673,939,Saturday
2018,6,23,1800,305,725,1030,Saturday
2018,6,23,1700,353,760,1113,Saturday
2018,6,23,1600,447,645,1092,Saturday
2018,6,23,1500,581,507,1088,Saturday
2018,6,23,1400,649,496,1145,Saturday
2018,6,23,1300,686,448,1134,Saturday
2018,6,23,1200,846,377,1223,Saturday
2018,6,23,1100,873,313,1186,Saturday
2018,6,23,1000,789,223,1012,Saturday
2018,6,23,900,578,147,725,Saturday
2018,6,23,800,402,96,498,Saturday
2018,6,23,700,176,49,225,Saturday
2018,6,23,600,81,38,119,Saturday
2018,6,23,500,31,21,52,Saturday
2018,6,23,400,20,45,65,Saturday
2018,6,23,300,33,30,63,Saturday
2018,6,23,200,49,35,84,Saturday
2018,6,23,100,54,64,118,Saturday
2018,6,22,2400,103,86,189,Friday
2018,6,22,2300,135,169,304,Friday
2018,6,22,2200,243,322,565,Friday
2018,6,22,2100,393,386,779,Friday
2018,6,22,2000,622,484,1106,Friday
2018,6,22,1900,704,615,1319,Friday
2018,6,22,1800,678,738,1416,Friday
2018,6,22,1700,747,768,1515,Friday
2018,6,22,1600,783,796,1579,Friday
2018,6,22,1500,815,689,1504,Friday
2018,6,22,1400,787,703,1490,Friday
2018,6,22,1300,802,547,1349,Friday
2018,6,22,1200,916,465,1381,Friday
2018,6,22,1100,949,399,1348,Friday
2018,6,22,1000,887,233,1120,Friday
2018,6,22,900,724,180,904,Friday
2018,6,22,800,487,109,596,Friday
2018,6,22,700,270,76,346,Friday
2018,6,22,600,101,48,149,Friday
2018,6,22,500,49,29,78,Friday
2018,6,22,400,41,45,86,Friday
2018,6,22,300,43,45,88,Friday
2018,6,22,200,37,51,88,Friday
2018,6,22,100,50,88,138,Friday
2018,6,21,2400,103,130,233,Thursday
2018,6,21,2300,158,178,336,Thursday
2018,6,21,2200,214,291,505,Thursday
2018,6,21,2100,303,358,661,Thursday
2018,6,21,2000,381,469,850,Thursday
2018,6,21,1900,411,686,1097,Thursday
2018,6,21,1800,499,926,1425,Thursday
2018,6,21,1700,439,774,1213,Thursday
2018,6,21,1600,538,757,1295,Thursday
2018,6,21,1500,614,609,1223,Thursday
2018,6,21,1400,561,590,1151,Thursday
2018,6,21,1300,680,487,1167,Thursday
2018,6,21,1200,858,397,1255,Thursday
2018,6,21,1100,900,347,1247,Thursday
2018,6,21,1000,851,235,1086,Thursday
2018,6,21,900,704,159,863,Thursday
2018,6,21,800,561,125,686,Thursday
2018,6,21,700,267,74,341,Thursday
2018,6,21,600,95,35,130,Thursday
2018,6,21,500,55,40,95,Thursday
2018,6,21,400,34,48,82,Thursday
2018,6,21,300,38,38,76,Thursday
2018,6,21,200,48,53,101,Thursday
2018,6,21,100,49,97,146,Thursday
2018,6,20,2400,105,155,260,Wednesday
2018,6,20,2300,133,226,359,Wednesday
2018,6,20,2200,162,383,545,Wednesday
2018,6,20,2100,255,528,783,Wednesday
2018,6,20,2000,260,624,884,Wednesday
2018,6,20,1900,286,794,1080,Wednesday
2018,6,20,1800,359,762,1121,Wednesday
2018,6,20,1700,451,732,1183,Wednesday
2018,6,20,1600,465,717,1182,Wednesday
2018,6,20,1500,518,622,1140,Wednesday
2018,6,20,1400,581,470,1051,Wednesday
2018,6,20,1300,643,557,1200,Wednesday
2018,6,20,1200,809,274,1083,Wednesday
2018,6,20,1100,902,270,1172,Wednesday
2018,6,20,1000,781,210,991,Wednesday
2018,6,20,900,673,182,855,Wednesday
2018,6,20,800,570,112,682,Wednesday
2018,6,20,700,275,65,340,Wednesday
2018,6,20,600,101,46,147,Wednesday
2018,6,20,500,40,44,84,Wednesday
2018,6,20,400,40,31,71,Wednesday
2018,6,20,300,27,58,85,Wednesday
2018,6,20,200,31,68,99,Wednesday
2018,6,20,100,49,78,127,Wednesday
2018,6,19,2400,93,137,230,Tuesday
2018,6,19,2300,130,245,375,Tuesday
2018,6,19,2200,163,363,526,Tuesday
2018,6,19,2100,181,526,707,Tuesday
2018,6,19,2000,213,590,803,Tuesday
2018,6,19,1900,262,788,1050,Tuesday
2018,6,19,1800,311,832,1143,Tuesday
2018,6,19,1700,369,829,1198,Tuesday
2018,6,19,1600,414,654,1068,Tuesday
2018,6,19,1500,473,572,1045,Tuesday
2018,6,19,1400,584,479,1063,Tuesday
2018,6,19,1300,625,484,1109,Tuesday
2018,6,19,1200,750,295,1045,Tuesday
2018,6,19,1100,917,300,1217,Tuesday
2018,6,19,1000,752,199,951,Tuesday
2018,6,19,900,695,158,853,Tuesday
2018,6,19,800,509,92,601,Tuesday
2018,6,19,700,273,67,340,Tuesday
2018,6,19,600,106,51,157,Tuesday
2018,6,19,500,51,35,86,Tuesday
2018,6,19,400,38,44,82,Tuesday
2018,6,19,300,25,50,75,Tuesday
2018,6,19,200,41,40,81,Tuesday
2018,6,19,100,49,87,136,Tuesday
2018,6,18,2400,58,150,208,Monday
2018,6,18,2300,113,235,348,Monday
2018,6,18,2200,149,402,551,Monday
2018,6,18,2100,198,560,758,Monday
2018,6,18,2000,254,706,960,Monday
2018,6,18,1900,308,956,1264,Monday
2018,6,18,1800,354,989,1343,Monday
2018,6,18,1700,360,1010,1370,Monday
2018,6,18,1600,461,768,1229,Monday
2018,6,18,1500,589,651,1240,Monday
2018,6,18,1400,594,551,1145,Monday
2018,6,18,1300,730,478,1208,Monday
2018,6,18,1200,928,413,1341,Monday
2018,6,18,1100,981,336,1317,Monday
2018,6,18,1000,909,227,1136,Monday
2018,6,18,900,715,148,863,Monday
2018,6,18,800,516,124,640,Monday
2018,6,18,700,242,65,307,Monday
2018,6,18,600,86,43,129,Monday
2018,6,18,500,39,23,62,Monday
2018,6,18,400,26,27,53,Monday
2018,6,18,300,32,41,73,Monday
2018,6,18,200,24,50,74,Monday
2018,6,18,100,37,79,116,Monday
2018,6,17,2400,44,149,193,Sunday
2018,6,17,2300,89,320,409,Sunday
2018,6,17,2200,159,575,734,Sunday
2018,6,17,2100,181,915,1096,Sunday
2018,6,17,2000,216,1239,1455,Sunday
2018,6,17,1900,258,1261,1519,Sunday
2018,6,17,1800,373,1488,1861,Sunday
2018,6,17,1700,457,1548,2005,Sunday
2018,6,17,1600,545,1340,1885,Sunday
2018,6,17,1500,744,1325,2069,Sunday
2018,6,17,1400,932,1087,2019,Sunday
2018,6,17,1300,1029,1005,2034,Sunday
2018,6,17,1200,1086,669,1755,Sunday
2018,6,17,1100,1153,479,1632,Sunday
2018,6,17,1000,1005,226,1231,Sunday
2018,6,17,900,750,138,888,Sunday
2018,6,17,800,480,107,587,Sunday
2018,6,17,700,201,41,242,Sunday
2018,6,17,600,75,26,101,Sunday
2018,6,17,500,48,10,58,Sunday
2018,6,17,400,18,28,46,Sunday
2018,6,17,300,13,25,38,Sunday
2018,6,17,200,22,41,63,Sunday
2018,6,17,100,31,56,87,Sunday
2018,6,16,2400,41,129,170,Saturday
2018,6,16,2300,91,214,305,Saturday
2018,6,16,2200,154,285,439,Saturday
2018,6,16,2100,160,453,613,Saturday
2018,6,16,2000,183,560,743,Saturday
2018,6,16,1900,234,788,1022,Saturday
2018,6,16,1800,268,773,1041,Saturday
2018,6,16,1700,394,752,1146,Saturday
2018,6,16,1600,499,712,1211,Saturday
2018,6,16,1500,545,550,1095,Saturday
2018,6,16,1400,633,543,1176,Saturday
2018,6,16,1300,700,382,1082,Saturday
2018,6,16,1200,918,348,1266,Saturday
2018,6,16,1100,917,276,1193,Saturday
2018,6,16,1000,772,175,947,Saturday
2018,6,16,900,595,133,728,Saturday
2018,6,16,800,396,78,474,Saturday
2018,6,16,700,164,61,225,Saturday
2018,6,16,600,79,33,112,Saturday
2018,6,16,500,29,21,50,Saturday
2018,6,16,400,28,32,60,Saturday
2018,6,16,300,39,43,82,Saturday
2018,6,16,200,32,58,90,Saturday
2018,6,16,100,49,62,111,Saturday
2018,6,15,2400,77,100,177,Friday
2018,6,15,2300,161,193,354,Friday
2018,6,15,2200,239,228,467,Friday
2018,6,15,2100,405,365,770,Friday
2018,6,15,2000,606,591,1197,Friday
2018,6,15,1900,761,650,1411,Friday
2018,6,15,1800,777,748,1525,Friday
2018,6,15,1700,786,797,1583,Friday
2018,6,15,1600,841,709,1550,Friday
2018,6,15,1500,797,659,1456,Friday
2018,6,15,1400,738,461,1199,Friday
2018,6,15,1300,807,422,1229,Friday
2018,6,15,1200,875,440,1315,Friday
2018,6,15,1100,918,281,1199,Friday
2018,6,15,1000,844,195,1039,Friday
2018,6,15,900,596,128,724,Friday
2018,6,15,800,406,100,506,Friday
2018,6,15,700,209,65,274,Friday
2018,6,15,600,93,45,138,Friday
2018,6,15,500,41,30,71,Friday
2018,6,15,400,53,31,84,Friday
2018,6,15,300,33,46,79,Friday
2018,6,15,200,43,65,108,Friday
2018,6,15,100,61,95,156,Friday
2018,6,14,2400,91,117,208,Thursday
2018,6,14,2300,143,173,316,Thursday
2018,6,14,2200,201,281,482,Thursday
2018,6,14,2100,291,397,688,Thursday
2018,6,14,2000,350,455,805,Thursday
2018,6,14,1900,410,601,1011,Thursday
2018,6,14,1800,436,591,1027,Thursday
2018,6,14,1700,467,599,1066,Thursday
2018,6,14,1600,522,587,1109,Thursday
2018,6,14,1500,552,612,1164,Thursday
2018,6,14,1400,542,312,854,Thursday
2018,6,14,1300,619,439,1058,Thursday
2018,6,14,1200,743,402,1145,Thursday
2018,6,14,1100,742,300,1042,Thursday
2018,6,14,1000,645,212,857,Thursday
2018,6,14,900,468,132,600,Thursday
2018,6,14,800,354,103,457,Thursday
2018,6,14,700,180,48,228,Thursday
2018,6,14,600,67,43,110,Thursday
2018,6,14,500,31,37,68,Thursday
2018,6,14,400,34,41,75,Thursday
2018,6,14,300,43,48,91,Thursday
2018,6,14,200,41,48,89,Thursday
2018,6,14,100,46,70,116,Thursday
2018,6,13,2400,82,97,179,Wednesday
2018,6,13,2300,97,176,273,Wednesday
2018,6,13,2200,137,295,432,Wednesday
2018,6,13,2100,196,376,572,Wednesday
2018,6,13,2000,209,553,762,Wednesday
2018,6,13,1900,250,632,882,Wednesday
2018,6,13,1800,294,702,996,Wednesday
2018,6,13,1700,410,823,1233,Wednesday
2018,6,13,1600,465,618,1083,Wednesday
2018,6,13,1500,475,551,1026,Wednesday
2018,6,13,1400,488,513,1001,Wednesday
2018,6,13,1300,584,410,994,Wednesday
2018,6,13,1200,720,290,1010,Wednesday
2018,6,13,1100,727,315,1042,Wednesday
2018,6,13,1000,727,196,923,Wednesday
2018,6,13,900,572,136,708,Wednesday
2018,6,13,800,395,96,491,Wednesday
2018,6,13,700,181,65,246,Wednesday
2018,6,13,600,67,41,108,Wednesday
2018,6,13,500,37,36,73,Wednesday
2018,6,13,400,32,41,73,Wednesday
2018,6,13,300,37,40,77,Wednesday
2018,6,13,200,44,50,94,Wednesday
2018,6,13,100,67,60,127,Wednesday
2018,6,12,2400,62,128,190,Tuesday
2018,6,12,2300,100,211,311,Tuesday
2018,6,12,2200,139,359,498,Tuesday
2018,6,12,2100,158,516,674,Tuesday
2018,6,12,2000,195,664,859,Tuesday
2018,6,12,1900,238,707,945,Tuesday
2018,6,12,1800,304,781,1085,Tuesday
2018,6,12,1700,333,708,1041,Tuesday
2018,6,12,1600,451,714,1165,Tuesday
2018,6,12,1500,435,513,948,Tuesday
2018,6,12,1400,466,460,926,Tuesday
2018,6,12,1300,546,391,937,Tuesday
2018,6,12,1200,730,334,1064,Tuesday
2018,6,12,1100,819,256,1075,Tuesday
2018,6,12,1000,698,191,889,Tuesday
2018,6,12,900,626,130,756,Tuesday
2018,6,12,800,407,102,509,Tuesday
2018,6,12,700,174,49,223,Tuesday
2018,6,12,600,65,45,110,Tuesday
2018,6,12,500,49,34,83,Tuesday
2018,6,12,400,31,49,80,Tuesday
2018,6,12,300,32,36,68,Tuesday
2018,6,12,200,39,39,78,Tuesday
2018,6,12,100,35,66,101,Tuesday
2018,6,11,2400,68,108,176,Monday
2018,6,11,2300,105,171,276,Monday
2018,6,11,2200,137,300,437,Monday
2018,6,11,2100,191,509,700,Monday
2018,6,11,2000,222,597,819,Monday
2018,6,11,1900,269,659,928,Monday
2018,6,11,1800,286,778,1064,Monday
2018,6,11,1700,365,769,1134,Monday
2018,6,11,1600,419,571,990,Monday
2018,6,11,1500,492,581,1073,Monday
2018,6,11,1400,528,478,1006,Monday
2018,6,11,1300,603,471,1074,Monday
2018,6,11,1200,808,328,1136,Monday
2018,6,11,1100,825,249,1074,Monday
2018,6,11,1000,756,201,957,Monday
2018,6,11,900,550,137,687,Monday
2018,6,11,800,356,83,439,Monday
2018,6,11,700,129,50,179,Monday
2018,6,11,600,65,28,93,Monday
2018,6,11,500,29,21,50,Monday
2018,6,11,400,21,26,47,Monday
2018,6,11,300,26,23,49,Monday
2018,6,11,200,25,43,68,Monday
2018,6,11,100,30,71,101,Monday
2018,6,10,2400,63,100,163,Sunday
2018,6,10,2300,85,191,276,Sunday
2018,6,10,2200,144,274,418,Sunday
2018,6,10,2100,167,414,581,Sunday
2018,6,10,2000,184,625,809,Sunday
2018,6,10,1900,252,834,1086,Sunday
2018,6,10,1800,329,981,1310,Sunday
2018,6,10,1700,452,1046,1498,Sunday
2018,6,10,1600,482,1093,1575,Sunday
2018,6,10,1500,547,983,1530,Sunday
2018,6,10,1400,532,899,1431,Sunday
2018,6,10,1300,632,913,1545,Sunday
2018,6,10,1200,735,631,1366,Sunday
2018,6,10,1100,637,472,1109,Sunday
2018,6,10,1000,540,290,830,Sunday
2018,6,10,900,388,113,501,Sunday
2018,6,10,800,238,65,303,Sunday
2018,6,10,700,106,33,139,Sunday
2018,6,10,600,45,10,55,Sunday
2018,6,10,500,28,11,39,Sunday
2018,6,10,400,23,19,42,Sunday
2018,6,10,300,21,26,47,Sunday
2018,6,10,200,15,28,43,Sunday
2018,6,10,100,31,58,89,Sunday
2018,6,9,2400,44,100,144,Saturday
2018,6,9,2300,102,159,261,Saturday
2018,6,9,2200,102,226,328,Saturday
2018,6,9,2100,154,298,452,Saturday
2018,6,9,2000,182,403,585,Saturday
2018,6,9,1900,214,726,940,Saturday
2018,6,9,1800,292,885,1177,Saturday
2018,6,9,1700,370,816,1186,Saturday
2018,6,9,1600,400,756,1156,Saturday
2018,6,9,1500,473,542,1015,Saturday
2018,6,9,1400,569,519,1088,Saturday
2018,6,9,1300,717,483,1200,Saturday
2018,6,9,1200,735,459,1194,Saturday
2018,6,9,1100,810,392,1202,Saturday
2018,6,9,1000,717,137,854,Saturday
2018,6,9,900,583,154,737,Saturday
2018,6,9,800,325,71,396,Saturday
2018,6,9,700,173,44,217,Saturday
2018,6,9,600,75,38,113,Saturday
2018,6,9,500,36,27,63,Saturday
2018,6,9,400,34,31,65,Saturday
2018,6,9,300,34,33,67,Saturday
2018,6,9,200,42,46,88,Saturday
2018,6,9,100,55,64,119,Saturday
2018,6,8,2400,87,137,224,Friday
2018,6,8,2300,130,196,326,Friday
2018,6,8,2200,218,315,533,Friday
2018,6,8,2100,347,444,791,Friday
2018,6,8,2000,506,581,1087,Friday
2018,6,8,1900,557,658,1215,Friday
2018,6,8,1800,620,823,1443,Friday
2018,6,8,1700,621,804,1425,Friday
2018,6,8,1600,646,662,1308,Friday
2018,6,8,1500,689,607,1296,Friday
2018,6,8,1400,684,658,1342,Friday
2018,6,8,1300,716,496,1212,Friday
2018,6,8,1200,984,243,1227,Friday
2018,6,8,1100,930,286,1216,Friday
2018,6,8,1000,843,207,1050,Friday
2018,6,8,900,658,134,792,Friday
2018,6,8,800,432,122,554,Friday
2018,6,8,700,229,70,299,Friday
2018,6,8,600,80,42,122,Friday
2018,6,8,500,51,42,93,Friday
2018,6,8,400,41,38,79,Friday
2018,6,8,300,32,57,89,Friday
2018,6,8,200,36,35,71,Friday
2018,6,8,100,53,68,121,Friday
2018,6,7,2400,88,114,202,Thursday
2018,6,7,2300,125,184,309,Thursday
2018,6,7,2200,216,268,484,Thursday
2018,6,7,2100,253,373,626,Thursday
2018,6,7,2000,320,473,793,Thursday
2018,6,7,1900,374,603,977,Thursday
2018,6,7,1800,398,793,1191,Thursday
2018,6,7,1700,458,648,1106,Thursday
2018,6,7,1600,493,659,1152,Thursday
2018,6,7,1500,505,475,980,Thursday
2018,6,7,1400,526,445,971,Thursday
2018,6,7,1300,689,393,1082,Thursday
2018,6,7,1200,772,326,1098,Thursday
2018,6,7,1100,777,261,1038,Thursday
2018,6,7,1000,750,188,938,Thursday
2018,6,7,900,600,145,745,Thursday
2018,6,7,800,408,97,505,Thursday
2018,6,7,700,185,70,255,Thursday
2018,6,7,600,63,39,102,Thursday
2018,6,7,500,42,22,64,Thursday
2018,6,7,400,42,33,75,Thursday
2018,6,7,300,38,45,83,Thursday
2018,6,7,200,37,50,87,Thursday
2018,6,7,100,44,72,116,Thursday
2018,6,6,2400,80,95,175,Wednesday
2018,6,6,2300,122,167,289,Wednesday
2018,6,6,2200,132,260,392,Wednesday
2018,6,6,2100,190,391,581,Wednesday
2018,6,6,2000,216,430,646,Wednesday
2018,6,6,1900,267,610,877,Wednesday
2018,6,6,1800,287,659,946,Wednesday
2018,6,6,1700,369,676,1045,Wednesday
2018,6,6,1600,405,588,993,Wednesday
2018,6,6,1500,425,513,938,Wednesday
2018,6,6,1400,481,427,908,Wednesday
2018,6,6,1300,585,333,918,Wednesday
2018,6,6,1200,634,300,934,Wednesday
2018,6,6,1100,730,267,997,Wednesday
2018,6,6,1000,687,163,850,Wednesday
2018,6,6,900,517,141,658,Wednesday
2018,6,6,800,343,109,452,Wednesday
2018,6,6,700,168,68,236,Wednesday
2018,6,6,600,74,31,105,Wednesday
2018,6,6,500,49,33,82,Wednesday
2018,6,6,400,36,36,72,Wednesday
2018,6,6,300,34,38,72,Wednesday
2018,6,6,200,27,43,70,Wednesday
2018,6,6,100,52,66,118,Wednesday
2018,6,5,2400,81,93,174,Tuesday
2018,6,5,2300,92,156,248,Tuesday
2018,6,5,2200,132,218,350,Tuesday
2018,6,5,2100,170,341,511,Tuesday
2018,6,5,2000,176,443,619,Tuesday
2018,6,5,1900,208,570,778,Tuesday
2018,6,5,1800,246,654,900,Tuesday
2018,6,5,1700,289,637,926,Tuesday
2018,6,5,1600,337,486,823,Tuesday
2018,6,5,1500,369,441,810,Tuesday
2018,6,5,1400,402,401,803,Tuesday
2018,6,5,1300,494,354,848,Tuesday
2018,6,5,1200,617,255,872,Tuesday
2018,6,5,1100,699,243,942,Tuesday
2018,6,5,1000,591,184,775,Tuesday
2018,6,5,900,466,129,595,Tuesday
2018,6,5,800,263,94,357,Tuesday
2018,6,5,700,140,53,193,Tuesday
2018,6,5,600,70,46,116,Tuesday
2018,6,5,500,38,38,76,Tuesday
2018,6,5,400,30,30,60,Tuesday
2018,6,5,300,25,51,76,Tuesday
2018,6,5,200,25,42,67,Tuesday
2018,6,5,100,48,91,139,Tuesday
2018,6,4,2400,82,110,192,Monday
2018,6,4,2300,116,160,276,Monday
2018,6,4,2200,144,231,375,Monday
2018,6,4,2100,165,379,544,Monday
2018,6,4,2000,193,415,608,Monday
2018,6,4,1900,199,695,894,Monday
2018,6,4,1800,278,791,1069,Monday
2018,6,4,1700,350,663,1013,Monday
2018,6,4,1600,377,541,918,Monday
2018,6,4,1500,414,582,996,Monday
2018,6,4,1400,457,491,948,Monday
2018,6,4,1300,607,413,1020,Monday
2018,6,4,1200,707,336,1043,Monday
2018,6,4,1100,797,277,1074,Monday
2018,6,4,1000,680,211,891,Monday
2018,6,4,900,485,142,627,Monday
2018,6,4,800,310,96,406,Monday
2018,6,4,700,140,61,201,Monday
2018,6,4,600,59,40,99,Monday
2018,6,4,500,37,36,73,Monday
2018,6,4,400,22,27,49,Monday
2018,6,4,300,22,24,46,Monday
2018,6,4,200,24,47,71,Monday
2018,6,4,100,28,76,104,Monday
2018,6,3,2400,70,92,162,Sunday
2018,6,3,2300,85,203,288,Sunday
2018,6,3,2200,117,335,452,Sunday
2018,6,3,2100,182,536,718,Sunday
2018,6,3,2000,210,795,1005,Sunday
2018,6,3,1900,237,847,1084,Sunday
2018,6,3,1800,325,1057,1382,Sunday
2018,6,3,1700,348,1176,1524,Sunday
2018,6,3,1600,396,1189,1585,Sunday
2018,6,3,1500,454,977,1431,Sunday
2018,6,3,1400,531,862,1393,Sunday
2018,6,3,1300,598,799,1397,Sunday
2018,6,3,1200,747,489,1236,Sunday
2018,6,3,1100,680,333,1013,Sunday
2018,6,3,1000,652,193,845,Sunday
2018,6,3,900,427,99,526,Sunday
2018,6,3,800,259,62,321,Sunday
2018,6,3,700,128,26,154,Sunday
2018,6,3,600,37,24,61,Sunday
2018,6,3,500,22,18,40,Sunday
2018,6,3,400,19,12,31,Sunday
2018,6,3,300,27,22,49,Sunday
2018,6,3,200,25,36,61,Sunday
2018,6,3,100,38,60,98,Sunday
2018,6,2,2400,40,102,142,Saturday
2018,6,2,2300,89,221,310,Saturday
2018,6,2,2200,101,265,366,Saturday
2018,6,2,2100,148,361,509,Saturday
2018,6,2,2000,179,442,621,Saturday
2018,6,2,1900,212,673,885,Saturday
2018,6,2,1800,257,783,1040,Saturday
2018,6,2,1700,315,685,1000,Saturday
2018,6,2,1600,421,614,1035,Saturday
2018,6,2,1500,475,545,1020,Saturday
2018,6,2,1400,548,465,1013,Saturday
2018,6,2,1300,647,442,1089,Saturday
2018,6,2,1200,801,316,1117,Saturday
2018,6,2,1100,792,252,1044,Saturday
2018,6,2,1000,730,169,899,Saturday
2018,6,2,900,487,136,623,Saturday
2018,6,2,800,329,73,402,Saturday
2018,6,2,700,191,56,247,Saturday
2018,6,2,600,90,35,125,Saturday
2018,6,2,500,46,35,81,Saturday
2018,6,2,400,35,35,70,Saturday
2018,6,2,300,21,24,45,Saturday
2018,6,2,200,43,42,85,Saturday
2018,6,2,100,44,74,118,Saturday
2018,6,1,2400,75,74,149,Friday
2018,6,1,2300,137,131,268,Friday
2018,6,1,2200,204,218,422,Friday
2018,6,1,2100,371,305,676,Friday
2018,6,1,2000,544,422,966,Friday
2018,6,1,1900,690,603,1293,Friday
2018,6,1,1800,609,633,1242,Friday
2018,6,1,1700,642,622,1264,Friday
2018,6,1,1600,641,562,1203,Friday
2018,6,1,1500,714,536,1250,Friday
2018,6,1,1400,613,458,1071,Friday
2018,6,1,1300,635,362,997,Friday
2018,6,1,1200,727,270,997,Friday
2018,6,1,1100,731,238,969,Friday
2018,6,1,1000,624,203,827,Friday
2018,6,1,900,471,144,615,Friday
2018,6,1,800,275,104,379,Friday
2018,6,1,700,174,71,245,Friday
2018,6,1,600,76,53,129,Friday
2018,6,1,500,41,51,92,Friday
2018,6,1,400,38,21,59,Friday
2018,6,1,300,39,31,70,Friday
2018,6,1,200,27,48,75,Friday
2018,6,1,100,48,85,133,Friday
2018,5,31,2400,87,99,186,Thursday
2018,5,31,2300,99,127,226,Thursday
2018,5,31,2200,159,172,331,Thursday
2018,5,31,2100,250,295,545,Thursday
2018,5,31,2000,343,371,714,Thursday
2018,5,31,1900,326,459,785,Thursday
2018,5,31,1800,375,589,964,Thursday
2018,5,31,1700,388,596,984,Thursday
2018,5,31,1600,442,540,982,Thursday
2018,5,31,1500,441,481,922,Thursday
2018,5,31,1400,463,372,835,Thursday
2018,5,31,1300,500,332,832,Thursday
2018,5,31,1200,569,316,885,Thursday
2018,5,31,1100,652,256,908,Thursday
2018,5,31,1000,512,187,699,Thursday
2018,5,31,900,449,136,585,Thursday
2018,5,31,800,250,89,339,Thursday
2018,5,31,700,154,53,207,Thursday
2018,5,31,600,66,44,110,Thursday
2018,5,31,500,27,35,62,Thursday
2018,5,31,400,40,32,72,Thursday
2018,5,31,300,37,53,90,Thursday
2018,5,31,200,33,44,77,Thursday
2018,5,31,100,50,73,123,Thursday
2018,5,30,2400,81,93,174,Wednesday
2018,5,30,2300,108,132,240,Wednesday
2018,5,30,2200,156,206,362,Wednesday
2018,5,30,2100,183,308,491,Wednesday
2018,5,30,2000,180,408,588,Wednesday
2018,5,30,1900,249,505,754,Wednesday
2018,5,30,1800,265,503,768,Wednesday
2018,5,30,1700,318,638,956,Wednesday
2018,5,30,1600,360,551,911,Wednesday
2018,5,30,1500,401,429,830,Wednesday
2018,5,30,1400,399,390,789,Wednesday
2018,5,30,1300,449,377,826,Wednesday
2018,5,30,1200,560,281,841,Wednesday
2018,5,30,1100,556,245,801,Wednesday
2018,5,30,1000,469,179,648,Wednesday
2018,5,30,900,345,148,493,Wednesday
2018,5,30,800,251,97,348,Wednesday
2018,5,30,700,132,71,203,Wednesday
2018,5,30,600,62,37,99,Wednesday
2018,5,30,500,30,36,66,Wednesday
2018,5,30,400,30,42,72,Wednesday
2018,5,30,300,37,44,81,Wednesday
2018,5,30,200,34,49,83,Wednesday
2018,5,30,100,55,86,141,Wednesday
2018,5,29,2400,58,80,138,Tuesday
2018,5,29,2300,86,133,219,Tuesday
2018,5,29,2200,106,185,291,Tuesday
2018,5,29,2100,166,249,415,Tuesday
2018,5,29,2000,185,322,507,Tuesday
2018,5,29,1900,197,505,702,Tuesday
2018,5,29,1800,234,505,739,Tuesday
2018,5,29,1700,298,617,915,Tuesday
2018,5,29,1600,342,600,942,Tuesday
2018,5,29,1500,355,497,852,Tuesday
2018,5,29,1400,352,375,727,Tuesday
2018,5,29,1300,418,317,735,Tuesday
2018,5,29,1200,540,337,877,Tuesday
2018,5,29,1100,459,257,716,Tuesday
2018,5,29,1000,492,209,701,Tuesday
2018,5,29,900,341,121,462,Tuesday
2018,5,29,800,248,69,317,Tuesday
2018,5,29,700,124,66,190,Tuesday
2018,5,29,600,46,35,81,Tuesday
2018,5,29,500,34,28,62,Tuesday
2018,5,29,400,34,42,76,Tuesday
2018,5,29,300,23,41,64,Tuesday
2018,5,29,200,24,41,65,Tuesday
2018,5,29,100,46,71,117,Tuesday
2018,5,28,2400,89,135,224,Monday
2018,5,28,2300,96,183,279,Monday
2018,5,28,2200,131,323,454,Monday
2018,5,28,2100,165,402,567,Monday
2018,5,28,2000,196,530,726,Monday
2018,5,28,1900,231,610,841,Monday
2018,5,28,1800,279,800,1079,Monday
2018,5,28,1700,349,733,1082,Monday
2018,5,28,1600,374,575,949,Monday
2018,5,28,1500,483,545,1028,Monday
2018,5,28,1400,452,507,959,Monday
2018,5,28,1300,522,358,880,Monday
2018,5,28,1200,736,350,1086,Monday
2018,5,28,1100,742,270,1012,Monday
2018,5,28,1000,682,205,887,Monday
2018,5,28,900,482,132,614,Monday
2018,5,28,800,324,120,444,Monday
2018,5,28,700,163,75,238,Monday
2018,5,28,600,74,44,118,Monday
2018,5,28,500,43,21,64,Monday
2018,5,28,400,26,32,58,Monday
2018,5,28,300,28,35,63,Monday
2018,5,28,200,25,47,72,Monday
2018,5,28,100,40,89,129,Monday
2018,5,27,2400,42,139,181,Sunday
2018,5,27,2300,89,253,342,Sunday
2018,5,27,2200,127,442,569,Sunday
2018,5,27,2100,177,725,902,Sunday
2018,5,27,2000,178,922,1100,Sunday
2018,5,27,1900,272,1042,1314,Sunday
2018,5,27,1800,318,1236,1554,Sunday
2018,5,27,1700,368,1180,1548,Sunday
2018,5,27,1600,480,974,1454,Sunday
2018,5,27,1500,550,895,1445,Sunday
2018,5,27,1400,744,749,1493,Sunday
2018,5,27,1300,662,625,1287,Sunday
2018,5,27,1200,666,483,1149,Sunday
2018,5,27,1100,679,316,995,Sunday
2018,5,27,1000,613,199,812,Sunday
2018,5,27,900,453,134,587,Sunday
2018,5,27,800,302,64,366,Sunday
2018,5,27,700,120,33,153,Sunday
2018,5,27,600,50,19,69,Sunday
2018,5,27,500,33,39,72,Sunday
2018,5,27,400,25,33,58,Sunday
2018,5,27,300,24,39,63,Sunday
2018,5,27,200,31,36,67,Sunday
2018,5,27,100,39,48,87,Sunday
2018,5,26,2400,44,106,150,Saturday
2018,5,26,2300,87,191,278,Saturday
2018,5,26,2200,118,229,347,Saturday
2018,5,26,2100,155,397,552,Saturday
2018,5,26,2000,169,517,686,Saturday
2018,5,26,1900,214,635,849,Saturday
2018,5,26,1800,278,745,1023,Saturday
2018,5,26,1700,323,579,902,Saturday
2018,5,26,1600,384,632,1016,Saturday
2018,5,26,1500,578,517,1095,Saturday
2018,5,26,1400,643,457,1100,Saturday
2018,5,26,1300,494,402,896,Saturday
2018,5,26,1200,582,319,901,Saturday
2018,5,26,1100,611,254,865,Saturday
2018,5,26,1000,674,168,842,Saturday
2018,5,26,900,545,135,680,Saturday
2018,5,26,800,278,90,368,Saturday
2018,5,26,700,142,52,194,Saturday
2018,5,26,600,67,42,109,Saturday
2018,5,26,500,34,31,65,Saturday
2018,5,26,400,36,30,66,Saturday
2018,5,26,300,36,40,76,Saturday
2018,5,26,200,25,45,70,Saturday
2018,5,26,100,50,75,125,Saturday
2018,5,25,2400,66,119,185,Friday
2018,5,25,2300,137,153,290,Friday
2018,5,25,2200,211,200,411,Friday
2018,5,25,2100,339,320,659,Friday
2018,5,25,2000,530,467,997,Friday
2018,5,25,1900,767,543,1310,Friday
2018,5,25,1800,783,672,1455,Friday
2018,5,25,1700,601,675,1276,Friday
2018,5,25,1600,577,635,1212,Friday
2018,5,25,1500,534,576,1110,Friday
2018,5,25,1400,550,591,1141,Friday
2018,5,25,1300,599,346,945,Friday
2018,5,25,1200,705,283,988,Friday
2018,5,25,1100,665,265,930,Friday
2018,5,25,1000,630,184,814,Friday
2018,5,25,900,509,143,652,Friday
2018,5,25,800,328,83,411,Friday
2018,5,25,700,142,63,205,Friday
2018,5,25,600,91,43,134,Friday
2018,5,25,500,42,35,77,Friday
2018,5,25,400,47,38,85,Friday
2018,5,25,300,31,33,64,Friday
2018,5,25,200,43,45,88,Friday
2018,5,25,100,54,76,130,Friday
2018,5,24,2400,85,106,191,Thursday
2018,5,24,2300,123,169,292,Thursday
2018,5,24,2200,175,228,403,Thursday
2018,5,24,2100,232,296,528,Thursday
2018,5,24,2000,292,457,749,Thursday
2018,5,24,1900,258,521,779,Thursday
2018,5,24,1800,299,589,888,Thursday
2018,5,24,1700,400,617,1017,Thursday
2018,5,24,1600,414,521,935,Thursday
2018,5,24,1500,432,487,919,Thursday
2018,5,24,1400,491,395,886,Thursday
2018,5,24,1300,489,368,857,Thursday
2018,5,24,1200,568,289,857,Thursday
2018,5,24,1100,650,222,872,Thursday
2018,5,24,1000,532,178,710,Thursday
2018,5,24,900,436,153,589,Thursday
2018,5,24,800,290,84,374,Thursday
2018,5,24,700,149,56,205,Thursday
2018,5,24,600,47,44,91,Thursday
2018,5,24,500,43,44,87,Thursday
2018,5,24,400,34,29,63,Thursday
2018,5,24,300,28,46,74,Thursday
2018,5,24,200,30,52,82,Thursday
2018,5,24,100,53,71,124,Thursday
2018,5,23,2400,66,107,173,Wednesday
2018,5,23,2300,93,162,255,Wednesday
2018,5,23,2200,128,214,342,Wednesday
2018,5,23,2100,166,271,437,Wednesday
2018,5,23,2000,183,420,603,Wednesday
2018,5,23,1900,217,547,764,Wednesday
2018,5,23,1800,269,618,887,Wednesday
2018,5,23,1700,316,583,899,Wednesday
2018,5,23,1600,338,550,888,Wednesday
2018,5,23,1500,346,485,831,Wednesday
2018,5,23,1400,437,473,910,Wednesday
2018,5,23,1300,419,407,826,Wednesday
2018,5,23,1200,531,321,852,Wednesday
2018,5,23,1100,581,248,829,Wednesday
2018,5,23,1000,559,228,787,Wednesday
2018,5,23,900,395,144,539,Wednesday
2018,5,23,800,243,108,351,Wednesday
2018,5,23,700,131,58,189,Wednesday
2018,5,23,600,53,45,98,Wednesday
2018,5,23,500,34,36,70,Wednesday
2018,5,23,400,22,46,68,Wednesday
2018,5,23,300,27,44,71,Wednesday
2018,5,23,200,30,52,82,Wednesday
2018,5,23,100,42,73,115,Wednesday
2018,5,22,2400,59,130,189,Tuesday
2018,5,22,2300,111,192,303,Tuesday
2018,5,22,2200,108,271,379,Tuesday
2018,5,22,2100,166,416,582,Tuesday
2018,5,22,2000,170,627,797,Tuesday
2018,5,22,1900,208,876,1084,Tuesday
2018,5,22,1800,248,1129,1377,Tuesday
2018,5,22,1700,286,874,1160,Tuesday
2018,5,22,1600,326,584,910,Tuesday
2018,5,22,1500,371,677,1048,Tuesday
2018,5,22,1400,389,610,999,Tuesday
2018,5,22,1300,507,529,1036,Tuesday
2018,5,22,1200,603,446,1049,Tuesday
2018,5,22,1100,625,344,969,Tuesday
2018,5,22,1000,592,261,853,Tuesday
2018,5,22,900,404,203,607,Tuesday
2018,5,22,800,281,136,417,Tuesday
2018,5,22,700,129,118,247,Tuesday
2018,5,22,600,50,47,97,Tuesday
2018,5,22,500,34,25,59,Tuesday
2018,5,22,400,26,45,71,Tuesday
2018,5,22,300,17,37,54,Tuesday
2018,5,22,200,22,74,96,Tuesday
2018,5,22,100,39,122,161,Tuesday
2018,5,21,2400,47,217,264,Monday
2018,5,21,2300,61,350,411,Monday
2018,5,21,2200,81,690,771,Monday
2018,5,21,2100,108,1171,1279,Monday
2018,5,21,2000,158,1531,1689,Monday
2018,5,21,1900,227,1841,2068,Monday
2018,5,21,1800,266,2102,2368,Monday
2018,5,21,1700,339,2418,2757,Monday
2018,5,21,1600,418,2240,2658,Monday
2018,5,21,1500,528,1978,2506,Monday
2018,5,21,1400,604,1770,2374,Monday
2018,5,21,1300,728,1594,2322,Monday
2018,5,21,1200,832,1170,2002,Monday
2018,5,21,1100,764,730,1494,Monday
2018,5,21,1000,701,365,1066,Monday
2018,5,21,900,497,201,698,Monday
2018,5,21,800,245,70,315,Monday
2018,5,21,700,119,43,162,Monday
2018,5,21,600,41,20,61,Monday
2018,5,21,500,29,21,50,Monday
2018,5,21,400,32,29,61,Monday
2018,5,21,300,26,32,58,Monday
2018,5,21,200,23,39,62,Monday
2018,5,21,100,36,105,141,Monday
2018,5,20,2400,40,150,190,Sunday
2018,5,20,2300,80,273,353,Sunday
2018,5,20,2200,104,413,517,Sunday
2018,5,20,2100,136,637,773,Sunday
2018,5,20,2000,186,842,1028,Sunday
2018,5,20,1900,243,972,1215,Sunday
2018,5,20,1800,328,1102,1430,Sunday
2018,5,20,1700,429,1106,1535,Sunday
2018,5,20,1600,508,1122,1630,Sunday
2018,5,20,1500,581,896,1477,Sunday
2018,5,20,1400,799,655,1454,Sunday
2018,5,20,1300,903,546,1449,Sunday
2018,5,20,1200,918,420,1338,Sunday
2018,5,20,1100,852,287,1139,Sunday
2018,5,20,1000,782,148,930,Sunday
2018,5,20,900,581,107,688,Sunday
2018,5,20,800,276,51,327,Sunday
2018,5,20,700,134,34,168,Sunday
2018,5,20,600,32,19,51,Sunday
2018,5,20,500,36,22,58,Sunday
2018,5,20,400,20,28,48,Sunday
2018,5,20,300,22,62,84,Sunday
2018,5,20,200,24,72,96,Sunday
2018,5,20,100,31,74,105,Sunday
2018,5,19,2400,52,86,138,Saturday
2018,5,19,2300,77,144,221,Saturday
2018,5,19,2200,124,223,347,Saturday
2018,5,19,2100,211,373,584,Saturday
2018,5,19,2000,229,492,721,Saturday
2018,5,19,1900,281,625,906,Saturday
2018,5,19,1800,387,721,1108,Saturday
2018,5,19,1700,457,773,1230,Saturday
2018,5,19,1600,606,637,1243,Saturday
2018,5,19,1500,664,551,1215,Saturday
2018,5,19,1400,868,459,1327,Saturday
2018,5,19,1300,988,413,1401,Saturday
2018,5,19,1200,1116,353,1469,Saturday
2018,5,19,1100,1152,240,1392,Saturday
2018,5,19,1000,913,185,1098,Saturday
2018,5,19,900,765,130,895,Saturday
2018,5,19,800,523,74,597,Saturday
2018,5,19,700,208,62,270,Saturday
2018,5,19,600,111,51,162,Saturday
2018,5,19,500,50,42,92,Saturday
2018,5,19,400,40,35,75,Saturday
2018,5,19,300,33,45,78,Saturday
2018,5,19,200,59,47,106,Saturday
2018,5,19,100,89,83,172,Saturday
2018,5,18,2400,130,118,248,Friday
2018,5,18,2300,190,168,358,Friday
2018,5,18,2200,343,205,548,Friday
2018,5,18,2100,612,310,922,Friday
2018,5,18,2000,1009,403,1412,Friday
2018,5,18,1900,1137,465,1602,Friday
2018,5,18,1800,1286,573,1859,Friday
2018,5,18,1700,1429,564,1993,Friday
2018,5,18,1600,1394,585,1979,Friday
2018,5,18,1500,1354,543,1897,Friday
2018,5,18,1400,1246,468,1714,Friday
2018,5,18,1300,1190,396,1586,Friday
2018,5,18,1200,1323,337,1660,Friday
2018,5,18,1100,1273,295,1568,Friday
2018,5,18,1000,1093,187,1280,Friday
2018,5,18,900,817,122,939,Friday
2018,5,18,800,497,70,567,Friday
2018,5,18,700,266,47,313,Friday
2018,5,18,600,125,52,177,Friday
2018,5,18,500,51,47,98,Friday
2018,5,18,400,64,36,100,Friday
2018,5,18,300,42,50,92,Friday
2018,5,18,200,49,74,123,Friday
2018,5,18,100,69,74,143,Friday
2018,5,17,2400,83,78,161,Thursday
2018,5,17,2300,170,154,324,Thursday
2018,5,17,2200,308,167,475,Thursday
2018,5,17,2100,562,243,805,Thursday
2018,5,17,2000,743,325,1068,Thursday
2018,5,17,1900,805,417,1222,Thursday
2018,5,17,1800,723,471,1194,Thursday
2018,5,17,1700,728,455,1183,Thursday
2018,5,17,1600,772,454,1226,Thursday
2018,5,17,1500,681,380,1061,Thursday
2018,5,17,1400,648,399,1047,Thursday
2018,5,17,1300,679,377,1056,Thursday
2018,5,17,1200,743,275,1018,Thursday
2018,5,17,1100,712,228,940,Thursday
2018,5,17,1000,579,169,748,Thursday
2018,5,17,900,449,95,544,Thursday
2018,5,17,800,313,98,411,Thursday
2018,5,17,700,174,58,232,Thursday
2018,5,17,600,81,36,117,Thursday
2018,5,17,500,44,38,82,Thursday
2018,5,17,400,41,44,85,Thursday
2018,5,17,300,28,48,76,Thursday
2018,5,17,200,44,41,85,Thursday
2018,5,17,100,51,69,120,Thursday
2018,5,16,2400,82,60,142,Wednesday
2018,5,16,2300,125,121,246,Wednesday
2018,5,16,2200,136,172,308,Wednesday
2018,5,16,2100,204,255,459,Wednesday
2018,5,16,2000,244,339,583,Wednesday
2018,5,16,1900,261,353,614,Wednesday
2018,5,16,1800,302,452,754,Wednesday
2018,5,16,1700,393,457,850,Wednesday
2018,5,16,1600,341,454,795,Wednesday
2018,5,16,1500,392,343,735,Wednesday
2018,5,16,1400,436,363,799,Wednesday
2018,5,16,1300,471,314,785,Wednesday
2018,5,16,1200,537,257,794,Wednesday
2018,5,16,1100,508,198,706,Wednesday
2018,5,16,1000,430,149,579,Wednesday
2018,5,16,900,321,132,453,Wednesday
2018,5,16,800,259,93,352,Wednesday
2018,5,16,700,114,63,177,Wednesday
2018,5,16,600,52,39,91,Wednesday
2018,5,16,500,28,30,58,Wednesday
2018,5,16,400,33,38,71,Wednesday
2018,5,16,300,25,40,65,Wednesday
2018,5,16,200,32,52,84,Wednesday
2018,5,16,100,55,66,121,Wednesday
2018,5,15,2400,65,98,163,Tuesday
2018,5,15,2300,88,138,226,Tuesday
2018,5,15,2200,137,173,310,Tuesday
2018,5,15,2100,159,221,380,Tuesday
2018,5,15,2000,188,290,478,Tuesday
2018,5,15,1900,186,419,605,Tuesday
2018,5,15,1800,265,440,705,Tuesday
2018,5,15,1700,271,499,770,Tuesday
2018,5,15,1600,304,369,673,Tuesday
2018,5,15,1500,326,391,717,Tuesday
2018,5,15,1400,371,335,706,Tuesday
2018,5,15,1300,400,310,710,Tuesday
2018,5,15,1200,494,230,724,Tuesday
2018,5,15,1100,500,194,694,Tuesday
2018,5,15,1000,453,189,642,Tuesday
2018,5,15,900,339,155,494,Tuesday
2018,5,15,800,209,68,277,Tuesday
2018,5,15,700,110,51,161,Tuesday
2018,5,15,600,47,42,89,Tuesday
2018,5,15,500,28,36,64,Tuesday
2018,5,15,400,29,33,62,Tuesday
2018,5,15,300,31,53,84,Tuesday
2018,5,15,200,28,44,72,Tuesday
2018,5,15,100,48,71,119,Tuesday
2018,5,14,2400,62,80,142,Monday
2018,5,14,2300,86,122,208,Monday
2018,5,14,2200,110,220,330,Monday
2018,5,14,2100,141,266,407,Monday
2018,5,14,2000,142,383,525,Monday
2018,5,14,1900,205,456,661,Monday
2018,5,14,1800,266,528,794,Monday
2018,5,14,1700,326,521,847,Monday
2018,5,14,1600,350,491,841,Monday
2018,5,14,1500,405,525,930,Monday
2018,5,14,1400,411,399,810,Monday
2018,5,14,1300,488,376,864,Monday
2018,5,14,1200,569,323,892,Monday
2018,5,14,1100,590,240,830,Monday
2018,5,14,1000,484,166,650,Monday
2018,5,14,900,348,124,472,Monday
2018,5,14,800,218,88,306,Monday
2018,5,14,700,124,44,168,Monday
2018,5,14,600,53,27,80,Monday
2018,5,14,500,28,17,45,Monday
2018,5,14,400,16,17,33,Monday
2018,5,14,300,21,31,52,Monday
2018,5,14,200,28,50,78,Monday
2018,5,14,100,31,78,109,Monday
2018,5,13,2400,32,134,166,Sunday
2018,5,13,2300,58,200,258,Sunday
2018,5,13,2200,97,343,440,Sunday
2018,5,13,2100,114,465,579,Sunday
2018,5,13,2000,179,590,769,Sunday
2018,5,13,1900,234,697,931,Sunday
2018,5,13,1800,290,826,1116,Sunday
2018,5,13,1700,351,788,1139,Sunday
2018,5,13,1600,366,908,1274,Sunday
2018,5,13,1500,424,777,1201,Sunday
2018,5,13,1400,456,641,1097,Sunday
2018,5,13,1300,765,530,1295,Sunday
2018,5,13,1200,442,432,874,Sunday
2018,5,13,1100,455,238,693,Sunday
2018,5,13,1000,418,170,588,Sunday
2018,5,13,900,281,102,383,Sunday
2018,5,13,800,156,41,197,Sunday
2018,5,13,700,74,21,95,Sunday
2018,5,13,600,25,17,42,Sunday
2018,5,13,500,25,16,41,Sunday
2018,5,13,400,14,25,39,Sunday
2018,5,13,300,22,19,41,Sunday
2018,5,13,200,20,30,50,Sunday
2018,5,13,100,34,56,90,Sunday
2018,5,12,2400,45,72,117,Saturday
2018,5,12,2300,60,98,158,Saturday
2018,5,12,2200,89,187,276,Saturday
2018,5,12,2100,115,263,378,Saturday
2018,5,12,2000,157,350,507,Saturday
2018,5,12,1900,176,460,636,Saturday
2018,5,12,1800,235,495,730,Saturday
2018,5,12,1700,304,539,843,Saturday
2018,5,12,1600,375,511,886,Saturday
2018,5,12,1500,476,479,955,Saturday
2018,5,12,1400,433,433,866,Saturday
2018,5,12,1300,555,456,1011,Saturday
2018,5,12,1200,587,317,904,Saturday
2018,5,12,1100,618,252,870,Saturday
2018,5,12,1000,536,186,722,Saturday
2018,5,12,900,373,110,483,Saturday
2018,5,12,800,197,78,275,Saturday
2018,5,12,700,111,45,156,Saturday
2018,5,12,600,45,37,82,Saturday
2018,5,12,500,33,31,64,Saturday
2018,5,12,400,29,19,48,Saturday
2018,5,12,300,29,40,69,Saturday
2018,5,12,200,34,35,69,Saturday
2018,5,12,100,45,58,103,Saturday
2018,5,11,2400,77,81,158,Friday
2018,5,11,2300,93,122,215,Friday
2018,5,11,2200,152,159,311,Friday
2018,5,11,2100,263,215,478,Friday
2018,5,11,2000,423,287,710,Friday
2018,5,11,1900,508,352,860,Friday
2018,5,11,1800,549,478,1027,Friday
2018,5,11,1700,532,470,1002,Friday
2018,5,11,1600,557,494,1051,Friday
2018,5,11,1500,492,430,922,Friday
2018,5,11,1400,475,391,866,Friday
2018,5,11,1300,477,355,832,Friday
2018,5,11,1200,550,296,846,Friday
2018,5,11,1100,552,255,807,Friday
2018,5,11,1000,458,183,641,Friday
2018,5,11,900,326,125,451,Friday
2018,5,11,800,185,72,257,Friday
2018,5,11,700,135,52,187,Friday
2018,5,11,600,62,33,95,Friday
2018,5,11,500,35,33,68,Friday
2018,5,11,400,28,27,55,Friday
2018,5,11,300,32,44,76,Friday
2018,5,11,200,36,45,81,Friday
2018,5,11,100,41,57,98,Friday
2018,5,10,2400,74,85,159,Thursday
2018,5,10,2300,105,116,221,Thursday
2018,5,10,2200,121,156,277,Thursday
2018,5,10,2100,194,210,404,Thursday
2018,5,10,2000,218,268,486,Thursday
2018,5,10,1900,279,362,641,Thursday
2018,5,10,1800,337,397,734,Thursday
2018,5,10,1700,350,423,773,Thursday
2018,5,10,1600,348,471,819,Thursday
2018,5,10,1500,346,332,678,Thursday
2018,5,10,1400,373,361,734,Thursday
2018,5,10,1300,401,258,659,Thursday
2018,5,10,1200,458,276,734,Thursday
2018,5,10,1100,483,200,683,Thursday
2018,5,10,1000,438,139,577,Thursday
2018,5,10,900,271,127,398,Thursday
2018,5,10,800,219,87,306,Thursday
2018,5,10,700,111,46,157,Thursday
2018,5,10,600,45,33,78,Thursday
2018,5,10,500,36,18,54,Thursday
2018,5,10,400,33,38,71,Thursday
2018,5,10,300,25,43,68,Thursday
2018,5,10,200,28,36,64,Thursday
2018,5,10,100,40,58,98,Thursday
2018,5,9,2400,63,51,114,Wednesday
2018,5,9,2300,76,102,178,Wednesday
2018,5,9,2200,111,151,262,Wednesday
2018,5,9,2100,144,168,312,Wednesday
2018,5,9,2000,165,245,410,Wednesday
2018,5,9,1900,183,296,479,Wednesday
2018,5,9,1800,225,422,647,Wednesday
2018,5,9,1700,291,450,741,Wednesday
2018,5,9,1600,280,360,640,Wednesday
2018,5,9,1500,329,357,686,Wednesday
2018,5,9,1400,329,357,686,Wednesday
2018,5,9,1300,401,270,671,Wednesday
2018,5,9,1200,396,306,702,Wednesday
2018,5,9,1100,391,188,579,Wednesday
2018,5,9,1000,351,151,502,Wednesday
2018,5,9,900,236,124,360,Wednesday
2018,5,9,800,200,82,282,Wednesday
2018,5,9,700,89,43,132,Wednesday
2018,5,9,600,46,51,97,Wednesday
2018,5,9,500,25,32,57,Wednesday
2018,5,9,400,39,49,88,Wednesday
2018,5,9,300,30,41,71,Wednesday
2018,5,9,200,26,60,86,Wednesday
2018,5,9,100,42,41,83,Wednesday
2018,5,8,2400,62,79,141,Tuesday
2018,5,8,2300,82,114,196,Tuesday
2018,5,8,2200,101,166,267,Tuesday
2018,5,8,2100,159,198,357,Tuesday
2018,5,8,2000,144,299,443,Tuesday
2018,5,8,1900,169,327,496,Tuesday
2018,5,8,1800,211,447,658,Tuesday
2018,5,8,1700,230,400,630,Tuesday
2018,5,8,1600,280,425,705,Tuesday
2018,5,8,1500,311,391,702,Tuesday
2018,5,8,1400,317,350,667,Tuesday
2018,5,8,1300,368,330,698,Tuesday
2018,5,8,1200,405,251,656,Tuesday
2018,5,8,1100,417,235,652,Tuesday
2018,5,8,1000,345,169,514,Tuesday
2018,5,8,900,256,128,384,Tuesday
2018,5,8,800,162,92,254,Tuesday
2018,5,8,700,93,51,144,Tuesday
2018,5,8,600,47,38,85,Tuesday
2018,5,8,500,25,42,67,Tuesday
2018,5,8,400,35,33,68,Tuesday
2018,5,8,300,20,35,55,Tuesday
2018,5,8,200,29,49,78,Tuesday
2018,5,8,100,35,74,109,Tuesday
2018,5,7,2400,60,50,110,Monday
2018,5,7,2300,67,111,178,Monday
2018,5,7,2200,100,165,265,Monday
2018,5,7,2100,129,239,368,Monday
2018,5,7,2000,154,297,451,Monday
2018,5,7,1900,171,373,544,Monday
2018,5,7,1800,204,444,648,Monday
2018,5,7,1700,266,493,759,Monday
2018,5,7,1600,289,499,788,Monday
2018,5,7,1500,334,379,713,Monday
2018,5,7,1400,363,408,771,Monday
2018,5,7,1300,426,325,751,Monday
2018,5,7,1200,494,282,776,Monday
2018,5,7,1100,482,235,717,Monday
2018,5,7,1000,373,173,546,Monday
2018,5,7,900,296,129,425,Monday
2018,5,7,800,189,74,263,Monday
2018,5,7,700,109,39,148,Monday
2018,5,7,600,44,24,68,Monday
2018,5,7,500,16,16,32,Monday
2018,5,7,400,24,25,49,Monday
2018,5,7,300,23,30,53,Monday
2018,5,7,200,20,55,75,Monday
2018,5,7,100,27,73,100,Monday
2018,5,6,2400,34,135,169,Sunday
2018,5,6,2300,69,160,229,Sunday
2018,5,6,2200,96,282,378,Sunday
2018,5,6,2100,137,401,538,Sunday
2018,5,6,2000,164,591,755,Sunday
2018,5,6,1900,178,717,895,Sunday
2018,5,6,1800,231,961,1192,Sunday
2018,5,6,1700,289,1018,1307,Sunday
2018,5,6,1600,403,959,1362,Sunday
2018,5,6,1500,435,863,1298,Sunday
2018,5,6,1400,468,665,1133,Sunday
2018,5,6,1300,560,624,1184,Sunday
2018,5,6,1200,642,499,1141,Sunday
2018,5,6,1100,665,346,1011,Sunday
2018,5,6,1000,588,183,771,Sunday
2018,5,6,900,380,72,452,Sunday
2018,5,6,800,171,35,206,Sunday
2018,5,6,700,87,6,93,Sunday
2018,5,6,600,36,8,44,Sunday
2018,5,6,500,15,8,23,Sunday
2018,5,6,400,17,36,53,Sunday
2018,5,6,300,23,3,26,Sunday
2018,5,6,200,13,9,22,Sunday
2018,5,6,100,22,13,35,Sunday
2018,5,5,2400,47,37,84,Saturday
2018,5,5,2300,83,52,135,Saturday
2018,5,5,2200,100,139,239,Saturday
2018,5,5,2100,111,210,321,Saturday
2018,5,5,2000,133,334,467,Saturday
2018,5,5,1900,183,434,617,Saturday
2018,5,5,1800,223,558,781,Saturday
2018,5,5,1700,290,611,901,Saturday
2018,5,5,1600,355,559,914,Saturday
2018,5,5,1500,359,497,856,Saturday
2018,5,5,1400,434,358,792,Saturday
2018,5,5,1300,491,319,810,Saturday
2018,5,5,1200,673,294,967,Saturday
2018,5,5,1100,717,220,937,Saturday
2018,5,5,1000,552,156,708,Saturday
2018,5,5,900,431,114,545,Saturday
2018,5,5,800,214,69,283,Saturday
2018,5,5,700,114,48,162,Saturday
2018,5,5,600,41,31,72,Saturday
2018,5,5,500,29,26,55,Saturday
2018,5,5,400,28,24,52,Saturday
2018,5,5,300,26,25,51,Saturday
2018,5,5,200,20,33,53,Saturday
2018,5,5,100,46,50,96,Saturday
2018,5,4,2400,48,79,127,Friday
2018,5,4,2300,90,122,212,Friday
2018,5,4,2200,176,150,326,Friday
2018,5,4,2100,271,207,478,Friday
2018,5,4,2000,382,274,656,Friday
2018,5,4,1900,483,379,862,Friday
2018,5,4,1800,581,468,1049,Friday
2018,5,4,1700,520,485,1005,Friday
2018,5,4,1600,504,546,1050,Friday
2018,5,4,1500,511,443,954,Friday
2018,5,4,1400,498,423,921,Friday
2018,5,4,1300,502,350,852,Friday
2018,5,4,1200,559,313,872,Friday
2018,5,4,1100,600,251,851,Friday
2018,5,4,1000,517,140,657,Friday
2018,5,4,900,384,134,518,Friday
2018,5,4,800,209,82,291,Friday
2018,5,4,700,144,50,194,Friday
2018,5,4,600,51,40,91,Friday
2018,5,4,500,38,57,95,Friday
2018,5,4,400,30,34,64,Friday
2018,5,4,300,37,42,79,Friday
2018,5,4,200,32,59,91,Friday
2018,5,4,100,48,74,122,Friday
2018,5,3,2400,83,65,148,Thursday
2018,5,3,2300,83,98,181,Thursday
2018,5,3,2200,130,169,299,Thursday
2018,5,3,2100,211,222,433,Thursday
2018,5,3,2000,215,255,470,Thursday
2018,5,3,1900,285,332,617,Thursday
2018,5,3,1800,276,457,733,Thursday
2018,5,3,1700,348,492,840,Thursday
2018,5,3,1600,368,480,848,Thursday
2018,5,3,1500,380,413,793,Thursday
2018,5,3,1400,365,340,705,Thursday
2018,5,3,1300,450,293,743,Thursday
2018,5,3,1200,525,263,788,Thursday
2018,5,3,1100,538,193,731,Thursday
2018,5,3,1000,494,182,676,Thursday
2018,5,3,900,356,124,480,Thursday
2018,5,3,800,207,75,282,Thursday
2018,5,3,700,103,48,151,Thursday
2018,5,3,600,70,35,105,Thursday
2018,5,3,500,34,37,71,Thursday
2018,5,3,400,23,37,60,Thursday
2018,5,3,300,18,41,59,Thursday
2018,5,3,200,28,43,71,Thursday
2018,5,3,100,50,60,110,Thursday
2018,5,2,2400,73,80,153,Wednesday
2018,5,2,2300,87,112,199,Wednesday
2018,5,2,2200,125,152,277,Wednesday
2018,5,2,2100,152,198,350,Wednesday
2018,5,2,2000,165,262,427,Wednesday
2018,5,2,1900,194,330,524,Wednesday
2018,5,2,1800,259,429,688,Wednesday
2018,5,2,1700,273,512,785,Wednesday
2018,5,2,1600,322,424,746,Wednesday
2018,5,2,1500,325,362,687,Wednesday
2018,5,2,1400,350,362,712,Wednesday
2018,5,2,1300,383,256,639,Wednesday
2018,5,2,1200,470,219,689,Wednesday
2018,5,2,1100,444,197,641,Wednesday
2018,5,2,1000,404,188,592,Wednesday
2018,5,2,900,276,106,382,Wednesday
2018,5,2,800,186,83,269,Wednesday
2018,5,2,700,102,43,145,Wednesday
2018,5,2,600,46,34,80,Wednesday
2018,5,2,500,34,37,71,Wednesday
2018,5,2,400,33,35,68,Wednesday
2018,5,2,300,30,36,66,Wednesday
2018,5,2,200,28,49,77,Wednesday
2018,5,2,100,42,50,92,Wednesday
2018,5,1,2400,71,68,139,Tuesday
2018,5,1,2300,70,96,166,Tuesday
2018,5,1,2200,99,141,240,Tuesday
2018,5,1,2100,146,166,312,Tuesday
2018,5,1,2000,167,260,427,Tuesday
2018,5,1,1900,179,320,499,Tuesday
2018,5,1,1800,200,396,596,Tuesday
2018,5,1,1700,219,399,618,Tuesday
2018,5,1,1600,302,407,709,Tuesday
2018,5,1,1500,317,348,665,Tuesday
2018,5,1,1400,296,326,622,Tuesday
2018,5,1,1300,374,274,648,Tuesday
2018,5,1,1200,377,249,626,Tuesday
2018,5,1,1100,447,214,661,Tuesday
2018,5,1,1000,345,149,494,Tuesday
2018,5,1,900,250,108,358,Tuesday
2018,5,1,800,166,61,227,Tuesday
2018,5,1,700,80,52,132,Tuesday
2018,5,1,600,42,42,84,Tuesday
2018,5,1,500,19,36,55,Tuesday
2018,5,1,400,23,35,58,Tuesday
2018,5,1,300,27,51,78,Tuesday
2018,5,1,200,29,51,80,Tuesday
2018,5,1,100,38,57,95,Tuesday
2018,4,30,2400,66,86,152,Monday
2018,4,30,2300,56,118,174,Monday
2018,4,30,2200,92,133,225,Monday
2018,4,30,2100,127,207,334,Monday
2018,4,30,2000,151,293,444,Monday
2018,4,30,1900,188,440,628,Monday
2018,4,30,1800,217,411,628,Monday
2018,4,30,1700,277,448,725,Monday
2018,4,30,1600,321,455,776,Monday
2018,4,30,1500,332,450,782,Monday
2018,4,30,1400,384,353,737,Monday
2018,4,30,1300,418,353,771,Monday
2018,4,30,1200,471,234,705,Monday
2018,4,30,1100,477,150,627,Monday
2018,4,30,1000,426,134,560,Monday
2018,4,30,900,299,92,391,Monday
2018,4,30,800,189,52,241,Monday
2018,4,30,700,90,33,123,Monday
2018,4,30,600,47,21,68,Monday
2018,4,30,500,20,22,42,Monday
2018,4,30,400,24,20,44,Monday
2018,4,30,300,24,35,59,Monday
2018,4,30,200,19,36,55,Monday
2018,4,30,100,32,47,79,Monday
2018,4,29,2400,41,72,113,Sunday
2018,4,29,2300,48,135,183,Sunday
2018,4,29,2200,101,170,271,Sunday
2018,4,29,2100,107,276,383,Sunday
2018,4,29,2000,186,373,559,Sunday
2018,4,29,1900,206,501,707,Sunday
2018,4,29,1800,242,678,920,Sunday
2018,4,29,1700,330,794,1124,Sunday
2018,4,29,1600,378,971,1349,Sunday
2018,4,29,1500,362,788,1150,Sunday
2018,4,29,1400,393,769,1162,Sunday
2018,4,29,1300,413,838,1251,Sunday
2018,4,29,1200,517,638,1155,Sunday
2018,4,29,1100,441,380,821,Sunday
2018,4,29,1000,376,200,576,Sunday
2018,4,29,900,315,93,408,Sunday
2018,4,29,800,139,39,178,Sunday
2018,4,29,700,69,23,92,Sunday
2018,4,29,600,21,13,34,Sunday
2018,4,29,500,16,23,39,Sunday
2018,4,29,400,16,25,41,Sunday
2018,4,29,300,17,36,53,Sunday
2018,4,29,200,20,32,52,Sunday
2018,4,29,100,24,69,93,Sunday
2018,4,28,2400,32,99,131,Saturday
2018,4,28,2300,58,97,155,Saturday
2018,4,28,2200,94,181,275,Saturday
2018,4,28,2100,115,293,408,Saturday
2018,4,28,2000,135,434,569,Saturday
2018,4,28,1900,198,572,770,Saturday
2018,4,28,1800,257,776,1033,Saturday
2018,4,28,1700,344,839,1183,Saturday
2018,4,28,1600,343,732,1075,Saturday
2018,4,28,1500,409,620,1029,Saturday
2018,4,28,1400,464,495,959,Saturday
2018,4,28,1300,543,401,944,Saturday
2018,4,28,1200,732,345,1077,Saturday
2018,4,28,1100,816,255,1071,Saturday
2018,4,28,1000,764,201,965,Saturday
2018,4,28,900,617,126,743,Saturday
2018,4,28,800,267,56,323,Saturday
2018,4,28,700,104,63,167,Saturday
2018,4,28,600,52,47,99,Saturday
2018,4,28,500,30,89,119,Saturday
2018,4,28,400,41,99,140,Saturday
2018,4,28,300,25,40,65,Saturday
2018,4,28,200,42,6,48,Saturday
2018,4,28,100,49,21,70,Saturday
2018,4,27,2400,72,27,99,Friday
2018,4,27,2300,93,41,134,Friday
2018,4,27,2200,181,74,255,Friday
2018,4,27,2100,256,185,441,Friday
2018,4,27,2000,366,203,569,Friday
2018,4,27,1900,471,410,881,Friday
2018,4,27,1800,515,450,965,Friday
2018,4,27,1700,556,613,1169,Friday
2018,4,27,1600,515,547,1062,Friday
2018,4,27,1500,596,466,1062,Friday
2018,4,27,1400,485,412,897,Friday
2018,4,27,1300,531,388,919,Friday
2018,4,27,1200,580,332,912,Friday
2018,4,27,1100,636,259,895,Friday
2018,4,27,1000,588,193,781,Friday
2018,4,27,900,416,129,545,Friday
2018,4,27,800,240,113,353,Friday
2018,4,27,700,107,56,163,Friday
2018,4,27,600,56,27,83,Friday
2018,4,27,500,43,32,75,Friday
2018,4,27,400,33,42,75,Friday
2018,4,27,300,31,40,71,Friday
2018,4,27,200,39,39,78,Friday
2018,4,27,100,54,64,118,Friday
2018,4,26,2400,72,130,202,Thursday
2018,4,26,2300,114,152,266,Thursday
2018,4,26,2200,155,391,546,Thursday
2018,4,26,2100,211,271,482,Thursday
2018,4,26,2000,262,290,552,Thursday
2018,4,26,1900,301,397,698,Thursday
2018,4,26,1800,313,380,693,Thursday
2018,4,26,1700,384,383,767,Thursday
2018,4,26,1600,361,542,903,Thursday
2018,4,26,1500,372,389,761,Thursday
2018,4,26,1400,374,349,723,Thursday
2018,4,26,1300,411,336,747,Thursday
2018,4,26,1200,488,254,742,Thursday
2018,4,26,1100,524,225,749,Thursday
2018,4,26,1000,471,173,644,Thursday
2018,4,26,900,336,130,466,Thursday
2018,4,26,800,229,69,298,Thursday
2018,4,26,700,96,44,140,Thursday
2018,4,26,600,63,44,107,Thursday
2018,4,26,500,33,26,59,Thursday
2018,4,26,400,40,30,70,Thursday
2018,4,26,300,38,67,105,Thursday
2018,4,26,200,27,63,90,Thursday
2018,4,26,100,43,26,69,Thursday
2018,4,25,2400,57,66,123,Wednesday
2018,4,25,2300,84,86,170,Wednesday
2018,4,25,2200,114,134,248,Wednesday
2018,4,25,2100,117,261,378,Wednesday
2018,4,25,2000,176,243,419,Wednesday
2018,4,25,1900,157,341,498,Wednesday
2018,4,25,1800,247,485,732,Wednesday
2018,4,25,1700,284,536,820,Wednesday
2018,4,25,1600,311,451,762,Wednesday
2018,4,25,1500,303,384,687,Wednesday
2018,4,25,1400,339,300,639,Wednesday
2018,4,25,1300,386,265,651,Wednesday
2018,4,25,1200,426,216,642,Wednesday
2018,4,25,1100,410,184,594,Wednesday
2018,4,25,1000,407,159,566,Wednesday
2018,4,25,900,336,118,454,Wednesday
2018,4,25,800,220,76,296,Wednesday
2018,4,25,700,109,65,174,Wednesday
2018,4,25,600,51,31,82,Wednesday
2018,4,25,500,30,34,64,Wednesday
2018,4,25,400,36,41,77,Wednesday
2018,4,25,300,25,33,58,Wednesday
2018,4,25,200,27,47,74,Wednesday
2018,4,25,100,41,53,94,Wednesday
2018,4,24,2400,58,72,130,Tuesday
2018,4,24,2300,78,122,200,Tuesday
2018,4,24,2200,110,164,274,Tuesday
2018,4,24,2100,132,169,301,Tuesday
2018,4,24,2000,144,250,394,Tuesday
2018,4,24,1900,182,313,495,Tuesday
2018,4,24,1800,216,450,666,Tuesday
2018,4,24,1700,259,487,746,Tuesday
2018,4,24,1600,277,425,702,Tuesday
2018,4,24,1500,301,383,684,Tuesday
2018,4,24,1400,306,340,646,Tuesday
2018,4,24,1300,356,246,602,Tuesday
2018,4,24,1200,379,224,603,Tuesday
2018,4,24,1100,434,203,637,Tuesday
2018,4,24,1000,392,155,547,Tuesday
2018,4,24,900,313,117,430,Tuesday
2018,4,24,800,173,86,259,Tuesday
2018,4,24,700,111,40,151,Tuesday
2018,4,24,600,46,43,89,Tuesday
2018,4,24,500,29,32,61,Tuesday
2018,4,24,400,24,36,60,Tuesday
2018,4,24,300,25,49,74,Tuesday
2018,4,24,200,26,50,76,Tuesday
2018,4,24,100,35,63,98,Tuesday
2018,4,23,2400,54,89,143,Monday
2018,4,23,2300,81,108,189,Monday
2018,4,23,2200,91,173,264,Monday
2018,4,23,2100,117,222,339,Monday
2018,4,23,2000,165,301,466,Monday
2018,4,23,1900,151,390,541,Monday
2018,4,23,1800,214,516,730,Monday
2018,4,23,1700,262,522,784,Monday
2018,4,23,1600,286,521,807,Monday
2018,4,23,1500,317,420,737,Monday
2018,4,23,1400,348,344,692,Monday
2018,4,23,1300,380,274,654,Monday
2018,4,23,1200,487,230,717,Monday
2018,4,23,1100,493,236,729,Monday
2018,4,23,1000,427,174,601,Monday
2018,4,23,900,330,98,428,Monday
2018,4,23,800,168,64,232,Monday
2018,4,23,700,91,48,139,Monday
2018,4,23,600,47,25,72,Monday
2018,4,23,500,20,25,45,Monday
2018,4,23,400,15,29,44,Monday
2018,4,23,300,21,38,59,Monday
2018,4,23,200,18,48,66,Monday
2018,4,23,100,20,74,94,Monday
2018,4,22,2400,47,126,173,Sunday
2018,4,22,2300,63,136,199,Sunday
2018,4,22,2200,86,212,298,Sunday
2018,4,22,2100,124,352,476,Sunday
2018,4,22,2000,153,405,558,Sunday
2018,4,22,1900,181,685,866,Sunday
2018,4,22,1800,220,1021,1241,Sunday
2018,4,22,1700,279,1147,1426,Sunday
2018,4,22,1600,324,957,1281,Sunday
2018,4,22,1500,344,805,1149,Sunday
2018,4,22,1400,429,599,1028,Sunday
2018,4,22,1300,421,517,938,Sunday
2018,4,22,1200,563,439,1002,Sunday
2018,4,22,1100,610,315,925,Sunday
2018,4,22,1000,653,144,797,Sunday
2018,4,22,900,548,87,635,Sunday
2018,4,22,800,241,40,281,Sunday
2018,4,22,700,93,20,113,Sunday
2018,4,22,600,45,13,58,Sunday
2018,4,22,500,17,17,34,Sunday
2018,4,22,400,10,29,39,Sunday
2018,4,22,300,22,13,35,Sunday
2018,4,22,200,21,30,51,Sunday
2018,4,22,100,41,47,88,Sunday
2018,4,21,2400,41,68,109,Saturday
2018,4,21,2300,54,75,129,Saturday
2018,4,21,2200,85,113,198,Saturday
2018,4,21,2100,99,171,270,Saturday
2018,4,21,2000,121,272,393,Saturday
2018,4,21,1900,175,374,549,Saturday
2018,4,21,1800,192,602,794,Saturday
2018,4,21,1700,233,689,922,Saturday
2018,4,21,1600,326,507,833,Saturday
2018,4,21,1500,354,459,813,Saturday
2018,4,21,1400,395,340,735,Saturday
2018,4,21,1300,424,325,749,Saturday
2018,4,21,1200,488,321,809,Saturday
2018,4,21,1100,526,223,749,Saturday
2018,4,21,1000,602,159,761,Saturday
2018,4,21,900,600,111,711,Saturday
2018,4,21,800,273,38,311,Saturday
2018,4,21,700,84,31,115,Saturday
2018,4,21,600,41,32,73,Saturday
2018,4,21,500,27,24,51,Saturday
2018,4,21,400,20,19,39,Saturday
2018,4,21,300,23,19,42,Saturday
2018,4,21,200,21,34,55,Saturday
2018,4,21,100,45,53,98,Saturday
2018,4,20,2400,62,71,133,Friday
2018,4,20,2300,87,93,180,Friday
2018,4,20,2200,128,133,261,Friday
2018,4,20,2100,230,177,407,Friday
2018,4,20,2000,349,251,600,Friday
2018,4,20,1900,377,364,741,Friday
2018,4,20,1800,451,541,992,Friday
2018,4,20,1700,439,658,1097,Friday
2018,4,20,1600,495,455,950,Friday
2018,4,20,1500,464,402,866,Friday
2018,4,20,1400,436,355,791,Friday
2018,4,20,1300,499,336,835,Friday
2018,4,20,1200,526,261,787,Friday
2018,4,20,1100,538,216,754,Friday
2018,4,20,1000,592,156,748,Friday
2018,4,20,900,447,128,575,Friday
2018,4,20,800,266,87,353,Friday
2018,4,20,700,116,46,162,Friday
2018,4,20,600,77,36,113,Friday
2018,4,20,500,42,30,72,Friday
2018,4,20,400,34,35,69,Friday
2018,4,20,300,40,37,77,Friday
2018,4,20,200,42,40,82,Friday
2018,4,20,100,47,82,129,Friday
2018,4,19,2400,73,82,155,Thursday
2018,4,19,2300,104,101,205,Thursday
2018,4,19,2200,131,162,293,Thursday
2018,4,19,2100,178,205,383,Thursday
2018,4,19,2000,233,248,481,Thursday
2018,4,19,1900,234,310,544,Thursday
2018,4,19,1800,310,468,778,Thursday
2018,4,19,1700,309,508,817,Thursday
2018,4,19,1600,318,456,774,Thursday
2018,4,19,1500,350,321,671,Thursday
2018,4,19,1400,388,289,677,Thursday
2018,4,19,1300,371,299,670,Thursday
2018,4,19,1200,428,217,645,Thursday
2018,4,19,1100,473,174,647,Thursday
2018,4,19,1000,522,146,668,Thursday
2018,4,19,900,371,120,491,Thursday
2018,4,19,800,209,80,289,Thursday
2018,4,19,700,103,51,154,Thursday
2018,4,19,600,57,35,92,Thursday
2018,4,19,500,37,33,70,Thursday
2018,4,19,400,28,26,54,Thursday
2018,4,19,300,41,26,67,Thursday
2018,4,19,200,28,24,52,Thursday
2018,4,19,100,47,55,102,Thursday
2018,4,18,2400,59,47,106,Wednesday
2018,4,18,2300,89,72,161,Wednesday
2018,4,18,2200,92,147,239,Wednesday
2018,4,18,2100,121,164,285,Wednesday
2018,4,18,2000,152,200,352,Wednesday
2018,4,18,1900,192,281,473,Wednesday
2018,4,18,1800,211,553,764,Wednesday
2018,4,18,1700,278,466,744,Wednesday
2018,4,18,1600,283,287,570,Wednesday
2018,4,18,1500,299,269,568,Wednesday
2018,4,18,1400,307,208,515,Wednesday
2018,4,18,1300,346,262,608,Wednesday
2018,4,18,1200,398,202,600,Wednesday
2018,4,18,1100,379,157,536,Wednesday
2018,4,18,1000,447,146,593,Wednesday
2018,4,18,900,373,121,494,Wednesday
2018,4,18,800,194,72,266,Wednesday
2018,4,18,700,90,38,128,Wednesday
2018,4,18,600,55,34,89,Wednesday
2018,4,18,500,29,26,55,Wednesday
2018,4,18,400,22,41,63,Wednesday
2018,4,18,300,28,39,67,Wednesday
2018,4,18,200,27,28,55,Wednesday
2018,4,18,100,36,45,81,Wednesday
2018,4,17,2400,60,56,116,Tuesday
2018,4,17,2300,71,99,170,Tuesday
2018,4,17,2200,95,129,224,Tuesday
2018,4,17,2100,103,158,261,Tuesday
2018,4,17,2000,111,178,289,Tuesday
2018,4,17,1900,128,257,385,Tuesday
2018,4,17,1800,157,433,590,Tuesday
2018,4,17,1700,194,438,632,Tuesday
2018,4,17,1600,204,424,628,Tuesday
2018,4,17,1500,249,311,560,Tuesday
2018,4,17,1400,227,309,536,Tuesday
2018,4,17,1300,259,189,448,Tuesday
2018,4,17,1200,305,168,473,Tuesday
2018,4,17,1100,330,151,481,Tuesday
2018,4,17,1000,353,140,493,Tuesday
2018,4,17,900,434,101,535,Tuesday
2018,4,17,800,171,72,243,Tuesday
2018,4,17,700,75,53,128,Tuesday
2018,4,17,600,24,28,52,Tuesday
2018,4,17,500,20,31,51,Tuesday
2018,4,17,400,22,29,51,Tuesday
2018,4,17,300,22,34,56,Tuesday
2018,4,17,200,27,32,59,Tuesday
2018,4,17,100,38,46,84,Tuesday
2018,4,16,2400,39,71,110,Monday
2018,4,16,2300,58,75,133,Monday
2018,4,16,2200,70,85,155,Monday
2018,4,16,2100,95,122,217,Monday
2018,4,16,2000,106,153,259,Monday
2018,4,16,1900,133,257,390,Monday
2018,4,16,1800,176,331,507,Monday
2018,4,16,1700,197,402,599,Monday
2018,4,16,1600,246,341,587,Monday
2018,4,16,1500,225,284,509,Monday
2018,4,16,1400,245,265,510,Monday
2018,4,16,1300,243,222,465,Monday
2018,4,16,1200,270,214,484,Monday
2018,4,16,1100,351,193,544,Monday
2018,4,16,1000,301,115,416,Monday
2018,4,16,900,250,94,344,Monday
2018,4,16,800,132,45,177,Monday
2018,4,16,700,71,35,106,Monday
2018,4,16,600,34,21,55,Monday
2018,4,16,500,23,18,41,Monday
2018,4,16,400,19,17,36,Monday
2018,4,16,300,15,19,34,Monday
2018,4,16,200,23,28,51,Monday
2018,4,16,100,27,42,69,Monday
2018,4,15,2400,21,80,101,Sunday
2018,4,15,2300,57,132,189,Sunday
2018,4,15,2200,59,148,207,Sunday
2018,4,15,2100,110,282,392,Sunday
2018,4,15,2000,152,346,498,Sunday
2018,4,15,1900,149,510,659,Sunday
2018,4,15,1800,214,807,1021,Sunday
2018,4,15,1700,243,1106,1349,Sunday
2018,4,15,1600,316,914,1230,Sunday
2018,4,15,1500,322,708,1030,Sunday
2018,4,15,1400,352,609,961,Sunday
2018,4,15,1300,412,494,906,Sunday
2018,4,15,1200,477,375,852,Sunday
2018,4,15,1100,513,226,739,Sunday
2018,4,15,1000,534,147,681,Sunday
2018,4,15,900,549,69,618,Sunday
2018,4,15,800,216,30,246,Sunday
2018,4,15,700,75,24,99,Sunday
2018,4,15,600,38,11,49,Sunday
2018,4,15,500,28,17,45,Sunday
2018,4,15,400,17,17,34,Sunday
2018,4,15,300,17,13,30,Sunday
2018,4,15,200,13,19,32,Sunday
2018,4,15,100,24,42,66,Sunday
2018,4,14,2400,32,53,85,Saturday
2018,4,14,2300,50,80,130,Saturday
2018,4,14,2200,69,129,198,Saturday
2018,4,14,2100,98,168,266,Saturday
2018,4,14,2000,124,194,318,Saturday
2018,4,14,1900,139,318,457,Saturday
2018,4,14,1800,184,677,861,Saturday
2018,4,14,1700,244,814,1058,Saturday
2018,4,14,1600,279,648,927,Saturday
2018,4,14,1500,310,450,760,Saturday
2018,4,14,1400,333,313,646,Saturday
2018,4,14,1300,406,251,657,Saturday
2018,4,14,1200,458,189,647,Saturday
2018,4,14,1100,537,191,728,Saturday
2018,4,14,1000,684,132,816,Saturday
2018,4,14,900,738,96,834,Saturday
2018,4,14,800,285,65,350,Saturday
2018,4,14,700,105,34,139,Saturday
2018,4,14,600,46,15,61,Saturday
2018,4,14,500,20,22,42,Saturday
2018,4,14,400,29,19,48,Saturday
2018,4,14,300,18,20,38,Saturday
2018,4,14,200,29,39,68,Saturday
2018,4,14,100,41,55,96,Saturday
2018,4,13,2400,61,61,122,Friday
2018,4,13,2300,92,70,162,Friday
2018,4,13,2200,150,95,245,Friday
2018,4,13,2100,220,165,385,Friday
2018,4,13,2000,323,186,509,Friday
2018,4,13,1900,400,327,727,Friday
2018,4,13,1800,384,483,867,Friday
2018,4,13,1700,426,532,958,Friday
2018,4,13,1600,428,481,909,Friday
2018,4,13,1500,430,360,790,Friday
2018,4,13,1400,394,336,730,Friday
2018,4,13,1300,383,272,655,Friday
2018,4,13,1200,414,215,629,Friday
2018,4,13,1100,451,197,648,Friday
2018,4,13,1000,444,143,587,Friday
2018,4,13,900,393,113,506,Friday
2018,4,13,800,216,70,286,Friday
2018,4,13,700,86,47,133,Friday
2018,4,13,600,39,20,59,Friday
2018,4,13,500,22,24,46,Friday
2018,4,13,400,35,35,70,Friday
2018,4,13,300,31,37,68,Friday
2018,4,13,200,35,31,66,Friday
2018,4,13,100,34,53,87,Friday
2018,4,12,2400,59,66,125,Thursday
2018,4,12,2300,84,64,148,Thursday
2018,4,12,2200,93,116,209,Thursday
2018,4,12,2100,157,149,306,Thursday
2018,4,12,2000,196,195,391,Thursday
2018,4,12,1900,211,236,447,Thursday
2018,4,12,1800,239,376,615,Thursday
2018,4,12,1700,299,365,664,Thursday
2018,4,12,1600,258,321,579,Thursday
2018,4,12,1500,267,297,564,Thursday
2018,4,12,1400,318,239,557,Thursday
2018,4,12,1300,305,252,557,Thursday
2018,4,12,1200,320,229,549,Thursday
2018,4,12,1100,341,205,546,Thursday
2018,4,12,1000,304,139,443,Thursday
2018,4,12,900,243,82,325,Thursday
2018,4,12,800,193,50,243,Thursday
2018,4,12,700,102,43,145,Thursday
2018,4,12,600,45,29,74,Thursday
2018,4,12,500,30,28,58,Thursday
2018,4,12,400,22,34,56,Thursday
2018,4,12,300,17,27,44,Thursday
2018,4,12,200,30,36,66,Thursday
2018,4,12,100,39,55,94,Thursday
2018,4,11,2400,56,71,127,Wednesday
2018,4,11,2300,66,71,137,Wednesday
2018,4,11,2200,113,115,228,Wednesday
2018,4,11,2100,125,157,282,Wednesday
2018,4,11,2000,141,205,346,Wednesday
2018,4,11,1900,191,235,426,Wednesday
2018,4,11,1800,209,393,602,Wednesday
2018,4,11,1700,249,446,695,Wednesday
2018,4,11,1600,263,342,605,Wednesday
2018,4,11,1500,252,270,522,Wednesday
2018,4,11,1400,246,240,486,Wednesday
2018,4,11,1300,308,254,562,Wednesday
2018,4,11,1200,302,204,506,Wednesday
2018,4,11,1100,310,171,481,Wednesday
2018,4,11,1000,332,146,478,Wednesday
2018,4,11,900,253,115,368,Wednesday
2018,4,11,800,176,59,235,Wednesday
2018,4,11,700,74,43,117,Wednesday
2018,4,11,600,51,40,91,Wednesday
2018,4,11,500,23,33,56,Wednesday
2018,4,11,400,26,39,65,Wednesday
2018,4,11,300,32,35,67,Wednesday
2018,4,11,200,23,29,52,Wednesday
2018,4,11,100,40,46,86,Wednesday
2018,4,10,2400,56,67,123,Tuesday
2018,4,10,2300,75,67,142,Tuesday
2018,4,10,2200,76,114,190,Tuesday
2018,4,10,2100,106,141,247,Tuesday
2018,4,10,2000,124,173,297,Tuesday
2018,4,10,1900,142,236,378,Tuesday
2018,4,10,1800,157,306,463,Tuesday
2018,4,10,1700,203,463,666,Tuesday
2018,4,10,1600,221,314,535,Tuesday
2018,4,10,1500,216,255,471,Tuesday
2018,4,10,1400,216,305,521,Tuesday
2018,4,10,1300,276,263,539,Tuesday
2018,4,10,1200,341,215,556,Tuesday
2018,4,10,1100,291,168,459,Tuesday
2018,4,10,1000,310,133,443,Tuesday
2018,4,10,900,286,105,391,Tuesday
2018,4,10,800,164,60,224,Tuesday
2018,4,10,700,77,41,118,Tuesday
2018,4,10,600,38,43,81,Tuesday
2018,4,10,500,23,27,50,Tuesday
2018,4,10,400,24,33,57,Tuesday
2018,4,10,300,15,33,48,Tuesday
2018,4,10,200,29,37,66,Tuesday
2018,4,10,100,36,54,90,Tuesday
2018,4,9,2400,58,71,129,Monday
2018,4,9,2300,57,79,136,Monday
2018,4,9,2200,95,112,207,Monday
2018,4,9,2100,100,145,245,Monday
2018,4,9,2000,129,214,343,Monday
2018,4,9,1900,131,329,460,Monday
2018,4,9,1800,177,429,606,Monday
2018,4,9,1700,212,492,704,Monday
2018,4,9,1600,233,364,597,Monday
2018,4,9,1500,227,352,579,Monday
2018,4,9,1400,290,328,618,Monday
2018,4,9,1300,326,283,609,Monday
2018,4,9,1200,361,209,570,Monday
2018,4,9,1100,379,188,567,Monday
2018,4,9,1000,385,105,490,Monday
2018,4,9,900,310,90,400,Monday
2018,4,9,800,151,57,208,Monday
2018,4,9,700,88,49,137,Monday
2018,4,9,600,29,30,59,Monday
2018,4,9,500,26,14,40,Monday
2018,4,9,400,20,13,33,Monday
2018,4,9,300,24,32,56,Monday
2018,4,9,200,30,35,65,Monday
2018,4,9,100,27,53,80,Monday
2018,4,8,2400,38,51,89,Sunday
2018,4,8,2300,43,95,138,Sunday
2018,4,8,2200,58,143,201,Sunday
2018,4,8,2100,80,222,302,Sunday
2018,4,8,2000,109,351,460,Sunday
2018,4,8,1900,116,643,759,Sunday
2018,4,8,1800,164,883,1047,Sunday
2018,4,8,1700,161,1062,1223,Sunday
2018,4,8,1600,243,872,1115,Sunday
2018,4,8,1500,266,703,969,Sunday
2018,4,8,1400,276,571,847,Sunday
2018,4,8,1300,318,526,844,Sunday
2018,4,8,1200,372,353,725,Sunday
2018,4,8,1100,374,246,620,Sunday
2018,4,8,1000,498,122,620,Sunday
2018,4,8,900,547,64,611,Sunday
2018,4,8,800,241,29,270,Sunday
2018,4,8,700,93,19,112,Sunday
2018,4,8,600,15,15,30,Sunday
2018,4,8,500,10,14,24,Sunday
2018,4,8,400,12,13,25,Sunday
2018,4,8,300,18,25,43,Sunday
2018,4,8,200,18,28,46,Sunday
2018,4,8,100,26,34,60,Sunday
2018,4,7,2400,23,38,61,Saturday
2018,4,7,2300,26,81,107,Saturday
2018,4,7,2200,63,100,163,Saturday
2018,4,7,2100,76,168,244,Saturday
2018,4,7,2000,80,205,285,Saturday
2018,4,7,1900,141,404,545,Saturday
2018,4,7,1800,144,728,872,Saturday
2018,4,7,1700,211,919,1130,Saturday
2018,4,7,1600,223,555,778,Saturday
2018,4,7,1500,271,446,717,Saturday
2018,4,7,1400,301,373,674,Saturday
2018,4,7,1300,316,252,568,Saturday
2018,4,7,1200,378,291,669,Saturday
2018,4,7,1100,430,209,639,Saturday
2018,4,7,1000,615,162,777,Saturday
2018,4,7,900,683,112,795,Saturday
2018,4,7,800,336,56,392,Saturday
2018,4,7,700,149,34,183,Saturday
2018,4,7,600,35,30,65,Saturday
2018,4,7,500,23,25,48,Saturday
2018,4,7,400,22,18,40,Saturday
2018,4,7,300,22,21,43,Saturday
2018,4,7,200,28,37,65,Saturday
2018,4,7,100,40,39,79,Saturday
2018,4,6,2400,63,49,112,Friday
2018,4,6,2300,83,81,164,Friday
2018,4,6,2200,142,100,242,Friday
2018,4,6,2100,225,169,394,Friday
2018,4,6,2000,332,235,567,Friday
2018,4,6,1900,387,361,748,Friday
2018,4,6,1800,462,578,1040,Friday
2018,4,6,1700,471,669,1140,Friday
2018,4,6,1600,403,565,968,Friday
2018,4,6,1500,396,447,843,Friday
2018,4,6,1400,353,368,721,Friday
2018,4,6,1300,364,336,700,Friday
2018,4,6,1200,421,263,684,Friday
2018,4,6,1100,466,215,681,Friday
2018,4,6,1000,486,142,628,Friday
2018,4,6,900,483,108,591,Friday
2018,4,6,800,269,54,323,Friday
2018,4,6,700,81,44,125,Friday
2018,4,6,600,48,32,80,Friday
2018,4,6,500,18,27,45,Friday
2018,4,6,400,38,25,63,Friday
2018,4,6,300,27,37,64,Friday
2018,4,6,200,32,45,77,Friday
2018,4,6,100,43,39,82,Friday
2018,4,5,2400,50,76,126,Thursday
2018,4,5,2300,95,116,211,Thursday
2018,4,5,2200,125,114,239,Thursday
2018,4,5,2100,145,148,293,Thursday
2018,4,5,2000,197,203,400,Thursday
2018,4,5,1900,220,326,546,Thursday
2018,4,5,1800,284,526,810,Thursday
2018,4,5,1700,304,579,883,Thursday
2018,4,5,1600,298,462,760,Thursday
2018,4,5,1500,327,345,672,Thursday
2018,4,5,1400,340,334,674,Thursday
2018,4,5,1300,343,305,648,Thursday
2018,4,5,1200,424,254,678,Thursday
2018,4,5,1100,456,201,657,Thursday
2018,4,5,1000,479,135,614,Thursday
2018,4,5,900,446,95,541,Thursday
2018,4,5,800,243,59,302,Thursday
2018,4,5,700,89,42,131,Thursday
2018,4,5,600,51,14,65,Thursday
2018,4,5,500,23,23,46,Thursday
2018,4,5,400,25,39,64,Thursday
2018,4,5,300,25,28,53,Thursday
2018,4,5,200,28,36,64,Thursday
2018,4,5,100,42,54,96,Thursday
2018,4,4,2400,55,72,127,Wednesday
2018,4,4,2300,86,75,161,Wednesday
2018,4,4,2200,84,148,232,Wednesday
2018,4,4,2100,132,171,303,Wednesday
2018,4,4,2000,146,197,343,Wednesday
2018,4,4,1900,167,328,495,Wednesday
2018,4,4,1800,211,476,687,Wednesday
2018,4,4,1700,269,618,887,Wednesday
2018,4,4,1600,277,472,749,Wednesday
2018,4,4,1500,288,383,671,Wednesday
2018,4,4,1400,302,317,619,Wednesday
2018,4,4,1300,350,318,668,Wednesday
2018,4,4,1200,372,233,605,Wednesday
2018,4,4,1100,426,205,631,Wednesday
2018,4,4,1000,454,155,609,Wednesday
2018,4,4,900,378,104,482,Wednesday
2018,4,4,800,213,56,269,Wednesday
2018,4,4,700,74,43,117,Wednesday
2018,4,4,600,39,54,93,Wednesday
2018,4,4,500,26,33,59,Wednesday
2018,4,4,400,25,39,64,Wednesday
2018,4,4,300,21,43,64,Wednesday
2018,4,4,200,18,48,66,Wednesday
2018,4,4,100,40,48,88,Wednesday
2018,4,3,2400,57,81,138,Tuesday
2018,4,3,2300,68,86,154,Tuesday
2018,4,3,2200,104,103,207,Tuesday
2018,4,3,2100,112,157,269,Tuesday
2018,4,3,2000,133,291,424,Tuesday
2018,4,3,1900,137,301,438,Tuesday
2018,4,3,1800,202,570,772,Tuesday
2018,4,3,1700,249,631,880,Tuesday
2018,4,3,1600,245,601,846,Tuesday
2018,4,3,1500,297,428,725,Tuesday
2018,4,3,1400,342,362,704,Tuesday
2018,4,3,1300,320,328,648,Tuesday
2018,4,3,1200,395,292,687,Tuesday
2018,4,3,1100,464,205,669,Tuesday
2018,4,3,1000,477,160,637,Tuesday
2018,4,3,900,418,112,530,Tuesday
2018,4,3,800,210,57,267,Tuesday
2018,4,3,700,82,35,117,Tuesday
2018,4,3,600,31,27,58,Tuesday
2018,4,3,500,21,27,48,Tuesday
2018,4,3,400,25,30,55,Tuesday
2018,4,3,300,23,39,62,Tuesday
2018,4,3,200,20,48,68,Tuesday
2018,4,3,100,38,62,100,Tuesday
2018,4,2,2400,51,57,108,Monday
2018,4,2,2300,69,115,184,Monday
2018,4,2,2200,87,180,267,Monday
2018,4,2,2100,101,234,335,Monday
2018,4,2,2000,144,448,592,Monday
2018,4,2,1900,161,578,739,Monday
2018,4,2,1800,221,1045,1266,Monday
2018,4,2,1700,269,1065,1334,Monday
2018,4,2,1600,359,951,1310,Monday
2018,4,2,1500,385,913,1298,Monday
2018,4,2,1400,494,785,1279,Monday
2018,4,2,1300,522,710,1232,Monday
2018,4,2,1200,622,513,1135,Monday
2018,4,2,1100,618,340,958,Monday
2018,4,2,1000,567,191,758,Monday
2018,4,2,900,572,119,691,Monday
2018,4,2,800,208,56,264,Monday
2018,4,2,700,75,50,125,Monday
2018,4,2,600,26,24,50,Monday
2018,4,2,500,16,35,51,Monday
2018,4,2,400,19,23,42,Monday
2018,4,2,300,14,21,35,Monday
2018,4,2,200,10,38,48,Monday
2018,4,2,100,31,61,92,Monday
2018,4,1,2400,30,87,117,Sunday
2018,4,1,2300,48,108,156,Sunday
2018,4,1,2200,67,194,261,Sunday
2018,4,1,2100,89,303,392,Sunday
2018,4,1,2000,99,430,529,Sunday
2018,4,1,1900,133,624,757,Sunday
2018,4,1,1800,209,1029,1238,Sunday
2018,4,1,1700,264,1319,1583,Sunday
2018,4,1,1600,362,1208,1570,Sunday
2018,4,1,1500,379,1040,1419,Sunday
2018,4,1,1400,452,961,1413,Sunday
2018,4,1,1300,487,828,1315,Sunday
2018,4,1,1200,537,601,1138,Sunday
2018,4,1,1100,544,293,837,Sunday
2018,4,1,1000,517,138,655,Sunday
2018,4,1,900,519,104,623,Sunday
2018,4,1,800,217,42,259,Sunday
2018,4,1,700,75,20,95,Sunday
2018,4,1,600,29,18,47,Sunday
2018,4,1,500,18,11,29,Sunday
2018,4,1,400,19,20,39,Sunday
2018,4,1,300,13,11,24,Sunday
2018,4,1,200,21,22,43,Sunday
2018,4,1,100,27,34,61,Sunday
2018,3,31,2400,36,51,87,Saturday
2018,3,31,2300,60,108,168,Saturday
2018,3,31,2200,67,134,201,Saturday
2018,3,31,2100,110,224,334,Saturday
2018,3,31,2000,132,397,529,Saturday
2018,3,31,1900,148,641,789,Saturday
2018,3,31,1800,227,1275,1502,Saturday
2018,3,31,1700,297,1193,1490,Saturday
2018,3,31,1600,355,842,1197,Saturday
2018,3,31,1500,431,661,1092,Saturday
2018,3,31,1400,525,567,1092,Saturday
2018,3,31,1300,691,472,1163,Saturday
2018,3,31,1200,713,339,1052,Saturday
2018,3,31,1100,699,230,929,Saturday
2018,3,31,1000,830,116,946,Saturday
2018,3,31,900,999,98,1097,Saturday
2018,3,31,800,357,26,383,Saturday
2018,3,31,700,99,19,118,Saturday
2018,3,31,600,24,16,40,Saturday
2018,3,31,500,16,13,29,Saturday
2018,3,31,400,13,22,35,Saturday
2018,3,31,300,17,27,44,Saturday
2018,3,31,200,18,16,34,Saturday
2018,3,31,100,33,47,80,Saturday
2018,3,30,2400,33,43,76,Friday
2018,3,30,2300,43,88,131,Friday
2018,3,30,2200,81,87,168,Friday
2018,3,30,2100,97,147,244,Friday
2018,3,30,2000,134,206,340,Friday
2018,3,30,1900,198,368,566,Friday
2018,3,30,1800,247,935,1182,Friday
2018,3,30,1700,537,997,1534,Friday
2018,3,30,1600,501,974,1475,Friday
2018,3,30,1500,644,494,1138,Friday
2018,3,30,1400,717,370,1087,Friday
2018,3,30,1300,730,324,1054,Friday
2018,3,30,1200,874,320,1194,Friday
2018,3,30,1100,822,251,1073,Friday
2018,3,30,1000,948,194,1142,Friday
2018,3,30,900,1106,127,1233,Friday
2018,3,30,800,505,64,569,Friday
2018,3,30,700,155,33,188,Friday
2018,3,30,600,76,18,94,Friday
2018,3,30,500,58,28,86,Friday
2018,3,30,400,39,34,73,Friday
2018,3,30,300,40,31,71,Friday
2018,3,30,200,54,40,94,Friday
2018,3,30,100,71,62,133,Friday
2018,3,29,2400,116,68,184,Thursday
2018,3,29,2300,173,111,284,Thursday
2018,3,29,2200,297,138,435,Thursday
2018,3,29,2100,429,214,643,Thursday
2018,3,29,2000,616,291,907,Thursday
2018,3,29,1900,810,419,1229,Thursday
2018,3,29,1800,859,769,1628,Thursday
2018,3,29,1700,755,839,1594,Thursday
2018,3,29,1600,668,649,1317,Thursday
2018,3,29,1500,676,533,1209,Thursday
2018,3,29,1400,588,450,1038,Thursday
2018,3,29,1300,590,471,1061,Thursday
2018,3,29,1200,634,307,941,Thursday
2018,3,29,1100,631,237,868,Thursday
2018,3,29,1000,713,164,877,Thursday
2018,3,29,900,651,123,774,Thursday
2018,3,29,800,330,89,419,Thursday
2018,3,29,700,115,37,152,Thursday
2018,3,29,600,59,35,94,Thursday
2018,3,29,500,27,25,52,Thursday
2018,3,29,400,34,25,59,Thursday
2018,3,29,300,24,50,74,Thursday
2018,3,29,200,43,49,92,Thursday
2018,3,29,100,40,60,100,Thursday
2018,3,28,2400,70,89,159,Wednesday
2018,3,28,2300,97,97,194,Wednesday
2018,3,28,2200,144,125,269,Wednesday
2018,3,28,2100,185,203,388,Wednesday
2018,3,28,2000,255,218,473,Wednesday
2018,3,28,1900,262,379,641,Wednesday
2018,3,28,1800,290,682,972,Wednesday
2018,3,28,1700,342,743,1085,Wednesday
2018,3,28,1600,373,536,909,Wednesday
2018,3,28,1500,469,449,918,Wednesday
2018,3,28,1400,396,396,792,Wednesday
2018,3,28,1300,451,349,800,Wednesday
2018,3,28,1200,523,256,779,Wednesday
2018,3,28,1100,574,207,781,Wednesday
2018,3,28,1000,582,146,728,Wednesday
2018,3,28,900,538,127,665,Wednesday
2018,3,28,800,292,72,364,Wednesday
2018,3,28,700,88,32,120,Wednesday
2018,3,28,600,53,28,81,Wednesday
2018,3,28,500,25,31,56,Wednesday
2018,3,28,400,22,30,52,Wednesday
2018,3,28,300,28,40,68,Wednesday
2018,3,28,200,27,53,80,Wednesday
2018,3,28,100,55,52,107,Wednesday
2018,3,27,2400,73,64,137,Tuesday
2018,3,27,2300,81,78,159,Tuesday
2018,3,27,2200,98,130,228,Tuesday
2018,3,27,2100,123,151,274,Tuesday
2018,3,27,2000,173,322,495,Tuesday
2018,3,27,1900,204,280,484,Tuesday
2018,3,27,1800,232,590,822,Tuesday
2018,3,27,1700,271,649,920,Tuesday
2018,3,27,1600,309,410,719,Tuesday
2018,3,27,1500,329,477,806,Tuesday
2018,3,27,1400,326,310,636,Tuesday
2018,3,27,1300,391,234,625,Tuesday
2018,3,27,1200,432,251,683,Tuesday
2018,3,27,1100,464,231,695,Tuesday
2018,3,27,1000,486,166,652,Tuesday
2018,3,27,900,475,110,585,Tuesday
2018,3,27,800,245,65,310,Tuesday
2018,3,27,700,76,52,128,Tuesday
2018,3,27,600,36,35,71,Tuesday
2018,3,27,500,26,33,59,Tuesday
2018,3,27,400,23,37,60,Tuesday
2018,3,27,300,10,35,45,Tuesday
2018,3,27,200,26,38,64,Tuesday
2018,3,27,100,36,47,83,Tuesday
2018,3,26,2400,60,47,107,Monday
2018,3,26,2300,81,58,139,Monday
2018,3,26,2200,98,112,210,Monday
2018,3,26,2100,117,182,299,Monday
2018,3,26,2000,146,234,380,Monday
2018,3,26,1900,146,313,459,Monday
2018,3,26,1800,240,626,866,Monday
2018,3,26,1700,335,756,1091,Monday
2018,3,26,1600,326,504,830,Monday
2018,3,26,1500,416,436,852,Monday
2018,3,26,1400,456,389,845,Monday
2018,3,26,1300,485,353,838,Monday
2018,3,26,1200,547,277,824,Monday
2018,3,26,1100,501,212,713,Monday
2018,3,26,1000,554,164,718,Monday
2018,3,26,900,486,102,588,Monday
2018,3,26,800,229,56,285,Monday
2018,3,26,700,101,43,144,Monday
2018,3,26,600,44,13,57,Monday
2018,3,26,500,17,15,32,Monday
2018,3,26,400,22,17,39,Monday
2018,3,26,300,17,33,50,Monday
2018,3,26,200,24,34,58,Monday
2018,3,26,100,25,57,82,Monday
2018,3,25,2400,32,56,88,Sunday
2018,3,25,2300,61,107,168,Sunday
2018,3,25,2200,86,176,262,Sunday
2018,3,25,2100,114,268,382,Sunday
2018,3,25,2000,159,323,482,Sunday
2018,3,25,1900,204,539,743,Sunday
2018,3,25,1800,290,1033,1323,Sunday
2018,3,25,1700,375,1281,1656,Sunday
2018,3,25,1600,479,1026,1505,Sunday
2018,3,25,1500,454,789,1243,Sunday
2018,3,25,1400,507,714,1221,Sunday
2018,3,25,1300,556,539,1095,Sunday
2018,3,25,1200,607,445,1052,Sunday
2018,3,25,1100,576,287,863,Sunday
2018,3,25,1000,651,192,843,Sunday
2018,3,25,900,735,58,793,Sunday
2018,3,25,800,269,31,300,Sunday
2018,3,25,700,92,17,109,Sunday
2018,3,25,600,47,46,93,Sunday
2018,3,25,500,27,7,34,Sunday
2018,3,25,400,19,4,23,Sunday
2018,3,25,300,35,1,36,Sunday
2018,3,25,200,26,6,32,Sunday
2018,3,25,100,36,39,75,Sunday
2018,3,24,2400,40,50,90,Saturday
2018,3,24,2300,69,77,146,Saturday
2018,3,24,2200,63,93,156,Saturday
2018,3,24,2100,96,140,236,Saturday
2018,3,24,2000,127,208,335,Saturday
2018,3,24,1900,146,379,525,Saturday
2018,3,24,1800,226,893,1119,Saturday
2018,3,24,1700,284,1010,1294,Saturday
2018,3,24,1600,391,673,1064,Saturday
2018,3,24,1500,412,419,831,Saturday
2018,3,24,1400,440,352,792,Saturday
2018,3,24,1300,504,301,805,Saturday
2018,3,24,1200,591,243,834,Saturday
2018,3,24,1100,660,184,844,Saturday
2018,3,24,1000,790,159,949,Saturday
2018,3,24,900,948,93,1041,Saturday
2018,3,24,800,446,58,504,Saturday
2018,3,24,700,123,30,153,Saturday
2018,3,24,600,47,18,65,Saturday
2018,3,24,500,27,25,52,Saturday
2018,3,24,400,27,24,51,Saturday
2018,3,24,300,30,24,54,Saturday
2018,3,24,200,37,39,76,Saturday
2018,3,24,100,40,47,87,Saturday
2018,3,23,2400,72,66,138,Friday
2018,3,23,2300,102,74,176,Friday
2018,3,23,2200,148,82,230,Friday
2018,3,23,2100,276,128,404,Friday
2018,3,23,2000,379,209,588,Friday
2018,3,23,1900,454,298,752,Friday
2018,3,23,1800,551,526,1077,Friday
2018,3,23,1700,582,660,1242,Friday
2018,3,23,1600,574,536,1110,Friday
2018,3,23,1500,573,373,946,Friday
2018,3,23,1400,472,291,763,Friday
2018,3,23,1300,483,293,776,Friday
2018,3,23,1200,521,228,749,Friday
2018,3,23,1100,500,194,694,Friday
2018,3,23,1000,603,143,746,Friday
2018,3,23,900,521,99,620,Friday
2018,3,23,800,235,59,294,Friday
2018,3,23,700,100,36,136,Friday
2018,3,23,600,39,41,80,Friday
2018,3,23,500,40,40,80,Friday
2018,3,23,400,35,22,57,Friday
2018,3,23,300,25,39,64,Friday
2018,3,23,200,30,33,63,Friday
2018,3,23,100,49,49,98,Friday
2018,3,22,2400,56,76,132,Thursday
2018,3,22,2300,92,75,167,Thursday
2018,3,22,2200,136,86,222,Thursday
2018,3,22,2100,182,146,328,Thursday
2018,3,22,2000,231,192,423,Thursday
2018,3,22,1900,247,228,475,Thursday
2018,3,22,1800,297,346,643,Thursday
2018,3,22,1700,353,450,803,Thursday
2018,3,22,1600,347,379,726,Thursday
2018,3,22,1500,329,309,638,Thursday
2018,3,22,1400,304,273,577,Thursday
2018,3,22,1300,369,231,600,Thursday
2018,3,22,1200,319,225,544,Thursday
2018,3,22,1100,374,173,547,Thursday
2018,3,22,1000,347,117,464,Thursday
2018,3,22,900,333,104,437,Thursday
2018,3,22,800,190,75,265,Thursday
2018,3,22,700,79,41,120,Thursday
2018,3,22,600,28,33,61,Thursday
2018,3,22,500,26,34,60,Thursday
2018,3,22,400,23,32,55,Thursday
2018,3,22,300,28,31,59,Thursday
2018,3,22,200,37,42,79,Thursday
2018,3,22,100,41,56,97,Thursday
2018,3,21,2400,73,92,165,Wednesday
2018,3,21,2300,76,97,173,Wednesday
2018,3,21,2200,87,87,174,Wednesday
2018,3,21,2100,129,110,239,Wednesday
2018,3,21,2000,151,149,300,Wednesday
2018,3,21,1900,172,274,446,Wednesday
2018,3,21,1800,238,356,594,Wednesday
2018,3,21,1700,209,449,658,Wednesday
2018,3,21,1600,258,366,624,Wednesday
2018,3,21,1500,290,320,610,Wednesday
2018,3,21,1400,280,278,558,Wednesday
2018,3,21,1300,265,206,471,Wednesday
2018,3,21,1200,330,238,568,Wednesday
2018,3,21,1100,318,192,510,Wednesday
2018,3,21,1000,349,177,526,Wednesday
2018,3,21,900,325,120,445,Wednesday
2018,3,21,800,186,61,247,Wednesday
2018,3,21,700,83,38,121,Wednesday
2018,3,21,600,40,29,69,Wednesday
2018,3,21,500,23,47,70,Wednesday
2018,3,21,400,34,32,66,Wednesday
2018,3,21,300,25,25,50,Wednesday
2018,3,21,200,29,39,68,Wednesday
2018,3,21,100,49,41,90,Wednesday
2018,3,20,2400,58,55,113,Tuesday
2018,3,20,2300,71,71,142,Tuesday
2018,3,20,2200,89,92,181,Tuesday
2018,3,20,2100,116,114,230,Tuesday
2018,3,20,2000,122,176,298,Tuesday
2018,3,20,1900,124,249,373,Tuesday
2018,3,20,1800,158,372,530,Tuesday
2018,3,20,1700,215,474,689,Tuesday
2018,3,20,1600,206,341,547,Tuesday
2018,3,20,1500,231,309,540,Tuesday
2018,3,20,1400,258,280,538,Tuesday
2018,3,20,1300,247,237,484,Tuesday
2018,3,20,1200,290,200,490,Tuesday
2018,3,20,1100,332,200,532,Tuesday
2018,3,20,1000,353,144,497,Tuesday
2018,3,20,900,293,109,402,Tuesday
2018,3,20,800,205,70,275,Tuesday
2018,3,20,700,73,41,114,Tuesday
2018,3,20,600,32,31,63,Tuesday
2018,3,20,500,16,21,37,Tuesday
2018,3,20,400,30,29,59,Tuesday
2018,3,20,300,25,35,60,Tuesday
2018,3,20,200,22,34,56,Tuesday
2018,3,20,100,35,57,92,Tuesday
2018,3,19,2400,56,56,112,Monday
2018,3,19,2300,64,91,155,Monday
2018,3,19,2200,83,96,179,Monday
2018,3,19,2100,97,147,244,Monday
2018,3,19,2000,126,285,411,Monday
2018,3,19,1900,151,203,354,Monday
2018,3,19,1800,201,426,627,Monday
2018,3,19,1700,222,557,779,Monday
2018,3,19,1600,227,424,651,Monday
2018,3,19,1500,237,347,584,Monday
2018,3,19,1400,284,289,573,Monday
2018,3,19,1300,313,270,583,Monday
2018,3,19,1200,335,210,545,Monday
2018,3,19,1100,377,178,555,Monday
2018,3,19,1000,403,138,541,Monday
2018,3,19,900,336,106,442,Monday
2018,3,19,800,188,64,252,Monday
2018,3,19,700,85,39,124,Monday
2018,3,19,600,35,21,56,Monday
2018,3,19,500,17,10,27,Monday
2018,3,19,400,20,29,49,Monday
2018,3,19,300,20,18,38,Monday
2018,3,19,200,18,23,41,Monday
2018,3,19,100,23,44,67,Monday
2018,3,18,2400,34,62,96,Sunday
2018,3,18,2300,40,75,115,Sunday
2018,3,18,2200,54,154,208,Sunday
2018,3,18,2100,75,196,271,Sunday
2018,3,18,2000,122,278,400,Sunday
2018,3,18,1900,147,509,656,Sunday
2018,3,18,1800,201,775,976,Sunday
2018,3,18,1700,203,1135,1338,Sunday
2018,3,18,1600,279,876,1155,Sunday
2018,3,18,1500,261,686,947,Sunday
2018,3,18,1400,299,611,910,Sunday
2018,3,18,1300,291,447,738,Sunday
2018,3,18,1200,407,391,798,Sunday
2018,3,18,1100,385,245,630,Sunday
2018,3,18,1000,495,155,650,Sunday
2018,3,18,900,649,84,733,Sunday
2018,3,18,800,227,37,264,Sunday
2018,3,18,700,41,19,60,Sunday
2018,3,18,600,25,19,44,Sunday
2018,3,18,500,10,18,28,Sunday
2018,3,18,400,18,17,35,Sunday
2018,3,18,300,15,21,36,Sunday
2018,3,18,200,18,30,48,Sunday
2018,3,18,100,21,37,58,Sunday
2018,3,17,2400,31,49,80,Saturday
2018,3,17,2300,51,62,113,Saturday
2018,3,17,2200,58,89,147,Saturday
2018,3,17,2100,81,154,235,Saturday
2018,3,17,2000,108,193,301,Saturday
2018,3,17,1900,114,342,456,Saturday
2018,3,17,1800,159,891,1050,Saturday
2018,3,17,1700,212,1001,1213,Saturday
2018,3,17,1600,223,583,806,Saturday
2018,3,17,1500,248,461,709,Saturday
2018,3,17,1400,284,333,617,Saturday
2018,3,17,1300,339,298,637,Saturday
2018,3,17,1200,386,230,616,Saturday
2018,3,17,1100,436,161,597,Saturday
2018,3,17,1000,647,120,767,Saturday
2018,3,17,900,1006,100,1106,Saturday
2018,3,17,800,373,61,434,Saturday
2018,3,17,700,90,37,127,Saturday
2018,3,17,600,36,15,51,Saturday
2018,3,17,500,21,20,41,Saturday
2018,3,17,400,26,29,55,Saturday
2018,3,17,300,19,22,41,Saturday
2018,3,17,200,24,28,52,Saturday
2018,3,17,100,43,49,92,Saturday
2018,3,16,2400,63,74,137,Friday
2018,3,16,2300,87,80,167,Friday
2018,3,16,2200,135,108,243,Friday
2018,3,16,2100,224,238,462,Friday
2018,3,16,2000,363,262,625,Friday
2018,3,16,1900,410,245,655,Friday
2018,3,16,1800,467,502,969,Friday
2018,3,16,1700,487,648,1135,Friday
2018,3,16,1600,447,563,1010,Friday
2018,3,16,1500,384,442,826,Friday
2018,3,16,1400,367,358,725,Friday
2018,3,16,1300,379,321,700,Friday
2018,3,16,1200,421,251,672,Friday
2018,3,16,1100,457,193,650,Friday
2018,3,16,1000,547,147,694,Friday
2018,3,16,900,592,125,717,Friday
2018,3,16,800,244,67,311,Friday
2018,3,16,700,89,50,139,Friday
2018,3,16,600,37,17,54,Friday
2018,3,16,500,25,19,44,Friday
2018,3,16,400,31,25,56,Friday
2018,3,16,300,14,30,44,Friday
2018,3,16,200,28,30,58,Friday
2018,3,16,100,37,54,91,Friday
2018,3,15,2400,51,50,101,Thursday
2018,3,15,2300,89,69,158,Thursday
2018,3,15,2200,80,80,160,Thursday
2018,3,15,2100,145,91,236,Thursday
2018,3,15,2000,192,136,328,Thursday
2018,3,15,1900,185,220,405,Thursday
2018,3,15,1800,194,391,585,Thursday
2018,3,15,1700,270,397,667,Thursday
2018,3,15,1600,248,360,608,Thursday
2018,3,15,1500,248,274,522,Thursday
2018,3,15,1400,196,227,423,Thursday
2018,3,15,1300,180,251,431,Thursday
2018,3,15,1200,250,174,424,Thursday
2018,3,15,1100,326,184,510,Thursday
2018,3,15,1000,345,129,474,Thursday
2018,3,15,900,335,91,426,Thursday
2018,3,15,800,190,70,260,Thursday
2018,3,15,700,90,44,134,Thursday
2018,3,15,600,41,28,69,Thursday
2018,3,15,500,29,26,55,Thursday
2018,3,15,400,43,31,74,Thursday
2018,3,15,300,24,26,50,Thursday
2018,3,15,200,29,34,63,Thursday
2018,3,15,100,42,47,89,Thursday
2018,3,14,2400,65,74,139,Wednesday
2018,3,14,2300,78,71,149,Wednesday
2018,3,14,2200,107,101,208,Wednesday
2018,3,14,2100,140,142,282,Wednesday
2018,3,14,2000,165,195,360,Wednesday
2018,3,14,1900,161,301,462,Wednesday
2018,3,14,1800,198,468,666,Wednesday
2018,3,14,1700,243,521,764,Wednesday
2018,3,14,1600,266,364,630,Wednesday
2018,3,14,1500,230,279,509,Wednesday
2018,3,14,1400,250,237,487,Wednesday
2018,3,14,1300,281,229,510,Wednesday
2018,3,14,1200,344,187,531,Wednesday
2018,3,14,1100,358,202,560,Wednesday
2018,3,14,1000,425,135,560,Wednesday
2018,3,14,900,340,112,452,Wednesday
2018,3,14,800,186,65,251,Wednesday
2018,3,14,700,80,41,121,Wednesday
2018,3,14,600,39,31,70,Wednesday
2018,3,14,500,25,29,54,Wednesday
2018,3,14,400,24,26,50,Wednesday
2018,3,14,300,25,38,63,Wednesday
2018,3,14,200,32,30,62,Wednesday
2018,3,14,100,48,62,110,Wednesday
2018,3,13,2400,62,70,132,Tuesday
2018,3,13,2300,87,80,167,Tuesday
2018,3,13,2200,78,94,172,Tuesday
2018,3,13,2100,120,169,289,Tuesday
2018,3,13,2000,118,154,272,Tuesday
2018,3,13,1900,149,292,441,Tuesday
2018,3,13,1800,175,492,667,Tuesday
2018,3,13,1700,198,584,782,Tuesday
2018,3,13,1600,205,380,585,Tuesday
2018,3,13,1500,253,303,556,Tuesday
2018,3,13,1400,246,259,505,Tuesday
2018,3,13,1300,276,246,522,Tuesday
2018,3,13,1200,330,196,526,Tuesday
2018,3,13,1100,389,181,570,Tuesday
2018,3,13,1000,391,134,525,Tuesday
2018,3,13,900,388,100,488,Tuesday
2018,3,13,800,184,56,240,Tuesday
2018,3,13,700,65,38,103,Tuesday
2018,3,13,600,29,28,57,Tuesday
2018,3,13,500,24,30,54,Tuesday
2018,3,13,400,24,37,61,Tuesday
2018,3,13,300,22,33,55,Tuesday
2018,3,13,200,28,49,77,Tuesday
2018,3,13,100,32,51,83,Tuesday
2018,3,12,2400,56,62,118,Monday
2018,3,12,2300,52,91,143,Monday
2018,3,12,2200,86,106,192,Monday
2018,3,12,2100,120,162,282,Monday
2018,3,12,2000,153,224,377,Monday
2018,3,12,1900,143,489,632,Monday
2018,3,12,1800,195,467,662,Monday
2018,3,12,1700,233,437,670,Monday
2018,3,12,1600,262,386,648,Monday
2018,3,12,1500,255,360,615,Monday
2018,3,12,1400,298,330,628,Monday
2018,3,12,1300,337,279,616,Monday
2018,3,12,1200,367,237,604,Monday
2018,3,12,1100,383,206,589,Monday
2018,3,12,1000,446,150,596,Monday
2018,3,12,900,414,124,538,Monday
2018,3,12,800,184,72,256,Monday
2018,3,12,700,83,43,126,Monday
2018,3,12,600,35,18,53,Monday
2018,3,12,500,24,18,42,Monday
2018,3,12,400,19,19,38,Monday
2018,3,12,300,9,30,39,Monday
2018,3,12,200,19,38,57,Monday
2018,3,12,100,25,47,72,Monday
2018,3,11,2400,39,79,118,Sunday
2018,3,11,2300,53,112,165,Sunday
2018,3,11,2200,73,358,431,Sunday
2018,3,11,2100,96,125,221,Sunday
2018,3,11,2000,138,284,422,Sunday
2018,3,11,1900,155,652,807,Sunday
2018,3,11,1800,245,1153,1398,Sunday
2018,3,11,1700,273,1350,1623,Sunday
2018,3,11,1600,334,919,1253,Sunday
2018,3,11,1500,309,791,1100,Sunday
2018,3,11,1400,393,702,1095,Sunday
2018,3,11,1300,419,519,938,Sunday
2018,3,11,1200,509,384,893,Sunday
2018,3,11,1100,511,228,739,Sunday
2018,3,11,1000,622,140,762,Sunday
2018,3,11,900,633,81,714,Sunday
2018,3,11,800,241,28,269,Sunday
2018,3,11,700,71,27,98,Sunday
2018,3,11,600,37,22,59,Sunday
2018,3,11,500,16,19,35,Sunday
2018,3,11,400,19,15,34,Sunday
2018,3,11,300,0,0,0,Sunday
2018,3,11,200,22,28,50,Sunday
2018,3,11,100,33,36,69,Sunday
2018,3,10,2400,30,46,76,Saturday
2018,3,10,2300,53,77,130,Saturday
2018,3,10,2200,64,102,166,Saturday
2018,3,10,2100,88,312,400,Saturday
2018,3,10,2000,113,201,314,Saturday
2018,3,10,1900,130,378,508,Saturday
2018,3,10,1800,204,991,1195,Saturday
2018,3,10,1700,244,985,1229,Saturday
2018,3,10,1600,263,669,932,Saturday
2018,3,10,1500,328,463,791,Saturday
2018,3,10,1400,404,361,765,Saturday
2018,3,10,1300,396,288,684,Saturday
2018,3,10,1200,511,231,742,Saturday
2018,3,10,1100,548,209,757,Saturday
2018,3,10,1000,805,165,970,Saturday
2018,3,10,900,1035,107,1142,Saturday
2018,3,10,800,489,70,559,Saturday
2018,3,10,700,118,40,158,Saturday
2018,3,10,600,47,15,62,Saturday
2018,3,10,500,21,16,37,Saturday
2018,3,10,400,28,27,55,Saturday
2018,3,10,300,26,32,58,Saturday
2018,3,10,200,18,36,54,Saturday
2018,3,10,100,40,31,71,Saturday
2018,3,9,2400,60,51,111,Friday
2018,3,9,2300,88,68,156,Friday
2018,3,9,2200,152,83,235,Friday
2018,3,9,2100,229,111,340,Friday
2018,3,9,2000,343,208,551,Friday
2018,3,9,1900,459,293,752,Friday
2018,3,9,1800,481,485,966,Friday
2018,3,9,1700,522,612,1134,Friday
2018,3,9,1600,491,473,964,Friday
2018,3,9,1500,429,385,814,Friday
2018,3,9,1400,355,284,639,Friday
2018,3,9,1300,375,241,616,Friday
2018,3,9,1200,423,229,652,Friday
2018,3,9,1100,432,179,611,Friday
2018,3,9,1000,554,134,688,Friday
2018,3,9,900,533,101,634,Friday
2018,3,9,800,248,54,302,Friday
2018,3,9,700,98,35,133,Friday
2018,3,9,600,35,22,57,Friday
2018,3,9,500,34,23,57,Friday
2018,3,9,400,36,24,60,Friday
2018,3,9,300,31,20,51,Friday
2018,3,9,200,24,32,56,Friday
2018,3,9,100,43,41,84,Friday
2018,3,8,2400,56,62,118,Thursday
2018,3,8,2300,105,54,159,Thursday
2018,3,8,2200,134,85,219,Thursday
2018,3,8,2100,169,110,279,Thursday
2018,3,8,2000,214,166,380,Thursday
2018,3,8,1900,255,227,482,Thursday
2018,3,8,1800,249,413,662,Thursday
2018,3,8,1700,267,521,788,Thursday
2018,3,8,1600,279,369,648,Thursday
2018,3,8,1500,290,280,570,Thursday
2018,3,8,1400,283,231,514,Thursday
2018,3,8,1300,291,203,494,Thursday
2018,3,8,1200,320,188,508,Thursday
2018,3,8,1100,340,155,495,Thursday
2018,3,8,1000,392,147,539,Thursday
2018,3,8,900,353,106,459,Thursday
2018,3,8,800,188,59,247,Thursday
2018,3,8,700,89,30,119,Thursday
2018,3,8,600,38,35,73,Thursday
2018,3,8,500,25,31,56,Thursday
2018,3,8,400,28,30,58,Thursday
2018,3,8,300,16,40,56,Thursday
2018,3,8,200,31,36,67,Thursday
2018,3,8,100,37,45,82,Thursday
2018,3,7,2400,50,32,82,Wednesday
2018,3,7,2300,60,61,121,Wednesday
2018,3,7,2200,111,94,205,Wednesday
2018,3,7,2100,111,115,226,Wednesday
2018,3,7,2000,137,157,294,Wednesday
2018,3,7,1900,162,251,413,Wednesday
2018,3,7,1800,202,431,633,Wednesday
2018,3,7,1700,233,538,771,Wednesday
2018,3,7,1600,224,378,602,Wednesday
2018,3,7,1500,225,276,501,Wednesday
2018,3,7,1400,270,220,490,Wednesday
2018,3,7,1300,275,227,502,Wednesday
2018,3,7,1200,322,185,507,Wednesday
2018,3,7,1100,325,144,469,Wednesday
2018,3,7,1000,417,132,549,Wednesday
2018,3,7,900,346,119,465,Wednesday
2018,3,7,800,207,64,271,Wednesday
2018,3,7,700,92,46,138,Wednesday
2018,3,7,600,42,31,73,Wednesday
2018,3,7,500,27,27,54,Wednesday
2018,3,7,400,23,31,54,Wednesday
2018,3,7,300,25,22,47,Wednesday
2018,3,7,200,33,29,62,Wednesday
2018,3,7,100,27,43,70,Wednesday
2018,3,6,2400,61,54,115,Tuesday
2018,3,6,2300,75,56,131,Tuesday
2018,3,6,2200,76,79,155,Tuesday
2018,3,6,2100,105,106,211,Tuesday
2018,3,6,2000,100,159,259,Tuesday
2018,3,6,1900,106,220,326,Tuesday
2018,3,6,1800,178,360,538,Tuesday
2018,3,6,1700,193,484,677,Tuesday
2018,3,6,1600,220,353,573,Tuesday
2018,3,6,1500,212,277,489,Tuesday
2018,3,6,1400,217,233,450,Tuesday
2018,3,6,1300,237,223,460,Tuesday
2018,3,6,1200,256,172,428,Tuesday
2018,3,6,1100,291,186,477,Tuesday
2018,3,6,1000,374,128,502,Tuesday
2018,3,6,900,348,112,460,Tuesday
2018,3,6,800,202,58,260,Tuesday
2018,3,6,700,58,46,104,Tuesday
2018,3,6,600,30,32,62,Tuesday
2018,3,6,500,20,23,43,Tuesday
2018,3,6,400,18,26,44,Tuesday
2018,3,6,300,18,30,48,Tuesday
2018,3,6,200,20,27,47,Tuesday
2018,3,6,100,23,45,68,Tuesday
2018,3,5,2400,36,42,78,Monday
2018,3,5,2300,66,69,135,Monday
2018,3,5,2200,69,81,150,Monday
2018,3,5,2100,76,113,189,Monday
2018,3,5,2000,106,144,250,Monday
2018,3,5,1900,136,222,358,Monday
2018,3,5,1800,158,444,602,Monday
2018,3,5,1700,209,536,745,Monday
2018,3,5,1600,220,363,583,Monday
2018,3,5,1500,221,262,483,Monday
2018,3,5,1400,245,303,548,Monday
2018,3,5,1300,277,265,542,Monday
2018,3,5,1200,294,202,496,Monday
2018,3,5,1100,345,178,523,Monday
2018,3,5,1000,391,138,529,Monday
2018,3,5,900,342,99,441,Monday
2018,3,5,800,191,45,236,Monday
2018,3,5,700,82,20,102,Monday
2018,3,5,600,32,22,54,Monday
2018,3,5,500,26,17,43,Monday
2018,3,5,400,17,16,33,Monday
2018,3,5,300,12,31,43,Monday
2018,3,5,200,15,27,42,Monday
2018,3,5,100,23,40,63,Monday
2018,3,4,2400,32,49,81,Sunday
2018,3,4,2300,43,81,124,Sunday
2018,3,4,2200,56,117,173,Sunday
2018,3,4,2100,82,183,265,Sunday
2018,3,4,2000,95,281,376,Sunday
2018,3,4,1900,127,520,647,Sunday
2018,3,4,1800,148,964,1112,Sunday
2018,3,4,1700,210,1140,1350,Sunday
2018,3,4,1600,232,852,1084,Sunday
2018,3,4,1500,271,702,973,Sunday
2018,3,4,1400,284,562,846,Sunday
2018,3,4,1300,303,553,856,Sunday
2018,3,4,1200,336,300,636,Sunday
2018,3,4,1100,424,243,667,Sunday
2018,3,4,1000,649,148,797,Sunday
2018,3,4,900,808,84,892,Sunday
2018,3,4,800,302,41,343,Sunday
2018,3,4,700,73,18,91,Sunday
2018,3,4,600,32,13,45,Sunday
2018,3,4,500,13,15,28,Sunday
2018,3,4,400,10,25,35,Sunday
2018,3,4,300,17,20,37,Sunday
2018,3,4,200,20,26,46,Sunday
2018,3,4,100,18,51,69,Sunday
2018,3,3,2400,18,59,77,Saturday
2018,3,3,2300,53,62,115,Saturday
2018,3,3,2200,61,77,138,Saturday
2018,3,3,2100,57,76,133,Saturday
2018,3,3,2000,88,162,250,Saturday
2018,3,3,1900,105,253,358,Saturday
2018,3,3,1800,127,733,860,Saturday
2018,3,3,1700,161,732,893,Saturday
2018,3,3,1600,207,470,677,Saturday
2018,3,3,1500,231,313,544,Saturday
2018,3,3,1400,246,234,480,Saturday
2018,3,3,1300,267,237,504,Saturday
2018,3,3,1200,341,187,528,Saturday
2018,3,3,1100,357,174,531,Saturday
2018,3,3,1000,590,114,704,Saturday
2018,3,3,900,719,72,791,Saturday
2018,3,3,800,303,31,334,Saturday
2018,3,3,700,82,26,108,Saturday
2018,3,3,600,27,9,36,Saturday
2018,3,3,500,15,23,38,Saturday
2018,3,3,400,14,20,34,Saturday
2018,3,3,300,26,6,32,Saturday
2018,3,3,200,28,16,44,Saturday
2018,3,3,100,28,18,46,Saturday
2018,3,2,2400,49,25,74,Friday
2018,3,2,2300,92,53,145,Friday
2018,3,2,2200,127,75,202,Friday
2018,3,2,2100,190,113,303,Friday
2018,3,2,2000,261,140,401,Friday
2018,3,2,1900,342,222,564,Friday
2018,3,2,1800,375,402,777,Friday
2018,3,2,1700,397,538,935,Friday
2018,3,2,1600,369,400,769,Friday
2018,3,2,1500,368,285,653,Friday
2018,3,2,1400,281,244,525,Friday
2018,3,2,1300,310,298,608,Friday
2018,3,2,1200,295,258,553,Friday
2018,3,2,1100,315,215,530,Friday
2018,3,2,1000,399,113,512,Friday
2018,3,2,900,426,78,504,Friday
2018,3,2,800,237,36,273,Friday
2018,3,2,700,97,20,117,Friday
2018,3,2,600,35,9,44,Friday
2018,3,2,500,25,16,41,Friday
2018,3,2,400,21,34,55,Friday
2018,3,2,300,24,23,47,Friday
2018,3,2,200,39,35,74,Friday
2018,3,2,100,41,55,96,Friday
2018,3,1,2400,64,45,109,Thursday
2018,3,1,2300,95,51,146,Thursday
2018,3,1,2200,108,93,201,Thursday
2018,3,1,2100,146,113,259,Thursday
2018,3,1,2000,209,144,353,Thursday
2018,3,1,1900,223,276,499,Thursday
2018,3,1,1800,275,366,641,Thursday
2018,3,1,1700,310,517,827,Thursday
2018,3,1,1600,339,371,710,Thursday
2018,3,1,1500,296,335,631,Thursday
2018,3,1,1400,291,248,539,Thursday
2018,3,1,1300,250,246,496,Thursday
2018,3,1,1200,333,171,504,Thursday
2018,3,1,1100,337,177,514,Thursday
2018,3,1,1000,357,130,487,Thursday
2018,3,1,900,393,91,484,Thursday
2018,3,1,800,210,63,273,Thursday
2018,3,1,700,94,45,139,Thursday
2018,3,1,600,41,25,66,Thursday
2018,3,1,500,30,24,54,Thursday
2018,3,1,400,26,34,60,Thursday
2018,3,1,300,43,26,69,Thursday
2018,3,1,200,22,43,65,Thursday
2018,3,1,100,34,50,84,Thursday
2018,2,28,2400,58,54,112,Wednesday
2018,2,28,2300,85,78,163,Wednesday
2018,2,28,2200,95,117,212,Wednesday
2018,2,28,2100,130,88,218,Wednesday
2018,2,28,2000,146,164,310,Wednesday
2018,2,28,1900,147,265,412,Wednesday
2018,2,28,1800,201,444,645,Wednesday
2018,2,28,1700,228,436,664,Wednesday
2018,2,28,1600,245,281,526,Wednesday
2018,2,28,1500,241,290,531,Wednesday
2018,2,28,1400,250,261,511,Wednesday
2018,2,28,1300,219,219,438,Wednesday
2018,2,28,1200,246,203,449,Wednesday
2018,2,28,1100,308,195,503,Wednesday
2018,2,28,1000,372,144,516,Wednesday
2018,2,28,900,324,95,419,Wednesday
2018,2,28,800,188,77,265,Wednesday
2018,2,28,700,63,39,102,Wednesday
2018,2,28,600,33,32,65,Wednesday
2018,2,28,500,29,26,55,Wednesday
2018,2,28,400,27,21,48,Wednesday
2018,2,28,300,17,30,47,Wednesday
2018,2,28,200,28,33,61,Wednesday
2018,2,28,100,35,27,62,Wednesday
2018,2,27,2400,66,51,117,Tuesday
2018,2,27,2300,55,77,132,Tuesday
2018,2,27,2200,90,99,189,Tuesday
2018,2,27,2100,102,159,261,Tuesday
2018,2,27,2000,109,218,327,Tuesday
2018,2,27,1900,132,108,240,Tuesday
2018,2,27,1800,164,317,481,Tuesday
2018,2,27,1700,187,478,665,Tuesday
2018,2,27,1600,238,362,600,Tuesday
2018,2,27,1500,218,305,523,Tuesday
2018,2,27,1400,220,241,461,Tuesday
2018,2,27,1300,242,225,467,Tuesday
2018,2,27,1200,259,182,441,Tuesday
2018,2,27,1100,291,182,473,Tuesday
2018,2,27,1000,327,146,473,Tuesday
2018,2,27,900,310,119,429,Tuesday
2018,2,27,800,194,70,264,Tuesday
2018,2,27,700,63,50,113,Tuesday
2018,2,27,600,30,41,71,Tuesday
2018,2,27,500,28,17,45,Tuesday
2018,2,27,400,20,26,46,Tuesday
2018,2,27,300,18,20,38,Tuesday
2018,2,27,200,19,33,52,Tuesday
2018,2,27,100,29,42,71,Tuesday
2018,2,26,2400,51,54,105,Monday
2018,2,26,2300,55,77,132,Monday
2018,2,26,2200,66,96,162,Monday
2018,2,26,2100,85,138,223,Monday
2018,2,26,2000,98,151,249,Monday
2018,2,26,1900,146,252,398,Monday
2018,2,26,1800,181,422,603,Monday
2018,2,26,1700,231,565,796,Monday
2018,2,26,1600,217,397,614,Monday
2018,2,26,1500,237,307,544,Monday
2018,2,26,1400,281,292,573,Monday
2018,2,26,1300,274,271,545,Monday
2018,2,26,1200,333,224,557,Monday
2018,2,26,1100,325,176,501,Monday
2018,2,26,1000,387,131,518,Monday
2018,2,26,900,349,121,470,Monday
2018,2,26,800,160,58,218,Monday
2018,2,26,700,74,34,108,Monday
2018,2,26,600,35,22,57,Monday
2018,2,26,500,22,14,36,Monday
2018,2,26,400,15,14,29,Monday
2018,2,26,300,16,22,38,Monday
2018,2,26,200,22,32,54,Monday
2018,2,26,100,22,51,73,Monday
2018,2,25,2400,29,73,102,Sunday
2018,2,25,2300,57,90,147,Sunday
2018,2,25,2200,54,113,167,Sunday
2018,2,25,2100,87,170,257,Sunday
2018,2,25,2000,102,299,401,Sunday
2018,2,25,1900,94,440,534,Sunday
2018,2,25,1800,173,867,1040,Sunday
2018,2,25,1700,196,1178,1374,Sunday
2018,2,25,1600,294,935,1229,Sunday
2018,2,25,1500,301,781,1082,Sunday
2018,2,25,1400,332,785,1117,Sunday
2018,2,25,1300,373,620,993,Sunday
2018,2,25,1200,398,488,886,Sunday
2018,2,25,1100,402,260,662,Sunday
2018,2,25,1000,502,155,657,Sunday
2018,2,25,900,653,69,722,Sunday
2018,2,25,800,287,32,319,Sunday
2018,2,25,700,82,21,103,Sunday
2018,2,25,600,25,4,29,Sunday
2018,2,25,500,13,18,31,Sunday
2018,2,25,400,14,19,33,Sunday
2018,2,25,300,19,30,49,Sunday
2018,2,25,200,19,24,43,Sunday
2018,2,25,100,23,35,58,Sunday
2018,2,24,2400,33,60,93,Saturday
2018,2,24,2300,35,55,90,Saturday
2018,2,24,2200,73,81,154,Saturday
2018,2,24,2100,70,157,227,Saturday
2018,2,24,2000,100,221,321,Saturday
2018,2,24,1900,136,354,490,Saturday
2018,2,24,1800,160,884,1044,Saturday
2018,2,24,1700,239,1127,1366,Saturday
2018,2,24,1600,301,727,1028,Saturday
2018,2,24,1500,309,524,833,Saturday
2018,2,24,1400,342,386,728,Saturday
2018,2,24,1300,450,338,788,Saturday
2018,2,24,1200,478,286,764,Saturday
2018,2,24,1100,497,241,738,Saturday
2018,2,24,1000,707,162,869,Saturday
2018,2,24,900,808,110,918,Saturday
2018,2,24,800,452,52,504,Saturday
2018,2,24,700,103,36,139,Saturday
2018,2,24,600,41,26,67,Saturday
2018,2,24,500,19,18,37,Saturday
2018,2,24,400,20,17,37,Saturday
2018,2,24,300,20,25,45,Saturday
2018,2,24,200,23,26,49,Saturday
2018,2,24,100,34,22,56,Saturday
2018,2,23,2400,62,84,146,Friday
2018,2,23,2300,81,88,169,Friday
2018,2,23,2200,178,54,232,Friday
2018,2,23,2100,371,120,491,Friday
2018,2,23,2000,354,192,546,Friday
2018,2,23,1900,314,300,614,Friday
2018,2,23,1800,402,648,1050,Friday
2018,2,23,1700,501,836,1337,Friday
2018,2,23,1600,512,511,1023,Friday
2018,2,23,1500,451,448,899,Friday
2018,2,23,1400,374,398,772,Friday
2018,2,23,1300,410,428,838,Friday
2018,2,23,1200,415,343,758,Friday
2018,2,23,1100,447,282,729,Friday
2018,2,23,1000,533,202,735,Friday
2018,2,23,900,503,138,641,Friday
2018,2,23,800,302,60,362,Friday
2018,2,23,700,81,49,130,Friday
2018,2,23,600,42,30,72,Friday
2018,2,23,500,34,30,64,Friday
2018,2,23,400,35,28,63,Friday
2018,2,23,300,29,28,57,Friday
2018,2,23,200,38,37,75,Friday
2018,2,23,100,36,60,96,Friday
2018,2,22,2400,57,58,115,Thursday
2018,2,22,2300,84,78,162,Thursday
2018,2,22,2200,119,113,232,Thursday
2018,2,22,2100,170,118,288,Thursday
2018,2,22,2000,177,187,364,Thursday
2018,2,22,1900,208,340,548,Thursday
2018,2,22,1800,226,735,961,Thursday
2018,2,22,1700,328,715,1043,Thursday
2018,2,22,1600,327,473,800,Thursday
2018,2,22,1500,333,341,674,Thursday
2018,2,22,1400,340,294,634,Thursday
2018,2,22,1300,347,292,639,Thursday
2018,2,22,1200,448,235,683,Thursday
2018,2,22,1100,460,205,665,Thursday
2018,2,22,1000,504,168,672,Thursday
2018,2,22,900,476,85,561,Thursday
2018,2,22,800,187,54,241,Thursday
2018,2,22,700,83,38,121,Thursday
2018,2,22,600,38,27,65,Thursday
2018,2,22,500,29,24,53,Thursday
2018,2,22,400,19,16,35,Thursday
2018,2,22,300,28,35,63,Thursday
2018,2,22,200,33,38,71,Thursday
2018,2,22,100,33,37,70,Thursday
2018,2,21,2400,59,52,111,Wednesday
2018,2,21,2300,62,65,127,Wednesday
2018,2,21,2200,93,106,199,Wednesday
2018,2,21,2100,118,125,243,Wednesday
2018,2,21,2000,148,162,310,Wednesday
2018,2,21,1900,160,290,450,Wednesday
2018,2,21,1800,187,554,741,Wednesday
2018,2,21,1700,275,742,1017,Wednesday
2018,2,21,1600,272,428,700,Wednesday
2018,2,21,1500,314,349,663,Wednesday
2018,2,21,1400,284,295,579,Wednesday
2018,2,21,1300,351,314,665,Wednesday
2018,2,21,1200,404,257,661,Wednesday
2018,2,21,1100,428,195,623,Wednesday
2018,2,21,1000,503,157,660,Wednesday
2018,2,21,900,395,112,507,Wednesday
2018,2,21,800,198,58,256,Wednesday
2018,2,21,700,69,40,109,Wednesday
2018,2,21,600,32,29,61,Wednesday
2018,2,21,500,24,22,46,Wednesday
2018,2,21,400,25,34,59,Wednesday
2018,2,21,300,28,17,45,Wednesday
2018,2,21,200,27,29,56,Wednesday
2018,2,21,100,42,40,82,Wednesday
2018,2,20,2400,66,54,120,Tuesday
2018,2,20,2300,73,84,157,Tuesday
2018,2,20,2200,74,87,161,Tuesday
2018,2,20,2100,120,122,242,Tuesday
2018,2,20,2000,125,184,309,Tuesday
2018,2,20,1900,153,311,464,Tuesday
2018,2,20,1800,194,604,798,Tuesday
2018,2,20,1700,275,669,944,Tuesday
2018,2,20,1600,266,520,786,Tuesday
2018,2,20,1500,287,391,678,Tuesday
2018,2,20,1400,293,298,591,Tuesday
2018,2,20,1300,348,324,672,Tuesday
2018,2,20,1200,377,300,677,Tuesday
2018,2,20,1100,380,257,637,Tuesday
2018,2,20,1000,417,188,605,Tuesday
2018,2,20,900,413,131,544,Tuesday
2018,2,20,800,198,64,262,Tuesday
2018,2,20,700,63,40,103,Tuesday
2018,2,20,600,31,35,66,Tuesday
2018,2,20,500,17,19,36,Tuesday
2018,2,20,400,18,30,48,Tuesday
2018,2,20,300,13,31,44,Tuesday
2018,2,20,200,10,36,46,Tuesday
2018,2,20,100,26,48,74,Tuesday
2018,2,19,2400,28,72,100,Monday
2018,2,19,2300,54,96,150,Monday
2018,2,19,2200,80,147,227,Monday
2018,2,19,2100,79,211,290,Monday
2018,2,19,2000,117,347,464,Monday
2018,2,19,1900,130,630,760,Monday
2018,2,19,1800,175,1292,1467,Monday
2018,2,19,1700,274,1291,1565,Monday
2018,2,19,1600,391,1216,1607,Monday
2018,2,19,1500,412,1259,1671,Monday
2018,2,19,1400,482,1261,1743,Monday
2018,2,19,1300,471,1050,1521,Monday
2018,2,19,1200,543,816,1359,Monday
2018,2,19,1100,525,480,1005,Monday
2018,2,19,1000,522,207,729,Monday
2018,2,19,900,517,133,650,Monday
2018,2,19,800,204,53,257,Monday
2018,2,19,700,73,29,102,Monday
2018,2,19,600,28,24,52,Monday
2018,2,19,500,16,21,37,Monday
2018,2,19,400,22,15,37,Monday
2018,2,19,300,12,17,29,Monday
2018,2,19,200,17,26,43,Monday
2018,2,19,100,26,32,58,Monday
2018,2,18,2400,30,59,89,Sunday
2018,2,18,2300,49,77,126,Sunday
2018,2,18,2200,71,117,188,Sunday
2018,2,18,2100,76,191,267,Sunday
2018,2,18,2000,104,254,358,Sunday
2018,2,18,1900,165,432,597,Sunday
2018,2,18,1800,238,906,1144,Sunday
2018,2,18,1700,316,905,1221,Sunday
2018,2,18,1600,388,744,1132,Sunday
2018,2,18,1500,425,635,1060,Sunday
2018,2,18,1400,508,490,998,Sunday
2018,2,18,1300,507,417,924,Sunday
2018,2,18,1200,554,326,880,Sunday
2018,2,18,1100,557,179,736,Sunday
2018,2,18,1000,566,119,685,Sunday
2018,2,18,900,586,60,646,Sunday
2018,2,18,800,243,40,283,Sunday
2018,2,18,700,65,20,85,Sunday
2018,2,18,600,25,14,39,Sunday
2018,2,18,500,13,15,28,Sunday
2018,2,18,400,15,10,25,Sunday
2018,2,18,300,18,20,38,Sunday
2018,2,18,200,30,31,61,Sunday
2018,2,18,100,34,31,65,Sunday
2018,2,17,2400,28,49,77,Saturday
2018,2,17,2300,53,45,98,Saturday
2018,2,17,2200,71,63,134,Saturday
2018,2,17,2100,88,80,168,Saturday
2018,2,17,2000,88,143,231,Saturday
2018,2,17,1900,167,282,449,Saturday
2018,2,17,1800,223,678,901,Saturday
2018,2,17,1700,268,951,1219,Saturday
2018,2,17,1600,354,547,901,Saturday
2018,2,17,1500,432,389,821,Saturday
2018,2,17,1400,533,292,825,Saturday
2018,2,17,1300,526,314,840,Saturday
2018,2,17,1200,684,248,932,Saturday
2018,2,17,1100,681,160,841,Saturday
2018,2,17,1000,938,158,1096,Saturday
2018,2,17,900,844,92,936,Saturday
2018,2,17,800,362,52,414,Saturday
2018,2,17,700,133,43,176,Saturday
2018,2,17,600,45,17,62,Saturday
2018,2,17,500,28,20,48,Saturday
2018,2,17,400,15,21,36,Saturday
2018,2,17,300,18,34,52,Saturday
2018,2,17,200,34,27,61,Saturday
2018,2,17,100,52,39,91,Saturday
2018,2,16,2400,74,61,135,Friday
2018,2,16,2300,156,70,226,Friday
2018,2,16,2200,210,97,307,Friday
2018,2,16,2100,383,90,473,Friday
2018,2,16,2000,521,176,697,Friday
2018,2,16,1900,528,238,766,Friday
2018,2,16,1800,758,646,1404,Friday
2018,2,16,1700,769,625,1394,Friday
2018,2,16,1600,836,487,1323,Friday
2018,2,16,1500,723,385,1108,Friday
2018,2,16,1400,686,297,983,Friday
2018,2,16,1300,576,244,820,Friday
2018,2,16,1200,618,204,822,Friday
2018,2,16,1100,594,175,769,Friday
2018,2,16,1000,645,156,801,Friday
2018,2,16,900,575,89,664,Friday
2018,2,16,800,282,75,357,Friday
2018,2,16,700,93,32,125,Friday
2018,2,16,600,49,30,79,Friday
2018,2,16,500,27,19,46,Friday
2018,2,16,400,36,34,70,Friday
2018,2,16,300,24,34,58,Friday
2018,2,16,200,36,38,74,Friday
2018,2,16,100,60,41,101,Friday
2018,2,15,2400,72,56,128,Thursday
2018,2,15,2300,142,85,227,Thursday
2018,2,15,2200,141,93,234,Thursday
2018,2,15,2100,217,126,343,Thursday
2018,2,15,2000,267,152,419,Thursday
2018,2,15,1900,278,222,500,Thursday
2018,2,15,1800,345,485,830,Thursday
2018,2,15,1700,418,549,967,Thursday
2018,2,15,1600,446,338,784,Thursday
2018,2,15,1500,443,309,752,Thursday
2018,2,15,1400,379,239,618,Thursday
2018,2,15,1300,368,230,598,Thursday
2018,2,15,1200,423,209,632,Thursday
2018,2,15,1100,409,171,580,Thursday
2018,2,15,1000,488,119,607,Thursday
2018,2,15,900,404,96,500,Thursday
2018,2,15,800,198,54,252,Thursday
2018,2,15,700,87,33,120,Thursday
2018,2,15,600,42,25,67,Thursday
2018,2,15,500,26,25,51,Thursday
2018,2,15,400,28,35,63,Thursday
2018,2,15,300,26,38,64,Thursday
2018,2,15,200,28,31,59,Thursday
2018,2,15,100,38,56,94,Thursday
2018,2,14,2400,47,61,108,Wednesday
2018,2,14,2300,64,57,121,Wednesday
2018,2,14,2200,88,64,152,Wednesday
2018,2,14,2100,128,101,229,Wednesday
2018,2,14,2000,156,100,256,Wednesday
2018,2,14,1900,222,200,422,Wednesday
2018,2,14,1800,215,320,535,Wednesday
2018,2,14,1700,106,365,471,Wednesday
2018,2,14,1600,230,321,551,Wednesday
2018,2,14,1500,198,262,460,Wednesday
2018,2,14,1400,213,242,455,Wednesday
2018,2,14,1300,217,166,383,Wednesday
2018,2,14,1200,198,163,361,Wednesday
2018,2,14,1100,275,160,435,Wednesday
2018,2,14,1000,315,103,418,Wednesday
2018,2,14,900,231,78,309,Wednesday
2018,2,14,800,141,44,185,Wednesday
2018,2,14,700,62,30,92,Wednesday
2018,2,14,600,36,22,58,Wednesday
2018,2,14,500,22,31,53,Wednesday
2018,2,14,400,27,22,49,Wednesday
2018,2,14,300,23,30,53,Wednesday
2018,2,14,200,19,30,49,Wednesday
2018,2,14,100,36,29,65,Wednesday
2018,2,13,2400,39,18,57,Tuesday
2018,2,13,2300,56,48,104,Tuesday
2018,2,13,2200,71,107,178,Tuesday
2018,2,13,2100,89,102,191,Tuesday
2018,2,13,2000,88,77,165,Tuesday
2018,2,13,1900,130,164,294,Tuesday
2018,2,13,1800,133,273,406,Tuesday
2018,2,13,1700,207,447,654,Tuesday
2018,2,13,1600,211,292,503,Tuesday
2018,2,13,1500,248,262,510,Tuesday
2018,2,13,1400,233,243,476,Tuesday
2018,2,13,1300,259,187,446,Tuesday
2018,2,13,1200,280,168,448,Tuesday
2018,2,13,1100,279,140,419,Tuesday
2018,2,13,1000,312,98,410,Tuesday
2018,2,13,900,278,78,356,Tuesday
2018,2,13,800,189,50,239,Tuesday
2018,2,13,700,74,30,104,Tuesday
2018,2,13,600,40,23,63,Tuesday
2018,2,13,500,21,19,40,Tuesday
2018,2,13,400,15,20,35,Tuesday
2018,2,13,300,22,19,41,Tuesday
2018,2,13,200,19,12,31,Tuesday
2018,2,13,100,37,36,73,Tuesday
2018,2,12,2400,43,53,96,Monday
2018,2,12,2300,69,58,127,Monday
2018,2,12,2200,86,75,161,Monday
2018,2,12,2100,95,111,206,Monday
2018,2,12,2000,126,126,252,Monday
2018,2,12,1900,130,225,355,Monday
2018,2,12,1800,187,411,598,Monday
2018,2,12,1700,217,493,710,Monday
2018,2,12,1600,276,340,616,Monday
2018,2,12,1500,298,259,557,Monday
2018,2,12,1400,292,291,583,Monday
2018,2,12,1300,322,301,623,Monday
2018,2,12,1200,297,205,502,Monday
2018,2,12,1100,359,196,555,Monday
2018,2,12,1000,322,120,442,Monday
2018,2,12,900,281,98,379,Monday
2018,2,12,800,173,54,227,Monday
2018,2,12,700,59,40,99,Monday
2018,2,12,600,23,27,50,Monday
2018,2,12,500,16,21,37,Monday
2018,2,12,400,13,11,24,Monday
2018,2,12,300,13,35,48,Monday
2018,2,12,200,12,48,60,Monday
2018,2,12,100,24,47,71,Monday
2018,2,11,2400,27,44,71,Sunday
2018,2,11,2300,48,41,89,Sunday
2018,2,11,2200,42,112,154,Sunday
2018,2,11,2100,63,170,233,Sunday
2018,2,11,2000,89,251,340,Sunday
2018,2,11,1900,110,468,578,Sunday
2018,2,11,1800,142,797,939,Sunday
2018,2,11,1700,189,1088,1277,Sunday
2018,2,11,1600,254,768,1022,Sunday
2018,2,11,1500,248,547,795,Sunday
2018,2,11,1400,251,519,770,Sunday
2018,2,11,1300,299,464,763,Sunday
2018,2,11,1200,316,390,706,Sunday
2018,2,11,1100,287,232,519,Sunday
2018,2,11,1000,495,168,663,Sunday
2018,2,11,900,642,63,705,Sunday
2018,2,11,800,221,38,259,Sunday
2018,2,11,700,54,17,71,Sunday
2018,2,11,600,22,26,48,Sunday
2018,2,11,500,7,17,24,Sunday
2018,2,11,400,14,21,35,Sunday
2018,2,11,300,14,10,24,Sunday
2018,2,11,200,22,17,39,Sunday
2018,2,11,100,26,29,55,Sunday
2018,2,10,2400,26,56,82,Saturday
2018,2,10,2300,52,61,113,Saturday
2018,2,10,2200,69,104,173,Saturday
2018,2,10,2100,83,130,213,Saturday
2018,2,10,2000,127,139,266,Saturday
2018,2,10,1900,118,401,519,Saturday
2018,2,10,1800,168,1073,1241,Saturday
2018,2,10,1700,247,949,1196,Saturday
2018,2,10,1600,250,621,871,Saturday
2018,2,10,1500,272,468,740,Saturday
2018,2,10,1400,306,330,636,Saturday
2018,2,10,1300,341,363,704,Saturday
2018,2,10,1200,471,278,749,Saturday
2018,2,10,1100,466,227,693,Saturday
2018,2,10,1000,734,152,886,Saturday
2018,2,10,900,1236,105,1341,Saturday
2018,2,10,800,473,44,517,Saturday
2018,2,10,700,106,95,201,Saturday
2018,2,10,600,37,54,91,Saturday
2018,2,10,500,14,12,26,Saturday
2018,2,10,400,19,5,24,Saturday
2018,2,10,300,16,8,24,Saturday
2018,2,10,200,19,7,26,Saturday
2018,2,10,100,35,11,46,Saturday
2018,2,9,2400,53,21,74,Friday
2018,2,9,2300,67,10,77,Friday
2018,2,9,2200,151,30,181,Friday
2018,2,9,2100,236,49,285,Friday
2018,2,9,2000,313,135,448,Friday
2018,2,9,1900,353,367,720,Friday
2018,2,9,1800,409,863,1272,Friday
2018,2,9,1700,420,836,1256,Friday
2018,2,9,1600,421,651,1072,Friday
2018,2,9,1500,430,618,1048,Friday
2018,2,9,1400,387,385,772,Friday
2018,2,9,1300,386,247,633,Friday
2018,2,9,1200,416,186,602,Friday
2018,2,9,1100,440,103,543,Friday
2018,2,9,1000,601,83,684,Friday
2018,2,9,900,822,38,860,Friday
2018,2,9,800,320,30,350,Friday
2018,2,9,700,54,5,59,Friday
2018,2,9,600,12,7,19,Friday
2018,2,9,500,11,5,16,Friday
2018,2,9,400,10,11,21,Friday
2018,2,9,300,7,25,32,Friday
2018,2,9,200,5,14,19,Friday
2018,2,9,100,15,16,31,Friday
2018,2,8,2400,12,5,17,Thursday
2018,2,8,2300,28,4,32,Thursday
2018,2,8,2200,47,10,57,Thursday
2018,2,8,2100,31,15,46,Thursday
2018,2,8,2000,33,22,55,Thursday
2018,2,8,1900,50,60,110,Thursday
2018,2,8,1800,62,234,296,Thursday
2018,2,8,1700,52,323,375,Thursday
2018,2,8,1600,74,227,301,Thursday
2018,2,8,1500,73,173,246,Thursday
2018,2,8,1400,91,162,253,Thursday
2018,2,8,1300,117,107,224,Thursday
2018,2,8,1200,113,34,147,Thursday
2018,2,8,1100,244,39,283,Thursday
2018,2,8,1000,258,63,321,Thursday
2018,2,8,900,348,61,409,Thursday
2018,2,8,800,194,26,220,Thursday
2018,2,8,700,48,11,59,Thursday
2018,2,8,600,18,2,20,Thursday
2018,2,8,500,17,13,30,Thursday
2018,2,8,400,20,8,28,Thursday
2018,2,8,300,12,8,20,Thursday
2018,2,8,200,17,17,34,Thursday
2018,2,8,100,39,7,46,Thursday
2018,2,7,2400,38,41,79,Wednesday
2018,2,7,2300,40,70,110,Wednesday
2018,2,7,2200,58,120,178,Wednesday
2018,2,7,2100,87,149,236,Wednesday
2018,2,7,2000,95,162,257,Wednesday
2018,2,7,1900,131,129,260,Wednesday
2018,2,7,1800,159,282,441,Wednesday
2018,2,7,1700,195,340,535,Wednesday
2018,2,7,1600,176,249,425,Wednesday
2018,2,7,1500,194,204,398,Wednesday
2018,2,7,1400,184,166,350,Wednesday
2018,2,7,1300,189,123,312,Wednesday
2018,2,7,1200,225,124,349,Wednesday
2018,2,7,1100,229,144,373,Wednesday
2018,2,7,1000,274,75,349,Wednesday
2018,2,7,900,262,69,331,Wednesday
2018,2,7,800,162,26,188,Wednesday
2018,2,7,700,55,14,69,Wednesday
2018,2,7,600,24,4,28,Wednesday
2018,2,7,500,16,6,22,Wednesday
2018,2,7,400,21,7,28,Wednesday
2018,2,7,300,28,5,33,Wednesday
2018,2,7,200,22,90,112,Wednesday
2018,2,7,100,38,7,45,Wednesday
2018,2,6,2400,61,8,69,Tuesday
2018,2,6,2300,69,38,107,Tuesday
2018,2,6,2200,63,86,149,Tuesday
2018,2,6,2100,73,107,180,Tuesday
2018,2,6,2000,105,143,248,Tuesday
2018,2,6,1900,123,227,350,Tuesday
2018,2,6,1800,144,304,448,Tuesday
2018,2,6,1700,177,370,547,Tuesday
2018,2,6,1600,202,297,499,Tuesday
2018,2,6,1500,195,259,454,Tuesday
2018,2,6,1400,230,223,453,Tuesday
2018,2,6,1300,216,204,420,Tuesday
2018,2,6,1200,247,146,393,Tuesday
2018,2,6,1100,281,184,465,Tuesday
2018,2,6,1000,278,109,387,Tuesday
2018,2,6,900,274,95,369,Tuesday
2018,2,6,800,159,50,209,Tuesday
2018,2,6,700,64,44,108,Tuesday
2018,2,6,600,37,29,66,Tuesday
2018,2,6,500,11,32,43,Tuesday
2018,2,6,400,18,19,37,Tuesday
2018,2,6,300,17,18,35,Tuesday
2018,2,6,200,21,24,45,Tuesday
2018,2,6,100,31,41,72,Tuesday
2018,2,5,2400,46,30,76,Monday
2018,2,5,2300,63,60,123,Monday
2018,2,5,2200,71,63,134,Monday
2018,2,5,2100,73,123,196,Monday
2018,2,5,2000,99,126,225,Monday
2018,2,5,1900,110,223,333,Monday
2018,2,5,1800,153,390,543,Monday
2018,2,5,1700,177,493,670,Monday
2018,2,5,1600,188,401,589,Monday
2018,2,5,1500,216,277,493,Monday
2018,2,5,1400,213,216,429,Monday
2018,2,5,1300,245,251,496,Monday
2018,2,5,1200,256,196,452,Monday
2018,2,5,1100,260,165,425,Monday
2018,2,5,1000,332,110,442,Monday
2018,2,5,900,355,80,435,Monday
2018,2,5,800,152,63,215,Monday
2018,2,5,700,65,29,94,Monday
2018,2,5,600,25,17,42,Monday
2018,2,5,500,20,23,43,Monday
2018,2,5,400,18,26,44,Monday
2018,2,5,300,17,81,98,Monday
2018,2,5,200,10,57,67,Monday
2018,2,5,100,21,16,37,Monday
2018,2,4,2400,23,36,59,Sunday
2018,2,4,2300,37,45,82,Sunday
2018,2,4,2200,47,84,131,Sunday
2018,2,4,2100,57,131,188,Sunday
2018,2,4,2000,81,175,256,Sunday
2018,2,4,1900,77,302,379,Sunday
2018,2,4,1800,112,813,925,Sunday
2018,2,4,1700,163,980,1143,Sunday
2018,2,4,1600,228,859,1087,Sunday
2018,2,4,1500,223,705,928,Sunday
2018,2,4,1400,219,580,799,Sunday
2018,2,4,1300,279,584,863,Sunday
2018,2,4,1200,300,366,666,Sunday
2018,2,4,1100,316,243,559,Sunday
2018,2,4,1000,450,137,587,Sunday
2018,2,4,900,757,68,825,Sunday
2018,2,4,800,307,43,350,Sunday
2018,2,4,700,50,27,77,Sunday
2018,2,4,600,22,21,43,Sunday
2018,2,4,500,13,21,34,Sunday
2018,2,4,400,13,16,29,Sunday
2018,2,4,300,9,16,25,Sunday
2018,2,4,200,12,16,28,Sunday
2018,2,4,100,26,28,54,Sunday
2018,2,3,2400,29,42,71,Saturday
2018,2,3,2300,32,62,94,Saturday
2018,2,3,2200,54,150,204,Saturday
2018,2,3,2100,66,194,260,Saturday
2018,2,3,2000,80,145,225,Saturday
2018,2,3,1900,105,209,314,Saturday
2018,2,3,1800,148,605,753,Saturday
2018,2,3,1700,151,726,877,Saturday
2018,2,3,1600,177,469,646,Saturday
2018,2,3,1500,194,325,519,Saturday
2018,2,3,1400,231,323,554,Saturday
2018,2,3,1300,268,277,545,Saturday
2018,2,3,1200,309,189,498,Saturday
2018,2,3,1100,323,160,483,Saturday
2018,2,3,1000,513,143,656,Saturday
2018,2,3,900,931,98,1029,Saturday
2018,2,3,800,421,68,489,Saturday
2018,2,3,700,109,25,134,Saturday
2018,2,3,600,36,35,71,Saturday
2018,2,3,500,12,29,41,Saturday
2018,2,3,400,15,36,51,Saturday
2018,2,3,300,21,42,63,Saturday
2018,2,3,200,21,45,66,Saturday
2018,2,3,100,24,39,63,Saturday
2018,2,2,2400,59,93,152,Friday
2018,2,2,2300,82,68,150,Friday
2018,2,2,2200,141,49,190,Friday
2018,2,2,2100,232,42,274,Friday
2018,2,2,2000,290,77,367,Friday
2018,2,2,1900,337,215,552,Friday
2018,2,2,1800,464,442,906,Friday
2018,2,2,1700,410,446,856,Friday
2018,2,2,1600,428,323,751,Friday
2018,2,2,1500,372,328,700,Friday
2018,2,2,1400,379,276,655,Friday
2018,2,2,1300,332,225,557,Friday
2018,2,2,1200,371,172,543,Friday
2018,2,2,1100,379,157,536,Friday
2018,2,2,1000,378,139,517,Friday
2018,2,2,900,414,89,503,Friday
2018,2,2,800,269,52,321,Friday
2018,2,2,700,98,24,122,Friday
2018,2,2,600,37,12,49,Friday
2018,2,2,500,22,24,46,Friday
2018,2,2,400,25,23,48,Friday
2018,2,2,300,21,26,47,Friday
2018,2,2,200,37,31,68,Friday
2018,2,2,100,39,47,86,Friday
2018,2,1,2400,57,82,139,Thursday
2018,2,1,2300,97,214,311,Thursday
2018,2,1,2200,121,236,357,Thursday
2018,2,1,2100,138,52,190,Thursday
2018,2,1,2000,200,56,256,Thursday
2018,2,1,1900,203,116,319,Thursday
2018,2,1,1800,265,270,535,Thursday
2018,2,1,1700,266,337,603,Thursday
2018,2,1,1600,272,248,520,Thursday
2018,2,1,1500,299,292,591,Thursday
2018,2,1,1400,259,179,438,Thursday
2018,2,1,1300,281,197,478,Thursday
2018,2,1,1200,305,170,475,Thursday
2018,2,1,1100,272,138,410,Thursday
2018,2,1,1000,307,117,424,Thursday
2018,2,1,900,299,86,385,Thursday
2018,2,1,800,205,55,260,Thursday
2018,2,1,700,79,25,104,Thursday
2018,2,1,600,38,28,66,Thursday
2018,2,1,500,21,19,40,Thursday
2018,2,1,400,29,30,59,Thursday
2018,2,1,300,30,29,59,Thursday
2018,2,1,200,39,29,68,Thursday
2018,2,1,100,41,61,102,Thursday
2018,1,31,2400,48,52,100,Wednesday
2018,1,31,2300,66,77,143,Wednesday
2018,1,31,2200,79,67,146,Wednesday
2018,1,31,2100,101,96,197,Wednesday
2018,1,31,2000,126,109,235,Wednesday
2018,1,31,1900,173,216,389,Wednesday
2018,1,31,1800,180,323,503,Wednesday
2018,1,31,1700,201,429,630,Wednesday
2018,1,31,1600,221,345,566,Wednesday
2018,1,31,1500,191,270,461,Wednesday
2018,1,31,1400,199,357,556,Wednesday
2018,1,31,1300,224,94,318,Wednesday
2018,1,31,1200,273,144,417,Wednesday
2018,1,31,1100,252,164,416,Wednesday
2018,1,31,1000,313,101,414,Wednesday
2018,1,31,900,327,84,411,Wednesday
2018,1,31,800,183,59,242,Wednesday
2018,1,31,700,79,29,108,Wednesday
2018,1,31,600,29,24,53,Wednesday
2018,1,31,500,25,20,45,Wednesday
2018,1,31,400,22,18,40,Wednesday
2018,1,31,300,26,29,55,Wednesday
2018,1,31,200,19,34,53,Wednesday
2018,1,31,100,31,34,65,Wednesday
2018,1,30,2400,51,39,90,Tuesday
2018,1,30,2300,49,64,113,Tuesday
2018,1,30,2200,76,73,149,Tuesday
2018,1,30,2100,89,105,194,Tuesday
2018,1,30,2000,78,97,175,Tuesday
2018,1,30,1900,109,197,306,Tuesday
2018,1,30,1800,147,372,519,Tuesday
2018,1,30,1700,179,574,753,Tuesday
2018,1,30,1600,181,549,730,Tuesday
2018,1,30,1500,167,381,548,Tuesday
2018,1,30,1400,205,242,447,Tuesday
2018,1,30,1300,214,155,369,Tuesday
2018,1,30,1200,255,115,370,Tuesday
2018,1,30,1100,254,213,467,Tuesday
2018,1,30,1000,330,95,425,Tuesday
2018,1,30,900,517,141,658,Tuesday
2018,1,30,800,218,60,278,Tuesday
2018,1,30,700,52,17,69,Tuesday
2018,1,30,600,37,11,48,Tuesday
2018,1,30,500,26,6,32,Tuesday
2018,1,30,400,17,2,19,Tuesday
2018,1,30,300,27,7,34,Tuesday
2018,1,30,200,21,3,24,Tuesday
2018,1,30,100,28,24,52,Tuesday
2018,1,29,2400,44,46,90,Monday
2018,1,29,2300,43,23,66,Monday
2018,1,29,2200,63,46,109,Monday
2018,1,29,2100,73,96,169,Monday
2018,1,29,2000,82,103,185,Monday
2018,1,29,1900,105,346,451,Monday
2018,1,29,1800,159,286,445,Monday
2018,1,29,1700,197,503,700,Monday
2018,1,29,1600,207,353,560,Monday
2018,1,29,1500,223,272,495,Monday
2018,1,29,1400,238,181,419,Monday
2018,1,29,1300,250,282,532,Monday
2018,1,29,1200,297,201,498,Monday
2018,1,29,1100,281,155,436,Monday
2018,1,29,1000,318,124,442,Monday
2018,1,29,900,310,82,392,Monday
2018,1,29,800,160,57,217,Monday
2018,1,29,700,62,33,95,Monday
2018,1,29,600,20,21,41,Monday
2018,1,29,500,19,20,39,Monday
2018,1,29,400,18,19,37,Monday
2018,1,29,300,21,33,54,Monday
2018,1,29,200,13,35,48,Monday
2018,1,29,100,20,22,42,Monday
2018,1,28,2400,27,45,72,Sunday
2018,1,28,2300,51,97,148,Sunday
2018,1,28,2200,57,133,190,Sunday
2018,1,28,2100,66,166,232,Sunday
2018,1,28,2000,98,305,403,Sunday
2018,1,28,1900,117,534,651,Sunday
2018,1,28,1800,174,1137,1311,Sunday
2018,1,28,1700,218,1175,1393,Sunday
2018,1,28,1600,241,1113,1354,Sunday
2018,1,28,1500,336,896,1232,Sunday
2018,1,28,1400,361,818,1179,Sunday
2018,1,28,1300,460,585,1045,Sunday
2018,1,28,1200,520,447,967,Sunday
2018,1,28,1100,466,242,708,Sunday
2018,1,28,1000,571,126,697,Sunday
2018,1,28,900,688,72,760,Sunday
2018,1,28,800,260,42,302,Sunday
2018,1,28,700,58,24,82,Sunday
2018,1,28,600,32,14,46,Sunday
2018,1,28,500,13,16,29,Sunday
2018,1,28,400,8,2,10,Sunday
2018,1,28,300,17,14,31,Sunday
2018,1,28,200,8,13,21,Sunday
2018,1,28,100,28,32,60,Sunday
2018,1,27,2400,35,43,78,Saturday
2018,1,27,2300,37,50,87,Saturday
2018,1,27,2200,66,85,151,Saturday
2018,1,27,2100,74,134,208,Saturday
2018,1,27,2000,114,248,362,Saturday
2018,1,27,1900,106,475,581,Saturday
2018,1,27,1800,202,892,1094,Saturday
2018,1,27,1700,221,1132,1353,Saturday
2018,1,27,1600,290,731,1021,Saturday
2018,1,27,1500,366,513,879,Saturday
2018,1,27,1400,509,445,954,Saturday
2018,1,27,1300,562,346,908,Saturday
2018,1,27,1200,624,250,874,Saturday
2018,1,27,1100,637,186,823,Saturday
2018,1,27,1000,749,125,874,Saturday
2018,1,27,900,950,67,1017,Saturday
2018,1,27,800,421,67,488,Saturday
2018,1,27,700,111,40,151,Saturday
2018,1,27,600,32,13,45,Saturday
2018,1,27,500,15,16,31,Saturday
2018,1,27,400,27,29,56,Saturday
2018,1,27,300,19,23,42,Saturday
2018,1,27,200,25,29,54,Saturday
2018,1,27,100,35,34,69,Saturday
2018,1,26,2400,62,48,110,Friday
2018,1,26,2300,85,62,147,Friday
2018,1,26,2200,118,86,204,Friday
2018,1,26,2100,260,125,385,Friday
2018,1,26,2000,384,141,525,Friday
2018,1,26,1900,471,282,753,Friday
2018,1,26,1800,484,571,1055,Friday
2018,1,26,1700,529,649,1178,Friday
2018,1,26,1600,611,565,1176,Friday
2018,1,26,1500,543,420,963,Friday
2018,1,26,1400,481,337,818,Friday
2018,1,26,1300,483,241,724,Friday
2018,1,26,1200,512,206,718,Friday
2018,1,26,1100,487,168,655,Friday
2018,1,26,1000,514,128,642,Friday
2018,1,26,900,507,88,595,Friday
2018,1,26,800,242,51,293,Friday
2018,1,26,700,100,41,141,Friday
2018,1,26,600,45,21,66,Friday
2018,1,26,500,23,21,44,Friday
2018,1,26,400,24,25,49,Friday
2018,1,26,300,31,26,57,Friday
2018,1,26,200,24,33,57,Friday
2018,1,26,100,39,48,87,Friday
2018,1,25,2400,70,52,122,Thursday
2018,1,25,2300,76,67,143,Thursday
2018,1,25,2200,109,104,213,Thursday
2018,1,25,2100,148,137,285,Thursday
2018,1,25,2000,209,131,340,Thursday
2018,1,25,1900,248,216,464,Thursday
2018,1,25,1800,272,350,622,Thursday
2018,1,25,1700,295,416,711,Thursday
2018,1,25,1600,270,388,658,Thursday
2018,1,25,1500,280,274,554,Thursday
2018,1,25,1400,274,281,555,Thursday
2018,1,25,1300,262,209,471,Thursday
2018,1,25,1200,332,159,491,Thursday
2018,1,25,1100,338,165,503,Thursday
2018,1,25,1000,308,123,431,Thursday
2018,1,25,900,279,84,363,Thursday
2018,1,25,800,192,63,255,Thursday
2018,1,25,700,76,35,111,Thursday
2018,1,25,600,33,19,52,Thursday
2018,1,25,500,19,32,51,Thursday
2018,1,25,400,17,34,51,Thursday
2018,1,25,300,26,30,56,Thursday
2018,1,25,200,28,46,74,Thursday
2018,1,25,100,38,120,158,Thursday
2018,1,24,2400,59,96,155,Wednesday
2018,1,24,2300,69,17,86,Wednesday
2018,1,24,2200,85,25,110,Wednesday
2018,1,24,2100,103,57,160,Wednesday
2018,1,24,2000,134,117,251,Wednesday
2018,1,24,1900,135,213,348,Wednesday
2018,1,24,1800,171,319,490,Wednesday
2018,1,24,1700,211,430,641,Wednesday
2018,1,24,1600,237,345,582,Wednesday
2018,1,24,1500,234,295,529,Wednesday
2018,1,24,1400,261,253,514,Wednesday
2018,1,24,1300,238,203,441,Wednesday
2018,1,24,1200,302,167,469,Wednesday
2018,1,24,1100,286,129,415,Wednesday
2018,1,24,1000,306,118,424,Wednesday
2018,1,24,900,242,88,330,Wednesday
2018,1,24,800,176,44,220,Wednesday
2018,1,24,700,64,25,89,Wednesday
2018,1,24,600,32,27,59,Wednesday
2018,1,24,500,22,17,39,Wednesday
2018,1,24,400,26,28,54,Wednesday
2018,1,24,300,28,29,57,Wednesday
2018,1,24,200,21,35,56,Wednesday
2018,1,24,100,28,35,63,Wednesday
2018,1,23,2400,45,53,98,Tuesday
2018,1,23,2300,63,66,129,Tuesday
2018,1,23,2200,70,74,144,Tuesday
2018,1,23,2100,87,99,186,Tuesday
2018,1,23,2000,115,134,249,Tuesday
2018,1,23,1900,106,159,265,Tuesday
2018,1,23,1800,147,353,500,Tuesday
2018,1,23,1700,205,446,651,Tuesday
2018,1,23,1600,232,392,624,Tuesday
2018,1,23,1500,233,275,508,Tuesday
2018,1,23,1400,275,295,570,Tuesday
2018,1,23,1300,266,252,518,Tuesday
2018,1,23,1200,323,209,532,Tuesday
2018,1,23,1100,325,158,483,Tuesday
2018,1,23,1000,347,145,492,Tuesday
2018,1,23,900,261,76,337,Tuesday
2018,1,23,800,151,58,209,Tuesday
2018,1,23,700,64,45,109,Tuesday
2018,1,23,600,30,23,53,Tuesday
2018,1,23,500,25,28,53,Tuesday
2018,1,23,400,15,24,39,Tuesday
2018,1,23,300,16,57,73,Tuesday
2018,1,23,200,22,39,61,Tuesday
2018,1,23,100,37,41,78,Tuesday
2018,1,22,2400,41,19,60,Monday
2018,1,22,2300,54,36,90,Monday
2018,1,22,2200,70,60,130,Monday
2018,1,22,2100,90,97,187,Monday
2018,1,22,2000,86,156,242,Monday
2018,1,22,1900,98,228,326,Monday
2018,1,22,1800,136,371,507,Monday
2018,1,22,1700,188,535,723,Monday
2018,1,22,1600,229,363,592,Monday
2018,1,22,1500,278,287,565,Monday
2018,1,22,1400,284,319,603,Monday
2018,1,22,1300,324,230,554,Monday
2018,1,22,1200,292,173,465,Monday
2018,1,22,1100,358,171,529,Monday
2018,1,22,1000,320,131,451,Monday
2018,1,22,900,272,100,372,Monday
2018,1,22,800,152,63,215,Monday
2018,1,22,700,63,30,93,Monday
2018,1,22,600,22,27,49,Monday
2018,1,22,500,28,11,39,Monday
2018,1,22,400,19,15,34,Monday
2018,1,22,300,17,11,28,Monday
2018,1,22,200,17,32,49,Monday
2018,1,22,100,26,37,63,Monday
2018,1,21,2400,29,49,78,Sunday
2018,1,21,2300,36,76,112,Sunday
2018,1,21,2200,69,115,184,Sunday
2018,1,21,2100,77,187,264,Sunday
2018,1,21,2000,98,275,373,Sunday
2018,1,21,1900,104,535,639,Sunday
2018,1,21,1800,168,983,1151,Sunday
2018,1,21,1700,204,1537,1741,Sunday
2018,1,21,1600,282,1185,1467,Sunday
2018,1,21,1500,332,933,1265,Sunday
2018,1,21,1400,458,781,1239,Sunday
2018,1,21,1300,557,581,1138,Sunday
2018,1,21,1200,625,457,1082,Sunday
2018,1,21,1100,574,268,842,Sunday
2018,1,21,1000,626,136,762,Sunday
2018,1,21,900,839,72,911,Sunday
2018,1,21,800,292,40,332,Sunday
2018,1,21,700,79,23,102,Sunday
2018,1,21,600,23,14,37,Sunday
2018,1,21,500,10,18,28,Sunday
2018,1,21,400,13,11,24,Sunday
2018,1,21,300,13,26,39,Sunday
2018,1,21,200,16,25,41,Sunday
2018,1,21,100,15,30,45,Sunday
2018,1,20,2400,25,47,72,Saturday
2018,1,20,2300,46,75,121,Saturday
2018,1,20,2200,52,85,137,Saturday
2018,1,20,2100,66,117,183,Saturday
2018,1,20,2000,104,252,356,Saturday
2018,1,20,1900,123,515,638,Saturday
2018,1,20,1800,173,1243,1416,Saturday
2018,1,20,1700,221,1273,1494,Saturday
2018,1,20,1600,276,884,1160,Saturday
2018,1,20,1500,422,755,1177,Saturday
2018,1,20,1400,535,382,917,Saturday
2018,1,20,1300,641,244,885,Saturday
2018,1,20,1200,638,165,803,Saturday
2018,1,20,1100,694,107,801,Saturday
2018,1,20,1000,1086,108,1194,Saturday
2018,1,20,900,1020,80,1100,Saturday
2018,1,20,800,405,39,444,Saturday
2018,1,20,700,113,26,139,Saturday
2018,1,20,600,38,16,54,Saturday
2018,1,20,500,18,14,32,Saturday
2018,1,20,400,20,30,50,Saturday
2018,1,20,300,22,22,44,Saturday
2018,1,20,200,21,30,51,Saturday
2018,1,20,100,37,36,73,Saturday
2018,1,19,2400,50,66,116,Friday
2018,1,19,2300,90,78,168,Friday
2018,1,19,2200,142,66,208,Friday
2018,1,19,2100,224,99,323,Friday
2018,1,19,2000,323,150,473,Friday
2018,1,19,1900,402,280,682,Friday
2018,1,19,1800,419,486,905,Friday
2018,1,19,1700,488,685,1173,Friday
2018,1,19,1600,494,542,1036,Friday
2018,1,19,1500,459,396,855,Friday
2018,1,19,1400,433,336,769,Friday
2018,1,19,1300,406,247,653,Friday
2018,1,19,1200,400,227,627,Friday
2018,1,19,1100,411,167,578,Friday
2018,1,19,1000,446,113,559,Friday
2018,1,19,900,557,81,638,Friday
2018,1,19,800,269,52,321,Friday
2018,1,19,700,81,35,116,Friday
2018,1,19,600,39,28,67,Friday
2018,1,19,500,24,20,44,Friday
2018,1,19,400,21,37,58,Friday
2018,1,19,300,24,30,54,Friday
2018,1,19,200,22,31,53,Friday
2018,1,19,100,34,46,80,Friday
2018,1,18,2400,56,60,116,Thursday
2018,1,18,2300,68,55,123,Thursday
2018,1,18,2200,107,84,191,Thursday
2018,1,18,2100,146,88,234,Thursday
2018,1,18,2000,194,131,325,Thursday
2018,1,18,1900,181,179,360,Thursday
2018,1,18,1800,222,380,602,Thursday
2018,1,18,1700,273,578,851,Thursday
2018,1,18,1600,256,271,527,Thursday
2018,1,18,1500,257,226,483,Thursday
2018,1,18,1400,265,177,442,Thursday
2018,1,18,1300,251,194,445,Thursday
2018,1,18,1200,284,180,464,Thursday
2018,1,18,1100,283,162,445,Thursday
2018,1,18,1000,346,120,466,Thursday
2018,1,18,900,266,86,352,Thursday
2018,1,18,800,177,37,214,Thursday
2018,1,18,700,89,38,127,Thursday
2018,1,18,600,35,34,69,Thursday
2018,1,18,500,27,30,57,Thursday
2018,1,18,400,25,29,54,Thursday
2018,1,18,300,35,55,90,Thursday
2018,1,18,200,34,117,151,Thursday
2018,1,18,100,24,135,159,Thursday
2018,1,17,2400,48,65,113,Wednesday
2018,1,17,2300,74,37,111,Wednesday
2018,1,17,2200,85,30,115,Wednesday
2018,1,17,2100,102,40,142,Wednesday
2018,1,17,2000,121,52,173,Wednesday
2018,1,17,1900,163,109,272,Wednesday
2018,1,17,1800,178,219,397,Wednesday
2018,1,17,1700,180,300,480,Wednesday
2018,1,17,1600,215,311,526,Wednesday
2018,1,17,1500,213,291,504,Wednesday
2018,1,17,1400,231,234,465,Wednesday
2018,1,17,1300,232,196,428,Wednesday
2018,1,17,1200,210,152,362,Wednesday
2018,1,17,1100,243,168,411,Wednesday
2018,1,17,1000,279,104,383,Wednesday
2018,1,17,900,244,97,341,Wednesday
2018,1,17,800,143,59,202,Wednesday
2018,1,17,700,56,26,82,Wednesday
2018,1,17,600,30,31,61,Wednesday
2018,1,17,500,19,22,41,Wednesday
2018,1,17,400,29,29,58,Wednesday
2018,1,17,300,22,72,94,Wednesday
2018,1,17,200,23,25,48,Wednesday
2018,1,17,100,34,17,51,Wednesday
2018,1,16,2400,43,45,88,Tuesday
2018,1,16,2300,69,52,121,Tuesday
2018,1,16,2200,78,93,171,Tuesday
2018,1,16,2100,81,79,160,Tuesday
2018,1,16,2000,101,107,208,Tuesday
2018,1,16,1900,90,188,278,Tuesday
2018,1,16,1800,120,275,395,Tuesday
2018,1,16,1700,190,370,560,Tuesday
2018,1,16,1600,174,348,522,Tuesday
2018,1,16,1500,178,381,559,Tuesday
2018,1,16,1400,203,129,332,Tuesday
2018,1,16,1300,217,143,360,Tuesday
2018,1,16,1200,259,148,407,Tuesday
2018,1,16,1100,291,147,438,Tuesday
2018,1,16,1000,292,133,425,Tuesday
2018,1,16,900,284,83,367,Tuesday
2018,1,16,800,153,52,205,Tuesday
2018,1,16,700,67,43,110,Tuesday
2018,1,16,600,36,29,65,Tuesday
2018,1,16,500,16,34,50,Tuesday
2018,1,16,400,21,27,48,Tuesday
2018,1,16,300,13,30,43,Tuesday
2018,1,16,200,22,30,52,Tuesday
2018,1,16,100,37,36,73,Tuesday
2018,1,15,2400,39,41,80,Monday
2018,1,15,2300,60,74,134,Monday
2018,1,15,2200,78,68,146,Monday
2018,1,15,2100,94,75,169,Monday
2018,1,15,2000,104,116,220,Monday
2018,1,15,1900,141,166,307,Monday
2018,1,15,1800,142,334,476,Monday
2018,1,15,1700,189,413,602,Monday
2018,1,15,1600,190,353,543,Monday
2018,1,15,1500,237,273,510,Monday
2018,1,15,1400,221,235,456,Monday
2018,1,15,1300,223,216,439,Monday
2018,1,15,1200,256,175,431,Monday
2018,1,15,1100,246,181,427,Monday
2018,1,15,1000,316,111,427,Monday
2018,1,15,900,282,116,398,Monday
2018,1,15,800,141,51,192,Monday
2018,1,15,700,73,33,106,Monday
2018,1,15,600,27,32,59,Monday
2018,1,15,500,25,20,45,Monday
2018,1,15,400,27,13,40,Monday
2018,1,15,300,26,24,50,Monday
2018,1,15,200,17,26,43,Monday
2018,1,15,100,24,39,63,Monday
2018,1,14,2400,13,58,71,Sunday
2018,1,14,2300,36,76,112,Sunday
2018,1,14,2200,52,122,174,Sunday
2018,1,14,2100,61,176,237,Sunday
2018,1,14,2000,88,289,377,Sunday
2018,1,14,1900,85,470,555,Sunday
2018,1,14,1800,128,834,962,Sunday
2018,1,14,1700,150,1271,1421,Sunday
2018,1,14,1600,208,787,995,Sunday
2018,1,14,1500,212,676,888,Sunday
2018,1,14,1400,264,515,779,Sunday
2018,1,14,1300,314,429,743,Sunday
2018,1,14,1200,368,341,709,Sunday
2018,1,14,1100,398,210,608,Sunday
2018,1,14,1000,540,123,663,Sunday
2018,1,14,900,731,56,787,Sunday
2018,1,14,800,249,34,283,Sunday
2018,1,14,700,53,12,65,Sunday
2018,1,14,600,29,6,35,Sunday
2018,1,14,500,12,20,32,Sunday
2018,1,14,400,16,24,40,Sunday
2018,1,14,300,13,16,29,Sunday
2018,1,14,200,13,24,37,Sunday
2018,1,14,100,32,28,60,Sunday
2018,1,13,2400,24,28,52,Saturday
2018,1,13,2300,34,68,102,Saturday
2018,1,13,2200,55,105,160,Saturday
2018,1,13,2100,73,99,172,Saturday
2018,1,13,2000,88,163,251,Saturday
2018,1,13,1900,97,292,389,Saturday
2018,1,13,1800,139,781,920,Saturday
2018,1,13,1700,185,1004,1189,Saturday
2018,1,13,1600,226,609,835,Saturday
2018,1,13,1500,254,360,614,Saturday
2018,1,13,1400,287,240,527,Saturday
2018,1,13,1300,327,229,556,Saturday
2018,1,13,1200,420,156,576,Saturday
2018,1,13,1100,437,133,570,Saturday
2018,1,13,1000,678,111,789,Saturday
2018,1,13,900,881,79,960,Saturday
2018,1,13,800,314,45,359,Saturday
2018,1,13,700,81,22,103,Saturday
2018,1,13,600,30,14,44,Saturday
2018,1,13,500,21,28,49,Saturday
2018,1,13,400,19,27,46,Saturday
2018,1,13,300,22,15,37,Saturday
2018,1,13,200,24,19,43,Saturday
2018,1,13,100,35,32,67,Saturday
2018,1,12,2400,49,43,92,Friday
2018,1,12,2300,75,50,125,Friday
2018,1,12,2200,145,65,210,Friday
2018,1,12,2100,200,93,293,Friday
2018,1,12,2000,335,118,453,Friday
2018,1,12,1900,365,200,565,Friday
2018,1,12,1800,392,337,729,Friday
2018,1,12,1700,425,440,865,Friday
2018,1,12,1600,362,308,670,Friday
2018,1,12,1500,367,254,621,Friday
2018,1,12,1400,307,190,497,Friday
2018,1,12,1300,283,199,482,Friday
2018,1,12,1200,330,171,501,Friday
2018,1,12,1100,318,141,459,Friday
2018,1,12,1000,301,108,409,Friday
2018,1,12,900,284,85,369,Friday
2018,1,12,800,171,46,217,Friday
2018,1,12,700,76,31,107,Friday
2018,1,12,600,43,26,69,Friday
2018,1,12,500,19,27,46,Friday
2018,1,12,400,27,34,61,Friday
2018,1,12,300,24,26,50,Friday
2018,1,12,200,27,29,56,Friday
2018,1,12,100,39,49,88,Friday
2018,1,11,2400,56,49,105,Thursday
2018,1,11,2300,83,55,138,Thursday
2018,1,11,2200,97,77,174,Thursday
2018,1,11,2100,155,88,243,Thursday
2018,1,11,2000,166,128,294,Thursday
2018,1,11,1900,158,156,314,Thursday
2018,1,11,1800,214,251,465,Thursday
2018,1,11,1700,249,310,559,Thursday
2018,1,11,1600,230,270,500,Thursday
2018,1,11,1500,214,209,423,Thursday
2018,1,11,1400,236,190,426,Thursday
2018,1,11,1300,216,204,420,Thursday
2018,1,11,1200,232,154,386,Thursday
2018,1,11,1100,191,149,340,Thursday
2018,1,11,1000,206,101,307,Thursday
2018,1,11,900,201,71,272,Thursday
2018,1,11,800,144,50,194,Thursday
2018,1,11,700,60,30,90,Thursday
2018,1,11,600,25,28,53,Thursday
2018,1,11,500,12,24,36,Thursday
2018,1,11,400,25,44,69,Thursday
2018,1,11,300,26,26,52,Thursday
2018,1,11,200,16,27,43,Thursday
2018,1,11,100,37,40,77,Thursday
2018,1,10,2400,50,47,97,Wednesday
2018,1,10,2300,54,87,141,Wednesday
2018,1,10,2200,87,72,159,Wednesday
2018,1,10,2100,102,88,190,Wednesday
2018,1,10,2000,100,111,211,Wednesday
2018,1,10,1900,107,140,247,Wednesday
2018,1,10,1800,133,230,363,Wednesday
2018,1,10,1700,160,318,478,Wednesday
2018,1,10,1600,202,226,428,Wednesday
2018,1,10,1500,162,234,396,Wednesday
2018,1,10,1400,156,217,373,Wednesday
2018,1,10,1300,158,221,379,Wednesday
2018,1,10,1200,178,119,297,Wednesday
2018,1,10,1100,194,117,311,Wednesday
2018,1,10,1000,241,96,337,Wednesday
2018,1,10,900,218,65,283,Wednesday
2018,1,10,800,152,44,196,Wednesday
2018,1,10,700,38,37,75,Wednesday
2018,1,10,600,29,19,48,Wednesday
2018,1,10,500,18,29,47,Wednesday
2018,1,10,400,5,34,39,Wednesday
2018,1,10,300,17,27,44,Wednesday
2018,1,10,200,28,21,49,Wednesday
2018,1,10,100,35,60,95,Wednesday
2018,1,9,2400,46,51,97,Tuesday
2018,1,9,2300,46,79,125,Tuesday
2018,1,9,2200,66,91,157,Tuesday
2018,1,9,2100,88,156,244,Tuesday
2018,1,9,2000,93,268,361,Tuesday
2018,1,9,1900,98,160,258,Tuesday
2018,1,9,1800,119,247,366,Tuesday
2018,1,9,1700,164,231,395,Tuesday
2018,1,9,1600,186,211,397,Tuesday
2018,1,9,1500,169,164,333,Tuesday
2018,1,9,1400,174,158,332,Tuesday
2018,1,9,1300,216,143,359,Tuesday
2018,1,9,1200,241,112,353,Tuesday
2018,1,9,1100,248,144,392,Tuesday
2018,1,9,1000,252,117,369,Tuesday
2018,1,9,900,222,85,307,Tuesday
2018,1,9,800,147,34,181,Tuesday
2018,1,9,700,62,48,110,Tuesday
2018,1,9,600,31,28,59,Tuesday
2018,1,9,500,20,31,51,Tuesday
2018,1,9,400,20,28,48,Tuesday
2018,1,9,300,15,22,37,Tuesday
2018,1,9,200,26,38,64,Tuesday
2018,1,9,100,34,32,66,Tuesday
2018,1,8,2400,49,47,96,Monday
2018,1,8,2300,60,58,118,Monday
2018,1,8,2200,69,68,137,Monday
2018,1,8,2100,82,91,173,Monday
2018,1,8,2000,105,134,239,Monday
2018,1,8,1900,118,152,270,Monday
2018,1,8,1800,134,300,434,Monday
2018,1,8,1700,160,407,567,Monday
2018,1,8,1600,212,380,592,Monday
2018,1,8,1500,214,258,472,Monday
2018,1,8,1400,259,247,506,Monday
2018,1,8,1300,228,217,445,Monday
2018,1,8,1200,237,166,403,Monday
2018,1,8,1100,249,133,382,Monday
2018,1,8,1000,289,101,390,Monday
2018,1,8,900,252,81,333,Monday
2018,1,8,800,156,48,204,Monday
2018,1,8,700,66,23,89,Monday
2018,1,8,600,33,15,48,Monday
2018,1,8,500,30,25,55,Monday
2018,1,8,400,9,17,26,Monday
2018,1,8,300,19,22,41,Monday
2018,1,8,200,14,40,54,Monday
2018,1,8,100,21,38,59,Monday
2018,1,7,2400,20,57,77,Sunday
2018,1,7,2300,32,71,103,Sunday
2018,1,7,2200,49,116,165,Sunday
2018,1,7,2100,81,170,251,Sunday
2018,1,7,2000,92,223,315,Sunday
2018,1,7,1900,99,370,469,Sunday
2018,1,7,1800,121,800,921,Sunday
2018,1,7,1700,162,1232,1394,Sunday
2018,1,7,1600,228,899,1127,Sunday
2018,1,7,1500,258,764,1022,Sunday
2018,1,7,1400,280,530,810,Sunday
2018,1,7,1300,323,510,833,Sunday
2018,1,7,1200,388,346,734,Sunday
2018,1,7,1100,403,195,598,Sunday
2018,1,7,1000,471,132,603,Sunday
2018,1,7,900,705,58,763,Sunday
2018,1,7,800,303,39,342,Sunday
2018,1,7,700,78,23,101,Sunday
2018,1,7,600,31,21,52,Sunday
2018,1,7,500,9,16,25,Sunday
2018,1,7,400,12,13,25,Sunday
2018,1,7,300,13,24,37,Sunday
2018,1,7,200,22,19,41,Sunday
2018,1,7,100,22,19,41,Sunday
2018,1,6,2400,29,43,72,Saturday
2018,1,6,2300,34,56,90,Saturday
2018,1,6,2200,64,86,150,Saturday
2018,1,6,2100,55,120,175,Saturday
2018,1,6,2000,79,203,282,Saturday
2018,1,6,1900,94,355,449,Saturday
2018,1,6,1800,128,978,1106,Saturday
2018,1,6,1700,192,1192,1384,Saturday
2018,1,6,1600,219,796,1015,Saturday
2018,1,6,1500,277,613,890,Saturday
2018,1,6,1400,346,445,791,Saturday
2018,1,6,1300,385,399,784,Saturday
2018,1,6,1200,502,329,831,Saturday
2018,1,6,1100,488,184,672,Saturday
2018,1,6,1000,707,145,852,Saturday
2018,1,6,900,846,103,949,Saturday
2018,1,6,800,353,53,406,Saturday
2018,1,6,700,80,24,104,Saturday
2018,1,6,600,28,35,63,Saturday
2018,1,6,500,15,25,40,Saturday
2018,1,6,400,23,26,49,Saturday
2018,1,6,300,34,12,46,Saturday
2018,1,6,200,28,35,63,Saturday
2018,1,6,100,24,27,51,Saturday
2018,1,5,2400,59,57,116,Friday
2018,1,5,2300,93,64,157,Friday
2018,1,5,2200,119,99,218,Friday
2018,1,5,2100,177,157,334,Friday
2018,1,5,2000,246,191,437,Friday
2018,1,5,1900,288,318,606,Friday
2018,1,5,1800,298,652,950,Friday
2018,1,5,1700,350,1062,1412,Friday
2018,1,5,1600,360,730,1090,Friday
2018,1,5,1500,367,563,930,Friday
2018,1,5,1400,357,467,824,Friday
2018,1,5,1300,405,469,874,Friday
2018,1,5,1200,458,324,782,Friday
2018,1,5,1100,491,214,705,Friday
2018,1,5,1000,591,160,751,Friday
2018,1,5,900,560,108,668,Friday
2018,1,5,800,272,62,334,Friday
2018,1,5,700,89,26,115,Friday
2018,1,5,600,31,27,58,Friday
2018,1,5,500,22,34,56,Friday
2018,1,5,400,30,36,66,Friday
2018,1,5,300,21,22,43,Friday
2018,1,5,200,29,30,59,Friday
2018,1,5,100,41,57,98,Friday
2018,1,4,2400,69,58,127,Thursday
2018,1,4,2300,76,77,153,Thursday
2018,1,4,2200,87,110,197,Thursday
2018,1,4,2100,109,117,226,Thursday
2018,1,4,2000,164,191,355,Thursday
2018,1,4,1900,180,346,526,Thursday
2018,1,4,1800,235,798,1033,Thursday
2018,1,4,1700,286,918,1204,Thursday
2018,1,4,1600,312,705,1017,Thursday
2018,1,4,1500,327,561,888,Thursday
2018,1,4,1400,363,418,781,Thursday
2018,1,4,1300,407,358,765,Thursday
2018,1,4,1200,525,270,795,Thursday
2018,1,4,1100,490,210,700,Thursday
2018,1,4,1000,574,127,701,Thursday
2018,1,4,900,626,111,737,Thursday
2018,1,4,800,215,42,257,Thursday
2018,1,4,700,68,38,106,Thursday
2018,1,4,600,38,28,66,Thursday
2018,1,4,500,27,35,62,Thursday
2018,1,4,400,21,36,57,Thursday
2018,1,4,300,16,28,44,Thursday
2018,1,4,200,20,42,62,Thursday
2018,1,4,100,37,43,80,Thursday
2018,1,3,2400,53,70,123,Wednesday
2018,1,3,2300,56,71,127,Wednesday
2018,1,3,2200,78,115,193,Wednesday
2018,1,3,2100,115,115,230,Wednesday
2018,1,3,2000,112,213,325,Wednesday
2018,1,3,1900,121,410,531,Wednesday
2018,1,3,1800,187,923,1110,Wednesday
2018,1,3,1700,256,922,1178,Wednesday
2018,1,3,1600,306,765,1071,Wednesday
2018,1,3,1500,376,580,956,Wednesday
2018,1,3,1400,428,466,894,Wednesday
2018,1,3,1300,453,380,833,Wednesday
2018,1,3,1200,538,285,823,Wednesday
2018,1,3,1100,548,215,763,Wednesday
2018,1,3,1000,645,138,783,Wednesday
2018,1,3,900,648,91,739,Wednesday
2018,1,3,800,259,80,339,Wednesday
2018,1,3,700,66,38,104,Wednesday
2018,1,3,600,41,12,53,Wednesday
2018,1,3,500,18,30,48,Wednesday
2018,1,3,400,20,39,59,Wednesday
2018,1,3,300,24,46,70,Wednesday
2018,1,3,200,21,56,77,Wednesday
2018,1,3,100,38,51,89,Wednesday
2018,1,2,2400,54,81,135,Tuesday
2018,1,2,2300,59,105,164,Tuesday
2018,1,2,2200,94,112,206,Tuesday
2018,1,2,2100,114,155,269,Tuesday
2018,1,2,2000,120,273,393,Tuesday
2018,1,2,1900,158,409,567,Tuesday
2018,1,2,1800,218,942,1160,Tuesday
2018,1,2,1700,307,1141,1448,Tuesday
2018,1,2,1600,436,853,1289,Tuesday
2018,1,2,1500,480,787,1267,Tuesday
2018,1,2,1400,659,694,1353,Tuesday
2018,1,2,1300,544,596,1140,Tuesday
2018,1,2,1200,410,440,850,Tuesday
2018,1,2,1100,492,257,749,Tuesday
2018,1,2,1000,664,182,846,Tuesday
2018,1,2,900,560,89,649,Tuesday
2018,1,2,800,215,62,277,Tuesday
2018,1,2,700,88,31,119,Tuesday
2018,1,2,600,29,37,66,Tuesday
2018,1,2,500,11,14,25,Tuesday
2018,1,2,400,13,19,32,Tuesday
2018,1,2,300,14,16,30,Tuesday
2018,1,2,200,14,34,48,Tuesday
2018,1,2,100,11,40,51,Tuesday
2018,1,1,2400,32,68,100,Monday
2018,1,1,2300,36,79,115,Monday
2018,1,1,2200,57,134,191,Monday
2018,1,1,2100,62,178,240,Monday
2018,1,1,2000,100,281,381,Monday
2018,1,1,1900,106,533,639,Monday
2018,1,1,1800,161,925,1086,Monday
2018,1,1,1700,243,1223,1466,Monday
2018,1,1,1600,336,1201,1537,Monday
2018,1,1,1500,402,1185,1587,Monday
2018,1,1,1400,489,1057,1546,Monday
2018,1,1,1300,501,806,1307,Monday
2018,1,1,1200,468,540,1008,Monday
2018,1,1,1100,427,212,639,Monday
2018,1,1,1000,391,109,500,Monday
2018,1,1,900,311,56,367,Monday
2018,1,1,800,115,27,142,Monday
2018,1,1,700,49,22,71,Monday
2018,1,1,600,15,6,21,Monday
2018,1,1,500,11,11,22,Monday
2018,1,1,400,10,6,16,Monday
2018,1,1,300,11,10,21,Monday
2018,1,1,200,16,24,40,Monday
2018,1,1,100,32,26,58,Monday
2017,12,31,2400,19,39,58,Sunday
2017,12,31,2300,31,50,81,Sunday
2017,12,31,2200,50,82,132,Sunday
2017,12,31,2100,60,124,184,Sunday
2017,12,31,2000,73,177,250,Sunday
2017,12,31,1900,95,305,400,Sunday
2017,12,31,1800,132,684,816,Sunday
2017,12,31,1700,220,774,994,Sunday
2017,12,31,1600,280,778,1058,Sunday
2017,12,31,1500,367,621,988,Sunday
2017,12,31,1400,447,558,1005,Sunday
2017,12,31,1300,512,533,1045,Sunday
2017,12,31,1200,530,374,904,Sunday
2017,12,31,1100,523,218,741,Sunday
2017,12,31,1000,423,117,540,Sunday
2017,12,31,900,361,78,439,Sunday
2017,12,31,800,176,34,210,Sunday
2017,12,31,700,63,19,82,Sunday
2017,12,31,600,25,18,43,Sunday
2017,12,31,500,17,22,39,Sunday
2017,12,31,400,12,14,26,Sunday
2017,12,31,300,18,35,53,Sunday
2017,12,31,200,16,43,59,Sunday
2017,12,31,100,23,60,83,Sunday
2017,12,30,2400,28,87,115,Saturday
2017,12,30,2300,50,86,136,Saturday
2017,12,30,2200,64,121,185,Saturday
2017,12,30,2100,110,177,287,Saturday
2017,12,30,2000,111,242,353,Saturday
2017,12,30,1900,181,394,575,Saturday
2017,12,30,1800,202,805,1007,Saturday
2017,12,30,1700,326,965,1291,Saturday
2017,12,30,1600,460,618,1078,Saturday
2017,12,30,1500,577,571,1148,Saturday
2017,12,30,1400,644,572,1216,Saturday
2017,12,30,1300,606,507,1113,Saturday
2017,12,30,1200,618,316,934,Saturday
2017,12,30,1100,619,229,848,Saturday
2017,12,30,1000,501,118,619,Saturday
2017,12,30,900,432,68,500,Saturday
2017,12,30,800,201,34,235,Saturday
2017,12,30,700,74,23,97,Saturday
2017,12,30,600,29,12,41,Saturday
2017,12,30,500,15,22,37,Saturday
2017,12,30,400,23,14,37,Saturday
2017,12,30,300,16,13,29,Saturday
2017,12,30,200,14,14,28,Saturday
2017,12,30,100,29,18,47,Saturday
2017,12,29,2400,45,43,88,Friday
2017,12,29,2300,57,82,139,Friday
2017,12,29,2200,92,91,183,Friday
2017,12,29,2100,127,166,293,Friday
2017,12,29,2000,171,224,395,Friday
2017,12,29,1900,245,369,614,Friday
2017,12,29,1800,343,767,1110,Friday
2017,12,29,1700,470,938,1408,Friday
2017,12,29,1600,597,710,1307,Friday
2017,12,29,1500,697,651,1348,Friday
2017,12,29,1400,669,550,1219,Friday
2017,12,29,1300,644,546,1190,Friday
2017,12,29,1200,706,369,1075,Friday
2017,12,29,1100,601,231,832,Friday
2017,12,29,1000,596,161,757,Friday
2017,12,29,900,510,83,593,Friday
2017,12,29,800,244,43,287,Friday
2017,12,29,700,94,34,128,Friday
2017,12,29,600,47,19,66,Friday
2017,12,29,500,16,14,30,Friday
2017,12,29,400,16,31,47,Friday
2017,12,29,300,20,38,58,Friday
2017,12,29,200,21,28,49,Friday
2017,12,29,100,34,28,62,Friday
2017,12,28,2400,50,78,128,Thursday
2017,12,28,2300,59,82,141,Thursday
2017,12,28,2200,95,152,247,Thursday
2017,12,28,2100,133,184,317,Thursday
2017,12,28,2000,150,178,328,Thursday
2017,12,28,1900,197,353,550,Thursday
2017,12,28,1800,281,780,1061,Thursday
2017,12,28,1700,523,899,1422,Thursday
2017,12,28,1600,534,741,1275,Thursday
2017,12,28,1500,704,630,1334,Thursday
2017,12,28,1400,735,556,1291,Thursday
2017,12,28,1300,718,436,1154,Thursday
2017,12,28,1200,834,307,1141,Thursday
2017,12,28,1100,675,236,911,Thursday
2017,12,28,1000,765,164,929,Thursday
2017,12,28,900,600,84,684,Thursday
2017,12,28,800,285,43,328,Thursday
2017,12,28,700,98,31,129,Thursday
2017,12,28,600,35,39,74,Thursday
2017,12,28,500,24,28,52,Thursday
2017,12,28,400,27,21,48,Thursday
2017,12,28,300,23,22,45,Thursday
2017,12,28,200,31,40,71,Thursday
2017,12,28,100,38,98,136,Thursday
2017,12,27,2400,54,216,270,Wednesday
2017,12,27,2300,68,194,262,Wednesday
2017,12,27,2200,91,215,306,Wednesday
2017,12,27,2100,159,113,272,Wednesday
2017,12,27,2000,222,73,295,Wednesday
2017,12,27,1900,253,243,496,Wednesday
2017,12,27,1800,354,532,886,Wednesday
2017,12,27,1700,534,817,1351,Wednesday
2017,12,27,1600,678,757,1435,Wednesday
2017,12,27,1500,895,615,1510,Wednesday
2017,12,27,1400,960,559,1519,Wednesday
2017,12,27,1300,928,458,1386,Wednesday
2017,12,27,1200,968,369,1337,Wednesday
2017,12,27,1100,798,203,1001,Wednesday
2017,12,27,1000,696,147,843,Wednesday
2017,12,27,900,568,75,643,Wednesday
2017,12,27,800,257,40,297,Wednesday
2017,12,27,700,110,20,130,Wednesday
2017,12,27,600,58,19,77,Wednesday
2017,12,27,500,24,18,42,Wednesday
2017,12,27,400,21,18,39,Wednesday
2017,12,27,300,17,18,35,Wednesday
2017,12,27,200,19,25,44,Wednesday
2017,12,27,100,27,53,80,Wednesday
2017,12,26,2400,29,54,83,Tuesday
2017,12,26,2300,54,55,109,Tuesday
2017,12,26,2200,86,77,163,Tuesday
2017,12,26,2100,126,131,257,Tuesday
2017,12,26,2000,146,167,313,Tuesday
2017,12,26,1900,216,318,534,Tuesday
2017,12,26,1800,281,570,851,Tuesday
2017,12,26,1700,506,663,1169,Tuesday
2017,12,26,1600,637,671,1308,Tuesday
2017,12,26,1500,771,652,1423,Tuesday
2017,12,26,1400,795,548,1343,Tuesday
2017,12,26,1300,737,490,1227,Tuesday
2017,12,26,1200,702,368,1070,Tuesday
2017,12,26,1100,539,207,746,Tuesday
2017,12,26,1000,425,102,527,Tuesday
2017,12,26,900,306,67,373,Tuesday
2017,12,26,800,170,40,210,Tuesday
2017,12,26,700,80,20,100,Tuesday
2017,12,26,600,29,5,34,Tuesday
2017,12,26,500,10,7,17,Tuesday
2017,12,26,400,10,9,19,Tuesday
2017,12,26,300,6,8,14,Tuesday
2017,12,26,200,7,12,19,Tuesday
2017,12,26,100,11,13,24,Tuesday
2017,12,25,2400,15,23,38,Monday
2017,12,25,2300,21,27,48,Monday
2017,12,25,2200,52,49,101,Monday
2017,12,25,2100,39,68,107,Monday
2017,12,25,2000,55,81,136,Monday
2017,12,25,1900,72,156,228,Monday
2017,12,25,1800,104,383,487,Monday
2017,12,25,1700,185,497,682,Monday
2017,12,25,1600,246,412,658,Monday
2017,12,25,1500,324,305,629,Monday
2017,12,25,1400,438,247,685,Monday
2017,12,25,1300,455,181,636,Monday
2017,12,25,1200,277,107,384,Monday
2017,12,25,1100,268,86,354,Monday
2017,12,25,1000,287,53,340,Monday
2017,12,25,900,196,39,235,Monday
2017,12,25,800,86,19,105,Monday
2017,12,25,700,31,12,43,Monday
2017,12,25,600,18,8,26,Monday
2017,12,25,500,7,8,15,Monday
2017,12,25,400,10,7,17,Monday
2017,12,25,300,13,17,30,Monday
2017,12,25,200,17,5,22,Monday
2017,12,25,100,19,15,34,Monday
2017,12,24,2400,10,12,22,Sunday
2017,12,24,2300,38,31,69,Sunday
2017,12,24,2200,42,38,80,Sunday
2017,12,24,2100,65,60,125,Sunday
2017,12,24,2000,65,86,151,Sunday
2017,12,24,1900,83,163,246,Sunday
2017,12,24,1800,155,310,465,Sunday
2017,12,24,1700,189,522,711,Sunday
2017,12,24,1600,296,484,780,Sunday
2017,12,24,1500,349,407,756,Sunday
2017,12,24,1400,422,349,771,Sunday
2017,12,24,1300,494,294,788,Sunday
2017,12,24,1200,475,249,724,Sunday
2017,12,24,1100,419,166,585,Sunday
2017,12,24,1000,364,104,468,Sunday
2017,12,24,900,289,57,346,Sunday
2017,12,24,800,151,23,174,Sunday
2017,12,24,700,66,19,85,Sunday
2017,12,24,600,26,14,40,Sunday
2017,12,24,500,11,16,27,Sunday
2017,12,24,400,20,11,31,Sunday
2017,12,24,300,15,15,30,Sunday
2017,12,24,200,15,30,45,Sunday
2017,12,24,100,25,40,65,Sunday
2017,12,23,2400,39,53,92,Saturday
2017,12,23,2300,60,62,122,Saturday
2017,12,23,2200,67,103,170,Saturday
2017,12,23,2100,84,109,193,Saturday
2017,12,23,2000,144,211,355,Saturday
2017,12,23,1900,158,304,462,Saturday
2017,12,23,1800,241,556,797,Saturday
2017,12,23,1700,375,801,1176,Saturday
2017,12,23,1600,568,779,1347,Saturday
2017,12,23,1500,892,647,1539,Saturday
2017,12,23,1400,686,551,1237,Saturday
2017,12,23,1300,736,478,1214,Saturday
2017,12,23,1200,844,337,1181,Saturday
2017,12,23,1100,738,225,963,Saturday
2017,12,23,1000,735,141,876,Saturday
2017,12,23,900,659,83,742,Saturday
2017,12,23,800,372,62,434,Saturday
2017,12,23,700,142,29,171,Saturday
2017,12,23,600,57,30,87,Saturday
2017,12,23,500,27,30,57,Saturday
2017,12,23,400,36,37,73,Saturday
2017,12,23,300,30,45,75,Saturday
2017,12,23,200,33,49,82,Saturday
2017,12,23,100,51,71,122,Saturday
2017,12,22,2400,75,74,149,Friday
2017,12,22,2300,93,198,291,Friday
2017,12,22,2200,124,172,296,Friday
2017,12,22,2100,163,47,210,Friday
2017,12,22,2000,256,187,443,Friday
2017,12,22,1900,275,329,604,Friday
2017,12,22,1800,388,556,944,Friday
2017,12,22,1700,493,810,1303,Friday
2017,12,22,1600,596,770,1366,Friday
2017,12,22,1500,609,566,1175,Friday
2017,12,22,1400,663,481,1144,Friday
2017,12,22,1300,604,409,1013,Friday
2017,12,22,1200,682,280,962,Friday
2017,12,22,1100,646,233,879,Friday
2017,12,22,1000,607,164,771,Friday
2017,12,22,900,522,104,626,Friday
2017,12,22,800,262,46,308,Friday
2017,12,22,700,111,40,151,Friday
2017,12,22,600,59,43,102,Friday
2017,12,22,500,24,48,72,Friday
2017,12,22,400,25,46,71,Friday
2017,12,22,300,28,47,75,Friday
2017,12,22,200,36,187,223,Friday
2017,12,22,100,52,86,138,Friday
2017,12,21,2400,62,31,93,Thursday
2017,12,21,2300,69,31,100,Thursday
2017,12,21,2200,119,34,153,Thursday
2017,12,21,2100,170,66,236,Thursday
2017,12,21,2000,191,97,288,Thursday
2017,12,21,1900,171,260,431,Thursday
2017,12,21,1800,238,372,610,Thursday
2017,12,21,1700,290,506,796,Thursday
2017,12,21,1600,336,514,850,Thursday
2017,12,21,1500,341,455,796,Thursday
2017,12,21,1400,358,327,685,Thursday
2017,12,21,1300,419,274,693,Thursday
2017,12,21,1200,451,240,691,Thursday
2017,12,21,1100,424,216,640,Thursday
2017,12,21,1000,512,150,662,Thursday
2017,12,21,900,464,117,581,Thursday
2017,12,21,800,239,72,311,Thursday
2017,12,21,700,106,48,154,Thursday
2017,12,21,600,55,32,87,Thursday
2017,12,21,500,28,36,64,Thursday
2017,12,21,400,28,43,71,Thursday
2017,12,21,300,42,43,85,Thursday
2017,12,21,200,35,39,74,Thursday
2017,12,21,100,44,48,92,Thursday
2017,12,20,2400,72,66,138,Wednesday
2017,12,20,2300,76,69,145,Wednesday
2017,12,20,2200,111,119,230,Wednesday
2017,12,20,2100,143,160,303,Wednesday
2017,12,20,2000,175,169,344,Wednesday
2017,12,20,1900,147,276,423,Wednesday
2017,12,20,1800,185,442,627,Wednesday
2017,12,20,1700,214,645,859,Wednesday
2017,12,20,1600,253,576,829,Wednesday
2017,12,20,1500,288,511,799,Wednesday
2017,12,20,1400,303,276,579,Wednesday
2017,12,20,1300,289,183,472,Wednesday
2017,12,20,1200,337,172,509,Wednesday
2017,12,20,1100,349,160,509,Wednesday
2017,12,20,1000,462,113,575,Wednesday
2017,12,20,900,490,64,554,Wednesday
2017,12,20,800,220,59,279,Wednesday
2017,12,20,700,75,24,99,Wednesday
2017,12,20,600,31,18,49,Wednesday
2017,12,20,500,14,30,44,Wednesday
2017,12,20,400,27,21,48,Wednesday
2017,12,20,300,20,25,45,Wednesday
2017,12,20,200,27,27,54,Wednesday
2017,12,20,100,37,30,67,Wednesday
2017,12,19,2400,71,29,100,Tuesday
2017,12,19,2300,54,61,115,Tuesday
2017,12,19,2200,69,63,132,Tuesday
2017,12,19,2100,119,43,162,Tuesday
2017,12,19,2000,96,127,223,Tuesday
2017,12,19,1900,104,157,261,Tuesday
2017,12,19,1800,159,291,450,Tuesday
2017,12,19,1700,185,395,580,Tuesday
2017,12,19,1600,191,333,524,Tuesday
2017,12,19,1500,195,339,534,Tuesday
2017,12,19,1400,242,293,535,Tuesday
2017,12,19,1300,241,243,484,Tuesday
2017,12,19,1200,260,220,480,Tuesday
2017,12,19,1100,328,186,514,Tuesday
2017,12,19,1000,304,141,445,Tuesday
2017,12,19,900,331,91,422,Tuesday
2017,12,19,800,183,50,233,Tuesday
2017,12,19,700,73,44,117,Tuesday
2017,12,19,600,36,30,66,Tuesday
2017,12,19,500,14,21,35,Tuesday
2017,12,19,400,25,24,49,Tuesday
2017,12,19,300,22,31,53,Tuesday
2017,12,19,200,25,32,57,Tuesday
2017,12,19,100,43,55,98,Tuesday
2017,12,18,2400,52,73,125,Monday
2017,12,18,2300,70,89,159,Monday
2017,12,18,2200,98,89,187,Monday
2017,12,18,2100,116,149,265,Monday
2017,12,18,2000,143,180,323,Monday
2017,12,18,1900,152,181,333,Monday
2017,12,18,1800,174,448,622,Monday
2017,12,18,1700,233,693,926,Monday
2017,12,18,1600,253,514,767,Monday
2017,12,18,1500,322,412,734,Monday
2017,12,18,1400,282,290,572,Monday
2017,12,18,1300,326,271,597,Monday
2017,12,18,1200,344,154,498,Monday
2017,12,18,1100,379,141,520,Monday
2017,12,18,1000,607,92,699,Monday
2017,12,18,900,464,82,546,Monday
2017,12,18,800,151,47,198,Monday
2017,12,18,700,85,28,113,Monday
2017,12,18,600,33,22,55,Monday
2017,12,18,500,24,31,55,Monday
2017,12,18,400,31,13,44,Monday
2017,12,18,300,10,22,32,Monday
2017,12,18,200,18,29,47,Monday
2017,12,18,100,19,38,57,Monday
2017,12,17,2400,34,46,80,Sunday
2017,12,17,2300,39,80,119,Sunday
2017,12,17,2200,55,111,166,Sunday
2017,12,17,2100,106,155,261,Sunday
2017,12,17,2000,111,195,306,Sunday
2017,12,17,1900,111,311,422,Sunday
2017,12,17,1800,176,549,725,Sunday
2017,12,17,1700,251,937,1188,Sunday
2017,12,17,1600,301,748,1049,Sunday
2017,12,17,1500,335,692,1027,Sunday
2017,12,17,1400,345,532,877,Sunday
2017,12,17,1300,376,424,800,Sunday
2017,12,17,1200,441,322,763,Sunday
2017,12,17,1100,389,214,603,Sunday
2017,12,17,1000,371,103,474,Sunday
2017,12,17,900,465,74,539,Sunday
2017,12,17,800,290,33,323,Sunday
2017,12,17,700,81,16,97,Sunday
2017,12,17,600,31,9,40,Sunday
2017,12,17,500,28,16,44,Sunday
2017,12,17,400,11,18,29,Sunday
2017,12,17,300,15,15,30,Sunday
2017,12,17,200,29,27,56,Sunday
2017,12,17,100,31,35,66,Sunday
2017,12,16,2400,35,50,85,Saturday
2017,12,16,2300,50,55,105,Saturday
2017,12,16,2200,62,63,125,Saturday
2017,12,16,2100,79,103,182,Saturday
2017,12,16,2000,117,142,259,Saturday
2017,12,16,1900,120,262,382,Saturday
2017,12,16,1800,172,486,658,Saturday
2017,12,16,1700,232,838,1070,Saturday
2017,12,16,1600,260,630,890,Saturday
2017,12,16,1500,311,434,745,Saturday
2017,12,16,1400,329,350,679,Saturday
2017,12,16,1300,354,302,656,Saturday
2017,12,16,1200,411,207,618,Saturday
2017,12,16,1100,441,175,616,Saturday
2017,12,16,1000,538,122,660,Saturday
2017,12,16,900,558,83,641,Saturday
2017,12,16,800,341,55,396,Saturday
2017,12,16,700,92,40,132,Saturday
2017,12,16,600,29,22,51,Saturday
2017,12,16,500,21,19,40,Saturday
2017,12,16,400,27,30,57,Saturday
2017,12,16,300,30,19,49,Saturday
2017,12,16,200,15,37,52,Saturday
2017,12,16,100,41,49,90,Saturday
2017,12,15,2400,70,56,126,Friday
2017,12,15,2300,93,74,167,Friday
2017,12,15,2200,111,55,166,Friday
2017,12,15,2100,162,116,278,Friday
2017,12,15,2000,238,120,358,Friday
2017,12,15,1900,279,196,475,Friday
2017,12,15,1800,313,353,666,Friday
2017,12,15,1700,349,408,757,Friday
2017,12,15,1600,384,412,796,Friday
2017,12,15,1500,358,326,684,Friday
2017,12,15,1400,324,279,603,Friday
2017,12,15,1300,333,220,553,Friday
2017,12,15,1200,349,202,551,Friday
2017,12,15,1100,328,175,503,Friday
2017,12,15,1000,314,139,453,Friday
2017,12,15,900,287,100,387,Friday
2017,12,15,800,183,43,226,Friday
2017,12,15,700,77,38,115,Friday
2017,12,15,600,32,31,63,Friday
2017,12,15,500,23,27,50,Friday
2017,12,15,400,31,18,49,Friday
2017,12,15,300,30,41,71,Friday
2017,12,15,200,27,37,64,Friday
2017,12,15,100,39,57,96,Friday
2017,12,14,2400,67,72,139,Thursday
2017,12,14,2300,85,59,144,Thursday
2017,12,14,2200,103,95,198,Thursday
2017,12,14,2100,135,127,262,Thursday
2017,12,14,2000,144,134,278,Thursday
2017,12,14,1900,163,190,353,Thursday
2017,12,14,1800,202,286,488,Thursday
2017,12,14,1700,240,382,622,Thursday
2017,12,14,1600,294,354,648,Thursday
2017,12,14,1500,256,310,566,Thursday
2017,12,14,1400,272,260,532,Thursday
2017,12,14,1300,239,229,468,Thursday
2017,12,14,1200,261,165,426,Thursday
2017,12,14,1100,265,176,441,Thursday
2017,12,14,1000,256,129,385,Thursday
2017,12,14,900,246,124,370,Thursday
2017,12,14,800,154,55,209,Thursday
2017,12,14,700,73,48,121,Thursday
2017,12,14,600,47,30,77,Thursday
2017,12,14,500,35,23,58,Thursday
2017,12,14,400,27,31,58,Thursday
2017,12,14,300,25,40,65,Thursday
2017,12,14,200,29,41,70,Thursday
2017,12,14,100,38,44,82,Thursday
2017,12,13,2400,70,64,134,Wednesday
2017,12,13,2300,72,62,134,Wednesday
2017,12,13,2200,106,94,200,Wednesday
2017,12,13,2100,86,104,190,Wednesday
2017,12,13,2000,122,134,256,Wednesday
2017,12,13,1900,149,195,344,Wednesday
2017,12,13,1800,172,303,475,Wednesday
2017,12,13,1700,173,369,542,Wednesday
2017,12,13,1600,225,344,569,Wednesday
2017,12,13,1500,231,298,529,Wednesday
2017,12,13,1400,252,235,487,Wednesday
2017,12,13,1300,258,228,486,Wednesday
2017,12,13,1200,253,195,448,Wednesday
2017,12,13,1100,255,149,404,Wednesday
2017,12,13,1000,266,129,395,Wednesday
2017,12,13,900,256,121,377,Wednesday
2017,12,13,800,192,75,267,Wednesday
2017,12,13,700,63,36,99,Wednesday
2017,12,13,600,32,37,69,Wednesday
2017,12,13,500,29,23,52,Wednesday
2017,12,13,400,19,35,54,Wednesday
2017,12,13,300,23,34,57,Wednesday
2017,12,13,200,23,36,59,Wednesday
2017,12,13,100,49,39,88,Wednesday
2017,12,12,2400,47,44,91,Tuesday
2017,12,12,2300,72,80,152,Tuesday
2017,12,12,2200,64,92,156,Tuesday
2017,12,12,2100,87,94,181,Tuesday
2017,12,12,2000,131,116,247,Tuesday
2017,12,12,1900,116,183,299,Tuesday
2017,12,12,1800,155,301,456,Tuesday
2017,12,12,1700,177,409,586,Tuesday
2017,12,12,1600,209,291,500,Tuesday
2017,12,12,1500,194,295,489,Tuesday
2017,12,12,1400,237,268,505,Tuesday
2017,12,12,1300,256,262,518,Tuesday
2017,12,12,1200,286,194,480,Tuesday
2017,12,12,1100,293,161,454,Tuesday
2017,12,12,1000,262,129,391,Tuesday
2017,12,12,900,248,122,370,Tuesday
2017,12,12,800,146,80,226,Tuesday
2017,12,12,700,68,42,110,Tuesday
2017,12,12,600,41,33,74,Tuesday
2017,12,12,500,17,18,35,Tuesday
2017,12,12,400,25,28,53,Tuesday
2017,12,12,300,24,32,56,Tuesday
2017,12,12,200,32,37,69,Tuesday
2017,12,12,100,30,64,94,Tuesday
2017,12,11,2400,47,48,95,Monday
2017,12,11,2300,55,68,123,Monday
2017,12,11,2200,78,89,167,Monday
2017,12,11,2100,98,101,199,Monday
2017,12,11,2000,122,113,235,Monday
2017,12,11,1900,121,190,311,Monday
2017,12,11,1800,155,304,459,Monday
2017,12,11,1700,210,398,608,Monday
2017,12,11,1600,222,345,567,Monday
2017,12,11,1500,258,305,563,Monday
2017,12,11,1400,238,222,460,Monday
2017,12,11,1300,268,218,486,Monday
2017,12,11,1200,284,192,476,Monday
2017,12,11,1100,317,150,467,Monday
2017,12,11,1000,277,129,406,Monday
2017,12,11,900,249,104,353,Monday
2017,12,11,800,145,59,204,Monday
2017,12,11,700,94,34,128,Monday
2017,12,11,600,30,20,50,Monday
2017,12,11,500,26,15,41,Monday
2017,12,11,400,19,30,49,Monday
2017,12,11,300,15,27,42,Monday
2017,12,11,200,27,30,57,Monday
2017,12,11,100,20,39,59,Monday
2017,12,10,2400,28,36,64,Sunday
2017,12,10,2300,38,88,126,Sunday
2017,12,10,2200,56,102,158,Sunday
2017,12,10,2100,86,159,245,Sunday
2017,12,10,2000,120,237,357,Sunday
2017,12,10,1900,131,363,494,Sunday
2017,12,10,1800,139,748,887,Sunday
2017,12,10,1700,224,1094,1318,Sunday
2017,12,10,1600,235,747,982,Sunday
2017,12,10,1500,235,653,888,Sunday
2017,12,10,1400,307,536,843,Sunday
2017,12,10,1300,349,477,826,Sunday
2017,12,10,1200,394,367,761,Sunday
2017,12,10,1100,353,247,600,Sunday
2017,12,10,1000,443,100,543,Sunday
2017,12,10,900,572,72,644,Sunday
2017,12,10,800,263,41,304,Sunday
2017,12,10,700,64,16,80,Sunday
2017,12,10,600,30,12,42,Sunday
2017,12,10,500,19,11,30,Sunday
2017,12,10,400,11,13,24,Sunday
2017,12,10,300,19,15,34,Sunday
2017,12,10,200,22,21,43,Sunday
2017,12,10,100,29,31,60,Sunday
2017,12,9,2400,30,35,65,Saturday
2017,12,9,2300,53,38,91,Saturday
2017,12,9,2200,60,60,120,Saturday
2017,12,9,2100,59,82,141,Saturday
2017,12,9,2000,87,123,210,Saturday
2017,12,9,1900,117,212,329,Saturday
2017,12,9,1800,133,515,648,Saturday
2017,12,9,1700,224,801,1025,Saturday
2017,12,9,1600,239,539,778,Saturday
2017,12,9,1500,289,465,754,Saturday
2017,12,9,1400,320,379,699,Saturday
2017,12,9,1300,348,297,645,Saturday
2017,12,9,1200,442,235,677,Saturday
2017,12,9,1100,426,172,598,Saturday
2017,12,9,1000,517,135,652,Saturday
2017,12,9,900,641,104,745,Saturday
2017,12,9,800,336,45,381,Saturday
2017,12,9,700,103,33,136,Saturday
2017,12,9,600,38,24,62,Saturday
2017,12,9,500,15,22,37,Saturday
2017,12,9,400,23,22,45,Saturday
2017,12,9,300,21,25,46,Saturday
2017,12,9,200,22,38,60,Saturday
2017,12,9,100,29,43,72,Saturday
2017,12,8,2400,61,45,106,Friday
2017,12,8,2300,77,61,138,Friday
2017,12,8,2200,108,92,200,Friday
2017,12,8,2100,185,92,277,Friday
2017,12,8,2000,288,155,443,Friday
2017,12,8,1900,308,214,522,Friday
2017,12,8,1800,371,460,831,Friday
2017,12,8,1700,433,538,971,Friday
2017,12,8,1600,416,404,820,Friday
2017,12,8,1500,414,329,743,Friday
2017,12,8,1400,356,266,622,Friday
2017,12,8,1300,369,211,580,Friday
2017,12,8,1200,338,196,534,Friday
2017,12,8,1100,389,162,551,Friday
2017,12,8,1000,373,122,495,Friday
2017,12,8,900,334,100,434,Friday
2017,12,8,800,228,61,289,Friday
2017,12,8,700,108,37,145,Friday
2017,12,8,600,43,28,71,Friday
2017,12,8,500,29,23,52,Friday
2017,12,8,400,24,30,54,Friday
2017,12,8,300,33,33,66,Friday
2017,12,8,200,25,54,79,Friday
2017,12,8,100,47,40,87,Friday
2017,12,7,2400,66,49,115,Thursday
2017,12,7,2300,89,63,152,Thursday
2017,12,7,2200,134,74,208,Thursday
2017,12,7,2100,153,102,255,Thursday
2017,12,7,2000,201,127,328,Thursday
2017,12,7,1900,188,178,366,Thursday
2017,12,7,1800,233,287,520,Thursday
2017,12,7,1700,240,343,583,Thursday
2017,12,7,1600,237,342,579,Thursday
2017,12,7,1500,252,276,528,Thursday
2017,12,7,1400,260,228,488,Thursday
2017,12,7,1300,264,196,460,Thursday
2017,12,7,1200,258,153,411,Thursday
2017,12,7,1100,249,170,419,Thursday
2017,12,7,1000,263,105,368,Thursday
2017,12,7,900,279,106,385,Thursday
2017,12,7,800,170,67,237,Thursday
2017,12,7,700,79,42,121,Thursday
2017,12,7,600,38,25,63,Thursday
2017,12,7,500,25,24,49,Thursday
2017,12,7,400,25,36,61,Thursday
2017,12,7,300,22,28,50,Thursday
2017,12,7,200,28,32,60,Thursday
2017,12,7,100,54,39,93,Thursday
2017,12,6,2400,59,76,135,Wednesday
2017,12,6,2300,80,71,151,Wednesday
2017,12,6,2200,89,83,172,Wednesday
2017,12,6,2100,104,80,184,Wednesday
2017,12,6,2000,124,109,233,Wednesday
2017,12,6,1900,132,192,324,Wednesday
2017,12,6,1800,137,281,418,Wednesday
2017,12,6,1700,209,411,620,Wednesday
2017,12,6,1600,218,305,523,Wednesday
2017,12,6,1500,204,274,478,Wednesday
2017,12,6,1400,221,213,434,Wednesday
2017,12,6,1300,244,217,461,Wednesday
2017,12,6,1200,253,182,435,Wednesday
2017,12,6,1100,250,168,418,Wednesday
2017,12,6,1000,254,118,372,Wednesday
2017,12,6,900,289,114,403,Wednesday
2017,12,6,800,181,72,253,Wednesday
2017,12,6,700,79,42,121,Wednesday
2017,12,6,600,36,32,68,Wednesday
2017,12,6,500,29,15,44,Wednesday
2017,12,6,400,30,24,54,Wednesday
2017,12,6,300,15,33,48,Wednesday
2017,12,6,200,30,33,63,Wednesday
2017,12,6,100,30,32,62,Wednesday
2017,12,5,2400,50,34,84,Tuesday
2017,12,5,2300,52,61,113,Tuesday
2017,12,5,2200,78,74,152,Tuesday
2017,12,5,2100,102,94,196,Tuesday
2017,12,5,2000,100,133,233,Tuesday
2017,12,5,1900,126,190,316,Tuesday
2017,12,5,1800,151,259,410,Tuesday
2017,12,5,1700,176,388,564,Tuesday
2017,12,5,1600,215,332,547,Tuesday
2017,12,5,1500,200,281,481,Tuesday
2017,12,5,1400,224,201,425,Tuesday
2017,12,5,1300,212,220,432,Tuesday
2017,12,5,1200,254,185,439,Tuesday
2017,12,5,1100,265,161,426,Tuesday
2017,12,5,1000,270,130,400,Tuesday
2017,12,5,900,215,88,303,Tuesday
2017,12,5,800,174,67,241,Tuesday
2017,12,5,700,73,44,117,Tuesday
2017,12,5,600,39,32,71,Tuesday
2017,12,5,500,16,24,40,Tuesday
2017,12,5,400,23,22,45,Tuesday
2017,12,5,300,25,33,58,Tuesday
2017,12,5,200,33,33,66,Tuesday
2017,12,5,100,25,43,68,Tuesday
2017,12,4,2400,51,54,105,Monday
2017,12,4,2300,56,74,130,Monday
2017,12,4,2200,65,73,138,Monday
2017,12,4,2100,82,88,170,Monday
2017,12,4,2000,126,114,240,Monday
2017,12,4,1900,129,186,315,Monday
2017,12,4,1800,160,282,442,Monday
2017,12,4,1700,196,332,528,Monday
2017,12,4,1600,202,358,560,Monday
2017,12,4,1500,203,258,461,Monday
2017,12,4,1400,221,243,464,Monday
2017,12,4,1300,236,204,440,Monday
2017,12,4,1200,252,160,412,Monday
2017,12,4,1100,277,152,429,Monday
2017,12,4,1000,287,114,401,Monday
2017,12,4,900,273,90,363,Monday
2017,12,4,800,150,57,207,Monday
2017,12,4,700,70,34,104,Monday
2017,12,4,600,30,29,59,Monday
2017,12,4,500,27,19,46,Monday
2017,12,4,400,20,23,43,Monday
2017,12,4,300,17,13,30,Monday
2017,12,4,200,24,38,62,Monday
2017,12,4,100,28,43,71,Monday
2017,12,3,2400,27,48,75,Sunday
2017,12,3,2300,46,85,131,Sunday
2017,12,3,2200,40,114,154,Sunday
2017,12,3,2100,65,201,266,Sunday
2017,12,3,2000,88,265,353,Sunday
2017,12,3,1900,111,432,543,Sunday
2017,12,3,1800,127,652,779,Sunday
2017,12,3,1700,176,1082,1258,Sunday
2017,12,3,1600,269,940,1209,Sunday
2017,12,3,1500,272,756,1028,Sunday
2017,12,3,1400,276,570,846,Sunday
2017,12,3,1300,362,375,737,Sunday
2017,12,3,1200,402,259,661,Sunday
2017,12,3,1100,494,179,673,Sunday
2017,12,3,1000,537,112,649,Sunday
2017,12,3,900,676,61,737,Sunday
2017,12,3,800,338,39,377,Sunday
2017,12,3,700,92,14,106,Sunday
2017,12,3,600,29,17,46,Sunday
2017,12,3,500,18,7,25,Sunday
2017,12,3,400,11,12,23,Sunday
2017,12,3,300,13,13,26,Sunday
2017,12,3,200,24,31,55,Sunday
2017,12,3,100,30,28,58,Sunday
2017,12,2,2400,35,37,72,Saturday
2017,12,2,2300,49,58,107,Saturday
2017,12,2,2200,57,62,119,Saturday
2017,12,2,2100,69,108,177,Saturday
2017,12,2,2000,97,122,219,Saturday
2017,12,2,1900,129,202,331,Saturday
2017,12,2,1800,160,387,547,Saturday
2017,12,2,1700,210,461,671,Saturday
2017,12,2,1600,201,455,656,Saturday
2017,12,2,1500,252,439,691,Saturday
2017,12,2,1400,289,316,605,Saturday
2017,12,2,1300,342,527,869,Saturday
2017,12,2,1200,410,863,1273,Saturday
2017,12,2,1100,465,202,667,Saturday
2017,12,2,1000,590,107,697,Saturday
2017,12,2,900,779,76,855,Saturday
2017,12,2,800,380,51,431,Saturday
2017,12,2,700,111,31,142,Saturday
2017,12,2,600,59,19,78,Saturday
2017,12,2,500,25,15,40,Saturday
2017,12,2,400,17,20,37,Saturday
2017,12,2,300,16,9,25,Saturday
2017,12,2,200,24,39,63,Saturday
2017,12,2,100,34,44,78,Saturday
2017,12,1,2400,63,49,112,Friday
2017,12,1,2300,68,63,131,Friday
2017,12,1,2200,122,82,204,Friday
2017,12,1,2100,159,89,248,Friday
2017,12,1,2000,295,127,422,Friday
2017,12,1,1900,302,188,490,Friday
2017,12,1,1800,306,306,612,Friday
2017,12,1,1700,349,487,836,Friday
2017,12,1,1600,370,415,785,Friday
2017,12,1,1500,363,485,848,Friday
2017,12,1,1400,314,237,551,Friday
2017,12,1,1300,335,173,508,Friday
2017,12,1,1200,383,212,595,Friday
2017,12,1,1100,323,171,494,Friday
2017,12,1,1000,352,121,473,Friday
2017,12,1,900,347,83,430,Friday
2017,12,1,800,223,63,286,Friday
2017,12,1,700,68,43,111,Friday
2017,12,1,600,37,22,59,Friday
2017,12,1,500,34,20,54,Friday
2017,12,1,400,35,38,73,Friday
2017,12,1,300,27,36,63,Friday
2017,12,1,200,31,45,76,Friday
2017,12,1,100,48,54,102,Friday
2017,11,30,2400,68,74,142,Thursday
2017,11,30,2300,104,91,195,Thursday
2017,11,30,2200,125,109,234,Thursday
2017,11,30,2100,94,99,193,Thursday
2017,11,30,2000,157,130,287,Thursday
2017,11,30,1900,179,185,364,Thursday
2017,11,30,1800,180,234,414,Thursday
2017,11,30,1700,224,323,547,Thursday
2017,11,30,1600,214,365,579,Thursday
2017,11,30,1500,218,248,466,Thursday
2017,11,30,1400,236,220,456,Thursday
2017,11,30,1300,238,203,441,Thursday
2017,11,30,1200,236,190,426,Thursday
2017,11,30,1100,289,151,440,Thursday
2017,11,30,1000,298,95,393,Thursday
2017,11,30,900,265,97,362,Thursday
2017,11,30,800,172,48,220,Thursday
2017,11,30,700,71,32,103,Thursday
2017,11,30,600,35,24,59,Thursday
2017,11,30,500,32,28,60,Thursday
2017,11,30,400,21,33,54,Thursday
2017,11,30,300,13,26,39,Thursday
2017,11,30,200,26,38,64,Thursday
2017,11,30,100,52,42,94,Thursday
2017,11,29,2400,67,74,141,Wednesday
2017,11,29,2300,65,102,167,Wednesday
2017,11,29,2200,86,107,193,Wednesday
2017,11,29,2100,131,97,228,Wednesday
2017,11,29,2000,135,120,255,Wednesday
2017,11,29,1900,127,171,298,Wednesday
2017,11,29,1800,208,255,463,Wednesday
2017,11,29,1700,221,367,588,Wednesday
2017,11,29,1600,205,328,533,Wednesday
2017,11,29,1500,210,301,511,Wednesday
2017,11,29,1400,227,252,479,Wednesday
2017,11,29,1300,202,188,390,Wednesday
2017,11,29,1200,267,177,444,Wednesday
2017,11,29,1100,240,119,359,Wednesday
2017,11,29,1000,278,107,385,Wednesday
2017,11,29,900,274,88,362,Wednesday
2017,11,29,800,178,49,227,Wednesday
2017,11,29,700,63,31,94,Wednesday
2017,11,29,600,26,21,47,Wednesday
2017,11,29,500,27,21,48,Wednesday
2017,11,29,400,26,33,59,Wednesday
2017,11,29,300,27,52,79,Wednesday
2017,11,29,200,29,32,61,Wednesday
2017,11,29,100,43,31,74,Wednesday
2017,11,28,2400,66,43,109,Tuesday
2017,11,28,2300,67,45,112,Tuesday
2017,11,28,2200,77,71,148,Tuesday
2017,11,28,2100,85,78,163,Tuesday
2017,11,28,2000,103,72,175,Tuesday
2017,11,28,1900,141,140,281,Tuesday
2017,11,28,1800,130,225,355,Tuesday
2017,11,28,1700,161,277,438,Tuesday
2017,11,28,1600,193,257,450,Tuesday
2017,11,28,1500,168,287,455,Tuesday
2017,11,28,1400,205,251,456,Tuesday
2017,11,28,1300,199,197,396,Tuesday
2017,11,28,1200,237,169,406,Tuesday
2017,11,28,1100,221,208,429,Tuesday
2017,11,28,1000,204,97,301,Tuesday
2017,11,28,900,203,99,302,Tuesday
2017,11,28,800,134,63,197,Tuesday
2017,11,28,700,60,121,181,Tuesday
2017,11,28,600,33,8,41,Tuesday
2017,11,28,500,23,2,25,Tuesday
2017,11,28,400,27,3,30,Tuesday
2017,11,28,300,17,50,67,Tuesday
2017,11,28,200,24,35,59,Tuesday
2017,11,28,100,41,11,52,Tuesday
2017,11,27,2400,40,25,65,Monday
2017,11,27,2300,57,54,111,Monday
2017,11,27,2200,78,105,183,Monday
2017,11,27,2100,82,82,164,Monday
2017,11,27,2000,99,89,188,Monday
2017,11,27,1900,104,142,246,Monday
2017,11,27,1800,164,265,429,Monday
2017,11,27,1700,203,353,556,Monday
2017,11,27,1600,225,326,551,Monday
2017,11,27,1500,243,294,537,Monday
2017,11,27,1400,212,269,481,Monday
2017,11,27,1300,266,223,489,Monday
2017,11,27,1200,298,170,468,Monday
2017,11,27,1100,290,164,454,Monday
2017,11,27,1000,229,130,359,Monday
2017,11,27,900,254,102,356,Monday
2017,11,27,800,141,50,191,Monday
2017,11,27,700,57,30,87,Monday
2017,11,27,600,30,18,48,Monday
2017,11,27,500,14,10,24,Monday
2017,11,27,400,16,23,39,Monday
2017,11,27,300,10,14,24,Monday
2017,11,27,200,24,27,51,Monday
2017,11,27,100,25,50,75,Monday
2017,11,26,2400,30,40,70,Sunday
2017,11,26,2300,52,76,128,Sunday
2017,11,26,2200,36,83,119,Sunday
2017,11,26,2100,72,129,201,Sunday
2017,11,26,2000,127,170,297,Sunday
2017,11,26,1900,106,284,390,Sunday
2017,11,26,1800,144,564,708,Sunday
2017,11,26,1700,180,807,987,Sunday
2017,11,26,1600,264,870,1134,Sunday
2017,11,26,1500,269,696,965,Sunday
2017,11,26,1400,281,530,811,Sunday
2017,11,26,1300,356,391,747,Sunday
2017,11,26,1200,407,311,718,Sunday
2017,11,26,1100,389,187,576,Sunday
2017,11,26,1000,420,160,580,Sunday
2017,11,26,900,491,69,560,Sunday
2017,11,26,800,233,43,276,Sunday
2017,11,26,700,74,16,90,Sunday
2017,11,26,600,30,10,40,Sunday
2017,11,26,500,15,10,25,Sunday
2017,11,26,400,17,14,31,Sunday
2017,11,26,300,19,15,34,Sunday
2017,11,26,200,17,18,35,Sunday
2017,11,26,100,18,34,52,Sunday
2017,11,25,2400,30,32,62,Saturday
2017,11,25,2300,37,46,83,Saturday
2017,11,25,2200,70,54,124,Saturday
2017,11,25,2100,67,129,196,Saturday
2017,11,25,2000,85,131,216,Saturday
2017,11,25,1900,107,241,348,Saturday
2017,11,25,1800,121,525,646,Saturday
2017,11,25,1700,182,841,1023,Saturday
2017,11,25,1600,220,675,895,Saturday
2017,11,25,1500,271,510,781,Saturday
2017,11,25,1400,287,334,621,Saturday
2017,11,25,1300,326,253,579,Saturday
2017,11,25,1200,503,213,716,Saturday
2017,11,25,1100,511,169,680,Saturday
2017,11,25,1000,641,127,768,Saturday
2017,11,25,900,688,111,799,Saturday
2017,11,25,800,328,54,382,Saturday
2017,11,25,700,75,36,111,Saturday
2017,11,25,600,41,28,69,Saturday
2017,11,25,500,23,13,36,Saturday
2017,11,25,400,21,14,35,Saturday
2017,11,25,300,16,25,41,Saturday
2017,11,25,200,26,35,61,Saturday
2017,11,25,100,27,29,56,Saturday
2017,11,24,2400,40,47,87,Friday
2017,11,24,2300,71,64,135,Friday
2017,11,24,2200,97,75,172,Friday
2017,11,24,2100,140,107,247,Friday
2017,11,24,2000,218,142,360,Friday
2017,11,24,1900,244,223,467,Friday
2017,11,24,1800,306,405,711,Friday
2017,11,24,1700,353,469,822,Friday
2017,11,24,1600,378,458,836,Friday
2017,11,24,1500,376,370,746,Friday
2017,11,24,1400,319,292,611,Friday
2017,11,24,1300,323,259,582,Friday
2017,11,24,1200,391,201,592,Friday
2017,11,24,1100,346,160,506,Friday
2017,11,24,1000,380,150,530,Friday
2017,11,24,900,344,99,443,Friday
2017,11,24,800,192,59,251,Friday
2017,11,24,700,76,41,117,Friday
2017,11,24,600,32,37,69,Friday
2017,11,24,500,24,28,52,Friday
2017,11,24,400,26,33,59,Friday
2017,11,24,300,33,30,63,Friday
2017,11,24,200,32,46,78,Friday
2017,11,24,100,40,56,96,Friday
2017,11,23,2400,71,59,130,Thursday
2017,11,23,2300,70,62,132,Thursday
2017,11,23,2200,87,63,150,Thursday
2017,11,23,2100,125,74,199,Thursday
2017,11,23,2000,140,122,262,Thursday
2017,11,23,1900,200,170,370,Thursday
2017,11,23,1800,241,254,495,Thursday
2017,11,23,1700,254,304,558,Thursday
2017,11,23,1600,289,349,638,Thursday
2017,11,23,1500,264,306,570,Thursday
2017,11,23,1400,230,243,473,Thursday
2017,11,23,1300,257,238,495,Thursday
2017,11,23,1200,277,208,485,Thursday
2017,11,23,1100,282,133,415,Thursday
2017,11,23,1000,282,151,433,Thursday
2017,11,23,900,223,101,324,Thursday
2017,11,23,800,135,61,196,Thursday
2017,11,23,700,78,41,119,Thursday
2017,11,23,600,37,25,62,Thursday
2017,11,23,500,23,16,39,Thursday
2017,11,23,400,26,33,59,Thursday
2017,11,23,300,21,27,48,Thursday
2017,11,23,200,24,30,54,Thursday
2017,11,23,100,38,63,101,Thursday
2017,11,22,2400,58,54,112,Wednesday
2017,11,22,2300,68,72,140,Wednesday
2017,11,22,2200,83,85,168,Wednesday
2017,11,22,2100,95,115,210,Wednesday
2017,11,22,2000,132,132,264,Wednesday
2017,11,22,1900,124,178,302,Wednesday
2017,11,22,1800,168,317,485,Wednesday
2017,11,22,1700,208,362,570,Wednesday
2017,11,22,1600,200,352,552,Wednesday
2017,11,22,1500,204,299,503,Wednesday
2017,11,22,1400,226,233,459,Wednesday
2017,11,22,1300,229,202,431,Wednesday
2017,11,22,1200,269,200,469,Wednesday
2017,11,22,1100,275,157,432,Wednesday
2017,11,22,1000,292,132,424,Wednesday
2017,11,22,900,250,110,360,Wednesday
2017,11,22,800,201,55,256,Wednesday
2017,11,22,700,82,33,115,Wednesday
2017,11,22,600,41,23,64,Wednesday
2017,11,22,500,33,21,54,Wednesday
2017,11,22,400,27,36,63,Wednesday
2017,11,22,300,31,29,60,Wednesday
2017,11,22,200,34,69,103,Wednesday
2017,11,22,100,41,26,67,Wednesday
2017,11,21,2400,51,37,88,Tuesday
2017,11,21,2300,48,53,101,Tuesday
2017,11,21,2200,69,76,145,Tuesday
2017,11,21,2100,78,72,150,Tuesday
2017,11,21,2000,101,110,211,Tuesday
2017,11,21,1900,133,131,264,Tuesday
2017,11,21,1800,136,241,377,Tuesday
2017,11,21,1700,186,321,507,Tuesday
2017,11,21,1600,198,316,514,Tuesday
2017,11,21,1500,193,274,467,Tuesday
2017,11,21,1400,229,264,493,Tuesday
2017,11,21,1300,220,247,467,Tuesday
2017,11,21,1200,266,186,452,Tuesday
2017,11,21,1100,287,165,452,Tuesday
2017,11,21,1000,254,130,384,Tuesday
2017,11,21,900,243,104,347,Tuesday
2017,11,21,800,157,65,222,Tuesday
2017,11,21,700,56,42,98,Tuesday
2017,11,21,600,27,41,68,Tuesday
2017,11,21,500,23,17,40,Tuesday
2017,11,21,400,14,41,55,Tuesday
2017,11,21,300,22,23,45,Tuesday
2017,11,21,200,28,26,54,Tuesday
2017,11,21,100,44,31,75,Tuesday
2017,11,20,2400,54,51,105,Monday
2017,11,20,2300,53,86,139,Monday
2017,11,20,2200,71,82,153,Monday
2017,11,20,2100,82,84,166,Monday
2017,11,20,2000,101,117,218,Monday
2017,11,20,1900,113,172,285,Monday
2017,11,20,1800,150,301,451,Monday
2017,11,20,1700,210,386,596,Monday
2017,11,20,1600,236,394,630,Monday
2017,11,20,1500,239,279,518,Monday
2017,11,20,1400,261,272,533,Monday
2017,11,20,1300,237,223,460,Monday
2017,11,20,1200,299,176,475,Monday
2017,11,20,1100,341,142,483,Monday
2017,11,20,1000,324,101,425,Monday
2017,11,20,900,355,104,459,Monday
2017,11,20,800,163,64,227,Monday
2017,11,20,700,57,36,93,Monday
2017,11,20,600,24,20,44,Monday
2017,11,20,500,14,17,31,Monday
2017,11,20,400,18,14,32,Monday
2017,11,20,300,14,41,55,Monday
2017,11,20,200,17,59,76,Monday
2017,11,20,100,36,30,66,Monday
2017,11,19,2400,34,54,88,Sunday
2017,11,19,2300,50,64,114,Sunday
2017,11,19,2200,59,46,105,Sunday
2017,11,19,2100,73,126,199,Sunday
2017,11,19,2000,100,155,255,Sunday
2017,11,19,1900,122,265,387,Sunday
2017,11,19,1800,150,461,611,Sunday
2017,11,19,1700,171,684,855,Sunday
2017,11,19,1600,215,609,824,Sunday
2017,11,19,1500,259,575,834,Sunday
2017,11,19,1400,295,505,800,Sunday
2017,11,19,1300,319,431,750,Sunday
2017,11,19,1200,381,314,695,Sunday
2017,11,19,1100,356,166,522,Sunday
2017,11,19,1000,379,130,509,Sunday
2017,11,19,900,422,63,485,Sunday
2017,11,19,800,184,35,219,Sunday
2017,11,19,700,66,18,84,Sunday
2017,11,19,600,20,10,30,Sunday
2017,11,19,500,19,14,33,Sunday
2017,11,19,400,23,9,32,Sunday
2017,11,19,300,11,18,29,Sunday
2017,11,19,200,15,30,45,Sunday
2017,11,19,100,28,23,51,Sunday
2017,11,18,2400,28,43,71,Saturday
2017,11,18,2300,43,48,91,Saturday
2017,11,18,2200,66,66,132,Saturday
2017,11,18,2100,80,87,167,Saturday
2017,11,18,2000,107,115,222,Saturday
2017,11,18,1900,117,167,284,Saturday
2017,11,18,1800,113,433,546,Saturday
2017,11,18,1700,185,641,826,Saturday
2017,11,18,1600,235,503,738,Saturday
2017,11,18,1500,275,487,762,Saturday
2017,11,18,1400,290,343,633,Saturday
2017,11,18,1300,324,329,653,Saturday
2017,11,18,1200,378,223,601,Saturday
2017,11,18,1100,397,178,575,Saturday
2017,11,18,1000,437,120,557,Saturday
2017,11,18,900,503,104,607,Saturday
2017,11,18,800,218,57,275,Saturday
2017,11,18,700,74,42,116,Saturday
2017,11,18,600,26,15,41,Saturday
2017,11,18,500,21,20,41,Saturday
2017,11,18,400,12,22,34,Saturday
2017,11,18,300,21,25,46,Saturday
2017,11,18,200,29,18,47,Saturday
2017,11,18,100,29,51,80,Saturday
2017,11,17,2400,42,48,90,Friday
2017,11,17,2300,57,56,113,Friday
2017,11,17,2200,92,101,193,Friday
2017,11,17,2100,144,99,243,Friday
2017,11,17,2000,192,119,311,Friday
2017,11,17,1900,224,193,417,Friday
2017,11,17,1800,254,296,550,Friday
2017,11,17,1700,310,341,651,Friday
2017,11,17,1600,324,396,720,Friday
2017,11,17,1500,334,329,663,Friday
2017,11,17,1400,329,272,601,Friday
2017,11,17,1300,320,212,532,Friday
2017,11,17,1200,317,164,481,Friday
2017,11,17,1100,339,152,491,Friday
2017,11,17,1000,288,120,408,Friday
2017,11,17,900,270,100,370,Friday
2017,11,17,800,159,58,217,Friday
2017,11,17,700,89,28,117,Friday
2017,11,17,600,28,37,65,Friday
2017,11,17,500,33,32,65,Friday
2017,11,17,400,29,28,57,Friday
2017,11,17,300,22,35,57,Friday
2017,11,17,200,33,56,89,Friday
2017,11,17,100,45,66,111,Friday
2017,11,16,2400,58,73,131,Thursday
2017,11,16,2300,69,91,160,Thursday
2017,11,16,2200,79,114,193,Thursday
2017,11,16,2100,112,106,218,Thursday
2017,11,16,2000,139,138,277,Thursday
2017,11,16,1900,136,162,298,Thursday
2017,11,16,1800,175,272,447,Thursday
2017,11,16,1700,208,310,518,Thursday
2017,11,16,1600,249,303,552,Thursday
2017,11,16,1500,226,285,511,Thursday
2017,11,16,1400,258,274,532,Thursday
2017,11,16,1300,224,200,424,Thursday
2017,11,16,1200,259,218,477,Thursday
2017,11,16,1100,223,112,335,Thursday
2017,11,16,1000,211,118,329,Thursday
2017,11,16,900,211,86,297,Thursday
2017,11,16,800,121,55,176,Thursday
2017,11,16,700,84,51,135,Thursday
2017,11,16,600,31,50,81,Thursday
2017,11,16,500,31,30,61,Thursday
2017,11,16,400,33,26,59,Thursday
2017,11,16,300,23,39,62,Thursday
2017,11,16,200,25,34,59,Thursday
2017,11,16,100,51,52,103,Thursday
2017,11,15,2400,53,47,100,Wednesday
2017,11,15,2300,57,65,122,Wednesday
2017,11,15,2200,81,70,151,Wednesday
2017,11,15,2100,98,98,196,Wednesday
2017,11,15,2000,120,110,230,Wednesday
2017,11,15,1900,116,168,284,Wednesday
2017,11,15,1800,153,256,409,Wednesday
2017,11,15,1700,185,309,494,Wednesday
2017,11,15,1600,206,298,504,Wednesday
2017,11,15,1500,215,289,504,Wednesday
2017,11,15,1400,213,259,472,Wednesday
2017,11,15,1300,229,205,434,Wednesday
2017,11,15,1200,233,147,380,Wednesday
2017,11,15,1100,261,158,419,Wednesday
2017,11,15,1000,237,128,365,Wednesday
2017,11,15,900,184,107,291,Wednesday
2017,11,15,800,169,71,240,Wednesday
2017,11,15,700,54,33,87,Wednesday
2017,11,15,600,33,33,66,Wednesday
2017,11,15,500,25,19,44,Wednesday
2017,11,15,400,28,34,62,Wednesday
2017,11,15,300,26,22,48,Wednesday
2017,11,15,200,34,28,62,Wednesday
2017,11,15,100,32,57,89,Wednesday
2017,11,14,2400,62,49,111,Tuesday
2017,11,14,2300,61,49,110,Tuesday
2017,11,14,2200,76,67,143,Tuesday
2017,11,14,2100,82,98,180,Tuesday
2017,11,14,2000,115,117,232,Tuesday
2017,11,14,1900,103,191,294,Tuesday
2017,11,14,1800,143,275,418,Tuesday
2017,11,14,1700,182,371,553,Tuesday
2017,11,14,1600,194,287,481,Tuesday
2017,11,14,1500,193,288,481,Tuesday
2017,11,14,1400,238,259,497,Tuesday
2017,11,14,1300,257,200,457,Tuesday
2017,11,14,1200,270,196,466,Tuesday
2017,11,14,1100,297,139,436,Tuesday
2017,11,14,1000,267,114,381,Tuesday
2017,11,14,900,198,79,277,Tuesday
2017,11,14,800,138,55,193,Tuesday
2017,11,14,700,56,33,89,Tuesday
2017,11,14,600,15,23,38,Tuesday
2017,11,14,500,23,26,49,Tuesday
2017,11,14,400,16,30,46,Tuesday
2017,11,14,300,26,71,97,Tuesday
2017,11,14,200,21,25,46,Tuesday
2017,11,14,100,22,23,45,Tuesday
2017,11,13,2400,36,61,97,Monday
2017,11,13,2300,40,105,145,Monday
2017,11,13,2200,70,89,159,Monday
2017,11,13,2100,71,131,202,Monday
2017,11,13,2000,113,211,324,Monday
2017,11,13,1900,95,271,366,Monday
2017,11,13,1800,162,402,564,Monday
2017,11,13,1700,240,543,783,Monday
2017,11,13,1600,263,635,898,Monday
2017,11,13,1500,284,576,860,Monday
2017,11,13,1400,361,484,845,Monday
2017,11,13,1300,370,433,803,Monday
2017,11,13,1200,434,365,799,Monday
2017,11,13,1100,412,229,641,Monday
2017,11,13,1000,407,119,526,Monday
2017,11,13,900,312,75,387,Monday
2017,11,13,800,152,46,198,Monday
2017,11,13,700,82,24,106,Monday
2017,11,13,600,27,22,49,Monday
2017,11,13,500,20,21,41,Monday
2017,11,13,400,12,20,32,Monday
2017,11,13,300,10,18,28,Monday
2017,11,13,200,22,21,43,Monday
2017,11,13,100,19,44,63,Monday
2017,11,12,2400,31,51,82,Sunday
2017,11,12,2300,43,72,115,Sunday
2017,11,12,2200,59,87,146,Sunday
2017,11,12,2100,79,149,228,Sunday
2017,11,12,2000,115,213,328,Sunday
2017,11,12,1900,147,291,438,Sunday
2017,11,12,1800,165,626,791,Sunday
2017,11,12,1700,230,903,1133,Sunday
2017,11,12,1600,245,897,1142,Sunday
2017,11,12,1500,335,719,1054,Sunday
2017,11,12,1400,370,579,949,Sunday
2017,11,12,1300,429,466,895,Sunday
2017,11,12,1200,471,369,840,Sunday
2017,11,12,1100,443,178,621,Sunday
2017,11,12,1000,387,112,499,Sunday
2017,11,12,900,367,57,424,Sunday
2017,11,12,800,146,33,179,Sunday
2017,11,12,700,64,14,78,Sunday
2017,11,12,600,23,7,30,Sunday
2017,11,12,500,13,7,20,Sunday
2017,11,12,400,19,18,37,Sunday
2017,11,12,300,22,25,47,Sunday
2017,11,12,200,17,24,41,Sunday
2017,11,12,100,26,28,54,Sunday
2017,11,11,2400,33,40,73,Saturday
2017,11,11,2300,45,49,94,Saturday
2017,11,11,2200,57,73,130,Saturday
2017,11,11,2100,77,66,143,Saturday
2017,11,11,2000,86,123,209,Saturday
2017,11,11,1900,125,235,360,Saturday
2017,11,11,1800,176,485,661,Saturday
2017,11,11,1700,236,721,957,Saturday
2017,11,11,1600,271,602,873,Saturday
2017,11,11,1500,321,499,820,Saturday
2017,11,11,1400,421,388,809,Saturday
2017,11,11,1300,464,335,799,Saturday
2017,11,11,1200,519,240,759,Saturday
2017,11,11,1100,529,181,710,Saturday
2017,11,11,1000,524,122,646,Saturday
2017,11,11,900,539,83,622,Saturday
2017,11,11,800,210,33,243,Saturday
2017,11,11,700,69,26,95,Saturday
2017,11,11,600,30,25,55,Saturday
2017,11,11,500,24,36,60,Saturday
2017,11,11,400,21,28,49,Saturday
2017,11,11,300,15,15,30,Saturday
2017,11,11,200,21,47,68,Saturday
2017,11,11,100,43,39,82,Saturday
2017,11,10,2400,42,64,106,Friday
2017,11,10,2300,76,79,155,Friday
2017,11,10,2200,122,104,226,Friday
2017,11,10,2100,214,118,332,Friday
2017,11,10,2000,261,144,405,Friday
2017,11,10,1900,388,225,613,Friday
2017,11,10,1800,388,352,740,Friday
2017,11,10,1700,408,514,922,Friday
2017,11,10,1600,472,468,940,Friday
2017,11,10,1500,427,397,824,Friday
2017,11,10,1400,459,271,730,Friday
2017,11,10,1300,425,266,691,Friday
2017,11,10,1200,423,228,651,Friday
2017,11,10,1100,477,176,653,Friday
2017,11,10,1000,377,152,529,Friday
2017,11,10,900,369,84,453,Friday
2017,11,10,800,185,68,253,Friday
2017,11,10,700,89,33,122,Friday
2017,11,10,600,52,14,66,Friday
2017,11,10,500,27,26,53,Friday
2017,11,10,400,34,21,55,Friday
2017,11,10,300,30,27,57,Friday
2017,11,10,200,34,33,67,Friday
2017,11,10,100,48,53,101,Friday
2017,11,9,2400,66,68,134,Thursday
2017,11,9,2300,76,73,149,Thursday
2017,11,9,2200,97,102,199,Thursday
2017,11,9,2100,136,105,241,Thursday
2017,11,9,2000,166,127,293,Thursday
2017,11,9,1900,184,187,371,Thursday
2017,11,9,1800,214,252,466,Thursday
2017,11,9,1700,233,281,514,Thursday
2017,11,9,1600,295,296,591,Thursday
2017,11,9,1500,303,290,593,Thursday
2017,11,9,1400,265,254,519,Thursday
2017,11,9,1300,273,364,637,Thursday
2017,11,9,1200,271,213,484,Thursday
2017,11,9,1100,284,143,427,Thursday
2017,11,9,1000,278,141,419,Thursday
2017,11,9,900,186,103,289,Thursday
2017,11,9,800,140,57,197,Thursday
2017,11,9,700,70,41,111,Thursday
2017,11,9,600,34,39,73,Thursday
2017,11,9,500,27,24,51,Thursday
2017,11,9,400,27,27,54,Thursday
2017,11,9,300,26,37,63,Thursday
2017,11,9,200,28,41,69,Thursday
2017,11,9,100,38,59,97,Thursday
2017,11,8,2400,54,52,106,Wednesday
2017,11,8,2300,64,78,142,Wednesday
2017,11,8,2200,77,93,170,Wednesday
2017,11,8,2100,95,113,208,Wednesday
2017,11,8,2000,108,142,250,Wednesday
2017,11,8,1900,117,157,274,Wednesday
2017,11,8,1800,159,228,387,Wednesday
2017,11,8,1700,186,273,459,Wednesday
2017,11,8,1600,215,263,478,Wednesday
2017,11,8,1500,232,307,539,Wednesday
2017,11,8,1400,238,252,490,Wednesday
2017,11,8,1300,264,222,486,Wednesday
2017,11,8,1200,266,169,435,Wednesday
2017,11,8,1100,252,136,388,Wednesday
2017,11,8,1000,212,120,332,Wednesday
2017,11,8,900,201,84,285,Wednesday
2017,11,8,800,154,62,216,Wednesday
2017,11,8,700,62,48,110,Wednesday
2017,11,8,600,37,28,65,Wednesday
2017,11,8,500,18,21,39,Wednesday
2017,11,8,400,29,27,56,Wednesday
2017,11,8,300,31,39,70,Wednesday
2017,11,8,200,33,43,76,Wednesday
2017,11,8,100,41,37,78,Wednesday
2017,11,7,2400,48,58,106,Tuesday
2017,11,7,2300,62,68,130,Tuesday
2017,11,7,2200,79,70,149,Tuesday
2017,11,7,2100,80,97,177,Tuesday
2017,11,7,2000,99,132,231,Tuesday
2017,11,7,1900,110,179,289,Tuesday
2017,11,7,1800,145,223,368,Tuesday
2017,11,7,1700,184,255,439,Tuesday
2017,11,7,1600,183,268,451,Tuesday
2017,11,7,1500,176,305,481,Tuesday
2017,11,7,1400,229,287,516,Tuesday
2017,11,7,1300,215,186,401,Tuesday
2017,11,7,1200,256,177,433,Tuesday
2017,11,7,1100,242,155,397,Tuesday
2017,11,7,1000,229,128,357,Tuesday
2017,11,7,900,209,83,292,Tuesday
2017,11,7,800,129,71,200,Tuesday
2017,11,7,700,66,46,112,Tuesday
2017,11,7,600,26,39,65,Tuesday
2017,11,7,500,26,26,52,Tuesday
2017,11,7,400,24,34,58,Tuesday
2017,11,7,300,22,22,44,Tuesday
2017,11,7,200,34,31,65,Tuesday
2017,11,7,100,24,52,76,Tuesday
2017,11,6,2400,58,44,102,Monday
2017,11,6,2300,59,73,132,Monday
2017,11,6,2200,72,63,135,Monday
2017,11,6,2100,96,78,174,Monday
2017,11,6,2000,94,140,234,Monday
2017,11,6,1900,127,197,324,Monday
2017,11,6,1800,149,264,413,Monday
2017,11,6,1700,197,297,494,Monday
2017,11,6,1600,252,269,521,Monday
2017,11,6,1500,297,305,602,Monday
2017,11,6,1400,288,242,530,Monday
2017,11,6,1300,284,167,451,Monday
2017,11,6,1200,302,162,464,Monday
2017,11,6,1100,317,130,447,Monday
2017,11,6,1000,245,114,359,Monday
2017,11,6,900,175,72,247,Monday
2017,11,6,800,126,48,174,Monday
2017,11,6,700,57,33,90,Monday
2017,11,6,600,42,19,61,Monday
2017,11,6,500,15,16,31,Monday
2017,11,6,400,26,11,37,Monday
2017,11,6,300,22,25,47,Monday
2017,11,6,200,13,36,49,Monday
2017,11,6,100,19,32,51,Monday
2017,11,5,2400,32,38,70,Sunday
2017,11,5,2300,52,60,112,Sunday
2017,11,5,2200,58,95,153,Sunday
2017,11,5,2100,71,122,193,Sunday
2017,11,5,2000,89,165,254,Sunday
2017,11,5,1900,117,237,354,Sunday
2017,11,5,1800,132,309,441,Sunday
2017,11,5,1700,184,507,691,Sunday
2017,11,5,1600,211,428,639,Sunday
2017,11,5,1500,253,452,705,Sunday
2017,11,5,1400,250,451,701,Sunday
2017,11,5,1300,306,437,743,Sunday
2017,11,5,1200,303,269,572,Sunday
2017,11,5,1100,262,189,451,Sunday
2017,11,5,1000,234,127,361,Sunday
2017,11,5,900,145,59,204,Sunday
2017,11,5,800,77,31,108,Sunday
2017,11,5,700,42,25,67,Sunday
2017,11,5,600,21,8,29,Sunday
2017,11,5,500,15,10,25,Sunday
2017,11,5,400,17,17,34,Sunday
2017,11,5,300,12,22,34,Sunday
2017,11,5,200,14,15,29,Sunday
2017,11,5,100,27,35,62,Sunday
2017,11,4,2400,37,53,90,Saturday
2017,11,4,2300,42,75,117,Saturday
2017,11,4,2200,56,75,131,Saturday
2017,11,4,2100,72,84,156,Saturday
2017,11,4,2000,69,115,184,Saturday
2017,11,4,1900,88,168,256,Saturday
2017,11,4,1800,141,237,378,Saturday
2017,11,4,1700,156,330,486,Saturday
2017,11,4,1600,220,330,550,Saturday
2017,11,4,1500,212,265,477,Saturday
2017,11,4,1400,258,250,508,Saturday
2017,11,4,1300,274,218,492,Saturday
2017,11,4,1200,304,194,498,Saturday
2017,11,4,1100,235,124,359,Saturday
2017,11,4,1000,179,118,297,Saturday
2017,11,4,900,136,78,214,Saturday
2017,11,4,800,110,51,161,Saturday
2017,11,4,700,60,18,78,Saturday
2017,11,4,600,23,25,48,Saturday
2017,11,4,500,21,19,40,Saturday
2017,11,4,400,14,18,32,Saturday
2017,11,4,300,17,28,45,Saturday
2017,11,4,200,33,21,54,Saturday
2017,11,4,100,40,45,85,Saturday
2017,11,3,2400,42,44,86,Friday
2017,11,3,2300,59,77,136,Friday
2017,11,3,2200,99,73,172,Friday
2017,11,3,2100,105,114,219,Friday
2017,11,3,2000,190,153,343,Friday
2017,11,3,1900,177,219,396,Friday
2017,11,3,1800,266,262,528,Friday
2017,11,3,1700,307,280,587,Friday
2017,11,3,1600,306,261,567,Friday
2017,11,3,1500,294,233,527,Friday
2017,11,3,1400,321,169,490,Friday
2017,11,3,1300,308,168,476,Friday
2017,11,3,1200,246,156,402,Friday
2017,11,3,1100,224,129,353,Friday
2017,11,3,1000,135,87,222,Friday
2017,11,3,900,118,59,177,Friday
2017,11,3,800,92,41,133,Friday
2017,11,3,700,47,24,71,Friday
2017,11,3,600,27,14,41,Friday
2017,11,3,500,21,8,29,Friday
2017,11,3,400,26,21,47,Friday
2017,11,3,300,40,13,53,Friday
2017,11,3,200,33,31,64,Friday
2017,11,3,100,40,41,81,Friday
2017,11,2,2400,54,32,86,Thursday
2017,11,2,2300,78,72,150,Thursday
2017,11,2,2200,71,77,148,Thursday
2017,11,2,2100,106,117,223,Thursday
2017,11,2,2000,106,134,240,Thursday
2017,11,2,1900,139,174,313,Thursday
2017,11,2,1800,153,243,396,Thursday
2017,11,2,1700,177,238,415,Thursday
2017,11,2,1600,212,236,448,Thursday
2017,11,2,1500,197,182,379,Thursday
2017,11,2,1400,217,152,369,Thursday
2017,11,2,1300,213,215,428,Thursday
2017,11,2,1200,243,154,397,Thursday
2017,11,2,1100,201,139,340,Thursday
2017,11,2,1000,189,103,292,Thursday
2017,11,2,900,132,84,216,Thursday
2017,11,2,800,99,67,166,Thursday
2017,11,2,700,47,33,80,Thursday
2017,11,2,600,30,23,53,Thursday
2017,11,2,500,20,24,44,Thursday
2017,11,2,400,35,36,71,Thursday
2017,11,2,300,33,33,66,Thursday
2017,11,2,200,31,65,96,Thursday
2017,11,2,100,35,45,80,Thursday
2017,11,1,2400,46,67,113,Wednesday
2017,11,1,2300,69,69,138,Wednesday
2017,11,1,2200,74,94,168,Wednesday
2017,11,1,2100,101,110,211,Wednesday
2017,11,1,2000,127,158,285,Wednesday
2017,11,1,1900,140,216,356,Wednesday
2017,11,1,1800,142,248,390,Wednesday
2017,11,1,1700,193,268,461,Wednesday
2017,11,1,1600,212,272,484,Wednesday
2017,11,1,1500,195,248,443,Wednesday
2017,11,1,1400,240,236,476,Wednesday
2017,11,1,1300,280,252,532,Wednesday
2017,11,1,1200,263,181,444,Wednesday
2017,11,1,1100,221,154,375,Wednesday
2017,11,1,1000,182,118,300,Wednesday
2017,11,1,900,149,101,250,Wednesday
2017,11,1,800,86,80,166,Wednesday
2017,11,1,700,62,44,106,Wednesday
2017,11,1,600,32,38,70,Wednesday
2017,11,1,500,23,12,35,Wednesday
2017,11,1,400,20,16,36,Wednesday
2017,11,1,300,24,29,53,Wednesday
2017,11,1,200,36,68,104,Wednesday
2017,11,1,100,53,45,98,Wednesday
2017,10,31,2400,61,61,122,Tuesday
2017,10,31,2300,48,108,156,Tuesday
2017,10,31,2200,88,127,215,Tuesday
2017,10,31,2100,82,137,219,Tuesday
2017,10,31,2000,97,145,242,Tuesday
2017,10,31,1900,110,182,292,Tuesday
2017,10,31,1800,137,253,390,Tuesday
2017,10,31,1700,175,217,392,Tuesday
2017,10,31,1600,202,256,458,Tuesday
2017,10,31,1500,229,311,540,Tuesday
2017,10,31,1400,232,235,467,Tuesday
2017,10,31,1300,222,225,447,Tuesday
2017,10,31,1200,250,209,459,Tuesday
2017,10,31,1100,236,188,424,Tuesday
2017,10,31,1000,202,154,356,Tuesday
2017,10,31,900,181,87,268,Tuesday
2017,10,31,800,155,88,243,Tuesday
2017,10,31,700,80,56,136,Tuesday
2017,10,31,600,35,35,70,Tuesday
2017,10,31,500,22,25,47,Tuesday
2017,10,31,400,28,47,75,Tuesday
2017,10,31,300,33,48,81,Tuesday
2017,10,31,200,31,41,72,Tuesday
2017,10,31,100,48,64,112,Tuesday
2017,10,30,2400,67,56,123,Monday
2017,10,30,2300,72,94,166,Monday
2017,10,30,2200,77,89,166,Monday
2017,10,30,2100,100,126,226,Monday
2017,10,30,2000,135,190,325,Monday
2017,10,30,1900,144,273,417,Monday
2017,10,30,1800,183,352,535,Monday
2017,10,30,1700,212,339,551,Monday
2017,10,30,1600,247,334,581,Monday
2017,10,30,1500,287,318,605,Monday
2017,10,30,1400,327,243,570,Monday
2017,10,30,1300,292,255,547,Monday
2017,10,30,1200,362,206,568,Monday
2017,10,30,1100,336,160,496,Monday
2017,10,30,1000,239,103,342,Monday
2017,10,30,900,180,106,286,Monday
2017,10,30,800,133,59,192,Monday
2017,10,30,700,80,39,119,Monday
2017,10,30,600,31,26,57,Monday
2017,10,30,500,22,17,39,Monday
2017,10,30,400,18,23,41,Monday
2017,10,30,300,29,26,55,Monday
2017,10,30,200,29,39,68,Monday
2017,10,30,100,29,53,82,Monday
2017,10,29,2400,33,76,109,Sunday
2017,10,29,2300,62,89,151,Sunday
2017,10,29,2200,58,155,213,Sunday
2017,10,29,2100,109,216,325,Sunday
2017,10,29,2000,131,233,364,Sunday
2017,10,29,1900,145,387,532,Sunday
2017,10,29,1800,208,583,791,Sunday
2017,10,29,1700,243,615,858,Sunday
2017,10,29,1600,302,615,917,Sunday
2017,10,29,1500,326,599,925,Sunday
2017,10,29,1400,350,471,821,Sunday
2017,10,29,1300,422,453,875,Sunday
2017,10,29,1200,408,348,756,Sunday
2017,10,29,1100,327,226,553,Sunday
2017,10,29,1000,267,118,385,Sunday
2017,10,29,900,174,89,263,Sunday
2017,10,29,800,112,39,151,Sunday
2017,10,29,700,57,26,83,Sunday
2017,10,29,600,27,12,39,Sunday
2017,10,29,500,10,14,24,Sunday
2017,10,29,400,18,10,28,Sunday
2017,10,29,300,16,33,49,Sunday
2017,10,29,200,17,38,55,Sunday
2017,10,29,100,31,38,69,Sunday
2017,10,28,2400,32,59,91,Saturday
2017,10,28,2300,57,86,143,Saturday
2017,10,28,2200,83,120,203,Saturday
2017,10,28,2100,94,144,238,Saturday
2017,10,28,2000,112,219,331,Saturday
2017,10,28,1900,148,373,521,Saturday
2017,10,28,1800,176,531,707,Saturday
2017,10,28,1700,232,490,722,Saturday
2017,10,28,1600,299,553,852,Saturday
2017,10,28,1500,335,474,809,Saturday
2017,10,28,1400,409,379,788,Saturday
2017,10,28,1300,459,288,747,Saturday
2017,10,28,1200,573,274,847,Saturday
2017,10,28,1100,472,201,673,Saturday
2017,10,28,1000,350,148,498,Saturday
2017,10,28,900,248,99,347,Saturday
2017,10,28,800,151,64,215,Saturday
2017,10,28,700,60,42,102,Saturday
2017,10,28,600,42,35,77,Saturday
2017,10,28,500,24,27,51,Saturday
2017,10,28,400,28,26,54,Saturday
2017,10,28,300,16,30,46,Saturday
2017,10,28,200,33,42,75,Saturday
2017,10,28,100,47,60,107,Saturday
2017,10,27,2400,61,53,114,Friday
2017,10,27,2300,61,125,186,Friday
2017,10,27,2200,119,134,253,Friday
2017,10,27,2100,161,150,311,Friday
2017,10,27,2000,220,212,432,Friday
2017,10,27,1900,340,325,665,Friday
2017,10,27,1800,347,398,745,Friday
2017,10,27,1700,369,436,805,Friday
2017,10,27,1600,400,424,824,Friday
2017,10,27,1500,431,409,840,Friday
2017,10,27,1400,377,327,704,Friday
2017,10,27,1300,429,292,721,Friday
2017,10,27,1200,449,238,687,Friday
2017,10,27,1100,407,184,591,Friday
2017,10,27,1000,327,143,470,Friday
2017,10,27,900,230,115,345,Friday
2017,10,27,800,165,68,233,Friday
2017,10,27,700,87,53,140,Friday
2017,10,27,600,44,46,90,Friday
2017,10,27,500,22,30,52,Friday
2017,10,27,400,37,43,80,Friday
2017,10,27,300,27,35,62,Friday
2017,10,27,200,32,34,66,Friday
2017,10,27,100,39,45,84,Friday
2017,10,26,2400,75,67,142,Thursday
2017,10,26,2300,71,104,175,Thursday
2017,10,26,2200,109,139,248,Thursday
2017,10,26,2100,112,147,259,Thursday
2017,10,26,2000,177,237,414,Thursday
2017,10,26,1900,198,287,485,Thursday
2017,10,26,1800,241,376,617,Thursday
2017,10,26,1700,279,333,612,Thursday
2017,10,26,1600,281,356,637,Thursday
2017,10,26,1500,318,294,612,Thursday
2017,10,26,1400,350,268,618,Thursday
2017,10,26,1300,329,238,567,Thursday
2017,10,26,1200,356,187,543,Thursday
2017,10,26,1100,360,167,527,Thursday
2017,10,26,1000,235,130,365,Thursday
2017,10,26,900,212,114,326,Thursday
2017,10,26,800,169,52,221,Thursday
2017,10,26,700,79,45,124,Thursday
2017,10,26,600,51,33,84,Thursday
2017,10,26,500,25,31,56,Thursday
2017,10,26,400,24,37,61,Thursday
2017,10,26,300,32,33,65,Thursday
2017,10,26,200,43,27,70,Thursday
2017,10,26,100,37,70,107,Thursday
2017,10,25,2400,56,62,118,Wednesday
2017,10,25,2300,69,75,144,Wednesday
2017,10,25,2200,88,108,196,Wednesday
2017,10,25,2100,108,127,235,Wednesday
2017,10,25,2000,144,207,351,Wednesday
2017,10,25,1900,183,287,470,Wednesday
2017,10,25,1800,178,464,642,Wednesday
2017,10,25,1700,220,457,677,Wednesday
2017,10,25,1600,238,187,425,Wednesday
2017,10,25,1500,239,220,459,Wednesday
2017,10,25,1400,242,260,502,Wednesday
2017,10,25,1300,230,275,505,Wednesday
2017,10,25,1200,312,144,456,Wednesday
2017,10,25,1100,272,113,385,Wednesday
2017,10,25,1000,199,89,288,Wednesday
2017,10,25,900,185,84,269,Wednesday
2017,10,25,800,134,44,178,Wednesday
2017,10,25,700,67,30,97,Wednesday
2017,10,25,600,35,10,45,Wednesday
2017,10,25,500,30,8,38,Wednesday
2017,10,25,400,20,10,30,Wednesday
2017,10,25,300,32,6,38,Wednesday
2017,10,25,200,31,10,41,Wednesday
2017,10,25,100,43,8,51,Wednesday
2017,10,24,2400,74,34,108,Tuesday
2017,10,24,2300,61,73,134,Tuesday
2017,10,24,2200,87,105,192,Tuesday
2017,10,24,2100,96,173,269,Tuesday
2017,10,24,2000,104,195,299,Tuesday
2017,10,24,1900,136,266,402,Tuesday
2017,10,24,1800,194,327,521,Tuesday
2017,10,24,1700,228,393,621,Tuesday
2017,10,24,1600,233,361,594,Tuesday
2017,10,24,1500,260,316,576,Tuesday
2017,10,24,1400,274,266,540,Tuesday
2017,10,24,1300,307,259,566,Tuesday
2017,10,24,1200,363,188,551,Tuesday
2017,10,24,1100,329,173,502,Tuesday
2017,10,24,1000,271,147,418,Tuesday
2017,10,24,900,233,115,348,Tuesday
2017,10,24,800,142,63,205,Tuesday
2017,10,24,700,77,55,132,Tuesday
2017,10,24,600,29,30,59,Tuesday
2017,10,24,500,23,40,63,Tuesday
2017,10,24,400,25,47,72,Tuesday
2017,10,24,300,27,44,71,Tuesday
2017,10,24,200,41,37,78,Tuesday
2017,10,24,100,40,49,89,Tuesday
2017,10,23,2400,60,63,123,Monday
2017,10,23,2300,64,92,156,Monday
2017,10,23,2200,78,114,192,Monday
2017,10,23,2100,103,137,240,Monday
2017,10,23,2000,136,202,338,Monday
2017,10,23,1900,177,320,497,Monday
2017,10,23,1800,198,374,572,Monday
2017,10,23,1700,250,369,619,Monday
2017,10,23,1600,285,357,642,Monday
2017,10,23,1500,295,356,651,Monday
2017,10,23,1400,310,282,592,Monday
2017,10,23,1300,373,283,656,Monday
2017,10,23,1200,428,225,653,Monday
2017,10,23,1100,370,194,564,Monday
2017,10,23,1000,339,132,471,Monday
2017,10,23,900,207,88,295,Monday
2017,10,23,800,137,54,191,Monday
2017,10,23,700,66,33,99,Monday
2017,10,23,600,22,19,41,Monday
2017,10,23,500,27,19,46,Monday
2017,10,23,400,14,24,38,Monday
2017,10,23,300,20,31,51,Monday
2017,10,23,200,17,36,53,Monday
2017,10,23,100,25,173,198,Monday
2017,10,22,2400,34,147,181,Sunday
2017,10,22,2300,60,215,275,Sunday
2017,10,22,2200,78,294,372,Sunday
2017,10,22,2100,119,238,357,Sunday
2017,10,22,2000,112,204,316,Sunday
2017,10,22,1900,148,281,429,Sunday
2017,10,22,1800,198,624,822,Sunday
2017,10,22,1700,268,655,923,Sunday
2017,10,22,1600,291,589,880,Sunday
2017,10,22,1500,340,534,874,Sunday
2017,10,22,1400,383,482,865,Sunday
2017,10,22,1300,417,492,909,Sunday
2017,10,22,1200,511,317,828,Sunday
2017,10,22,1100,399,230,629,Sunday
2017,10,22,1000,265,138,403,Sunday
2017,10,22,900,179,68,247,Sunday
2017,10,22,800,112,35,147,Sunday
2017,10,22,700,43,33,76,Sunday
2017,10,22,600,28,13,41,Sunday
2017,10,22,500,17,15,32,Sunday
2017,10,22,400,23,14,37,Sunday
2017,10,22,300,19,16,35,Sunday
2017,10,22,200,16,34,50,Sunday
2017,10,22,100,28,43,71,Sunday
2017,10,21,2400,38,55,93,Saturday
2017,10,21,2300,55,76,131,Saturday
2017,10,21,2200,68,73,141,Saturday
2017,10,21,2100,78,114,192,Saturday
2017,10,21,2000,137,206,343,Saturday
2017,10,21,1900,142,320,462,Saturday
2017,10,21,1800,152,476,628,Saturday
2017,10,21,1700,249,529,778,Saturday
2017,10,21,1600,320,574,894,Saturday
2017,10,21,1500,357,451,808,Saturday
2017,10,21,1400,460,412,872,Saturday
2017,10,21,1300,518,313,831,Saturday
2017,10,21,1200,531,256,787,Saturday
2017,10,21,1100,508,196,704,Saturday
2017,10,21,1000,448,192,640,Saturday
2017,10,21,900,269,74,343,Saturday
2017,10,21,800,138,46,184,Saturday
2017,10,21,700,68,40,108,Saturday
2017,10,21,600,19,29,48,Saturday
2017,10,21,500,19,24,43,Saturday
2017,10,21,400,27,22,49,Saturday
2017,10,21,300,12,30,42,Saturday
2017,10,21,200,22,29,51,Saturday
2017,10,21,100,59,46,105,Saturday
2017,10,20,2400,58,90,148,Friday
2017,10,20,2300,99,83,182,Friday
2017,10,20,2200,111,100,211,Friday
2017,10,20,2100,175,134,309,Friday
2017,10,20,2000,308,222,530,Friday
2017,10,20,1900,371,338,709,Friday
2017,10,20,1800,420,382,802,Friday
2017,10,20,1700,409,519,928,Friday
2017,10,20,1600,425,381,806,Friday
2017,10,20,1500,416,371,787,Friday
2017,10,20,1400,440,368,808,Friday
2017,10,20,1300,456,309,765,Friday
2017,10,20,1200,465,256,721,Friday
2017,10,20,1100,410,229,639,Friday
2017,10,20,1000,343,145,488,Friday
2017,10,20,900,243,111,354,Friday
2017,10,20,800,158,58,216,Friday
2017,10,20,700,84,42,126,Friday
2017,10,20,600,38,48,86,Friday
2017,10,20,500,25,37,62,Friday
2017,10,20,400,33,33,66,Friday
2017,10,20,300,25,32,57,Friday
2017,10,20,200,36,47,83,Friday
2017,10,20,100,56,64,120,Friday
2017,10,19,2400,66,75,141,Thursday
2017,10,19,2300,59,93,152,Thursday
2017,10,19,2200,93,104,197,Thursday
2017,10,19,2100,145,151,296,Thursday
2017,10,19,2000,175,181,356,Thursday
2017,10,19,1900,166,295,461,Thursday
2017,10,19,1800,265,346,611,Thursday
2017,10,19,1700,253,393,646,Thursday
2017,10,19,1600,301,407,708,Thursday
2017,10,19,1500,289,326,615,Thursday
2017,10,19,1400,304,294,598,Thursday
2017,10,19,1300,335,243,578,Thursday
2017,10,19,1200,344,216,560,Thursday
2017,10,19,1100,365,168,533,Thursday
2017,10,19,1000,276,138,414,Thursday
2017,10,19,900,212,121,333,Thursday
2017,10,19,800,148,63,211,Thursday
2017,10,19,700,78,60,138,Thursday
2017,10,19,600,47,41,88,Thursday
2017,10,19,500,31,33,64,Thursday
2017,10,19,400,33,46,79,Thursday
2017,10,19,300,42,36,78,Thursday
2017,10,19,200,44,61,105,Thursday
2017,10,19,100,51,63,114,Thursday
2017,10,18,2400,83,67,150,Wednesday
2017,10,18,2300,64,64,128,Wednesday
2017,10,18,2200,108,90,198,Wednesday
2017,10,18,2100,134,139,273,Wednesday
2017,10,18,2000,134,198,332,Wednesday
2017,10,18,1900,186,254,440,Wednesday
2017,10,18,1800,205,364,569,Wednesday
2017,10,18,1700,254,397,651,Wednesday
2017,10,18,1600,295,428,723,Wednesday
2017,10,18,1500,374,478,852,Wednesday
2017,10,18,1400,345,405,750,Wednesday
2017,10,18,1300,348,347,695,Wednesday
2017,10,18,1200,418,265,683,Wednesday
2017,10,18,1100,417,223,640,Wednesday
2017,10,18,1000,323,197,520,Wednesday
2017,10,18,900,239,117,356,Wednesday
2017,10,18,800,151,83,234,Wednesday
2017,10,18,700,69,47,116,Wednesday
2017,10,18,600,40,47,87,Wednesday
2017,10,18,500,25,31,56,Wednesday
2017,10,18,400,26,30,56,Wednesday
2017,10,18,300,34,50,84,Wednesday
2017,10,18,200,37,60,97,Wednesday
2017,10,18,100,64,76,140,Wednesday
2017,10,17,2400,85,74,159,Tuesday
2017,10,17,2300,78,93,171,Tuesday
2017,10,17,2200,91,137,228,Tuesday
2017,10,17,2100,116,173,289,Tuesday
2017,10,17,2000,114,135,249,Tuesday
2017,10,17,1900,145,221,366,Tuesday
2017,10,17,1800,193,311,504,Tuesday
2017,10,17,1700,232,351,583,Tuesday
2017,10,17,1600,236,363,599,Tuesday
2017,10,17,1500,254,370,624,Tuesday
2017,10,17,1400,248,285,533,Tuesday
2017,10,17,1300,336,298,634,Tuesday
2017,10,17,1200,343,208,551,Tuesday
2017,10,17,1100,351,197,548,Tuesday
2017,10,17,1000,279,153,432,Tuesday
2017,10,17,900,215,117,332,Tuesday
2017,10,17,800,142,64,206,Tuesday
2017,10,17,700,65,62,127,Tuesday
2017,10,17,600,42,36,78,Tuesday
2017,10,17,500,12,36,48,Tuesday
2017,10,17,400,29,38,67,Tuesday
2017,10,17,300,28,28,56,Tuesday
2017,10,17,200,23,51,74,Tuesday
2017,10,17,100,54,59,113,Tuesday
2017,10,16,2400,57,64,121,Monday
2017,10,16,2300,54,67,121,Monday
2017,10,16,2200,100,114,214,Monday
2017,10,16,2100,102,146,248,Monday
2017,10,16,2000,125,267,392,Monday
2017,10,16,1900,159,305,464,Monday
2017,10,16,1800,218,492,710,Monday
2017,10,16,1700,259,524,783,Monday
2017,10,16,1600,269,465,734,Monday
2017,10,16,1500,328,406,734,Monday
2017,10,16,1400,303,377,680,Monday
2017,10,16,1300,459,336,795,Monday
2017,10,16,1200,500,250,750,Monday
2017,10,16,1100,491,175,666,Monday
2017,10,16,1000,336,151,487,Monday
2017,10,16,900,263,97,360,Monday
2017,10,16,800,153,56,209,Monday
2017,10,16,700,69,51,120,Monday
2017,10,16,600,38,20,58,Monday
2017,10,16,500,26,27,53,Monday
2017,10,16,400,18,30,48,Monday
2017,10,16,300,31,26,57,Monday
2017,10,16,200,23,53,76,Monday
2017,10,16,100,35,64,99,Monday
2017,10,15,2400,33,76,109,Sunday
2017,10,15,2300,56,94,150,Sunday
2017,10,15,2200,80,190,270,Sunday
2017,10,15,2100,121,317,438,Sunday
2017,10,15,2000,141,274,415,Sunday
2017,10,15,1900,197,582,779,Sunday
2017,10,15,1800,228,767,995,Sunday
2017,10,15,1700,261,850,1111,Sunday
2017,10,15,1600,322,925,1247,Sunday
2017,10,15,1500,402,725,1127,Sunday
2017,10,15,1400,447,591,1038,Sunday
2017,10,15,1300,619,496,1115,Sunday
2017,10,15,1200,633,353,986,Sunday
2017,10,15,1100,510,203,713,Sunday
2017,10,15,1000,409,162,571,Sunday
2017,10,15,900,276,74,350,Sunday
2017,10,15,800,159,48,207,Sunday
2017,10,15,700,73,21,94,Sunday
2017,10,15,600,31,11,42,Sunday
2017,10,15,500,22,27,49,Sunday
2017,10,15,400,17,19,36,Sunday
2017,10,15,300,18,15,33,Sunday
2017,10,15,200,17,31,48,Sunday
2017,10,15,100,27,53,80,Sunday
2017,10,14,2400,27,69,96,Saturday
2017,10,14,2300,50,93,143,Saturday
2017,10,14,2200,64,102,166,Saturday
2017,10,14,2100,75,145,220,Saturday
2017,10,14,2000,115,265,380,Saturday
2017,10,14,1900,141,474,615,Saturday
2017,10,14,1800,179,564,743,Saturday
2017,10,14,1700,282,603,885,Saturday
2017,10,14,1600,358,563,921,Saturday
2017,10,14,1500,425,470,895,Saturday
2017,10,14,1400,466,394,860,Saturday
2017,10,14,1300,538,353,891,Saturday
2017,10,14,1200,580,284,864,Saturday
2017,10,14,1100,607,242,849,Saturday
2017,10,14,1000,449,140,589,Saturday
2017,10,14,900,279,108,387,Saturday
2017,10,14,800,170,89,259,Saturday
2017,10,14,700,90,78,168,Saturday
2017,10,14,600,36,12,48,Saturday
2017,10,14,500,17,10,27,Saturday
2017,10,14,400,30,25,55,Saturday
2017,10,14,300,26,15,41,Saturday
2017,10,14,200,26,25,51,Saturday
2017,10,14,100,48,72,120,Saturday
2017,10,13,2400,67,74,141,Friday
2017,10,13,2300,77,85,162,Friday
2017,10,13,2200,115,87,202,Friday
2017,10,13,2100,176,171,347,Friday
2017,10,13,2000,260,297,557,Friday
2017,10,13,1900,315,424,739,Friday
2017,10,13,1800,400,481,881,Friday
2017,10,13,1700,450,534,984,Friday
2017,10,13,1600,419,508,927,Friday
2017,10,13,1500,447,445,892,Friday
2017,10,13,1400,431,438,869,Friday
2017,10,13,1300,461,392,853,Friday
2017,10,13,1200,500,318,818,Friday
2017,10,13,1100,529,230,759,Friday
2017,10,13,1000,413,144,557,Friday
2017,10,13,900,278,117,395,Friday
2017,10,13,800,187,62,249,Friday
2017,10,13,700,100,47,147,Friday
2017,10,13,600,49,37,86,Friday
2017,10,13,500,36,33,69,Friday
2017,10,13,400,37,32,69,Friday
2017,10,13,300,28,43,71,Friday
2017,10,13,200,45,60,105,Friday
2017,10,13,100,55,52,107,Friday
2017,10,12,2400,56,88,144,Thursday
2017,10,12,2300,87,82,169,Thursday
2017,10,12,2200,101,140,241,Thursday
2017,10,12,2100,163,184,347,Thursday
2017,10,12,2000,175,258,433,Thursday
2017,10,12,1900,238,401,639,Thursday
2017,10,12,1800,248,502,750,Thursday
2017,10,12,1700,280,435,715,Thursday
2017,10,12,1600,299,438,737,Thursday
2017,10,12,1500,333,424,757,Thursday
2017,10,12,1400,364,371,735,Thursday
2017,10,12,1300,435,301,736,Thursday
2017,10,12,1200,466,270,736,Thursday
2017,10,12,1100,501,205,706,Thursday
2017,10,12,1000,385,147,532,Thursday
2017,10,12,900,254,122,376,Thursday
2017,10,12,800,176,69,245,Thursday
2017,10,12,700,82,44,126,Thursday
2017,10,12,600,38,36,74,Thursday
2017,10,12,500,28,32,60,Thursday
2017,10,12,400,25,30,55,Thursday
2017,10,12,300,31,47,78,Thursday
2017,10,12,200,41,46,87,Thursday
2017,10,12,100,35,62,97,Thursday
2017,10,11,2400,63,76,139,Wednesday
2017,10,11,2300,72,115,187,Wednesday
2017,10,11,2200,89,128,217,Wednesday
2017,10,11,2100,100,141,241,Wednesday
2017,10,11,2000,139,255,394,Wednesday
2017,10,11,1900,142,326,468,Wednesday
2017,10,11,1800,204,492,696,Wednesday
2017,10,11,1700,215,385,600,Wednesday
2017,10,11,1600,262,377,639,Wednesday
2017,10,11,1500,306,413,719,Wednesday
2017,10,11,1400,334,436,770,Wednesday
2017,10,11,1300,385,444,829,Wednesday
2017,10,11,1200,471,305,776,Wednesday
2017,10,11,1100,469,240,709,Wednesday
2017,10,11,1000,409,188,597,Wednesday
2017,10,11,900,316,136,452,Wednesday
2017,10,11,800,192,68,260,Wednesday
2017,10,11,700,92,58,150,Wednesday
2017,10,11,600,45,38,83,Wednesday
2017,10,11,500,30,20,50,Wednesday
2017,10,11,400,31,39,70,Wednesday
2017,10,11,300,32,48,80,Wednesday
2017,10,11,200,36,72,108,Wednesday
2017,10,11,100,40,75,115,Wednesday
2017,10,10,2400,64,77,141,Tuesday
2017,10,10,2300,85,104,189,Tuesday
2017,10,10,2200,88,149,237,Tuesday
2017,10,10,2100,122,227,349,Tuesday
2017,10,10,2000,167,361,528,Tuesday
2017,10,10,1900,160,598,758,Tuesday
2017,10,10,1800,251,807,1058,Tuesday
2017,10,10,1700,281,791,1072,Tuesday
2017,10,10,1600,366,619,985,Tuesday
2017,10,10,1500,392,527,919,Tuesday
2017,10,10,1400,466,480,946,Tuesday
2017,10,10,1300,514,387,901,Tuesday
2017,10,10,1200,696,327,1023,Tuesday
2017,10,10,1100,718,227,945,Tuesday
2017,10,10,1000,569,200,769,Tuesday
2017,10,10,900,405,138,543,Tuesday
2017,10,10,800,225,75,300,Tuesday
2017,10,10,700,117,46,163,Tuesday
2017,10,10,600,41,33,74,Tuesday
2017,10,10,500,26,29,55,Tuesday
2017,10,10,400,16,24,40,Tuesday
2017,10,10,300,18,23,41,Tuesday
2017,10,10,200,26,51,77,Tuesday
2017,10,10,100,29,87,116,Tuesday
2017,10,9,2400,28,121,149,Monday
2017,10,9,2300,48,189,237,Monday
2017,10,9,2200,70,292,362,Monday
2017,10,9,2100,85,619,704,Monday
2017,10,9,2000,151,932,1083,Monday
2017,10,9,1900,184,1326,1510,Monday
2017,10,9,1800,265,1702,1967,Monday
2017,10,9,1700,342,1759,2101,Monday
2017,10,9,1600,507,1727,2234,Monday
2017,10,9,1500,595,1597,2192,Monday
2017,10,9,1400,781,1435,2216,Monday
2017,10,9,1300,839,1168,2007,Monday
2017,10,9,1200,1030,743,1773,Monday
2017,10,9,1100,914,397,1311,Monday
2017,10,9,1000,707,192,899,Monday
2017,10,9,900,513,97,610,Monday
2017,10,9,800,296,52,348,Monday
2017,10,9,700,126,19,145,Monday
2017,10,9,600,55,16,71,Monday
2017,10,9,500,25,19,44,Monday
2017,10,9,400,20,14,34,Monday
2017,10,9,300,20,26,46,Monday
2017,10,9,200,25,30,55,Monday
2017,10,9,100,35,38,73,Monday
2017,10,8,2400,34,65,99,Sunday
2017,10,8,2300,49,104,153,Sunday
2017,10,8,2200,79,172,251,Sunday
2017,10,8,2100,101,329,430,Sunday
2017,10,8,2000,114,538,652,Sunday
2017,10,8,1900,151,738,889,Sunday
2017,10,8,1800,225,925,1150,Sunday
2017,10,8,1700,269,849,1118,Sunday
2017,10,8,1600,401,861,1262,Sunday
2017,10,8,1500,458,703,1161,Sunday
2017,10,8,1400,550,561,1111,Sunday
2017,10,8,1300,675,567,1242,Sunday
2017,10,8,1200,784,364,1148,Sunday
2017,10,8,1100,741,237,978,Sunday
2017,10,8,1000,543,151,694,Sunday
2017,10,8,900,374,88,462,Sunday
2017,10,8,800,226,44,270,Sunday
2017,10,8,700,115,25,140,Sunday
2017,10,8,600,38,29,67,Sunday
2017,10,8,500,20,21,41,Sunday
2017,10,8,400,25,15,40,Sunday
2017,10,8,300,17,20,37,Sunday
2017,10,8,200,23,33,56,Sunday
2017,10,8,100,31,58,89,Sunday
2017,10,7,2400,37,65,102,Saturday
2017,10,7,2300,73,100,173,Saturday
2017,10,7,2200,91,135,226,Saturday
2017,10,7,2100,124,238,362,Saturday
2017,10,7,2000,163,441,604,Saturday
2017,10,7,1900,206,663,869,Saturday
2017,10,7,1800,325,842,1167,Saturday
2017,10,7,1700,363,810,1173,Saturday
2017,10,7,1600,564,803,1367,Saturday
2017,10,7,1500,629,721,1350,Saturday
2017,10,7,1400,840,649,1489,Saturday
2017,10,7,1300,920,530,1450,Saturday
2017,10,7,1200,1142,406,1548,Saturday
2017,10,7,1100,1071,302,1373,Saturday
2017,10,7,1000,863,191,1054,Saturday
2017,10,7,900,660,111,771,Saturday
2017,10,7,800,378,76,454,Saturday
2017,10,7,700,197,51,248,Saturday
2017,10,7,600,95,44,139,Saturday
2017,10,7,500,37,54,91,Saturday
2017,10,7,400,31,34,65,Saturday
2017,10,7,300,37,51,88,Saturday
2017,10,7,200,49,61,110,Saturday
2017,10,7,100,78,73,151,Saturday
2017,10,6,2400,104,115,219,Friday
2017,10,6,2300,172,152,324,Friday
2017,10,6,2200,295,197,492,Friday
2017,10,6,2100,467,240,707,Friday
2017,10,6,2000,674,432,1106,Friday
2017,10,6,1900,839,695,1534,Friday
2017,10,6,1800,910,895,1805,Friday
2017,10,6,1700,988,1004,1992,Friday
2017,10,6,1600,981,847,1828,Friday
2017,10,6,1500,940,714,1654,Friday
2017,10,6,1400,851,575,1426,Friday
2017,10,6,1300,948,586,1534,Friday
2017,10,6,1200,1121,409,1530,Friday
2017,10,6,1100,1117,298,1415,Friday
2017,10,6,1000,912,204,1116,Friday
2017,10,6,900,669,136,805,Friday
2017,10,6,800,410,93,503,Friday
2017,10,6,700,220,78,298,Friday
2017,10,6,600,87,37,124,Friday
2017,10,6,500,53,38,91,Friday
2017,10,6,400,40,39,79,Friday
2017,10,6,300,42,64,106,Friday
2017,10,6,200,57,66,123,Friday
2017,10,6,100,62,71,133,Friday
2017,10,5,2400,104,110,214,Thursday
2017,10,5,2300,130,146,276,Thursday
2017,10,5,2200,174,176,350,Thursday
2017,10,5,2100,303,383,686,Thursday
2017,10,5,2000,391,561,952,Thursday
2017,10,5,1900,475,737,1212,Thursday
2017,10,5,1800,480,773,1253,Thursday
2017,10,5,1700,484,841,1325,Thursday
2017,10,5,1600,546,629,1175,Thursday
2017,10,5,1500,568,514,1082,Thursday
2017,10,5,1400,563,583,1146,Thursday
2017,10,5,1300,627,342,969,Thursday
2017,10,5,1200,731,277,1008,Thursday
2017,10,5,1100,843,275,1118,Thursday
2017,10,5,1000,683,144,827,Thursday
2017,10,5,900,578,115,693,Thursday
2017,10,5,800,310,79,389,Thursday
2017,10,5,700,158,55,213,Thursday
2017,10,5,600,72,31,103,Thursday
2017,10,5,500,39,25,64,Thursday
2017,10,5,400,25,49,74,Thursday
2017,10,5,300,24,41,65,Thursday
2017,10,5,200,37,48,85,Thursday
2017,10,5,100,47,65,112,Thursday
2017,10,4,2400,75,100,175,Wednesday
2017,10,4,2300,80,114,194,Wednesday
2017,10,4,2200,128,160,288,Wednesday
2017,10,4,2100,171,345,516,Wednesday
2017,10,4,2000,183,490,673,Wednesday
2017,10,4,1900,211,672,883,Wednesday
2017,10,4,1800,286,655,941,Wednesday
2017,10,4,1700,324,672,996,Wednesday
2017,10,4,1600,341,533,874,Wednesday
2017,10,4,1500,363,443,806,Wednesday
2017,10,4,1400,427,434,861,Wednesday
2017,10,4,1300,519,276,795,Wednesday
2017,10,4,1200,659,252,911,Wednesday
2017,10,4,1100,668,198,866,Wednesday
2017,10,4,1000,603,173,776,Wednesday
2017,10,4,900,499,122,621,Wednesday
2017,10,4,800,275,71,346,Wednesday
2017,10,4,700,146,57,203,Wednesday
2017,10,4,600,59,41,100,Wednesday
2017,10,4,500,34,32,66,Wednesday
2017,10,4,400,29,37,66,Wednesday
2017,10,4,300,34,45,79,Wednesday
2017,10,4,200,32,43,75,Wednesday
2017,10,4,100,55,66,121,Wednesday
2017,10,3,2400,73,76,149,Tuesday
2017,10,3,2300,81,113,194,Tuesday
2017,10,3,2200,109,156,265,Tuesday
2017,10,3,2100,142,317,459,Tuesday
2017,10,3,2000,207,467,674,Tuesday
2017,10,3,1900,250,626,876,Tuesday
2017,10,3,1800,262,618,880,Tuesday
2017,10,3,1700,324,586,910,Tuesday
2017,10,3,1600,353,584,937,Tuesday
2017,10,3,1500,420,428,848,Tuesday
2017,10,3,1400,411,373,784,Tuesday
2017,10,3,1300,460,307,767,Tuesday
2017,10,3,1200,632,252,884,Tuesday
2017,10,3,1100,614,210,824,Tuesday
2017,10,3,1000,553,164,717,Tuesday
2017,10,3,900,424,106,530,Tuesday
2017,10,3,800,245,79,324,Tuesday
2017,10,3,700,133,36,169,Tuesday
2017,10,3,600,46,32,78,Tuesday
2017,10,3,500,27,26,53,Tuesday
2017,10,3,400,17,29,46,Tuesday
2017,10,3,300,28,42,70,Tuesday
2017,10,3,200,26,52,78,Tuesday
2017,10,3,100,32,52,84,Tuesday
2017,10,2,2400,52,74,126,Monday
2017,10,2,2300,61,104,165,Monday
2017,10,2,2200,85,143,228,Monday
2017,10,2,2100,120,250,370,Monday
2017,10,2,2000,123,471,594,Monday
2017,10,2,1900,171,564,735,Monday
2017,10,2,1800,194,588,782,Monday
2017,10,2,1700,265,592,857,Monday
2017,10,2,1600,249,489,738,Monday
2017,10,2,1500,320,314,634,Monday
2017,10,2,1400,322,358,680,Monday
2017,10,2,1300,401,357,758,Monday
2017,10,2,1200,553,256,809,Monday
2017,10,2,1100,467,235,702,Monday
2017,10,2,1000,436,147,583,Monday
2017,10,2,900,339,128,467,Monday
2017,10,2,800,208,68,276,Monday
2017,10,2,700,110,43,153,Monday
2017,10,2,600,40,27,67,Monday
2017,10,2,500,28,26,54,Monday
2017,10,2,400,20,36,56,Monday
2017,10,2,300,17,37,54,Monday
2017,10,2,200,25,47,72,Monday
2017,10,2,100,32,71,103,Monday
2017,10,1,2400,63,86,149,Sunday
2017,10,1,2300,81,181,262,Sunday
2017,10,1,2200,109,210,319,Sunday
2017,10,1,2100,184,450,634,Sunday
2017,10,1,2000,167,673,840,Sunday
2017,10,1,1900,224,938,1162,Sunday
2017,10,1,1800,278,1055,1333,Sunday
2017,10,1,1700,376,1140,1516,Sunday
2017,10,1,1600,425,1045,1470,Sunday
2017,10,1,1500,483,953,1436,Sunday
2017,10,1,1400,570,791,1361,Sunday
2017,10,1,1300,617,688,1305,Sunday
2017,10,1,1200,774,489,1263,Sunday
2017,10,1,1100,688,321,1009,Sunday
2017,10,1,1000,667,172,839,Sunday
2017,10,1,900,453,101,554,Sunday
2017,10,1,800,233,47,280,Sunday
2017,10,1,700,161,37,198,Sunday
2017,10,1,600,49,14,63,Sunday
2017,10,1,500,22,20,42,Sunday
2017,10,1,400,24,17,41,Sunday
2017,10,1,300,21,31,52,Sunday
2017,10,1,200,16,46,62,Sunday
2017,10,1,100,25,47,72,Sunday
2017,9,30,2400,57,59,116,Saturday
2017,9,30,2300,49,114,163,Saturday
2017,9,30,2200,91,183,274,Saturday
2017,9,30,2100,130,348,478,Saturday
2017,9,30,2000,170,601,771,Saturday
2017,9,30,1900,185,907,1092,Saturday
2017,9,30,1800,263,926,1189,Saturday
2017,9,30,1700,350,888,1238,Saturday
2017,9,30,1600,416,848,1264,Saturday
2017,9,30,1500,531,628,1159,Saturday
2017,9,30,1400,591,589,1180,Saturday
2017,9,30,1300,864,472,1336,Saturday
2017,9,30,1200,727,389,1116,Saturday
2017,9,30,1100,1009,269,1278,Saturday
2017,9,30,1000,885,177,1062,Saturday
2017,9,30,900,689,111,800,Saturday
2017,9,30,800,432,72,504,Saturday
2017,9,30,700,220,29,249,Saturday
2017,9,30,600,69,42,111,Saturday
2017,9,30,500,26,29,55,Saturday
2017,9,30,400,33,37,70,Saturday
2017,9,30,300,30,45,75,Saturday
2017,9,30,200,33,45,78,Saturday
2017,9,30,100,51,62,113,Saturday
2017,9,29,2400,89,63,152,Friday
2017,9,29,2300,82,145,227,Friday
2017,9,29,2200,185,175,360,Friday
2017,9,29,2100,289,483,772,Friday
2017,9,29,2000,418,727,1145,Friday
2017,9,29,1900,489,901,1390,Friday
2017,9,29,1800,574,916,1490,Friday
2017,9,29,1700,593,830,1423,Friday
2017,9,29,1600,642,832,1474,Friday
2017,9,29,1500,665,680,1345,Friday
2017,9,29,1400,673,538,1211,Friday
2017,9,29,1300,843,426,1269,Friday
2017,9,29,1200,718,347,1065,Friday
2017,9,29,1100,831,283,1114,Friday
2017,9,29,1000,860,199,1059,Friday
2017,9,29,900,647,136,783,Friday
2017,9,29,800,452,79,531,Friday
2017,9,29,700,223,64,287,Friday
2017,9,29,600,81,43,124,Friday
2017,9,29,500,34,42,76,Friday
2017,9,29,400,31,46,77,Friday
2017,9,29,300,32,47,79,Friday
2017,9,29,200,34,64,98,Friday
2017,9,29,100,45,98,143,Friday
2017,9,28,2400,80,85,165,Thursday
2017,9,28,2300,114,120,234,Thursday
2017,9,28,2200,162,173,335,Thursday
2017,9,28,2100,228,414,642,Thursday
2017,9,28,2000,276,648,924,Thursday
2017,9,28,1900,305,752,1057,Thursday
2017,9,28,1800,333,807,1140,Thursday
2017,9,28,1700,390,747,1137,Thursday
2017,9,28,1600,407,681,1088,Thursday
2017,9,28,1500,510,551,1061,Thursday
2017,9,28,1400,527,453,980,Thursday
2017,9,28,1300,569,330,899,Thursday
2017,9,28,1200,710,284,994,Thursday
2017,9,28,1100,858,257,1115,Thursday
2017,9,28,1000,724,173,897,Thursday
2017,9,28,900,611,126,737,Thursday
2017,9,28,800,404,101,505,Thursday
2017,9,28,700,222,57,279,Thursday
2017,9,28,600,76,40,116,Thursday
2017,9,28,500,32,40,72,Thursday
2017,9,28,400,34,46,80,Thursday
2017,9,28,300,34,38,72,Thursday
2017,9,28,200,37,53,90,Thursday
2017,9,28,100,61,57,118,Thursday
2017,9,27,2400,76,84,160,Wednesday
2017,9,27,2300,99,127,226,Wednesday
2017,9,27,2200,121,198,319,Wednesday
2017,9,27,2100,142,391,533,Wednesday
2017,9,27,2000,198,569,767,Wednesday
2017,9,27,1900,218,743,961,Wednesday
2017,9,27,1800,300,781,1081,Wednesday
2017,9,27,1700,351,725,1076,Wednesday
2017,9,27,1600,377,541,918,Wednesday
2017,9,27,1500,391,519,910,Wednesday
2017,9,27,1400,433,404,837,Wednesday
2017,9,27,1300,540,382,922,Wednesday
2017,9,27,1200,742,314,1056,Wednesday
2017,9,27,1100,726,226,952,Wednesday
2017,9,27,1000,725,203,928,Wednesday
2017,9,27,900,581,142,723,Wednesday
2017,9,27,800,325,94,419,Wednesday
2017,9,27,700,207,62,269,Wednesday
2017,9,27,600,71,32,103,Wednesday
2017,9,27,500,26,32,58,Wednesday
2017,9,27,400,25,41,66,Wednesday
2017,9,27,300,24,51,75,Wednesday
2017,9,27,200,41,51,92,Wednesday
2017,9,27,100,45,77,122,Wednesday
2017,9,26,2400,81,67,148,Tuesday
2017,9,26,2300,93,127,220,Tuesday
2017,9,26,2200,106,182,288,Tuesday
2017,9,26,2100,142,342,484,Tuesday
2017,9,26,2000,165,490,655,Tuesday
2017,9,26,1900,174,683,857,Tuesday
2017,9,26,1800,245,711,956,Tuesday
2017,9,26,1700,273,752,1025,Tuesday
2017,9,26,1600,346,610,956,Tuesday
2017,9,26,1500,347,481,828,Tuesday
2017,9,26,1400,425,448,873,Tuesday
2017,9,26,1300,480,334,814,Tuesday
2017,9,26,1200,627,306,933,Tuesday
2017,9,26,1100,692,243,935,Tuesday
2017,9,26,1000,661,182,843,Tuesday
2017,9,26,900,527,146,673,Tuesday
2017,9,26,800,317,73,390,Tuesday
2017,9,26,700,204,68,272,Tuesday
2017,9,26,600,67,39,106,Tuesday
2017,9,26,500,20,31,51,Tuesday
2017,9,26,400,20,43,63,Tuesday
2017,9,26,300,36,47,83,Tuesday
2017,9,26,200,43,64,107,Tuesday
2017,9,26,100,36,82,118,Tuesday
2017,9,25,2400,67,72,139,Monday
2017,9,25,2300,70,115,185,Monday
2017,9,25,2200,112,159,271,Monday
2017,9,25,2100,139,357,496,Monday
2017,9,25,2000,183,592,775,Monday
2017,9,25,1900,234,769,1003,Monday
2017,9,25,1800,260,827,1087,Monday
2017,9,25,1700,301,715,1016,Monday
2017,9,25,1600,406,680,1086,Monday
2017,9,25,1500,457,662,1119,Monday
2017,9,25,1400,501,539,1040,Monday
2017,9,25,1300,557,413,970,Monday
2017,9,25,1200,706,349,1055,Monday
2017,9,25,1100,724,261,985,Monday
2017,9,25,1000,735,186,921,Monday
2017,9,25,900,550,119,669,Monday
2017,9,25,800,346,83,429,Monday
2017,9,25,700,169,54,223,Monday
2017,9,25,600,71,35,106,Monday
2017,9,25,500,24,20,44,Monday
2017,9,25,400,21,30,51,Monday
2017,9,25,300,27,38,65,Monday
2017,9,25,200,28,46,74,Monday
2017,9,25,100,28,74,102,Monday
2017,9,24,2400,33,142,175,Sunday
2017,9,24,2300,65,149,214,Sunday
2017,9,24,2200,95,295,390,Sunday
2017,9,24,2100,126,603,729,Sunday
2017,9,24,2000,179,847,1026,Sunday
2017,9,24,1900,224,1210,1434,Sunday
2017,9,24,1800,295,1407,1702,Sunday
2017,9,24,1700,382,1511,1893,Sunday
2017,9,24,1600,432,1269,1701,Sunday
2017,9,24,1500,561,1112,1673,Sunday
2017,9,24,1400,578,962,1540,Sunday
2017,9,24,1300,755,757,1512,Sunday
2017,9,24,1200,850,592,1442,Sunday
2017,9,24,1100,881,361,1242,Sunday
2017,9,24,1000,829,193,1022,Sunday
2017,9,24,900,624,101,725,Sunday
2017,9,24,800,390,58,448,Sunday
2017,9,24,700,239,34,273,Sunday
2017,9,24,600,70,13,83,Sunday
2017,9,24,500,26,18,44,Sunday
2017,9,24,400,21,22,43,Sunday
2017,9,24,300,16,19,35,Sunday
2017,9,24,200,23,30,53,Sunday
2017,9,24,100,36,64,100,Sunday
2017,9,23,2400,46,95,141,Saturday
2017,9,23,2300,63,99,162,Saturday
2017,9,23,2200,92,202,294,Saturday
2017,9,23,2100,139,383,522,Saturday
2017,9,23,2000,145,626,771,Saturday
2017,9,23,1900,218,908,1126,Saturday
2017,9,23,1800,261,960,1221,Saturday
2017,9,23,1700,358,979,1337,Saturday
2017,9,23,1600,428,767,1195,Saturday
2017,9,23,1500,502,715,1217,Saturday
2017,9,23,1400,597,509,1106,Saturday
2017,9,23,1300,627,426,1053,Saturday
2017,9,23,1200,896,344,1240,Saturday
2017,9,23,1100,953,278,1231,Saturday
2017,9,23,1000,896,204,1100,Saturday
2017,9,23,900,702,135,837,Saturday
2017,9,23,800,474,67,541,Saturday
2017,9,23,700,211,41,252,Saturday
2017,9,23,600,52,34,86,Saturday
2017,9,23,500,34,22,56,Saturday
2017,9,23,400,22,33,55,Saturday
2017,9,23,300,31,37,68,Saturday
2017,9,23,200,26,51,77,Saturday
2017,9,23,100,45,61,106,Saturday
2017,9,22,2400,70,85,155,Friday
2017,9,22,2300,97,113,210,Friday
2017,9,22,2200,176,185,361,Friday
2017,9,22,2100,268,318,586,Friday
2017,9,22,2000,446,596,1042,Friday
2017,9,22,1900,578,742,1320,Friday
2017,9,22,1800,645,857,1502,Friday
2017,9,22,1700,584,801,1385,Friday
2017,9,22,1600,676,702,1378,Friday
2017,9,22,1500,645,514,1159,Friday
2017,9,22,1400,692,441,1133,Friday
2017,9,22,1300,766,387,1153,Friday
2017,9,22,1200,876,318,1194,Friday
2017,9,22,1100,906,260,1166,Friday
2017,9,22,1000,784,180,964,Friday
2017,9,22,900,519,112,631,Friday
2017,9,22,800,306,74,380,Friday
2017,9,22,700,160,46,206,Friday
2017,9,22,600,64,37,101,Friday
2017,9,22,500,38,36,74,Friday
2017,9,22,400,31,42,73,Friday
2017,9,22,300,29,40,69,Friday
2017,9,22,200,35,50,85,Friday
2017,9,22,100,53,88,141,Friday
2017,9,21,2400,74,108,182,Thursday
2017,9,21,2300,109,115,224,Thursday
2017,9,21,2200,140,160,300,Thursday
2017,9,21,2100,199,329,528,Thursday
2017,9,21,2000,258,427,685,Thursday
2017,9,21,1900,329,555,884,Thursday
2017,9,21,1800,357,659,1016,Thursday
2017,9,21,1700,383,500,883,Thursday
2017,9,21,1600,455,511,966,Thursday
2017,9,21,1500,457,481,938,Thursday
2017,9,21,1400,466,409,875,Thursday
2017,9,21,1300,563,384,947,Thursday
2017,9,21,1200,664,327,991,Thursday
2017,9,21,1100,742,269,1011,Thursday
2017,9,21,1000,566,183,749,Thursday
2017,9,21,900,445,127,572,Thursday
2017,9,21,800,269,81,350,Thursday
2017,9,21,700,133,54,187,Thursday
2017,9,21,600,65,47,112,Thursday
2017,9,21,500,38,32,70,Thursday
2017,9,21,400,27,34,61,Thursday
2017,9,21,300,24,40,64,Thursday
2017,9,21,200,26,52,78,Thursday
2017,9,21,100,55,59,114,Thursday
2017,9,20,2400,67,83,150,Wednesday
2017,9,20,2300,78,106,184,Wednesday
2017,9,20,2200,115,140,255,Wednesday
2017,9,20,2100,152,313,465,Wednesday
2017,9,20,2000,194,416,610,Wednesday
2017,9,20,1900,217,601,818,Wednesday
2017,9,20,1800,266,601,867,Wednesday
2017,9,20,1700,305,638,943,Wednesday
2017,9,20,1600,362,618,980,Wednesday
2017,9,20,1500,394,560,954,Wednesday
2017,9,20,1400,499,501,1000,Wednesday
2017,9,20,1300,494,418,912,Wednesday
2017,9,20,1200,590,338,928,Wednesday
2017,9,20,1100,714,263,977,Wednesday
2017,9,20,1000,614,205,819,Wednesday
2017,9,20,900,445,124,569,Wednesday
2017,9,20,800,283,86,369,Wednesday
2017,9,20,700,124,60,184,Wednesday
2017,9,20,600,48,51,99,Wednesday
2017,9,20,500,30,30,60,Wednesday
2017,9,20,400,31,32,63,Wednesday
2017,9,20,300,32,45,77,Wednesday
2017,9,20,200,37,39,76,Wednesday
2017,9,20,100,37,71,108,Wednesday
2017,9,19,2400,83,71,154,Tuesday
2017,9,19,2300,94,116,210,Tuesday
2017,9,19,2200,119,194,313,Tuesday
2017,9,19,2100,140,346,486,Tuesday
2017,9,19,2000,157,485,642,Tuesday
2017,9,19,1900,222,650,872,Tuesday
2017,9,19,1800,254,755,1009,Tuesday
2017,9,19,1700,305,694,999,Tuesday
2017,9,19,1600,360,627,987,Tuesday
2017,9,19,1500,396,544,940,Tuesday
2017,9,19,1400,429,486,915,Tuesday
2017,9,19,1300,512,376,888,Tuesday
2017,9,19,1200,645,333,978,Tuesday
2017,9,19,1100,712,255,967,Tuesday
2017,9,19,1000,712,207,919,Tuesday
2017,9,19,900,575,148,723,Tuesday
2017,9,19,800,318,85,403,Tuesday
2017,9,19,700,167,57,224,Tuesday
2017,9,19,600,61,46,107,Tuesday
2017,9,19,500,32,35,67,Tuesday
2017,9,19,400,33,42,75,Tuesday
2017,9,19,300,18,33,51,Tuesday
2017,9,19,200,40,48,88,Tuesday
2017,9,19,100,47,75,122,Tuesday
2017,9,18,2400,61,103,164,Monday
2017,9,18,2300,77,115,192,Monday
2017,9,18,2200,106,225,331,Monday
2017,9,18,2100,152,365,517,Monday
2017,9,18,2000,175,501,676,Monday
2017,9,18,1900,195,598,793,Monday
2017,9,18,1800,289,780,1069,Monday
2017,9,18,1700,338,980,1318,Monday
2017,9,18,1600,394,914,1308,Monday
2017,9,18,1500,455,618,1073,Monday
2017,9,18,1400,522,597,1119,Monday
2017,9,18,1300,547,511,1058,Monday
2017,9,18,1200,757,441,1198,Monday
2017,9,18,1100,871,311,1182,Monday
2017,9,18,1000,690,203,893,Monday
2017,9,18,900,535,138,673,Monday
2017,9,18,800,321,70,391,Monday
2017,9,18,700,156,54,210,Monday
2017,9,18,600,65,27,92,Monday
2017,9,18,500,31,29,60,Monday
2017,9,18,400,21,21,42,Monday
2017,9,18,300,20,46,66,Monday
2017,9,18,200,20,48,68,Monday
2017,9,18,100,33,84,117,Monday
2017,9,17,2400,36,114,150,Sunday
2017,9,17,2300,63,182,245,Sunday
2017,9,17,2200,122,366,488,Sunday
2017,9,17,2100,128,583,711,Sunday
2017,9,17,2000,174,1038,1212,Sunday
2017,9,17,1900,231,1383,1614,Sunday
2017,9,17,1800,347,1467,1814,Sunday
2017,9,17,1700,362,1424,1786,Sunday
2017,9,17,1600,472,1248,1720,Sunday
2017,9,17,1500,516,1202,1718,Sunday
2017,9,17,1400,682,1114,1796,Sunday
2017,9,17,1300,780,966,1746,Sunday
2017,9,17,1200,1028,846,1874,Sunday
2017,9,17,1100,986,532,1518,Sunday
2017,9,17,1000,954,298,1252,Sunday
2017,9,17,900,763,132,895,Sunday
2017,9,17,800,437,68,505,Sunday
2017,9,17,700,209,32,241,Sunday
2017,9,17,600,56,26,82,Sunday
2017,9,17,500,15,15,30,Sunday
2017,9,17,400,13,23,36,Sunday
2017,9,17,300,17,30,47,Sunday
2017,9,17,200,23,40,63,Sunday
2017,9,17,100,32,51,83,Sunday
2017,9,16,2400,40,93,133,Saturday
2017,9,16,2300,87,159,246,Saturday
2017,9,16,2200,94,309,403,Saturday
2017,9,16,2100,115,564,679,Saturday
2017,9,16,2000,152,711,863,Saturday
2017,9,16,1900,208,1095,1303,Saturday
2017,9,16,1800,276,1191,1467,Saturday
2017,9,16,1700,374,1073,1447,Saturday
2017,9,16,1600,479,901,1380,Saturday
2017,9,16,1500,564,703,1267,Saturday
2017,9,16,1400,686,611,1297,Saturday
2017,9,16,1300,798,499,1297,Saturday
2017,9,16,1200,1067,410,1477,Saturday
2017,9,16,1100,1148,281,1429,Saturday
2017,9,16,1000,1075,192,1267,Saturday
2017,9,16,900,806,138,944,Saturday
2017,9,16,800,506,89,595,Saturday
2017,9,16,700,216,17,233,Saturday
2017,9,16,600,84,45,129,Saturday
2017,9,16,500,33,36,69,Saturday
2017,9,16,400,27,29,56,Saturday
2017,9,16,300,31,121,152,Saturday
2017,9,16,200,45,10,55,Saturday
2017,9,16,100,48,28,76,Saturday
2017,9,15,2400,80,99,179,Friday
2017,9,15,2300,131,123,254,Friday
2017,9,15,2200,225,219,444,Friday
2017,9,15,2100,356,390,746,Friday
2017,9,15,2000,499,621,1120,Friday
2017,9,15,1900,638,809,1447,Friday
2017,9,15,1800,685,883,1568,Friday
2017,9,15,1700,687,876,1563,Friday
2017,9,15,1600,727,758,1485,Friday
2017,9,15,1500,852,683,1535,Friday
2017,9,15,1400,801,482,1283,Friday
2017,9,15,1300,759,438,1197,Friday
2017,9,15,1200,942,374,1316,Friday
2017,9,15,1100,968,271,1239,Friday
2017,9,15,1000,853,198,1051,Friday
2017,9,15,900,680,139,819,Friday
2017,9,15,800,402,92,494,Friday
2017,9,15,700,201,54,255,Friday
2017,9,15,600,90,59,149,Friday
2017,9,15,500,42,30,72,Friday
2017,9,15,400,49,67,116,Friday
2017,9,15,300,31,79,110,Friday
2017,9,15,200,38,22,60,Friday
2017,9,15,100,52,56,108,Friday
2017,9,14,2400,84,108,192,Thursday
2017,9,14,2300,107,134,241,Thursday
2017,9,14,2200,147,233,380,Thursday
2017,9,14,2100,238,386,624,Thursday
2017,9,14,2000,275,572,847,Thursday
2017,9,14,1900,335,698,1033,Thursday
2017,9,14,1800,394,771,1165,Thursday
2017,9,14,1700,421,711,1132,Thursday
2017,9,14,1600,475,664,1139,Thursday
2017,9,14,1500,545,537,1082,Thursday
2017,9,14,1400,596,388,984,Thursday
2017,9,14,1300,594,428,1022,Thursday
2017,9,14,1200,740,376,1116,Thursday
2017,9,14,1100,852,282,1134,Thursday
2017,9,14,1000,794,202,996,Thursday
2017,9,14,900,572,169,741,Thursday
2017,9,14,800,383,97,480,Thursday
2017,9,14,700,142,52,194,Thursday
2017,9,14,600,64,50,114,Thursday
2017,9,14,500,25,35,60,Thursday
2017,9,14,400,30,37,67,Thursday
2017,9,14,300,33,52,85,Thursday
2017,9,14,200,35,52,87,Thursday
2017,9,14,100,48,77,125,Thursday
2017,9,13,2400,71,99,170,Wednesday
2017,9,13,2300,97,126,223,Wednesday
2017,9,13,2200,137,200,337,Wednesday
2017,9,13,2100,184,266,450,Wednesday
2017,9,13,2000,193,416,609,Wednesday
2017,9,13,1900,232,569,801,Wednesday
2017,9,13,1800,291,665,956,Wednesday
2017,9,13,1700,356,615,971,Wednesday
2017,9,13,1600,399,531,930,Wednesday
2017,9,13,1500,420,530,950,Wednesday
2017,9,13,1400,475,522,997,Wednesday
2017,9,13,1300,484,499,983,Wednesday
2017,9,13,1200,653,394,1047,Wednesday
2017,9,13,1100,665,279,944,Wednesday
2017,9,13,1000,579,205,784,Wednesday
2017,9,13,900,468,147,615,Wednesday
2017,9,13,800,285,90,375,Wednesday
2017,9,13,700,156,55,211,Wednesday
2017,9,13,600,54,41,95,Wednesday
2017,9,13,500,32,28,60,Wednesday
2017,9,13,400,31,45,76,Wednesday
2017,9,13,300,36,52,88,Wednesday
2017,9,13,200,30,46,76,Wednesday
2017,9,13,100,42,59,101,Wednesday
2017,9,12,2400,51,111,162,Tuesday
2017,9,12,2300,97,96,193,Tuesday
2017,9,12,2200,118,170,288,Tuesday
2017,9,12,2100,149,274,423,Tuesday
2017,9,12,2000,180,370,550,Tuesday
2017,9,12,1900,190,519,709,Tuesday
2017,9,12,1800,291,797,1088,Tuesday
2017,9,12,1700,360,878,1238,Tuesday
2017,9,12,1600,394,820,1214,Tuesday
2017,9,12,1500,437,699,1136,Tuesday
2017,9,12,1400,439,569,1008,Tuesday
2017,9,12,1300,496,412,908,Tuesday
2017,9,12,1200,659,338,997,Tuesday
2017,9,12,1100,799,259,1058,Tuesday
2017,9,12,1000,787,206,993,Tuesday
2017,9,12,900,604,173,777,Tuesday
2017,9,12,800,380,79,459,Tuesday
2017,9,12,700,196,53,249,Tuesday
2017,9,12,600,93,45,138,Tuesday
2017,9,12,500,27,28,55,Tuesday
2017,9,12,400,20,39,59,Tuesday
2017,9,12,300,34,44,78,Tuesday
2017,9,12,200,27,63,90,Tuesday
2017,9,12,100,48,57,105,Tuesday
2017,9,11,2400,63,101,164,Monday
2017,9,11,2300,82,136,218,Monday
2017,9,11,2200,109,271,380,Monday
2017,9,11,2100,160,501,661,Monday
2017,9,11,2000,190,803,993,Monday
2017,9,11,1900,237,925,1162,Monday
2017,9,11,1800,298,991,1289,Monday
2017,9,11,1700,365,895,1260,Monday
2017,9,11,1600,435,811,1246,Monday
2017,9,11,1500,526,662,1188,Monday
2017,9,11,1400,563,520,1083,Monday
2017,9,11,1300,735,464,1199,Monday
2017,9,11,1200,942,372,1314,Monday
2017,9,11,1100,1017,259,1276,Monday
2017,9,11,1000,871,203,1074,Monday
2017,9,11,900,778,170,948,Monday
2017,9,11,800,455,90,545,Monday
2017,9,11,700,234,57,291,Monday
2017,9,11,600,61,23,84,Monday
2017,9,11,500,25,25,50,Monday
2017,9,11,400,28,22,50,Monday
2017,9,11,300,22,40,62,Monday
2017,9,11,200,28,60,88,Monday
2017,9,11,100,37,77,114,Monday
2017,9,10,2400,52,145,197,Sunday
2017,9,10,2300,79,191,270,Sunday
2017,9,10,2200,119,406,525,Sunday
2017,9,10,2100,166,663,829,Sunday
2017,9,10,2000,235,1005,1240,Sunday
2017,9,10,1900,252,1329,1581,Sunday
2017,9,10,1800,348,1324,1672,Sunday
2017,9,10,1700,432,1274,1706,Sunday
2017,9,10,1600,556,1182,1738,Sunday
2017,9,10,1500,620,1063,1683,Sunday
2017,9,10,1400,737,777,1514,Sunday
2017,9,10,1300,842,745,1587,Sunday
2017,9,10,1200,918,571,1489,Sunday
2017,9,10,1100,963,381,1344,Sunday
2017,9,10,1000,897,249,1146,Sunday
2017,9,10,900,718,145,863,Sunday
2017,9,10,800,382,59,441,Sunday
2017,9,10,700,199,31,230,Sunday
2017,9,10,600,77,24,101,Sunday
2017,9,10,500,26,71,97,Sunday
2017,9,10,400,25,14,39,Sunday
2017,9,10,300,17,1,18,Sunday
2017,9,10,200,19,21,40,Sunday
2017,9,10,100,38,60,98,Sunday
2017,9,9,2400,44,107,151,Saturday
2017,9,9,2300,79,134,213,Saturday
2017,9,9,2200,97,174,271,Saturday
2017,9,9,2100,147,357,504,Saturday
2017,9,9,2000,198,556,754,Saturday
2017,9,9,1900,200,680,880,Saturday
2017,9,9,1800,297,795,1092,Saturday
2017,9,9,1700,372,931,1303,Saturday
2017,9,9,1600,480,895,1375,Saturday
2017,9,9,1500,517,857,1374,Saturday
2017,9,9,1400,599,747,1346,Saturday
2017,9,9,1300,718,646,1364,Saturday
2017,9,9,1200,906,503,1409,Saturday
2017,9,9,1100,1013,394,1407,Saturday
2017,9,9,1000,919,264,1183,Saturday
2017,9,9,900,668,153,821,Saturday
2017,9,9,800,360,75,435,Saturday
2017,9,9,700,198,50,248,Saturday
2017,9,9,600,78,28,106,Saturday
2017,9,9,500,34,34,68,Saturday
2017,9,9,400,18,32,50,Saturday
2017,9,9,300,42,29,71,Saturday
2017,9,9,200,35,39,74,Saturday
2017,9,9,100,55,78,133,Saturday
2017,9,8,2400,82,97,179,Friday
2017,9,8,2300,117,161,278,Friday
2017,9,8,2200,198,238,436,Friday
2017,9,8,2100,281,412,693,Friday
2017,9,8,2000,443,604,1047,Friday
2017,9,8,1900,481,812,1293,Friday
2017,9,8,1800,565,869,1434,Friday
2017,9,8,1700,556,920,1476,Friday
2017,9,8,1600,681,828,1509,Friday
2017,9,8,1500,639,782,1421,Friday
2017,9,8,1400,646,615,1261,Friday
2017,9,8,1300,664,483,1147,Friday
2017,9,8,1200,840,451,1291,Friday
2017,9,8,1100,929,357,1286,Friday
2017,9,8,1000,883,201,1084,Friday
2017,9,8,900,786,164,950,Friday
2017,9,8,800,441,111,552,Friday
2017,9,8,700,219,63,282,Friday
2017,9,8,600,96,37,133,Friday
2017,9,8,500,40,42,82,Friday
2017,9,8,400,37,52,89,Friday
2017,9,8,300,38,58,96,Friday
2017,9,8,200,38,49,87,Friday
2017,9,8,100,56,88,144,Friday
2017,9,7,2400,69,150,219,Thursday
2017,9,7,2300,129,128,257,Thursday
2017,9,7,2200,173,246,419,Thursday
2017,9,7,2100,223,367,590,Thursday
2017,9,7,2000,322,614,936,Thursday
2017,9,7,1900,281,818,1099,Thursday
2017,9,7,1800,342,863,1205,Thursday
2017,9,7,1700,402,939,1341,Thursday
2017,9,7,1600,464,800,1264,Thursday
2017,9,7,1500,512,640,1152,Thursday
2017,9,7,1400,508,530,1038,Thursday
2017,9,7,1300,608,457,1065,Thursday
2017,9,7,1200,818,366,1184,Thursday
2017,9,7,1100,927,321,1248,Thursday
2017,9,7,1000,879,210,1089,Thursday
2017,9,7,900,694,167,861,Thursday
2017,9,7,800,406,112,518,Thursday
2017,9,7,700,207,56,263,Thursday
2017,9,7,600,74,44,118,Thursday
2017,9,7,500,34,47,81,Thursday
2017,9,7,400,32,43,75,Thursday
2017,9,7,300,29,68,97,Thursday
2017,9,7,200,30,66,96,Thursday
2017,9,7,100,45,69,114,Thursday
2017,9,6,2400,77,102,179,Wednesday
2017,9,6,2300,101,163,264,Wednesday
2017,9,6,2200,148,242,390,Wednesday
2017,9,6,2100,169,429,598,Wednesday
2017,9,6,2000,203,615,818,Wednesday
2017,9,6,1900,235,822,1057,Wednesday
2017,9,6,1800,265,869,1134,Wednesday
2017,9,6,1700,333,920,1253,Wednesday
2017,9,6,1600,407,771,1178,Wednesday
2017,9,6,1500,437,653,1090,Wednesday
2017,9,6,1400,534,599,1133,Wednesday
2017,9,6,1300,614,435,1049,Wednesday
2017,9,6,1200,765,399,1164,Wednesday
2017,9,6,1100,791,271,1062,Wednesday
2017,9,6,1000,766,208,974,Wednesday
2017,9,6,900,622,153,775,Wednesday
2017,9,6,800,393,111,504,Wednesday
2017,9,6,700,188,58,246,Wednesday
2017,9,6,600,75,54,129,Wednesday
2017,9,6,500,28,33,61,Wednesday
2017,9,6,400,37,48,85,Wednesday
2017,9,6,300,25,53,78,Wednesday
2017,9,6,200,28,58,86,Wednesday
2017,9,6,100,57,98,155,Wednesday
2017,9,5,2400,73,159,232,Tuesday
2017,9,5,2300,113,178,291,Tuesday
2017,9,5,2200,127,311,438,Tuesday
2017,9,5,2100,180,505,685,Tuesday
2017,9,5,2000,216,714,930,Tuesday
2017,9,5,1900,235,973,1208,Tuesday
2017,9,5,1800,303,1104,1407,Tuesday
2017,9,5,1700,321,1125,1446,Tuesday
2017,9,5,1600,399,969,1368,Tuesday
2017,9,5,1500,499,779,1278,Tuesday
2017,9,5,1400,540,674,1214,Tuesday
2017,9,5,1300,670,611,1281,Tuesday
2017,9,5,1200,860,491,1351,Tuesday
2017,9,5,1100,917,363,1280,Tuesday
2017,9,5,1000,877,222,1099,Tuesday
2017,9,5,900,693,187,880,Tuesday
2017,9,5,800,456,118,574,Tuesday
2017,9,5,700,233,89,322,Tuesday
2017,9,5,600,96,42,138,Tuesday
2017,9,5,500,25,41,66,Tuesday
2017,9,5,400,16,31,47,Tuesday
2017,9,5,300,21,67,88,Tuesday
2017,9,5,200,29,83,112,Tuesday
2017,9,5,100,30,132,162,Tuesday
2017,9,4,2400,53,199,252,Monday
2017,9,4,2300,86,373,459,Monday
2017,9,4,2200,105,662,767,Monday
2017,9,4,2100,130,1169,1299,Monday
2017,9,4,2000,176,1651,1827,Monday
2017,9,4,1900,245,1936,2181,Monday
2017,9,4,1800,341,2167,2508,Monday
2017,9,4,1700,434,2176,2610,Monday
2017,9,4,1600,596,2047,2643,Monday
2017,9,4,1500,610,1966,2576,Monday
2017,9,4,1400,764,1837,2601,Monday
2017,9,4,1300,951,1647,2598,Monday
2017,9,4,1200,1128,1186,2314,Monday
2017,9,4,1100,1102,781,1883,Monday
2017,9,4,1000,989,489,1478,Monday
2017,9,4,900,839,235,1074,Monday
2017,9,4,800,554,102,656,Monday
2017,9,4,700,267,50,317,Monday
2017,9,4,600,98,21,119,Monday
2017,9,4,500,41,22,63,Monday
2017,9,4,400,30,61,91,Monday
2017,9,4,300,38,55,93,Monday
2017,9,4,200,25,76,101,Monday
2017,9,4,100,38,143,181,Monday
2017,9,3,2400,56,192,248,Sunday
2017,9,3,2300,83,344,427,Sunday
2017,9,3,2200,135,714,849,Sunday
2017,9,3,2100,156,1043,1199,Sunday
2017,9,3,2000,230,1345,1575,Sunday
2017,9,3,1900,360,1682,2042,Sunday
2017,9,3,1800,395,1925,2320,Sunday
2017,9,3,1700,568,1637,2205,Sunday
2017,9,3,1600,598,1550,2148,Sunday
2017,9,3,1500,789,1283,2072,Sunday
2017,9,3,1400,970,1090,2060,Sunday
2017,9,3,1300,1088,892,1980,Sunday
2017,9,3,1200,1320,658,1978,Sunday
2017,9,3,1100,1204,463,1667,Sunday
2017,9,3,1000,1156,252,1408,Sunday
2017,9,3,900,903,156,1059,Sunday
2017,9,3,800,563,58,621,Sunday
2017,9,3,700,294,40,334,Sunday
2017,9,3,600,103,16,119,Sunday
2017,9,3,500,32,31,63,Sunday
2017,9,3,400,30,40,70,Sunday
2017,9,3,300,26,43,69,Sunday
2017,9,3,200,36,49,85,Sunday
2017,9,3,100,57,114,171,Sunday
2017,9,2,2400,66,137,203,Saturday
2017,9,2,2300,95,275,370,Saturday
2017,9,2,2200,168,573,741,Saturday
2017,9,2,2100,208,796,1004,Saturday
2017,9,2,2000,309,1051,1360,Saturday
2017,9,2,1900,359,1320,1679,Saturday
2017,9,2,1800,536,1343,1879,Saturday
2017,9,2,1700,622,1340,1962,Saturday
2017,9,2,1600,922,1128,2050,Saturday
2017,9,2,1500,816,957,1773,Saturday
2017,9,2,1400,1177,775,1952,Saturday
2017,9,2,1300,1470,645,2115,Saturday
2017,9,2,1200,1212,486,1698,Saturday
2017,9,2,1100,1563,378,1941,Saturday
2017,9,2,1000,1451,282,1733,Saturday
2017,9,2,900,1169,179,1348,Saturday
2017,9,2,800,714,85,799,Saturday
2017,9,2,700,402,46,448,Saturday
2017,9,2,600,168,39,207,Saturday
2017,9,2,500,65,41,106,Saturday
2017,9,2,400,62,50,112,Saturday
2017,9,2,300,51,68,119,Saturday
2017,9,2,200,61,76,137,Saturday
2017,9,2,100,90,99,189,Saturday
2017,9,1,2400,158,140,298,Friday
2017,9,1,2300,232,226,458,Friday
2017,9,1,2200,424,387,811,Friday
2017,9,1,2100,656,562,1218,Friday
2017,9,1,2000,1028,765,1793,Friday
2017,9,1,1900,1131,937,2068,Friday
2017,9,1,1800,1205,1057,2262,Friday
2017,9,1,1700,1242,1086,2328,Friday
2017,9,1,1600,1296,959,2255,Friday
2017,9,1,1500,1227,793,2020,Friday
2017,9,1,1400,1187,704,1891,Friday
2017,9,1,1300,1175,678,1853,Friday
2017,9,1,1200,1382,543,1925,Friday
2017,9,1,1100,1388,387,1775,Friday
2017,9,1,1000,1321,256,1577,Friday
2017,9,1,900,953,159,1112,Friday
2017,9,1,800,702,118,820,Friday
2017,9,1,700,363,67,430,Friday
2017,9,1,600,161,56,217,Friday
2017,9,1,500,73,46,119,Friday
2017,9,1,400,55,49,104,Friday
2017,9,1,300,58,47,105,Friday
2017,9,1,200,61,77,138,Friday
2017,9,1,100,62,107,169,Friday
2017,8,31,2400,139,154,293,Thursday
2017,8,31,2300,175,198,373,Thursday
2017,8,31,2200,312,351,663,Thursday
2017,8,31,2100,450,468,918,Thursday
2017,8,31,2000,648,748,1396,Thursday
2017,8,31,1900,680,1053,1733,Thursday
2017,8,31,1800,705,1060,1765,Thursday
2017,8,31,1700,790,1004,1794,Thursday
2017,8,31,1600,815,853,1668,Thursday
2017,8,31,1500,773,757,1530,Thursday
2017,8,31,1400,791,593,1384,Thursday
2017,8,31,1300,957,564,1521,Thursday
2017,8,31,1200,1140,478,1618,Thursday
2017,8,31,1100,1173,360,1533,Thursday
2017,8,31,1000,1068,257,1325,Thursday
2017,8,31,900,779,160,939,Thursday
2017,8,31,800,581,109,690,Thursday
2017,8,31,700,295,111,406,Thursday
2017,8,31,600,106,27,133,Thursday
2017,8,31,500,59,15,74,Thursday
2017,8,31,400,35,48,83,Thursday
2017,8,31,300,33,54,87,Thursday
2017,8,31,200,42,71,113,Thursday
2017,8,31,100,68,73,141,Thursday
2017,8,30,2400,98,142,240,Wednesday
2017,8,30,2300,122,210,332,Wednesday
2017,8,30,2200,200,343,543,Wednesday
2017,8,30,2100,255,516,771,Wednesday
2017,8,30,2000,292,743,1035,Wednesday
2017,8,30,1900,372,957,1329,Wednesday
2017,8,30,1800,400,1061,1461,Wednesday
2017,8,30,1700,479,1052,1531,Wednesday
2017,8,30,1600,622,918,1540,Wednesday
2017,8,30,1500,551,716,1267,Wednesday
2017,8,30,1400,631,599,1230,Wednesday
2017,8,30,1300,746,534,1280,Wednesday
2017,8,30,1200,923,482,1405,Wednesday
2017,8,30,1100,1070,351,1421,Wednesday
2017,8,30,1000,972,261,1233,Wednesday
2017,8,30,900,729,198,927,Wednesday
2017,8,30,800,556,119,675,Wednesday
2017,8,30,700,248,94,342,Wednesday
2017,8,30,600,89,52,141,Wednesday
2017,8,30,500,40,48,88,Wednesday
2017,8,30,400,37,51,88,Wednesday
2017,8,30,300,40,54,94,Wednesday
2017,8,30,200,31,78,109,Wednesday
2017,8,30,100,61,176,237,Wednesday
2017,8,29,2400,85,279,364,Tuesday
2017,8,29,2300,136,199,335,Tuesday
2017,8,29,2200,165,569,734,Tuesday
2017,8,29,2100,193,928,1121,Tuesday
2017,8,29,2000,235,967,1202,Tuesday
2017,8,29,1900,308,715,1023,Tuesday
2017,8,29,1800,334,741,1075,Tuesday
2017,8,29,1700,489,867,1356,Tuesday
2017,8,29,1600,532,1024,1556,Tuesday
2017,8,29,1500,603,762,1365,Tuesday
2017,8,29,1400,672,683,1355,Tuesday
2017,8,29,1300,789,605,1394,Tuesday
2017,8,29,1200,1002,427,1429,Tuesday
2017,8,29,1100,1040,347,1387,Tuesday
2017,8,29,1000,947,251,1198,Tuesday
2017,8,29,900,708,164,872,Tuesday
2017,8,29,800,517,102,619,Tuesday
2017,8,29,700,264,60,324,Tuesday
2017,8,29,600,102,52,154,Tuesday
2017,8,29,500,45,43,88,Tuesday
2017,8,29,400,36,50,86,Tuesday
2017,8,29,300,35,76,111,Tuesday
2017,8,29,200,35,78,113,Tuesday
2017,8,29,100,64,118,182,Tuesday
2017,8,28,2400,81,141,222,Monday
2017,8,28,2300,129,250,379,Monday
2017,8,28,2200,148,528,676,Monday
2017,8,28,2100,186,718,904,Monday
2017,8,28,2000,255,977,1232,Monday
2017,8,28,1900,319,1177,1496,Monday
2017,8,28,1800,391,1385,1776,Monday
2017,8,28,1700,497,1288,1785,Monday
2017,8,28,1600,605,1263,1868,Monday
2017,8,28,1500,666,989,1655,Monday
2017,8,28,1400,761,946,1707,Monday
2017,8,28,1300,894,681,1575,Monday
2017,8,28,1200,1125,570,1695,Monday
2017,8,28,1100,1141,429,1570,Monday
2017,8,28,1000,992,283,1275,Monday
2017,8,28,900,833,240,1073,Monday
2017,8,28,800,567,125,692,Monday
2017,8,28,700,272,84,356,Monday
2017,8,28,600,98,53,151,Monday
2017,8,28,500,28,29,57,Monday
2017,8,28,400,37,42,79,Monday
2017,8,28,300,30,49,79,Monday
2017,8,28,200,24,103,127,Monday
2017,8,28,100,37,102,139,Monday
2017,8,27,2400,81,219,300,Sunday
2017,8,27,2300,115,364,479,Sunday
2017,8,27,2200,153,937,1090,Sunday
2017,8,27,2100,182,1575,1757,Sunday
2017,8,27,2000,265,1774,2039,Sunday
2017,8,27,1900,342,1860,2202,Sunday
2017,8,27,1800,440,1600,2040,Sunday
2017,8,27,1700,547,1754,2301,Sunday
2017,8,27,1600,661,1514,2175,Sunday
2017,8,27,1500,821,1150,1971,Sunday
2017,8,27,1400,923,1112,2035,Sunday
2017,8,27,1300,1099,1037,2136,Sunday
2017,8,27,1200,1196,757,1953,Sunday
2017,8,27,1100,1154,516,1670,Sunday
2017,8,27,1000,1105,261,1366,Sunday
2017,8,27,900,835,140,975,Sunday
2017,8,27,800,521,66,587,Sunday
2017,8,27,700,228,33,261,Sunday
2017,8,27,600,116,17,133,Sunday
2017,8,27,500,29,27,56,Sunday
2017,8,27,400,26,35,61,Sunday
2017,8,27,300,34,47,81,Sunday
2017,8,27,200,35,67,102,Sunday
2017,8,27,100,55,98,153,Sunday
2017,8,26,2400,80,155,235,Saturday
2017,8,26,2300,96,264,360,Saturday
2017,8,26,2200,152,490,642,Saturday
2017,8,26,2100,188,849,1037,Saturday
2017,8,26,2000,256,1083,1339,Saturday
2017,8,26,1900,336,1470,1806,Saturday
2017,8,26,1800,426,1501,1927,Saturday
2017,8,26,1700,490,1353,1843,Saturday
2017,8,26,1600,689,1235,1924,Saturday
2017,8,26,1500,919,952,1871,Saturday
2017,8,26,1400,812,828,1640,Saturday
2017,8,26,1300,999,700,1699,Saturday
2017,8,26,1200,1294,555,1849,Saturday
2017,8,26,1100,1413,413,1826,Saturday
2017,8,26,1000,1257,279,1536,Saturday
2017,8,26,900,1040,163,1203,Saturday
2017,8,26,800,661,88,749,Saturday
2017,8,26,700,325,56,381,Saturday
2017,8,26,600,135,40,175,Saturday
2017,8,26,500,51,44,95,Saturday
2017,8,26,400,30,40,70,Saturday
2017,8,26,300,39,50,89,Saturday
2017,8,26,200,47,67,114,Saturday
2017,8,26,100,61,157,218,Saturday
2017,8,25,2400,96,150,246,Friday
2017,8,25,2300,168,265,433,Friday
2017,8,25,2200,254,345,599,Friday
2017,8,25,2100,446,800,1246,Friday
2017,8,25,2000,721,1471,2192,Friday
2017,8,25,1900,774,1344,2118,Friday
2017,8,25,1800,884,1275,2159,Friday
2017,8,25,1700,895,1093,1988,Friday
2017,8,25,1600,978,864,1842,Friday
2017,8,25,1500,993,728,1721,Friday
2017,8,25,1400,1012,653,1665,Friday
2017,8,25,1300,1127,690,1817,Friday
2017,8,25,1200,1351,485,1836,Friday
2017,8,25,1100,1318,401,1719,Friday
2017,8,25,1000,1145,285,1430,Friday
2017,8,25,900,937,182,1119,Friday
2017,8,25,800,607,116,723,Friday
2017,8,25,700,291,59,350,Friday
2017,8,25,600,140,65,205,Friday
2017,8,25,500,55,45,100,Friday
2017,8,25,400,57,52,109,Friday
2017,8,25,300,38,59,97,Friday
2017,8,25,200,61,80,141,Friday
2017,8,25,100,60,108,168,Friday
2017,8,24,2400,100,177,277,Thursday
2017,8,24,2300,147,238,385,Thursday
2017,8,24,2200,232,335,567,Thursday
2017,8,24,2100,335,558,893,Thursday
2017,8,24,2000,443,847,1290,Thursday
2017,8,24,1900,526,1108,1634,Thursday
2017,8,24,1800,583,1282,1865,Thursday
2017,8,24,1700,631,1060,1691,Thursday
2017,8,24,1600,756,1007,1763,Thursday
2017,8,24,1500,770,901,1671,Thursday
2017,8,24,1400,846,776,1622,Thursday
2017,8,24,1300,964,640,1604,Thursday
2017,8,24,1200,1190,509,1699,Thursday
2017,8,24,1100,1104,371,1475,Thursday
2017,8,24,1000,998,275,1273,Thursday
2017,8,24,900,876,194,1070,Thursday
2017,8,24,800,579,112,691,Thursday
2017,8,24,700,267,69,336,Thursday
2017,8,24,600,123,42,165,Thursday
2017,8,24,500,52,29,81,Thursday
2017,8,24,400,37,49,86,Thursday
2017,8,24,300,47,49,96,Thursday
2017,8,24,200,45,75,120,Thursday
2017,8,24,100,68,106,174,Thursday
2017,8,23,2400,104,163,267,Wednesday
2017,8,23,2300,144,243,387,Wednesday
2017,8,23,2200,167,418,585,Wednesday
2017,8,23,2100,276,741,1017,Wednesday
2017,8,23,2000,309,910,1219,Wednesday
2017,8,23,1900,335,975,1310,Wednesday
2017,8,23,1800,469,1304,1773,Wednesday
2017,8,23,1700,449,1131,1580,Wednesday
2017,8,23,1600,547,972,1519,Wednesday
2017,8,23,1500,672,783,1455,Wednesday
2017,8,23,1400,759,678,1437,Wednesday
2017,8,23,1300,890,588,1478,Wednesday
2017,8,23,1200,1021,471,1492,Wednesday
2017,8,23,1100,1107,370,1477,Wednesday
2017,8,23,1000,1010,260,1270,Wednesday
2017,8,23,900,797,185,982,Wednesday
2017,8,23,800,542,119,661,Wednesday
2017,8,23,700,271,74,345,Wednesday
2017,8,23,600,113,46,159,Wednesday
2017,8,23,500,45,40,85,Wednesday
2017,8,23,400,36,59,95,Wednesday
2017,8,23,300,58,57,115,Wednesday
2017,8,23,200,47,76,123,Wednesday
2017,8,23,100,63,115,178,Wednesday
2017,8,22,2400,102,147,249,Tuesday
2017,8,22,2300,109,283,392,Tuesday
2017,8,22,2200,197,482,679,Tuesday
2017,8,22,2100,213,694,907,Tuesday
2017,8,22,2000,247,844,1091,Tuesday
2017,8,22,1900,295,1108,1403,Tuesday
2017,8,22,1800,378,1279,1657,Tuesday
2017,8,22,1700,441,1251,1692,Tuesday
2017,8,22,1600,528,841,1369,Tuesday
2017,8,22,1500,669,692,1361,Tuesday
2017,8,22,1400,675,642,1317,Tuesday
2017,8,22,1300,865,547,1412,Tuesday
2017,8,22,1200,1068,485,1553,Tuesday
2017,8,22,1100,1062,360,1422,Tuesday
2017,8,22,1000,1022,250,1272,Tuesday
2017,8,22,900,766,200,966,Tuesday
2017,8,22,800,531,106,637,Tuesday
2017,8,22,700,251,68,319,Tuesday
2017,8,22,600,106,58,164,Tuesday
2017,8,22,500,48,35,83,Tuesday
2017,8,22,400,38,55,93,Tuesday
2017,8,22,300,40,63,103,Tuesday
2017,8,22,200,34,69,103,Tuesday
2017,8,22,100,64,126,190,Tuesday
2017,8,21,2400,80,141,221,Monday
2017,8,21,2300,105,282,387,Monday
2017,8,21,2200,136,473,609,Monday
2017,8,21,2100,220,789,1009,Monday
2017,8,21,2000,266,1071,1337,Monday
2017,8,21,1900,321,1441,1762,Monday
2017,8,21,1800,392,1335,1727,Monday
2017,8,21,1700,495,1409,1904,Monday
2017,8,21,1600,651,1085,1736,Monday
2017,8,21,1500,815,998,1813,Monday
2017,8,21,1400,905,814,1719,Monday
2017,8,21,1300,1024,759,1783,Monday
2017,8,21,1200,1189,540,1729,Monday
2017,8,21,1100,1195,399,1594,Monday
2017,8,21,1000,1070,249,1319,Monday
2017,8,21,900,832,191,1023,Monday
2017,8,21,800,595,117,712,Monday
2017,8,21,700,284,80,364,Monday
2017,8,21,600,99,33,132,Monday
2017,8,21,500,43,34,77,Monday
2017,8,21,400,30,43,73,Monday
2017,8,21,300,35,38,73,Monday
2017,8,21,200,42,72,114,Monday
2017,8,21,100,49,127,176,Monday
2017,8,20,2400,54,212,266,Sunday
2017,8,20,2300,92,323,415,Sunday
2017,8,20,2200,135,590,725,Sunday
2017,8,20,2100,195,1014,1209,Sunday
2017,8,20,2000,244,1252,1496,Sunday
2017,8,20,1900,363,1874,2237,Sunday
2017,8,20,1800,480,2054,2534,Sunday
2017,8,20,1700,523,2085,2608,Sunday
2017,8,20,1600,745,1800,2545,Sunday
2017,8,20,1500,869,1580,2449,Sunday
2017,8,20,1400,986,1395,2381,Sunday
2017,8,20,1300,1139,1156,2295,Sunday
2017,8,20,1200,1371,819,2190,Sunday
2017,8,20,1100,1363,515,1878,Sunday
2017,8,20,1000,1117,328,1445,Sunday
2017,8,20,900,837,161,998,Sunday
2017,8,20,800,519,58,577,Sunday
2017,8,20,700,258,51,309,Sunday
2017,8,20,600,121,19,140,Sunday
2017,8,20,500,33,26,59,Sunday
2017,8,20,400,37,32,69,Sunday
2017,8,20,300,26,36,62,Sunday
2017,8,20,200,41,60,101,Sunday
2017,8,20,100,38,119,157,Sunday
2017,8,19,2400,67,178,245,Saturday
2017,8,19,2300,105,290,395,Saturday
2017,8,19,2200,169,453,622,Saturday
2017,8,19,2100,216,866,1082,Saturday
2017,8,19,2000,262,1178,1440,Saturday
2017,8,19,1900,340,1512,1852,Saturday
2017,8,19,1800,431,1494,1925,Saturday
2017,8,19,1700,530,1389,1919,Saturday
2017,8,19,1600,708,1248,1956,Saturday
2017,8,19,1500,777,994,1771,Saturday
2017,8,19,1400,948,839,1787,Saturday
2017,8,19,1300,1205,741,1946,Saturday
2017,8,19,1200,1420,568,1988,Saturday
2017,8,19,1100,1367,414,1781,Saturday
2017,8,19,1000,1372,251,1623,Saturday
2017,8,19,900,1085,197,1282,Saturday
2017,8,19,800,686,91,777,Saturday
2017,8,19,700,341,53,394,Saturday
2017,8,19,600,123,46,169,Saturday
2017,8,19,500,49,33,82,Saturday
2017,8,19,400,37,42,79,Saturday
2017,8,19,300,30,48,78,Saturday
2017,8,19,200,42,70,112,Saturday
2017,8,19,100,68,99,167,Saturday
2017,8,18,2400,101,159,260,Friday
2017,8,18,2300,169,276,445,Friday
2017,8,18,2200,282,459,741,Friday
2017,8,18,2100,473,759,1232,Friday
2017,8,18,2000,706,928,1634,Friday
2017,8,18,1900,914,1299,2213,Friday
2017,8,18,1800,872,1266,2138,Friday
2017,8,18,1700,954,1342,2296,Friday
2017,8,18,1600,964,1143,2107,Friday
2017,8,18,1500,1050,931,1981,Friday
2017,8,18,1400,1186,800,1986,Friday
2017,8,18,1300,1167,725,1892,Friday
2017,8,18,1200,1409,547,1956,Friday
2017,8,18,1100,1440,408,1848,Friday
2017,8,18,1000,1244,300,1544,Friday
2017,8,18,900,969,213,1182,Friday
2017,8,18,800,670,95,765,Friday
2017,8,18,700,336,80,416,Friday
2017,8,18,600,152,47,199,Friday
2017,8,18,500,67,48,115,Friday
2017,8,18,400,42,52,94,Friday
2017,8,18,300,53,48,101,Friday
2017,8,18,200,46,72,118,Friday
2017,8,18,100,71,122,193,Friday
2017,8,17,2400,115,175,290,Thursday
2017,8,17,2300,153,262,415,Thursday
2017,8,17,2200,210,501,711,Thursday
2017,8,17,2100,344,739,1083,Thursday
2017,8,17,2000,490,892,1382,Thursday
2017,8,17,1900,543,1106,1649,Thursday
2017,8,17,1800,611,1197,1808,Thursday
2017,8,17,1700,667,1157,1824,Thursday
2017,8,17,1600,768,1031,1799,Thursday
2017,8,17,1500,860,905,1765,Thursday
2017,8,17,1400,855,676,1531,Thursday
2017,8,17,1300,943,671,1614,Thursday
2017,8,17,1200,1216,528,1744,Thursday
2017,8,17,1100,1255,391,1646,Thursday
2017,8,17,1000,1105,270,1375,Thursday
2017,8,17,900,963,190,1153,Thursday
2017,8,17,800,673,99,772,Thursday
2017,8,17,700,308,70,378,Thursday
2017,8,17,600,118,44,162,Thursday
2017,8,17,500,47,42,89,Thursday
2017,8,17,400,38,58,96,Thursday
2017,8,17,300,51,66,117,Thursday
2017,8,17,200,46,88,134,Thursday
2017,8,17,100,62,93,155,Thursday
2017,8,16,2400,91,146,237,Wednesday
2017,8,16,2300,149,245,394,Wednesday
2017,8,16,2200,178,388,566,Wednesday
2017,8,16,2100,241,716,957,Wednesday
2017,8,16,2000,304,895,1199,Wednesday
2017,8,16,1900,342,1081,1423,Wednesday
2017,8,16,1800,450,1245,1695,Wednesday
2017,8,16,1700,499,1153,1652,Wednesday
2017,8,16,1600,624,1005,1629,Wednesday
2017,8,16,1500,701,766,1467,Wednesday
2017,8,16,1400,677,632,1309,Wednesday
2017,8,16,1300,941,585,1526,Wednesday
2017,8,16,1200,1089,459,1548,Wednesday
2017,8,16,1100,1106,391,1497,Wednesday
2017,8,16,1000,1138,252,1390,Wednesday
2017,8,16,900,878,207,1085,Wednesday
2017,8,16,800,593,106,699,Wednesday
2017,8,16,700,284,69,353,Wednesday
2017,8,16,600,105,52,157,Wednesday
2017,8,16,500,35,33,68,Wednesday
2017,8,16,400,39,45,84,Wednesday
2017,8,16,300,34,51,85,Wednesday
2017,8,16,200,39,85,124,Wednesday
2017,8,16,100,48,89,137,Wednesday
2017,8,15,2400,86,139,225,Tuesday
2017,8,15,2300,131,260,391,Tuesday
2017,8,15,2200,162,468,630,Tuesday
2017,8,15,2100,234,662,896,Tuesday
2017,8,15,2000,271,1123,1394,Tuesday
2017,8,15,1900,336,1293,1629,Tuesday
2017,8,15,1800,373,1138,1511,Tuesday
2017,8,15,1700,452,1195,1647,Tuesday
2017,8,15,1600,562,1039,1601,Tuesday
2017,8,15,1500,599,889,1488,Tuesday
2017,8,15,1400,762,681,1443,Tuesday
2017,8,15,1300,870,593,1463,Tuesday
2017,8,15,1200,995,498,1493,Tuesday
2017,8,15,1100,1160,342,1502,Tuesday
2017,8,15,1000,1084,258,1342,Tuesday
2017,8,15,900,881,193,1074,Tuesday
2017,8,15,800,567,104,671,Tuesday
2017,8,15,700,268,55,323,Tuesday
2017,8,15,600,117,55,172,Tuesday
2017,8,15,500,43,57,100,Tuesday
2017,8,15,400,33,57,90,Tuesday
2017,8,15,300,33,47,80,Tuesday
2017,8,15,200,34,69,103,Tuesday
2017,8,15,100,53,108,161,Tuesday
2017,8,14,2400,69,130,199,Monday
2017,8,14,2300,123,283,406,Monday
2017,8,14,2200,145,464,609,Monday
2017,8,14,2100,181,790,971,Monday
2017,8,14,2000,286,1223,1509,Monday
2017,8,14,1900,333,1440,1773,Monday
2017,8,14,1800,433,1387,1820,Monday
2017,8,14,1700,493,1089,1582,Monday
2017,8,14,1600,661,882,1543,Monday
2017,8,14,1500,683,957,1640,Monday
2017,8,14,1400,863,739,1602,Monday
2017,8,14,1300,1019,748,1767,Monday
2017,8,14,1200,1136,605,1741,Monday
2017,8,14,1100,1228,430,1658,Monday
2017,8,14,1000,1014,287,1301,Monday
2017,8,14,900,798,179,977,Monday
2017,8,14,800,491,102,593,Monday
2017,8,14,700,278,66,344,Monday
2017,8,14,600,85,33,118,Monday
2017,8,14,500,40,35,75,Monday
2017,8,14,400,23,40,63,Monday
2017,8,14,300,34,41,75,Monday
2017,8,14,200,33,82,115,Monday
2017,8,14,100,47,125,172,Monday
2017,8,13,2400,62,185,247,Sunday
2017,8,13,2300,88,344,432,Sunday
2017,8,13,2200,137,611,748,Sunday
2017,8,13,2100,207,955,1162,Sunday
2017,8,13,2000,303,1284,1587,Sunday
2017,8,13,1900,364,1596,1960,Sunday
2017,8,13,1800,454,1827,2281,Sunday
2017,8,13,1700,557,1850,2407,Sunday
2017,8,13,1600,683,1959,2642,Sunday
2017,8,13,1500,763,1733,2496,Sunday
2017,8,13,1400,920,1540,2460,Sunday
2017,8,13,1300,1161,1283,2444,Sunday
2017,8,13,1200,1189,1022,2211,Sunday
2017,8,13,1100,1325,532,1857,Sunday
2017,8,13,1000,1147,310,1457,Sunday
2017,8,13,900,907,154,1061,Sunday
2017,8,13,800,563,62,625,Sunday
2017,8,13,700,305,46,351,Sunday
2017,8,13,600,129,31,160,Sunday
2017,8,13,500,32,30,62,Sunday
2017,8,13,400,23,35,58,Sunday
2017,8,13,300,40,59,99,Sunday
2017,8,13,200,32,106,138,Sunday
2017,8,13,100,57,120,177,Sunday
2017,8,12,2400,72,166,238,Saturday
2017,8,12,2300,102,406,508,Saturday
2017,8,12,2200,146,610,756,Saturday
2017,8,12,2100,193,867,1060,Saturday
2017,8,12,2000,260,1168,1428,Saturday
2017,8,12,1900,323,1548,1871,Saturday
2017,8,12,1800,430,1498,1928,Saturday
2017,8,12,1700,553,1588,2141,Saturday
2017,8,12,1600,628,1378,2006,Saturday
2017,8,12,1500,754,1186,1940,Saturday
2017,8,12,1400,1006,937,1943,Saturday
2017,8,12,1300,1316,859,2175,Saturday
2017,8,12,1200,1466,636,2102,Saturday
2017,8,12,1100,1601,460,2061,Saturday
2017,8,12,1000,1182,273,1455,Saturday
2017,8,12,900,1193,196,1389,Saturday
2017,8,12,800,826,84,910,Saturday
2017,8,12,700,371,61,432,Saturday
2017,8,12,600,172,44,216,Saturday
2017,8,12,500,46,29,75,Saturday
2017,8,12,400,46,46,92,Saturday
2017,8,12,300,44,54,98,Saturday
2017,8,12,200,62,101,163,Saturday
2017,8,12,100,76,120,196,Saturday
2017,8,11,2400,115,167,282,Friday
2017,8,11,2300,180,309,489,Friday
2017,8,11,2200,297,498,795,Friday
2017,8,11,2100,438,702,1140,Friday
2017,8,11,2000,639,973,1612,Friday
2017,8,11,1900,776,1165,1941,Friday
2017,8,11,1800,772,1528,2300,Friday
2017,8,11,1700,846,1254,2100,Friday
2017,8,11,1600,946,1158,2104,Friday
2017,8,11,1500,982,973,1955,Friday
2017,8,11,1400,1069,831,1900,Friday
2017,8,11,1300,1182,716,1898,Friday
2017,8,11,1200,1388,641,2029,Friday
2017,8,11,1100,1379,439,1818,Friday
2017,8,11,1000,1233,302,1535,Friday
2017,8,11,900,1134,175,1309,Friday
2017,8,11,800,764,126,890,Friday
2017,8,11,700,352,89,441,Friday
2017,8,11,600,146,71,217,Friday
2017,8,11,500,50,47,97,Friday
2017,8,11,400,45,42,87,Friday
2017,8,11,300,62,53,115,Friday
2017,8,11,200,47,77,124,Friday
2017,8,11,100,64,117,181,Friday
2017,8,10,2400,125,159,284,Thursday
2017,8,10,2300,147,301,448,Thursday
2017,8,10,2200,218,587,805,Thursday
2017,8,10,2100,302,1003,1305,Thursday
2017,8,10,2000,443,866,1309,Thursday
2017,8,10,1900,448,1323,1771,Thursday
2017,8,10,1800,588,1178,1766,Thursday
2017,8,10,1700,577,989,1566,Thursday
2017,8,10,1600,620,945,1565,Thursday
2017,8,10,1500,701,864,1565,Thursday
2017,8,10,1400,881,684,1565,Thursday
2017,8,10,1300,1041,631,1672,Thursday
2017,8,10,1200,1286,507,1793,Thursday
2017,8,10,1100,1206,373,1579,Thursday
2017,8,10,1000,1129,282,1411,Thursday
2017,8,10,900,967,200,1167,Thursday
2017,8,10,800,650,102,752,Thursday
2017,8,10,700,326,75,401,Thursday
2017,8,10,600,125,53,178,Thursday
2017,8,10,500,62,24,86,Thursday
2017,8,10,400,35,53,88,Thursday
2017,8,10,300,49,60,109,Thursday
2017,8,10,200,53,80,133,Thursday
2017,8,10,100,63,94,157,Thursday
2017,8,9,2400,97,195,292,Wednesday
2017,8,9,2300,122,323,445,Wednesday
2017,8,9,2200,185,613,798,Wednesday
2017,8,9,2100,242,868,1110,Wednesday
2017,8,9,2000,318,838,1156,Wednesday
2017,8,9,1900,351,1154,1505,Wednesday
2017,8,9,1800,410,1378,1788,Wednesday
2017,8,9,1700,492,1217,1709,Wednesday
2017,8,9,1600,590,941,1531,Wednesday
2017,8,9,1500,665,815,1480,Wednesday
2017,8,9,1400,771,720,1491,Wednesday
2017,8,9,1300,910,615,1525,Wednesday
2017,8,9,1200,1175,542,1717,Wednesday
2017,8,9,1100,1122,382,1504,Wednesday
2017,8,9,1000,1101,283,1384,Wednesday
2017,8,9,900,928,229,1157,Wednesday
2017,8,9,800,642,142,784,Wednesday
2017,8,9,700,285,78,363,Wednesday
2017,8,9,600,129,51,180,Wednesday
2017,8,9,500,55,54,109,Wednesday
2017,8,9,400,29,34,63,Wednesday
2017,8,9,300,46,82,128,Wednesday
2017,8,9,200,48,69,117,Wednesday
2017,8,9,100,51,109,160,Wednesday
2017,8,8,2400,91,224,315,Tuesday
2017,8,8,2300,131,555,686,Tuesday
2017,8,8,2200,171,1278,1449,Tuesday
2017,8,8,2100,215,1244,1459,Tuesday
2017,8,8,2000,280,1212,1492,Tuesday
2017,8,8,1900,324,1398,1722,Tuesday
2017,8,8,1800,438,1145,1583,Tuesday
2017,8,8,1700,515,1068,1583,Tuesday
2017,8,8,1600,616,781,1397,Tuesday
2017,8,8,1500,695,718,1413,Tuesday
2017,8,8,1400,850,836,1686,Tuesday
2017,8,8,1300,1061,811,1872,Tuesday
2017,8,8,1200,1068,620,1688,Tuesday
2017,8,8,1100,1180,462,1642,Tuesday
2017,8,8,1000,1103,347,1450,Tuesday
2017,8,8,900,910,230,1140,Tuesday
2017,8,8,800,615,188,803,Tuesday
2017,8,8,700,318,110,428,Tuesday
2017,8,8,600,90,49,139,Tuesday
2017,8,8,500,53,33,86,Tuesday
2017,8,8,400,26,55,81,Tuesday
2017,8,8,300,31,57,88,Tuesday
2017,8,8,200,26,120,146,Tuesday
2017,8,8,100,30,170,200,Tuesday
2017,8,7,2400,65,269,334,Monday
2017,8,7,2300,72,573,645,Monday
2017,8,7,2200,138,1060,1198,Monday
2017,8,7,2100,195,1418,1613,Monday
2017,8,7,2000,238,1765,2003,Monday
2017,8,7,1900,316,1950,2266,Monday
2017,8,7,1800,414,1973,2387,Monday
2017,8,7,1700,553,1846,2399,Monday
2017,8,7,1600,732,1933,2665,Monday
2017,8,7,1500,901,1932,2833,Monday
2017,8,7,1400,995,1623,2618,Monday
2017,8,7,1300,1229,1659,2888,Monday
2017,8,7,1200,1372,1190,2562,Monday
2017,8,7,1100,1307,750,2057,Monday
2017,8,7,1000,1256,489,1745,Monday
2017,8,7,900,982,248,1230,Monday
2017,8,7,800,680,89,769,Monday
2017,8,7,700,291,47,338,Monday
2017,8,7,600,118,38,156,Monday
2017,8,7,500,50,43,93,Monday
2017,8,7,400,18,37,55,Monday
2017,8,7,300,21,57,78,Monday
2017,8,7,200,31,89,120,Monday
2017,8,7,100,53,163,216,Monday
2017,8,6,2400,62,274,336,Sunday
2017,8,6,2300,106,564,670,Sunday
2017,8,6,2200,184,863,1047,Sunday
2017,8,6,2100,187,1264,1451,Sunday
2017,8,6,2000,236,1597,1833,Sunday
2017,8,6,1900,331,1777,2108,Sunday
2017,8,6,1800,454,1750,2204,Sunday
2017,8,6,1700,594,1714,2308,Sunday
2017,8,6,1600,816,1357,2173,Sunday
2017,8,6,1500,1140,1250,2390,Sunday
2017,8,6,1400,1251,1034,2285,Sunday
2017,8,6,1300,1335,801,2136,Sunday
2017,8,6,1200,1030,653,1683,Sunday
2017,8,6,1100,1495,415,1910,Sunday
2017,8,6,1000,1345,228,1573,Sunday
2017,8,6,900,1042,137,1179,Sunday
2017,8,6,800,725,71,796,Sunday
2017,8,6,700,324,40,364,Sunday
2017,8,6,600,138,29,167,Sunday
2017,8,6,500,42,25,67,Sunday
2017,8,6,400,25,33,58,Sunday
2017,8,6,300,22,49,71,Sunday
2017,8,6,200,28,73,101,Sunday
2017,8,6,100,53,108,161,Sunday
2017,8,5,2400,72,202,274,Saturday
2017,8,5,2300,108,404,512,Saturday
2017,8,5,2200,136,625,761,Saturday
2017,8,5,2100,195,867,1062,Saturday
2017,8,5,2000,286,1011,1297,Saturday
2017,8,5,1900,350,1376,1726,Saturday
2017,8,5,1800,450,1378,1828,Saturday
2017,8,5,1700,492,1313,1805,Saturday
2017,8,5,1600,721,1104,1825,Saturday
2017,8,5,1500,913,960,1873,Saturday
2017,8,5,1400,1057,765,1822,Saturday
2017,8,5,1300,1353,589,1942,Saturday
2017,8,5,1200,1611,458,2069,Saturday
2017,8,5,1100,1780,343,2123,Saturday
2017,8,5,1000,1755,253,2008,Saturday
2017,8,5,900,1445,167,1612,Saturday
2017,8,5,800,979,103,1082,Saturday
2017,8,5,700,517,52,569,Saturday
2017,8,5,600,220,70,290,Saturday
2017,8,5,500,112,43,155,Saturday
2017,8,5,400,50,65,115,Saturday
2017,8,5,300,38,68,106,Saturday
2017,8,5,200,54,82,136,Saturday
2017,8,5,100,101,138,239,Saturday
2017,8,4,2400,132,185,317,Friday
2017,8,4,2300,258,291,549,Friday
2017,8,4,2200,395,491,886,Friday
2017,8,4,2100,636,670,1306,Friday
2017,8,4,2000,865,879,1744,Friday
2017,8,4,1900,1095,1115,2210,Friday
2017,8,4,1800,1216,1154,2370,Friday
2017,8,4,1700,1196,1068,2264,Friday
2017,8,4,1600,1233,1171,2404,Friday
2017,8,4,1500,1394,897,2291,Friday
2017,8,4,1400,1352,816,2168,Friday
2017,8,4,1300,1412,708,2120,Friday
2017,8,4,1200,1633,605,2238,Friday
2017,8,4,1100,1656,433,2089,Friday
2017,8,4,1000,1581,259,1840,Friday
2017,8,4,900,1282,184,1466,Friday
2017,8,4,800,920,128,1048,Friday
2017,8,4,700,463,73,536,Friday
2017,8,4,600,200,54,254,Friday
2017,8,4,500,82,50,132,Friday
2017,8,4,400,69,51,120,Friday
2017,8,4,300,61,77,138,Friday
2017,8,4,200,83,88,171,Friday
2017,8,4,100,111,126,237,Friday
2017,8,3,2400,157,174,331,Thursday
2017,8,3,2300,217,292,509,Thursday
2017,8,3,2200,309,466,775,Thursday
2017,8,3,2100,513,638,1151,Thursday
2017,8,3,2000,640,877,1517,Thursday
2017,8,3,1900,752,1155,1907,Thursday
2017,8,3,1800,809,1180,1989,Thursday
2017,8,3,1700,781,1102,1883,Thursday
2017,8,3,1600,860,1014,1874,Thursday
2017,8,3,1500,951,817,1768,Thursday
2017,8,3,1400,986,754,1740,Thursday
2017,8,3,1300,1138,623,1761,Thursday
2017,8,3,1200,1440,560,2000,Thursday
2017,8,3,1100,1403,388,1791,Thursday
2017,8,3,1000,1330,239,1569,Thursday
2017,8,3,900,1144,179,1323,Thursday
2017,8,3,800,765,96,861,Thursday
2017,8,3,700,372,58,430,Thursday
2017,8,3,600,138,50,188,Thursday
2017,8,3,500,69,37,106,Thursday
2017,8,3,400,44,37,81,Thursday
2017,8,3,300,43,60,103,Thursday
2017,8,3,200,45,56,101,Thursday
2017,8,3,100,74,102,176,Thursday
2017,8,2,2400,100,166,266,Wednesday
2017,8,2,2300,139,300,439,Wednesday
2017,8,2,2200,203,565,768,Wednesday
2017,8,2,2100,283,732,1015,Wednesday
2017,8,2,2000,367,884,1251,Wednesday
2017,8,2,1900,312,1133,1445,Wednesday
2017,8,2,1800,445,1229,1674,Wednesday
2017,8,2,1700,522,1210,1732,Wednesday
2017,8,2,1600,567,1120,1687,Wednesday
2017,8,2,1500,651,829,1480,Wednesday
2017,8,2,1400,737,588,1325,Wednesday
2017,8,2,1300,871,352,1223,Wednesday
2017,8,2,1200,1126,361,1487,Wednesday
2017,8,2,1100,1219,164,1383,Wednesday
2017,8,2,1000,1161,111,1272,Wednesday
2017,8,2,900,925,173,1098,Wednesday
2017,8,2,800,650,97,747,Wednesday
2017,8,2,700,288,50,338,Wednesday
2017,8,2,600,109,47,156,Wednesday
2017,8,2,500,51,31,82,Wednesday
2017,8,2,400,32,47,79,Wednesday
2017,8,2,300,32,67,99,Wednesday
2017,8,2,200,32,67,99,Wednesday
2017,8,2,100,71,80,151,Wednesday
2017,8,1,2400,91,151,242,Tuesday
2017,8,1,2300,110,272,382,Tuesday
2017,8,1,2200,163,418,581,Tuesday
2017,8,1,2100,194,634,828,Tuesday
2017,8,1,2000,262,891,1153,Tuesday
2017,8,1,1900,312,1108,1420,Tuesday
2017,8,1,1800,427,1055,1482,Tuesday
2017,8,1,1700,487,1050,1537,Tuesday
2017,8,1,1600,554,938,1492,Tuesday
2017,8,1,1500,696,786,1482,Tuesday
2017,8,1,1400,745,682,1427,Tuesday
2017,8,1,1300,868,577,1445,Tuesday
2017,8,1,1200,1161,446,1607,Tuesday
2017,8,1,1100,1125,324,1449,Tuesday
2017,8,1,1000,1029,252,1281,Tuesday
2017,8,1,900,814,173,987,Tuesday
2017,8,1,800,572,115,687,Tuesday
2017,8,1,700,273,61,334,Tuesday
2017,8,1,600,108,54,162,Tuesday
2017,8,1,500,40,42,82,Tuesday
2017,8,1,400,32,56,88,Tuesday
2017,8,1,300,37,57,94,Tuesday
2017,8,1,200,42,62,104,Tuesday
2017,8,1,100,48,106,154,Tuesday
2017,7,31,2400,79,206,285,Monday
2017,7,31,2300,133,308,441,Monday
2017,7,31,2200,171,555,726,Monday
2017,7,31,2100,216,854,1070,Monday
2017,7,31,2000,283,1169,1452,Monday
2017,7,31,1900,361,1406,1767,Monday
2017,7,31,1800,406,1330,1736,Monday
2017,7,31,1700,540,1265,1805,Monday
2017,7,31,1600,643,1077,1720,Monday
2017,7,31,1500,788,905,1693,Monday
2017,7,31,1400,935,780,1715,Monday
2017,7,31,1300,1187,687,1874,Monday
2017,7,31,1200,1156,613,1769,Monday
2017,7,31,1100,1300,391,1691,Monday
2017,7,31,1000,1181,264,1445,Monday
2017,7,31,900,931,200,1131,Monday
2017,7,31,800,649,138,787,Monday
2017,7,31,700,261,70,331,Monday
2017,7,31,600,119,60,179,Monday
2017,7,31,500,58,34,92,Monday
2017,7,31,400,42,36,78,Monday
2017,7,31,300,29,49,78,Monday
2017,7,31,200,26,96,122,Monday
2017,7,31,100,54,143,197,Monday
2017,7,30,2400,60,230,290,Sunday
2017,7,30,2300,107,406,513,Sunday
2017,7,30,2200,167,846,1013,Sunday
2017,7,30,2100,213,1164,1377,Sunday
2017,7,30,2000,323,1506,1829,Sunday
2017,7,30,1900,378,1787,2165,Sunday
2017,7,30,1800,479,1888,2367,Sunday
2017,7,30,1700,586,1871,2457,Sunday
2017,7,30,1600,792,1601,2393,Sunday
2017,7,30,1500,960,1455,2415,Sunday
2017,7,30,1400,1055,1233,2288,Sunday
2017,7,30,1300,1211,1001,2212,Sunday
2017,7,30,1200,1281,738,2019,Sunday
2017,7,30,1100,1310,447,1757,Sunday
2017,7,30,1000,1192,307,1499,Sunday
2017,7,30,900,1017,169,1186,Sunday
2017,7,30,800,621,101,722,Sunday
2017,7,30,700,269,40,309,Sunday
2017,7,30,600,98,22,120,Sunday
2017,7,30,500,45,18,63,Sunday
2017,7,30,400,29,31,60,Sunday
2017,7,30,300,24,48,72,Sunday
2017,7,30,200,23,64,87,Sunday
2017,7,30,100,48,100,148,Sunday
2017,7,29,2400,85,175,260,Saturday
2017,7,29,2300,102,371,473,Saturday
2017,7,29,2200,149,615,764,Saturday
2017,7,29,2100,205,918,1123,Saturday
2017,7,29,2000,285,1140,1425,Saturday
2017,7,29,1900,397,1454,1851,Saturday
2017,7,29,1800,504,1366,1870,Saturday
2017,7,29,1700,550,1225,1775,Saturday
2017,7,29,1600,762,1258,2020,Saturday
2017,7,29,1500,990,1030,2020,Saturday
2017,7,29,1400,1057,871,1928,Saturday
2017,7,29,1300,1342,737,2079,Saturday
2017,7,29,1200,1525,557,2082,Saturday
2017,7,29,1100,1577,421,1998,Saturday
2017,7,29,1000,1550,312,1862,Saturday
2017,7,29,900,1226,165,1391,Saturday
2017,7,29,800,805,129,934,Saturday
2017,7,29,700,380,46,426,Saturday
2017,7,29,600,152,7,159,Saturday
2017,7,29,500,67,4,71,Saturday
2017,7,29,400,45,33,78,Saturday
2017,7,29,300,50,55,105,Saturday
2017,7,29,200,52,72,124,Saturday
2017,7,29,100,76,113,189,Saturday
2017,7,28,2400,114,166,280,Friday
2017,7,28,2300,195,299,494,Friday
2017,7,28,2200,345,456,801,Friday
2017,7,28,2100,549,649,1198,Friday
2017,7,28,2000,789,887,1676,Friday
2017,7,28,1900,937,1143,2080,Friday
2017,7,28,1800,1008,1250,2258,Friday
2017,7,28,1700,1091,1213,2304,Friday
2017,7,28,1600,1077,1036,2113,Friday
2017,7,28,1500,1179,895,2074,Friday
2017,7,28,1400,1167,797,1964,Friday
2017,7,28,1300,1228,701,1929,Friday
2017,7,28,1200,1447,591,2038,Friday
2017,7,28,1100,1468,421,1889,Friday
2017,7,28,1000,1301,265,1566,Friday
2017,7,28,900,1042,176,1218,Friday
2017,7,28,800,725,121,846,Friday
2017,7,28,700,361,56,417,Friday
2017,7,28,600,135,63,198,Friday
2017,7,28,500,79,47,126,Friday
2017,7,28,400,48,52,100,Friday
2017,7,28,300,55,40,95,Friday
2017,7,28,200,49,74,123,Friday
2017,7,28,100,67,108,175,Friday
2017,7,27,2400,116,178,294,Thursday
2017,7,27,2300,214,273,487,Thursday
2017,7,27,2200,258,415,673,Thursday
2017,7,27,2100,415,622,1037,Thursday
2017,7,27,2000,549,866,1415,Thursday
2017,7,27,1900,510,1124,1634,Thursday
2017,7,27,1800,581,1187,1768,Thursday
2017,7,27,1700,664,1164,1828,Thursday
2017,7,27,1600,764,996,1760,Thursday
2017,7,27,1500,869,856,1725,Thursday
2017,7,27,1400,924,743,1667,Thursday
2017,7,27,1300,1025,561,1586,Thursday
2017,7,27,1200,1291,484,1775,Thursday
2017,7,27,1100,1280,364,1644,Thursday
2017,7,27,1000,1191,254,1445,Thursday
2017,7,27,900,956,164,1120,Thursday
2017,7,27,800,662,105,767,Thursday
2017,7,27,700,275,67,342,Thursday
2017,7,27,600,107,64,171,Thursday
2017,7,27,500,65,40,105,Thursday
2017,7,27,400,38,43,81,Thursday
2017,7,27,300,45,55,100,Thursday
2017,7,27,200,54,79,133,Thursday
2017,7,27,100,58,99,157,Thursday
2017,7,26,2400,82,177,259,Wednesday
2017,7,26,2300,169,330,499,Wednesday
2017,7,26,2200,177,466,643,Wednesday
2017,7,26,2100,303,658,961,Wednesday
2017,7,26,2000,316,832,1148,Wednesday
2017,7,26,1900,391,1148,1539,Wednesday
2017,7,26,1800,490,1112,1602,Wednesday
2017,7,26,1700,492,1107,1599,Wednesday
2017,7,26,1600,584,972,1556,Wednesday
2017,7,26,1500,749,760,1509,Wednesday
2017,7,26,1400,783,594,1377,Wednesday
2017,7,26,1300,901,550,1451,Wednesday
2017,7,26,1200,1098,421,1519,Wednesday
2017,7,26,1100,1170,338,1508,Wednesday
2017,7,26,1000,1034,247,1281,Wednesday
2017,7,26,900,911,168,1079,Wednesday
2017,7,26,800,566,132,698,Wednesday
2017,7,26,700,280,61,341,Wednesday
2017,7,26,600,102,51,153,Wednesday
2017,7,26,500,67,49,116,Wednesday
2017,7,26,400,35,39,74,Wednesday
2017,7,26,300,37,53,90,Wednesday
2017,7,26,200,48,85,133,Wednesday
2017,7,26,100,63,107,170,Wednesday
2017,7,25,2400,81,168,249,Tuesday
2017,7,25,2300,106,291,397,Tuesday
2017,7,25,2200,167,459,626,Tuesday
2017,7,25,2100,205,723,928,Tuesday
2017,7,25,2000,272,832,1104,Tuesday
2017,7,25,1900,329,1047,1376,Tuesday
2017,7,25,1800,429,1190,1619,Tuesday
2017,7,25,1700,492,1055,1547,Tuesday
2017,7,25,1600,558,872,1430,Tuesday
2017,7,25,1500,660,745,1405,Tuesday
2017,7,25,1400,793,654,1447,Tuesday
2017,7,25,1300,907,517,1424,Tuesday
2017,7,25,1200,1113,469,1582,Tuesday
2017,7,25,1100,1039,336,1375,Tuesday
2017,7,25,1000,1050,221,1271,Tuesday
2017,7,25,900,847,182,1029,Tuesday
2017,7,25,800,569,113,682,Tuesday
2017,7,25,700,231,71,302,Tuesday
2017,7,25,600,83,48,131,Tuesday
2017,7,25,500,55,39,94,Tuesday
2017,7,25,400,28,67,95,Tuesday
2017,7,25,300,39,51,90,Tuesday
2017,7,25,200,40,72,112,Tuesday
2017,7,25,100,62,102,164,Tuesday
2017,7,24,2400,74,167,241,Monday
2017,7,24,2300,128,309,437,Monday
2017,7,24,2200,161,478,639,Monday
2017,7,24,2100,210,1179,1389,Monday
2017,7,24,2000,291,870,1161,Monday
2017,7,24,1900,341,855,1196,Monday
2017,7,24,1800,412,1290,1702,Monday
2017,7,24,1700,563,1196,1759,Monday
2017,7,24,1600,700,1093,1793,Monday
2017,7,24,1500,796,933,1729,Monday
2017,7,24,1400,914,763,1677,Monday
2017,7,24,1300,1053,670,1723,Monday
2017,7,24,1200,1245,491,1736,Monday
2017,7,24,1100,1294,367,1661,Monday
2017,7,24,1000,1179,253,1432,Monday
2017,7,24,900,861,191,1052,Monday
2017,7,24,800,603,153,756,Monday
2017,7,24,700,265,77,342,Monday
2017,7,24,600,95,44,139,Monday
2017,7,24,500,58,26,84,Monday
2017,7,24,400,28,41,69,Monday
2017,7,24,300,28,50,78,Monday
2017,7,24,200,32,157,189,Monday
2017,7,24,100,51,100,151,Monday
2017,7,23,2400,62,148,210,Sunday
2017,7,23,2300,119,411,530,Sunday
2017,7,23,2200,169,668,837,Sunday
2017,7,23,2100,230,1174,1404,Sunday
2017,7,23,2000,296,1549,1845,Sunday
2017,7,23,1900,378,1742,2120,Sunday
2017,7,23,1800,485,1887,2372,Sunday
2017,7,23,1700,538,1836,2374,Sunday
2017,7,23,1600,777,1604,2381,Sunday
2017,7,23,1500,821,1377,2198,Sunday
2017,7,23,1400,1001,1172,2173,Sunday
2017,7,23,1300,1095,1068,2163,Sunday
2017,7,23,1200,1351,728,2079,Sunday
2017,7,23,1100,1282,445,1727,Sunday
2017,7,23,1000,1131,289,1420,Sunday
2017,7,23,900,852,139,991,Sunday
2017,7,23,800,502,71,573,Sunday
2017,7,23,700,244,38,282,Sunday
2017,7,23,600,74,22,96,Sunday
2017,7,23,500,34,26,60,Sunday
2017,7,23,400,26,29,55,Sunday
2017,7,23,300,15,40,55,Sunday
2017,7,23,200,27,53,80,Sunday
2017,7,23,100,38,96,134,Sunday
2017,7,22,2400,66,142,208,Saturday
2017,7,22,2300,89,292,381,Saturday
2017,7,22,2200,145,462,607,Saturday
2017,7,22,2100,198,734,932,Saturday
2017,7,22,2000,242,1032,1274,Saturday
2017,7,22,1900,341,1225,1566,Saturday
2017,7,22,1800,466,1308,1774,Saturday
2017,7,22,1700,572,1161,1733,Saturday
2017,7,22,1600,737,1146,1883,Saturday
2017,7,22,1500,1024,864,1888,Saturday
2017,7,22,1400,1167,799,1966,Saturday
2017,7,22,1300,943,648,1591,Saturday
2017,7,22,1200,1243,543,1786,Saturday
2017,7,22,1100,1511,347,1858,Saturday
2017,7,22,1000,1323,267,1590,Saturday
2017,7,22,900,1123,148,1271,Saturday
2017,7,22,800,714,88,802,Saturday
2017,7,22,700,350,56,406,Saturday
2017,7,22,600,150,46,196,Saturday
2017,7,22,500,64,42,106,Saturday
2017,7,22,400,37,45,82,Saturday
2017,7,22,300,45,51,96,Saturday
2017,7,22,200,52,76,128,Saturday
2017,7,22,100,66,110,176,Saturday
2017,7,21,2400,124,167,291,Friday
2017,7,21,2300,153,284,437,Friday
2017,7,21,2200,330,352,682,Friday
2017,7,21,2100,532,521,1053,Friday
2017,7,21,2000,776,889,1665,Friday
2017,7,21,1900,928,1095,2023,Friday
2017,7,21,1800,932,1032,1964,Friday
2017,7,21,1700,978,1150,2128,Friday
2017,7,21,1600,1050,1030,2080,Friday
2017,7,21,1500,1099,880,1979,Friday
2017,7,21,1400,1046,790,1836,Friday
2017,7,21,1300,1176,687,1863,Friday
2017,7,21,1200,1377,568,1945,Friday
2017,7,21,1100,1370,399,1769,Friday
2017,7,21,1000,1189,269,1458,Friday
2017,7,21,900,972,187,1159,Friday
2017,7,21,800,603,93,696,Friday
2017,7,21,700,286,57,343,Friday
2017,7,21,600,134,44,178,Friday
2017,7,21,500,54,42,96,Friday
2017,7,21,400,54,41,95,Friday
2017,7,21,300,45,53,98,Friday
2017,7,21,200,74,78,152,Friday
2017,7,21,100,73,140,213,Friday
2017,7,20,2400,117,156,273,Thursday
2017,7,20,2300,170,192,362,Thursday
2017,7,20,2200,234,351,585,Thursday
2017,7,20,2100,380,488,868,Thursday
2017,7,20,2000,553,685,1238,Thursday
2017,7,20,1900,520,931,1451,Thursday
2017,7,20,1800,639,1199,1838,Thursday
2017,7,20,1700,659,1180,1839,Thursday
2017,7,20,1600,783,1127,1910,Thursday
2017,7,20,1500,762,800,1562,Thursday
2017,7,20,1400,896,677,1573,Thursday
2017,7,20,1300,924,576,1500,Thursday
2017,7,20,1200,1158,476,1634,Thursday
2017,7,20,1100,1201,364,1565,Thursday
2017,7,20,1000,1042,259,1301,Thursday
2017,7,20,900,883,163,1046,Thursday
2017,7,20,800,572,109,681,Thursday
2017,7,20,700,285,75,360,Thursday
2017,7,20,600,110,45,155,Thursday
2017,7,20,500,68,42,110,Thursday
2017,7,20,400,36,46,82,Thursday
2017,7,20,300,48,49,97,Thursday
2017,7,20,200,40,62,102,Thursday
2017,7,20,100,61,95,156,Thursday
2017,7,19,2400,93,147,240,Wednesday
2017,7,19,2300,136,261,397,Wednesday
2017,7,19,2200,188,541,729,Wednesday
2017,7,19,2100,228,673,901,Wednesday
2017,7,19,2000,293,760,1053,Wednesday
2017,7,19,1900,375,741,1116,Wednesday
2017,7,19,1800,412,917,1329,Wednesday
2017,7,19,1700,471,980,1451,Wednesday
2017,7,19,1600,540,884,1424,Wednesday
2017,7,19,1500,642,702,1344,Wednesday
2017,7,19,1400,722,622,1344,Wednesday
2017,7,19,1300,889,569,1458,Wednesday
2017,7,19,1200,971,453,1424,Wednesday
2017,7,19,1100,1102,348,1450,Wednesday
2017,7,19,1000,943,231,1174,Wednesday
2017,7,19,900,791,169,960,Wednesday
2017,7,19,800,539,109,648,Wednesday
2017,7,19,700,256,59,315,Wednesday
2017,7,19,600,105,41,146,Wednesday
2017,7,19,500,58,36,94,Wednesday
2017,7,19,400,28,41,69,Wednesday
2017,7,19,300,42,44,86,Wednesday
2017,7,19,200,52,68,120,Wednesday
2017,7,19,100,68,83,151,Wednesday
2017,7,18,2400,84,171,255,Tuesday
2017,7,18,2300,145,273,418,Tuesday
2017,7,18,2200,188,340,528,Tuesday
2017,7,18,2100,212,574,786,Tuesday
2017,7,18,2000,268,820,1088,Tuesday
2017,7,18,1900,291,1059,1350,Tuesday
2017,7,18,1800,422,1183,1605,Tuesday
2017,7,18,1700,470,1105,1575,Tuesday
2017,7,18,1600,547,950,1497,Tuesday
2017,7,18,1500,674,738,1412,Tuesday
2017,7,18,1400,697,681,1378,Tuesday
2017,7,18,1300,966,531,1497,Tuesday
2017,7,18,1200,1080,386,1466,Tuesday
2017,7,18,1100,1060,326,1386,Tuesday
2017,7,18,1000,1029,240,1269,Tuesday
2017,7,18,900,794,140,934,Tuesday
2017,7,18,800,562,117,679,Tuesday
2017,7,18,700,228,58,286,Tuesday
2017,7,18,600,108,53,161,Tuesday
2017,7,18,500,68,36,104,Tuesday
2017,7,18,400,33,54,87,Tuesday
2017,7,18,300,26,42,68,Tuesday
2017,7,18,200,31,78,109,Tuesday
2017,7,18,100,57,106,163,Tuesday
2017,7,17,2400,82,154,236,Monday
2017,7,17,2300,117,334,451,Monday
2017,7,17,2200,172,479,651,Monday
2017,7,17,2100,218,696,914,Monday
2017,7,17,2000,306,921,1227,Monday
2017,7,17,1900,344,1274,1618,Monday
2017,7,17,1800,457,1243,1700,Monday
2017,7,17,1700,589,1234,1823,Monday
2017,7,17,1600,700,985,1685,Monday
2017,7,17,1500,833,810,1643,Monday
2017,7,17,1400,984,765,1749,Monday
2017,7,17,1300,1188,609,1797,Monday
2017,7,17,1200,1306,532,1838,Monday
2017,7,17,1100,1309,375,1684,Monday
2017,7,17,1000,1163,242,1405,Monday
2017,7,17,900,930,185,1115,Monday
2017,7,17,800,629,129,758,Monday
2017,7,17,700,263,97,360,Monday
2017,7,17,600,98,52,150,Monday
2017,7,17,500,54,21,75,Monday
2017,7,17,400,33,31,64,Monday
2017,7,17,300,51,54,105,Monday
2017,7,17,200,51,76,127,Monday
2017,7,17,100,53,148,201,Monday
2017,7,16,2400,86,169,255,Sunday
2017,7,16,2300,96,264,360,Sunday
2017,7,16,2200,188,534,722,Sunday
2017,7,16,2100,214,847,1061,Sunday
2017,7,16,2000,329,1158,1487,Sunday
2017,7,16,1900,416,1507,1923,Sunday
2017,7,16,1800,456,1728,2184,Sunday
2017,7,16,1700,621,1913,2534,Sunday
2017,7,16,1600,816,1721,2537,Sunday
2017,7,16,1500,899,1475,2374,Sunday
2017,7,16,1400,1020,1220,2240,Sunday
2017,7,16,1300,1284,1028,2312,Sunday
2017,7,16,1200,1431,793,2224,Sunday
2017,7,16,1100,1354,500,1854,Sunday
2017,7,16,1000,1245,301,1546,Sunday
2017,7,16,900,883,153,1036,Sunday
2017,7,16,800,570,86,656,Sunday
2017,7,16,700,233,35,268,Sunday
2017,7,16,600,109,35,144,Sunday
2017,7,16,500,46,14,60,Sunday
2017,7,16,400,23,45,68,Sunday
2017,7,16,300,24,38,62,Sunday
2017,7,16,200,38,56,94,Sunday
2017,7,16,100,50,93,143,Sunday
2017,7,15,2400,73,178,251,Saturday
2017,7,15,2300,94,298,392,Saturday
2017,7,15,2200,176,553,729,Saturday
2017,7,15,2100,215,780,995,Saturday
2017,7,15,2000,281,1029,1310,Saturday
2017,7,15,1900,370,1279,1649,Saturday
2017,7,15,1800,613,1372,1985,Saturday
2017,7,15,1700,835,1254,2089,Saturday
2017,7,15,1600,636,1094,1730,Saturday
2017,7,15,1500,600,1018,1618,Saturday
2017,7,15,1400,1095,851,1946,Saturday
2017,7,15,1300,1281,732,2013,Saturday
2017,7,15,1200,1558,599,2157,Saturday
2017,7,15,1100,1582,389,1971,Saturday
2017,7,15,1000,1418,263,1681,Saturday
2017,7,15,900,1153,163,1316,Saturday
2017,7,15,800,721,110,831,Saturday
2017,7,15,700,359,55,414,Saturday
2017,7,15,600,113,36,149,Saturday
2017,7,15,500,58,46,104,Saturday
2017,7,15,400,36,36,72,Saturday
2017,7,15,300,45,51,96,Saturday
2017,7,15,200,53,72,125,Saturday
2017,7,15,100,70,112,182,Saturday
2017,7,14,2400,139,213,352,Friday
2017,7,14,2300,197,256,453,Friday
2017,7,14,2200,297,457,754,Friday
2017,7,14,2100,487,641,1128,Friday
2017,7,14,2000,683,916,1599,Friday
2017,7,14,1900,817,1045,1862,Friday
2017,7,14,1800,872,1153,2025,Friday
2017,7,14,1700,1007,1170,2177,Friday
2017,7,14,1600,989,1103,2092,Friday
2017,7,14,1500,1113,944,2057,Friday
2017,7,14,1400,1169,844,2013,Friday
2017,7,14,1300,1190,684,1874,Friday
2017,7,14,1200,1440,595,2035,Friday
2017,7,14,1100,1486,446,1932,Friday
2017,7,14,1000,1264,304,1568,Friday
2017,7,14,900,1064,201,1265,Friday
2017,7,14,800,684,119,803,Friday
2017,7,14,700,326,74,400,Friday
2017,7,14,600,166,53,219,Friday
2017,7,14,500,88,47,135,Friday
2017,7,14,400,37,50,87,Friday
2017,7,14,300,43,74,117,Friday
2017,7,14,200,51,65,116,Friday
2017,7,14,100,62,133,195,Friday
2017,7,13,2400,122,161,283,Thursday
2017,7,13,2300,171,328,499,Thursday
2017,7,13,2200,246,416,662,Thursday
2017,7,13,2100,319,651,970,Thursday
2017,7,13,2000,467,1083,1550,Thursday
2017,7,13,1900,533,915,1448,Thursday
2017,7,13,1800,621,1200,1821,Thursday
2017,7,13,1700,679,1191,1870,Thursday
2017,7,13,1600,788,1042,1830,Thursday
2017,7,13,1500,889,815,1704,Thursday
2017,7,13,1400,868,702,1570,Thursday
2017,7,13,1300,1019,687,1706,Thursday
2017,7,13,1200,1364,502,1866,Thursday
2017,7,13,1100,1155,388,1543,Thursday
2017,7,13,1000,1121,248,1369,Thursday
2017,7,13,900,995,193,1188,Thursday
2017,7,13,800,634,120,754,Thursday
2017,7,13,700,294,74,368,Thursday
2017,7,13,600,120,53,173,Thursday
2017,7,13,500,68,41,109,Thursday
2017,7,13,400,38,41,79,Thursday
2017,7,13,300,46,55,101,Thursday
2017,7,13,200,41,94,135,Thursday
2017,7,13,100,52,84,136,Thursday
2017,7,12,2400,105,137,242,Wednesday
2017,7,12,2300,143,260,403,Wednesday
2017,7,12,2200,223,417,640,Wednesday
2017,7,12,2100,257,650,907,Wednesday
2017,7,12,2000,298,804,1102,Wednesday
2017,7,12,1900,383,1122,1505,Wednesday
2017,7,12,1800,497,1071,1568,Wednesday
2017,7,12,1700,552,1096,1648,Wednesday
2017,7,12,1600,660,1011,1671,Wednesday
2017,7,12,1500,749,775,1524,Wednesday
2017,7,12,1400,943,757,1700,Wednesday
2017,7,12,1300,902,589,1491,Wednesday
2017,7,12,1200,990,450,1440,Wednesday
2017,7,12,1100,1186,362,1548,Wednesday
2017,7,12,1000,1000,259,1259,Wednesday
2017,7,12,900,781,176,957,Wednesday
2017,7,12,800,530,119,649,Wednesday
2017,7,12,700,232,79,311,Wednesday
2017,7,12,600,96,51,147,Wednesday
2017,7,12,500,52,44,96,Wednesday
2017,7,12,400,35,37,72,Wednesday
2017,7,12,300,38,53,91,Wednesday
2017,7,12,200,45,69,114,Wednesday
2017,7,12,100,55,107,162,Wednesday
2017,7,11,2400,91,200,291,Tuesday
2017,7,11,2300,123,250,373,Tuesday
2017,7,11,2200,155,404,559,Tuesday
2017,7,11,2100,200,481,681,Tuesday
2017,7,11,2000,282,703,985,Tuesday
2017,7,11,1900,310,965,1275,Tuesday
2017,7,11,1800,449,1074,1523,Tuesday
2017,7,11,1700,453,913,1366,Tuesday
2017,7,11,1600,584,845,1429,Tuesday
2017,7,11,1500,597,688,1285,Tuesday
2017,7,11,1400,787,619,1406,Tuesday
2017,7,11,1300,843,543,1386,Tuesday
2017,7,11,1200,987,490,1477,Tuesday
2017,7,11,1100,961,374,1335,Tuesday
2017,7,11,1000,785,260,1045,Tuesday
2017,7,11,900,628,177,805,Tuesday
2017,7,11,800,369,119,488,Tuesday
2017,7,11,700,193,76,269,Tuesday
2017,7,11,600,82,50,132,Tuesday
2017,7,11,500,42,26,68,Tuesday
2017,7,11,400,25,52,77,Tuesday
2017,7,11,300,33,40,73,Tuesday
2017,7,11,200,34,75,109,Tuesday
2017,7,11,100,44,113,157,Tuesday
2017,7,10,2400,90,165,255,Monday
2017,7,10,2300,120,318,438,Monday
2017,7,10,2200,156,444,600,Monday
2017,7,10,2100,244,610,854,Monday
2017,7,10,2000,313,795,1108,Monday
2017,7,10,1900,344,1236,1580,Monday
2017,7,10,1800,406,1334,1740,Monday
2017,7,10,1700,554,1267,1821,Monday
2017,7,10,1600,635,1086,1721,Monday
2017,7,10,1500,774,907,1681,Monday
2017,7,10,1400,831,824,1655,Monday
2017,7,10,1300,959,669,1628,Monday
2017,7,10,1200,1221,567,1788,Monday
2017,7,10,1100,1144,425,1569,Monday
2017,7,10,1000,995,238,1233,Monday
2017,7,10,900,783,214,997,Monday
2017,7,10,800,476,133,609,Monday
2017,7,10,700,202,76,278,Monday
2017,7,10,600,82,35,117,Monday
2017,7,10,500,48,43,91,Monday
2017,7,10,400,34,37,71,Monday
2017,7,10,300,39,50,89,Monday
2017,7,10,200,39,89,128,Monday
2017,7,10,100,48,158,206,Monday
2017,7,9,2400,63,206,269,Sunday
2017,7,9,2300,100,435,535,Sunday
2017,7,9,2200,138,707,845,Sunday
2017,7,9,2100,214,955,1169,Sunday
2017,7,9,2000,274,1271,1545,Sunday
2017,7,9,1900,346,1605,1951,Sunday
2017,7,9,1800,399,1874,2273,Sunday
2017,7,9,1700,584,1736,2320,Sunday
2017,7,9,1600,729,1550,2279,Sunday
2017,7,9,1500,950,1475,2425,Sunday
2017,7,9,1400,998,1255,2253,Sunday
2017,7,9,1300,1154,1085,2239,Sunday
2017,7,9,1200,1288,784,2072,Sunday
2017,7,9,1100,1211,531,1742,Sunday
2017,7,9,1000,1087,305,1392,Sunday
2017,7,9,900,879,174,1053,Sunday
2017,7,9,800,523,106,629,Sunday
2017,7,9,700,217,47,264,Sunday
2017,7,9,600,88,21,109,Sunday
2017,7,9,500,53,29,82,Sunday
2017,7,9,400,34,23,57,Sunday
2017,7,9,300,30,27,57,Sunday
2017,7,9,200,33,54,87,Sunday
2017,7,9,100,50,96,146,Sunday
2017,7,8,2400,67,194,261,Saturday
2017,7,8,2300,108,404,512,Saturday
2017,7,8,2200,160,551,711,Saturday
2017,7,8,2100,197,845,1042,Saturday
2017,7,8,2000,236,1072,1308,Saturday
2017,7,8,1900,339,1399,1738,Saturday
2017,7,8,1800,404,1409,1813,Saturday
2017,7,8,1700,570,1291,1861,Saturday
2017,7,8,1600,724,1152,1876,Saturday
2017,7,8,1500,858,955,1813,Saturday
2017,7,8,1400,970,833,1803,Saturday
2017,7,8,1300,1212,670,1882,Saturday
2017,7,8,1200,1348,601,1949,Saturday
2017,7,8,1100,1389,444,1833,Saturday
2017,7,8,1000,1298,273,1571,Saturday
2017,7,8,900,1059,190,1249,Saturday
2017,7,8,800,661,101,762,Saturday
2017,7,8,700,297,59,356,Saturday
2017,7,8,600,118,43,161,Saturday
2017,7,8,500,70,41,111,Saturday
2017,7,8,400,38,47,85,Saturday
2017,7,8,300,45,55,100,Saturday
2017,7,8,200,33,70,103,Saturday
2017,7,8,100,78,109,187,Saturday
2017,7,7,2400,103,180,283,Friday
2017,7,7,2300,191,306,497,Friday
2017,7,7,2200,294,440,734,Friday
2017,7,7,2100,383,597,980,Friday
2017,7,7,2000,573,885,1458,Friday
2017,7,7,1900,713,1276,1989,Friday
2017,7,7,1800,741,1205,1946,Friday
2017,7,7,1700,794,1198,1992,Friday
2017,7,7,1600,938,1136,2074,Friday
2017,7,7,1500,944,946,1890,Friday
2017,7,7,1400,1019,833,1852,Friday
2017,7,7,1300,1064,724,1788,Friday
2017,7,7,1200,1220,591,1811,Friday
2017,7,7,1100,1230,428,1658,Friday
2017,7,7,1000,1165,311,1476,Friday
2017,7,7,900,1008,190,1198,Friday
2017,7,7,800,655,124,779,Friday
2017,7,7,700,335,70,405,Friday
2017,7,7,600,130,52,182,Friday
2017,7,7,500,81,56,137,Friday
2017,7,7,400,51,49,100,Friday
2017,7,7,300,54,47,101,Friday
2017,7,7,200,35,89,124,Friday
2017,7,7,100,89,123,212,Friday
2017,7,6,2400,121,191,312,Thursday
2017,7,6,2300,163,334,497,Thursday
2017,7,6,2200,221,570,791,Thursday
2017,7,6,2100,350,690,1040,Thursday
2017,7,6,2000,451,956,1407,Thursday
2017,7,6,1900,496,1227,1723,Thursday
2017,7,6,1800,571,1314,1885,Thursday
2017,7,6,1700,644,1273,1917,Thursday
2017,7,6,1600,680,1081,1761,Thursday
2017,7,6,1500,789,973,1762,Thursday
2017,7,6,1400,849,837,1686,Thursday
2017,7,6,1300,983,712,1695,Thursday
2017,7,6,1200,1241,530,1771,Thursday
2017,7,6,1100,1232,368,1600,Thursday
2017,7,6,1000,1050,241,1291,Thursday
2017,7,6,900,922,172,1094,Thursday
2017,7,6,800,608,112,720,Thursday
2017,7,6,700,293,79,372,Thursday
2017,7,6,600,133,52,185,Thursday
2017,7,6,500,66,55,121,Thursday
2017,7,6,400,42,50,92,Thursday
2017,7,6,300,61,60,121,Thursday
2017,7,6,200,16,58,74,Thursday
2017,7,6,100,75,121,196,Thursday
2017,7,5,2400,104,310,414,Wednesday
2017,7,5,2300,138,407,545,Wednesday
2017,7,5,2200,215,377,592,Wednesday
2017,7,5,2100,275,744,1019,Wednesday
2017,7,5,2000,351,1087,1438,Wednesday
2017,7,5,1900,382,1097,1479,Wednesday
2017,7,5,1800,423,1296,1719,Wednesday
2017,7,5,1700,536,1087,1623,Wednesday
2017,7,5,1600,557,1107,1664,Wednesday
2017,7,5,1500,706,918,1624,Wednesday
2017,7,5,1400,773,782,1555,Wednesday
2017,7,5,1300,937,654,1591,Wednesday
2017,7,5,1200,1103,498,1601,Wednesday
2017,7,5,1100,1182,392,1574,Wednesday
2017,7,5,1000,1035,308,1343,Wednesday
2017,7,5,900,915,189,1104,Wednesday
2017,7,5,800,653,113,766,Wednesday
2017,7,5,700,279,69,348,Wednesday
2017,7,5,600,92,54,146,Wednesday
2017,7,5,500,63,48,111,Wednesday
2017,7,5,400,38,41,79,Wednesday
2017,7,5,300,28,55,83,Wednesday
2017,7,5,200,43,62,105,Wednesday
2017,7,5,100,52,180,232,Wednesday
2017,7,4,2400,100,578,678,Tuesday
2017,7,4,2300,118,726,844,Tuesday
2017,7,4,2200,164,686,850,Tuesday
2017,7,4,2100,235,826,1061,Tuesday
2017,7,4,2000,288,1112,1400,Tuesday
2017,7,4,1900,334,1288,1622,Tuesday
2017,7,4,1800,439,1222,1661,Tuesday
2017,7,4,1700,497,1256,1753,Tuesday
2017,7,4,1600,637,958,1595,Tuesday
2017,7,4,1500,726,1020,1746,Tuesday
2017,7,4,1400,775,860,1635,Tuesday
2017,7,4,1300,965,798,1763,Tuesday
2017,7,4,1200,1203,595,1798,Tuesday
2017,7,4,1100,1243,486,1729,Tuesday
2017,7,4,1000,1097,372,1469,Tuesday
2017,7,4,900,974,228,1202,Tuesday
2017,7,4,800,611,206,817,Tuesday
2017,7,4,700,280,220,500,Tuesday
2017,7,4,600,83,48,131,Tuesday
2017,7,4,500,55,10,65,Tuesday
2017,7,4,400,40,18,58,Tuesday
2017,7,4,300,30,40,70,Tuesday
2017,7,4,200,31,89,120,Tuesday
2017,7,4,100,41,169,210,Tuesday
2017,7,3,2400,98,322,420,Monday
2017,7,3,2300,109,636,745,Monday
2017,7,3,2200,183,1191,1374,Monday
2017,7,3,2100,219,1712,1931,Monday
2017,7,3,2000,245,1798,2043,Monday
2017,7,3,1900,351,2128,2479,Monday
2017,7,3,1800,484,2224,2708,Monday
2017,7,3,1700,612,2058,2670,Monday
2017,7,3,1600,781,2013,2794,Monday
2017,7,3,1500,1036,1833,2869,Monday
2017,7,3,1400,964,1792,2756,Monday
2017,7,3,1300,1087,1437,2524,Monday
2017,7,3,1200,1473,1072,2545,Monday
2017,7,3,1100,1396,686,2082,Monday
2017,7,3,1000,1356,368,1724,Monday
2017,7,3,900,1032,221,1253,Monday
2017,7,3,800,695,101,796,Monday
2017,7,3,700,281,67,348,Monday
2017,7,3,600,105,43,148,Monday
2017,7,3,500,47,28,75,Monday
2017,7,3,400,30,44,74,Monday
2017,7,3,300,22,62,84,Monday
2017,7,3,200,34,117,151,Monday
2017,7,3,100,47,163,210,Monday
2017,7,2,2400,82,311,393,Sunday
2017,7,2,2300,123,593,716,Sunday
2017,7,2,2200,167,877,1044,Sunday
2017,7,2,2100,223,1185,1408,Sunday
2017,7,2,2000,296,1527,1823,Sunday
2017,7,2,1900,376,1700,2076,Sunday
2017,7,2,1800,513,1675,2188,Sunday
2017,7,2,1700,641,1600,2241,Sunday
2017,7,2,1600,848,1350,2198,Sunday
2017,7,2,1500,1011,1190,2201,Sunday
2017,7,2,1400,1283,940,2223,Sunday
2017,7,2,1300,1312,729,2041,Sunday
2017,7,2,1200,1575,577,2152,Sunday
2017,7,2,1100,1531,318,1849,Sunday
2017,7,2,1000,1303,202,1505,Sunday
2017,7,2,900,1005,117,1122,Sunday
2017,7,2,800,532,69,601,Sunday
2017,7,2,700,229,37,266,Sunday
2017,7,2,600,82,22,104,Sunday
2017,7,2,500,37,31,68,Sunday
2017,7,2,400,33,34,67,Sunday
2017,7,2,300,30,22,52,Sunday
2017,7,2,200,28,48,76,Sunday
2017,7,2,100,72,74,146,Sunday
2017,7,1,2400,199,114,313,Saturday
2017,7,1,2300,91,283,374,Saturday
2017,7,1,2200,119,428,547,Saturday
2017,7,1,2100,196,674,870,Saturday
2017,7,1,2000,246,757,1003,Saturday
2017,7,1,1900,315,854,1169,Saturday
2017,7,1,1800,420,919,1339,Saturday
2017,7,1,1700,589,1016,1605,Saturday
2017,7,1,1600,683,879,1562,Saturday
2017,7,1,1500,910,713,1623,Saturday
2017,7,1,1400,1058,616,1674,Saturday
2017,7,1,1300,1318,550,1868,Saturday
2017,7,1,1200,1266,444,1710,Saturday
2017,7,1,1100,1469,376,1845,Saturday
2017,7,1,1000,1357,267,1624,Saturday
2017,7,1,900,1144,182,1326,Saturday
2017,7,1,800,822,103,925,Saturday
2017,7,1,700,470,72,542,Saturday
2017,7,1,600,201,41,242,Saturday
2017,7,1,500,85,34,119,Saturday
2017,7,1,400,55,37,92,Saturday
2017,7,1,300,79,61,140,Saturday
2017,7,1,200,90,86,176,Saturday
2017,7,1,100,125,127,252,Saturday
2017,6,30,2400,202,183,385,Friday
2017,6,30,2300,281,268,549,Friday
2017,6,30,2200,467,364,831,Friday
2017,6,30,2100,794,565,1359,Friday
2017,6,30,2000,1162,764,1926,Friday
2017,6,30,1900,1255,882,2137,Friday
2017,6,30,1800,1394,1007,2401,Friday
2017,6,30,1700,1596,942,2538,Friday
2017,6,30,1600,1675,921,2596,Friday
2017,6,30,1500,1755,706,2461,Friday
2017,6,30,1400,1534,636,2170,Friday
2017,6,30,1300,1565,570,2135,Friday
2017,6,30,1200,1865,493,2358,Friday
2017,6,30,1100,1840,368,2208,Friday
2017,6,30,1000,1774,249,2023,Friday
2017,6,30,900,1403,182,1585,Friday
2017,6,30,800,1015,108,1123,Friday
2017,6,30,700,444,76,520,Friday
2017,6,30,600,189,56,245,Friday
2017,6,30,500,92,43,135,Friday
2017,6,30,400,54,34,88,Friday
2017,6,30,300,77,45,122,Friday
2017,6,30,200,68,66,134,Friday
2017,6,30,100,118,93,211,Friday
2017,6,29,2400,175,160,335,Thursday
2017,6,29,2300,294,252,546,Thursday
2017,6,29,2200,487,401,888,Thursday
2017,6,29,2100,660,556,1216,Thursday
2017,6,29,2000,1016,680,1696,Thursday
2017,6,29,1900,1020,876,1896,Thursday
2017,6,29,1800,960,859,1819,Thursday
2017,6,29,1700,1036,856,1892,Thursday
2017,6,29,1600,959,864,1823,Thursday
2017,6,29,1500,963,666,1629,Thursday
2017,6,29,1400,1060,574,1634,Thursday
2017,6,29,1300,1095,556,1651,Thursday
2017,6,29,1200,1193,394,1587,Thursday
2017,6,29,1100,1295,313,1608,Thursday
2017,6,29,1000,1160,215,1375,Thursday
2017,6,29,900,969,164,1133,Thursday
2017,6,29,800,606,133,739,Thursday
2017,6,29,700,268,72,340,Thursday
2017,6,29,600,125,47,172,Thursday
2017,6,29,500,60,43,103,Thursday
2017,6,29,400,44,42,86,Thursday
2017,6,29,300,42,50,92,Thursday
2017,6,29,200,45,53,98,Thursday
2017,6,29,100,64,78,142,Thursday
2017,6,28,2400,106,128,234,Wednesday
2017,6,28,2300,146,201,347,Wednesday
2017,6,28,2200,219,284,503,Wednesday
2017,6,28,2100,278,371,649,Wednesday
2017,6,28,2000,382,540,922,Wednesday
2017,6,28,1900,401,792,1193,Wednesday
2017,6,28,1800,494,732,1226,Wednesday
2017,6,28,1700,569,759,1328,Wednesday
2017,6,28,1600,570,675,1245,Wednesday
2017,6,28,1500,659,655,1314,Wednesday
2017,6,28,1400,722,534,1256,Wednesday
2017,6,28,1300,609,495,1104,Wednesday
2017,6,28,1200,829,396,1225,Wednesday
2017,6,28,1100,892,322,1214,Wednesday
2017,6,28,1000,806,247,1053,Wednesday
2017,6,28,900,665,153,818,Wednesday
2017,6,28,800,400,106,506,Wednesday
2017,6,28,700,172,72,244,Wednesday
2017,6,28,600,73,51,124,Wednesday
2017,6,28,500,55,43,98,Wednesday
2017,6,28,400,32,43,75,Wednesday
2017,6,28,300,21,50,71,Wednesday
2017,6,28,200,54,58,112,Wednesday
2017,6,28,100,64,81,145,Wednesday
2017,6,27,2400,94,113,207,Tuesday
2017,6,27,2300,124,211,335,Tuesday
2017,6,27,2200,154,342,496,Tuesday
2017,6,27,2100,203,526,729,Tuesday
2017,6,27,2000,252,644,896,Tuesday
2017,6,27,1900,270,845,1115,Tuesday
2017,6,27,1800,346,848,1194,Tuesday
2017,6,27,1700,378,838,1216,Tuesday
2017,6,27,1600,465,756,1221,Tuesday
2017,6,27,1500,544,575,1119,Tuesday
2017,6,27,1400,572,493,1065,Tuesday
2017,6,27,1300,621,504,1125,Tuesday
2017,6,27,1200,820,363,1183,Tuesday
2017,6,27,1100,902,299,1201,Tuesday
2017,6,27,1000,926,229,1155,Tuesday
2017,6,27,900,711,149,860,Tuesday
2017,6,27,800,430,114,544,Tuesday
2017,6,27,700,202,64,266,Tuesday
2017,6,27,600,89,47,136,Tuesday
2017,6,27,500,31,28,59,Tuesday
2017,6,27,400,27,37,64,Tuesday
2017,6,27,300,31,38,69,Tuesday
2017,6,27,200,30,49,79,Tuesday
2017,6,27,100,55,90,145,Tuesday
2017,6,26,2400,70,124,194,Monday
2017,6,26,2300,117,192,309,Monday
2017,6,26,2200,149,391,540,Monday
2017,6,26,2100,186,521,707,Monday
2017,6,26,2000,231,711,942,Monday
2017,6,26,1900,260,893,1153,Monday
2017,6,26,1800,369,1041,1410,Monday
2017,6,26,1700,404,1028,1432,Monday
2017,6,26,1600,521,887,1408,Monday
2017,6,26,1500,551,666,1217,Monday
2017,6,26,1400,647,618,1265,Monday
2017,6,26,1300,741,536,1277,Monday
2017,6,26,1200,969,455,1424,Monday
2017,6,26,1100,975,262,1237,Monday
2017,6,26,1000,979,207,1186,Monday
2017,6,26,900,667,148,815,Monday
2017,6,26,800,423,126,549,Monday
2017,6,26,700,206,62,268,Monday
2017,6,26,600,57,42,99,Monday
2017,6,26,500,49,18,67,Monday
2017,6,26,400,34,34,68,Monday
2017,6,26,300,29,29,58,Monday
2017,6,26,200,30,45,75,Monday
2017,6,26,100,36,108,144,Monday
2017,6,25,2400,55,193,248,Sunday
2017,6,25,2300,112,344,456,Sunday
2017,6,25,2200,141,559,700,Sunday
2017,6,25,2100,185,817,1002,Sunday
2017,6,25,2000,248,1112,1360,Sunday
2017,6,25,1900,313,1311,1624,Sunday
2017,6,25,1800,370,1580,1950,Sunday
2017,6,25,1700,452,1601,2053,Sunday
2017,6,25,1600,542,1315,1857,Sunday
2017,6,25,1500,676,1159,1835,Sunday
2017,6,25,1400,730,931,1661,Sunday
2017,6,25,1300,854,843,1697,Sunday
2017,6,25,1200,976,619,1595,Sunday
2017,6,25,1100,994,386,1380,Sunday
2017,6,25,1000,904,247,1151,Sunday
2017,6,25,900,698,130,828,Sunday
2017,6,25,800,401,82,483,Sunday
2017,6,25,700,174,33,207,Sunday
2017,6,25,600,74,26,100,Sunday
2017,6,25,500,47,14,61,Sunday
2017,6,25,400,22,28,50,Sunday
2017,6,25,300,20,27,47,Sunday
2017,6,25,200,31,37,68,Sunday
2017,6,25,100,34,63,97,Sunday
2017,6,24,2400,64,130,194,Saturday
2017,6,24,2300,105,211,316,Saturday
2017,6,24,2200,161,375,536,Saturday
2017,6,24,2100,181,569,750,Saturday
2017,6,24,2000,187,696,883,Saturday
2017,6,24,1900,267,893,1160,Saturday
2017,6,24,1800,329,938,1267,Saturday
2017,6,24,1700,397,944,1341,Saturday
2017,6,24,1600,519,754,1273,Saturday
2017,6,24,1500,589,592,1181,Saturday
2017,6,24,1400,706,568,1274,Saturday
2017,6,24,1300,796,496,1292,Saturday
2017,6,24,1200,1035,446,1481,Saturday
2017,6,24,1100,1191,301,1492,Saturday
2017,6,24,1000,1024,192,1216,Saturday
2017,6,24,900,795,144,939,Saturday
2017,6,24,800,493,92,585,Saturday
2017,6,24,700,188,55,243,Saturday
2017,6,24,600,70,29,99,Saturday
2017,6,24,500,50,31,81,Saturday
2017,6,24,400,36,38,74,Saturday
2017,6,24,300,30,39,69,Saturday
2017,6,24,200,48,60,108,Saturday
2017,6,24,100,54,78,132,Saturday
2017,6,23,2400,97,127,224,Friday
2017,6,23,2300,156,202,358,Friday
2017,6,23,2200,265,312,577,Friday
2017,6,23,2100,476,448,924,Friday
2017,6,23,2000,660,615,1275,Friday
2017,6,23,1900,770,692,1462,Friday
2017,6,23,1800,773,814,1587,Friday
2017,6,23,1700,740,783,1523,Friday
2017,6,23,1600,804,708,1512,Friday
2017,6,23,1500,819,580,1399,Friday
2017,6,23,1400,797,520,1317,Friday
2017,6,23,1300,802,551,1353,Friday
2017,6,23,1200,945,360,1305,Friday
2017,6,23,1100,1066,305,1371,Friday
2017,6,23,1000,950,254,1204,Friday
2017,6,23,900,705,138,843,Friday
2017,6,23,800,431,100,531,Friday
2017,6,23,700,211,60,271,Friday
2017,6,23,600,88,51,139,Friday
2017,6,23,500,51,20,71,Friday
2017,6,23,400,39,34,73,Friday
2017,6,23,300,37,35,72,Friday
2017,6,23,200,44,42,86,Friday
2017,6,23,100,53,92,145,Friday
2017,6,22,2400,98,124,222,Thursday
2017,6,22,2300,149,207,356,Thursday
2017,6,22,2200,227,323,550,Thursday
2017,6,22,2100,342,411,753,Thursday
2017,6,22,2000,392,542,934,Thursday
2017,6,22,1900,446,696,1142,Thursday
2017,6,22,1800,480,827,1307,Thursday
2017,6,22,1700,512,713,1225,Thursday
2017,6,22,1600,548,633,1181,Thursday
2017,6,22,1500,658,613,1271,Thursday
2017,6,22,1400,618,499,1117,Thursday
2017,6,22,1300,631,443,1074,Thursday
2017,6,22,1200,766,395,1161,Thursday
2017,6,22,1100,911,294,1205,Thursday
2017,6,22,1000,857,208,1065,Thursday
2017,6,22,900,698,163,861,Thursday
2017,6,22,800,370,79,449,Thursday
2017,6,22,700,175,61,236,Thursday
2017,6,22,600,84,56,140,Thursday
2017,6,22,500,49,30,79,Thursday
2017,6,22,400,32,32,64,Thursday
2017,6,22,300,35,29,64,Thursday
2017,6,22,200,39,53,92,Thursday
2017,6,22,100,54,77,131,Thursday
2017,6,21,2400,87,122,209,Wednesday
2017,6,21,2300,130,173,303,Wednesday
2017,6,21,2200,196,261,457,Wednesday
2017,6,21,2100,233,396,629,Wednesday
2017,6,21,2000,244,448,692,Wednesday
2017,6,21,1900,311,696,1007,Wednesday
2017,6,21,1800,320,780,1100,Wednesday
2017,6,21,1700,386,723,1109,Wednesday
2017,6,21,1600,392,657,1049,Wednesday
2017,6,21,1500,489,567,1056,Wednesday
2017,6,21,1400,529,464,993,Wednesday
2017,6,21,1300,624,441,1065,Wednesday
2017,6,21,1200,738,337,1075,Wednesday
2017,6,21,1100,830,278,1108,Wednesday
2017,6,21,1000,759,217,976,Wednesday
2017,6,21,900,627,148,775,Wednesday
2017,6,21,800,365,119,484,Wednesday
2017,6,21,700,170,64,234,Wednesday
2017,6,21,600,73,39,112,Wednesday
2017,6,21,500,33,27,60,Wednesday
2017,6,21,400,32,39,71,Wednesday
2017,6,21,300,26,49,75,Wednesday
2017,6,21,200,32,46,78,Wednesday
2017,6,21,100,62,88,150,Wednesday
2017,6,20,2400,75,109,184,Tuesday
2017,6,20,2300,106,164,270,Tuesday
2017,6,20,2200,158,235,393,Tuesday
2017,6,20,2100,206,389,595,Tuesday
2017,6,20,2000,204,546,750,Tuesday
2017,6,20,1900,248,916,1164,Tuesday
2017,6,20,1800,296,753,1049,Tuesday
2017,6,20,1700,359,814,1173,Tuesday
2017,6,20,1600,388,715,1103,Tuesday
2017,6,20,1500,456,577,1033,Tuesday
2017,6,20,1400,505,424,929,Tuesday
2017,6,20,1300,615,402,1017,Tuesday
2017,6,20,1200,784,394,1178,Tuesday
2017,6,20,1100,829,230,1059,Tuesday
2017,6,20,1000,754,220,974,Tuesday
2017,6,20,900,590,153,743,Tuesday
2017,6,20,800,372,104,476,Tuesday
2017,6,20,700,166,47,213,Tuesday
2017,6,20,600,53,44,97,Tuesday
2017,6,20,500,37,22,59,Tuesday
2017,6,20,400,20,31,51,Tuesday
2017,6,20,300,30,39,69,Tuesday
2017,6,20,200,32,68,100,Tuesday
2017,6,20,100,47,74,121,Tuesday
2017,6,19,2400,89,144,233,Monday
2017,6,19,2300,100,187,287,Monday
2017,6,19,2200,145,343,488,Monday
2017,6,19,2100,171,576,747,Monday
2017,6,19,2000,193,707,900,Monday
2017,6,19,1900,221,776,997,Monday
2017,6,19,1800,276,1019,1295,Monday
2017,6,19,1700,372,834,1206,Monday
2017,6,19,1600,409,634,1043,Monday
2017,6,19,1500,500,698,1198,Monday
2017,6,19,1400,549,514,1063,Monday
2017,6,19,1300,680,471,1151,Monday
2017,6,19,1200,837,392,1229,Monday
2017,6,19,1100,890,261,1151,Monday
2017,6,19,1000,768,175,943,Monday
2017,6,19,900,588,149,737,Monday
2017,6,19,800,357,100,457,Monday
2017,6,19,700,163,51,214,Monday
2017,6,19,600,62,29,91,Monday
2017,6,19,500,20,21,41,Monday
2017,6,19,400,23,24,47,Monday
2017,6,19,300,25,32,57,Monday
2017,6,19,200,25,34,59,Monday
2017,6,19,100,35,85,120,Monday
2017,6,18,2400,55,156,211,Sunday
2017,6,18,2300,99,254,353,Sunday
2017,6,18,2200,149,412,561,Sunday
2017,6,18,2100,185,694,879,Sunday
2017,6,18,2000,187,853,1040,Sunday
2017,6,18,1900,256,1212,1468,Sunday
2017,6,18,1800,309,1324,1633,Sunday
2017,6,18,1700,394,1380,1774,Sunday
2017,6,18,1600,469,1388,1857,Sunday
2017,6,18,1500,649,1384,2033,Sunday
2017,6,18,1400,738,1214,1952,Sunday
2017,6,18,1300,889,1030,1919,Sunday
2017,6,18,1200,1012,805,1817,Sunday
2017,6,18,1100,999,453,1452,Sunday
2017,6,18,1000,940,270,1210,Sunday
2017,6,18,900,627,163,790,Sunday
2017,6,18,800,295,82,377,Sunday
2017,6,18,700,122,34,156,Sunday
2017,6,18,600,45,17,62,Sunday
2017,6,18,500,21,14,35,Sunday
2017,6,18,400,21,28,49,Sunday
2017,6,18,300,26,28,54,Sunday
2017,6,18,200,25,34,59,Sunday
2017,6,18,100,38,57,95,Sunday
2017,6,17,2400,48,100,148,Saturday
2017,6,17,2300,100,342,442,Saturday
2017,6,17,2200,121,285,406,Saturday
2017,6,17,2100,170,437,607,Saturday
2017,6,17,2000,196,588,784,Saturday
2017,6,17,1900,205,794,999,Saturday
2017,6,17,1800,312,824,1136,Saturday
2017,6,17,1700,362,843,1205,Saturday
2017,6,17,1600,483,812,1295,Saturday
2017,6,17,1500,560,664,1224,Saturday
2017,6,17,1400,634,553,1187,Saturday
2017,6,17,1300,792,447,1239,Saturday
2017,6,17,1200,961,380,1341,Saturday
2017,6,17,1100,968,266,1234,Saturday
2017,6,17,1000,879,182,1061,Saturday
2017,6,17,900,651,132,783,Saturday
2017,6,17,800,402,93,495,Saturday
2017,6,17,700,158,44,202,Saturday
2017,6,17,600,92,36,128,Saturday
2017,6,17,500,44,19,63,Saturday
2017,6,17,400,18,29,47,Saturday
2017,6,17,300,29,35,64,Saturday
2017,6,17,200,32,45,77,Saturday
2017,6,17,100,58,75,133,Saturday
2017,6,16,2400,89,121,210,Friday
2017,6,16,2300,159,143,302,Friday
2017,6,16,2200,258,272,530,Friday
2017,6,16,2100,441,402,843,Friday
2017,6,16,2000,640,489,1129,Friday
2017,6,16,1900,791,752,1543,Friday
2017,6,16,1800,908,909,1817,Friday
2017,6,16,1700,895,845,1740,Friday
2017,6,16,1600,923,807,1730,Friday
2017,6,16,1500,873,671,1544,Friday
2017,6,16,1400,813,645,1458,Friday
2017,6,16,1300,866,554,1420,Friday
2017,6,16,1200,1097,436,1533,Friday
2017,6,16,1100,1125,303,1428,Friday
2017,6,16,1000,966,220,1186,Friday
2017,6,16,900,689,138,827,Friday
2017,6,16,800,418,86,504,Friday
2017,6,16,700,180,59,239,Friday
2017,6,16,600,93,57,150,Friday
2017,6,16,500,53,25,78,Friday
2017,6,16,400,29,40,69,Friday
2017,6,16,300,43,41,84,Friday
2017,6,16,200,38,55,93,Friday
2017,6,16,100,52,88,140,Friday
2017,6,15,2400,100,96,196,Thursday
2017,6,15,2300,129,161,290,Thursday
2017,6,15,2200,200,285,485,Thursday
2017,6,15,2100,299,434,733,Thursday
2017,6,15,2000,374,605,979,Thursday
2017,6,15,1900,412,788,1200,Thursday
2017,6,15,1800,511,881,1392,Thursday
2017,6,15,1700,512,801,1313,Thursday
2017,6,15,1600,600,811,1411,Thursday
2017,6,15,1500,622,619,1241,Thursday
2017,6,15,1400,711,480,1191,Thursday
2017,6,15,1300,779,444,1223,Thursday
2017,6,15,1200,959,398,1357,Thursday
2017,6,15,1100,1051,242,1293,Thursday
2017,6,15,1000,917,210,1127,Thursday
2017,6,15,900,703,158,861,Thursday
2017,6,15,800,397,95,492,Thursday
2017,6,15,700,197,71,268,Thursday
2017,6,15,600,80,41,121,Thursday
2017,6,15,500,44,26,70,Thursday
2017,6,15,400,26,28,54,Thursday
2017,6,15,300,30,40,70,Thursday
2017,6,15,200,37,48,85,Thursday
2017,6,15,100,40,77,117,Thursday
2017,6,14,2400,84,89,173,Wednesday
2017,6,14,2300,111,162,273,Wednesday
2017,6,14,2200,159,268,427,Wednesday
2017,6,14,2100,222,417,639,Wednesday
2017,6,14,2000,245,501,746,Wednesday
2017,6,14,1900,280,656,936,Wednesday
2017,6,14,1800,363,695,1058,Wednesday
2017,6,14,1700,410,652,1062,Wednesday
2017,6,14,1600,467,593,1060,Wednesday
2017,6,14,1500,537,538,1075,Wednesday
2017,6,14,1400,574,488,1062,Wednesday
2017,6,14,1300,596,390,986,Wednesday
2017,6,14,1200,746,385,1131,Wednesday
2017,6,14,1100,842,284,1126,Wednesday
2017,6,14,1000,695,217,912,Wednesday
2017,6,14,900,466,147,613,Wednesday
2017,6,14,800,251,109,360,Wednesday
2017,6,14,700,125,51,176,Wednesday
2017,6,14,600,39,42,81,Wednesday
2017,6,14,500,32,34,66,Wednesday
2017,6,14,400,21,31,52,Wednesday
2017,6,14,300,33,53,86,Wednesday
2017,6,14,200,34,52,86,Wednesday
2017,6,14,100,58,68,126,Wednesday
2017,6,13,2400,70,106,176,Tuesday
2017,6,13,2300,96,142,238,Tuesday
2017,6,13,2200,126,185,311,Tuesday
2017,6,13,2100,174,261,435,Tuesday
2017,6,13,2000,171,343,514,Tuesday
2017,6,13,1900,227,506,733,Tuesday
2017,6,13,1800,291,659,950,Tuesday
2017,6,13,1700,348,675,1023,Tuesday
2017,6,13,1600,427,757,1184,Tuesday
2017,6,13,1500,422,602,1024,Tuesday
2017,6,13,1400,490,611,1101,Tuesday
2017,6,13,1300,540,427,967,Tuesday
2017,6,13,1200,660,385,1045,Tuesday
2017,6,13,1100,791,303,1094,Tuesday
2017,6,13,1000,658,201,859,Tuesday
2017,6,13,900,516,148,664,Tuesday
2017,6,13,800,253,91,344,Tuesday
2017,6,13,700,118,52,170,Tuesday
2017,6,13,600,56,29,85,Tuesday
2017,6,13,500,33,39,72,Tuesday
2017,6,13,400,33,50,83,Tuesday
2017,6,13,300,29,38,67,Tuesday
2017,6,13,200,49,55,104,Tuesday
2017,6,13,100,51,71,122,Tuesday
2017,6,12,2400,69,124,193,Monday
2017,6,12,2300,113,225,338,Monday
2017,6,12,2200,154,348,502,Monday
2017,6,12,2100,162,480,642,Monday
2017,6,12,2000,217,627,844,Monday
2017,6,12,1900,251,993,1244,Monday
2017,6,12,1800,305,939,1244,Monday
2017,6,12,1700,372,857,1229,Monday
2017,6,12,1600,451,771,1222,Monday
2017,6,12,1500,514,632,1146,Monday
2017,6,12,1400,651,635,1286,Monday
2017,6,12,1300,722,495,1217,Monday
2017,6,12,1200,953,388,1341,Monday
2017,6,12,1100,1010,303,1313,Monday
2017,6,12,1000,924,205,1129,Monday
2017,6,12,900,704,146,850,Monday
2017,6,12,800,360,94,454,Monday
2017,6,12,700,154,74,228,Monday
2017,6,12,600,62,32,94,Monday
2017,6,12,500,41,27,68,Monday
2017,6,12,400,22,24,46,Monday
2017,6,12,300,19,36,55,Monday
2017,6,12,200,21,42,63,Monday
2017,6,12,100,36,73,109,Monday
2017,6,11,2400,55,126,181,Sunday
2017,6,11,2300,84,254,338,Sunday
2017,6,11,2200,149,375,524,Sunday
2017,6,11,2100,184,597,781,Sunday
2017,6,11,2000,210,884,1094,Sunday
2017,6,11,1900,276,1025,1301,Sunday
2017,6,11,1800,358,1317,1675,Sunday
2017,6,11,1700,457,1367,1824,Sunday
2017,6,11,1600,530,1322,1852,Sunday
2017,6,11,1500,601,940,1541,Sunday
2017,6,11,1400,705,989,1694,Sunday
2017,6,11,1300,778,713,1491,Sunday
2017,6,11,1200,898,529,1427,Sunday
2017,6,11,1100,1022,350,1372,Sunday
2017,6,11,1000,806,189,995,Sunday
2017,6,11,900,559,108,667,Sunday
2017,6,11,800,269,49,318,Sunday
2017,6,11,700,110,42,152,Sunday
2017,6,11,600,49,18,67,Sunday
2017,6,11,500,28,15,43,Sunday
2017,6,11,400,13,10,23,Sunday
2017,6,11,300,15,27,42,Sunday
2017,6,11,200,20,40,60,Sunday
2017,6,11,100,27,46,73,Sunday
2017,6,10,2400,39,100,139,Saturday
2017,6,10,2300,73,140,213,Saturday
2017,6,10,2200,93,151,244,Saturday
2017,6,10,2100,140,216,356,Saturday
2017,6,10,2000,146,279,425,Saturday
2017,6,10,1900,172,383,555,Saturday
2017,6,10,1800,224,387,611,Saturday
2017,6,10,1700,265,427,692,Saturday
2017,6,10,1600,313,507,820,Saturday
2017,6,10,1500,370,504,874,Saturday
2017,6,10,1400,424,479,903,Saturday
2017,6,10,1300,466,396,862,Saturday
2017,6,10,1200,643,397,1040,Saturday
2017,6,10,1100,682,323,1005,Saturday
2017,6,10,1000,587,172,759,Saturday
2017,6,10,900,438,85,523,Saturday
2017,6,10,800,214,57,271,Saturday
2017,6,10,700,98,24,122,Saturday
2017,6,10,600,41,13,54,Saturday
2017,6,10,500,17,12,29,Saturday
2017,6,10,400,8,15,23,Saturday
2017,6,10,300,18,22,40,Saturday
2017,6,10,200,19,17,36,Saturday
2017,6,10,100,29,43,72,Saturday
2017,6,9,2400,48,80,128,Friday
2017,6,9,2300,102,134,236,Friday
2017,6,9,2200,192,191,383,Friday
2017,6,9,2100,262,276,538,Friday
2017,6,9,2000,441,410,851,Friday
2017,6,9,1900,549,555,1104,Friday
2017,6,9,1800,596,637,1233,Friday
2017,6,9,1700,580,652,1232,Friday
2017,6,9,1600,642,615,1257,Friday
2017,6,9,1500,714,554,1268,Friday
2017,6,9,1400,663,546,1209,Friday
2017,6,9,1300,708,568,1276,Friday
2017,6,9,1200,843,470,1313,Friday
2017,6,9,1100,960,409,1369,Friday
2017,6,9,1000,799,240,1039,Friday
2017,6,9,900,598,177,775,Friday
2017,6,9,800,360,111,471,Friday
2017,6,9,700,148,53,201,Friday
2017,6,9,600,69,32,101,Friday
2017,6,9,500,36,46,82,Friday
2017,6,9,400,44,164,208,Friday
2017,6,9,300,34,31,65,Friday
2017,6,9,200,37,109,146,Friday
2017,6,9,100,54,123,177,Friday
2017,6,8,2400,95,89,184,Thursday
2017,6,8,2300,149,58,207,Thursday
2017,6,8,2200,220,83,303,Thursday
2017,6,8,2100,293,173,466,Thursday
2017,6,8,2000,375,511,886,Thursday
2017,6,8,1900,362,698,1060,Thursday
2017,6,8,1800,441,566,1007,Thursday
2017,6,8,1700,396,604,1000,Thursday
2017,6,8,1600,389,546,935,Thursday
2017,6,8,1500,549,562,1111,Thursday
2017,6,8,1400,521,464,985,Thursday
2017,6,8,1300,596,370,966,Thursday
2017,6,8,1200,706,307,1013,Thursday
2017,6,8,1100,747,237,984,Thursday
2017,6,8,1000,654,178,832,Thursday
2017,6,8,900,458,141,599,Thursday
2017,6,8,800,322,86,408,Thursday
2017,6,8,700,165,57,222,Thursday
2017,6,8,600,54,52,106,Thursday
2017,6,8,500,37,25,62,Thursday
2017,6,8,400,37,32,69,Thursday
2017,6,8,300,19,41,60,Thursday
2017,6,8,200,39,44,83,Thursday
2017,6,8,100,60,79,139,Thursday
2017,6,7,2400,73,125,198,Wednesday
2017,6,7,2300,110,163,273,Wednesday
2017,6,7,2200,156,218,374,Wednesday
2017,6,7,2100,191,371,562,Wednesday
2017,6,7,2000,247,412,659,Wednesday
2017,6,7,1900,228,557,785,Wednesday
2017,6,7,1800,312,733,1045,Wednesday
2017,6,7,1700,398,604,1002,Wednesday
2017,6,7,1600,365,590,955,Wednesday
2017,6,7,1500,442,487,929,Wednesday
2017,6,7,1400,489,400,889,Wednesday
2017,6,7,1300,513,331,844,Wednesday
2017,6,7,1200,644,300,944,Wednesday
2017,6,7,1100,756,244,1000,Wednesday
2017,6,7,1000,664,175,839,Wednesday
2017,6,7,900,466,139,605,Wednesday
2017,6,7,800,295,90,385,Wednesday
2017,6,7,700,139,69,208,Wednesday
2017,6,7,600,65,35,100,Wednesday
2017,6,7,500,41,23,64,Wednesday
2017,6,7,400,28,33,61,Wednesday
2017,6,7,300,26,48,74,Wednesday
2017,6,7,200,37,51,88,Wednesday
2017,6,7,100,51,75,126,Wednesday
2017,6,6,2400,74,87,161,Tuesday
2017,6,6,2300,100,171,271,Tuesday
2017,6,6,2200,145,235,380,Tuesday
2017,6,6,2100,154,328,482,Tuesday
2017,6,6,2000,195,465,660,Tuesday
2017,6,6,1900,221,607,828,Tuesday
2017,6,6,1800,248,634,882,Tuesday
2017,6,6,1700,311,604,915,Tuesday
2017,6,6,1600,325,562,887,Tuesday
2017,6,6,1500,374,501,875,Tuesday
2017,6,6,1400,421,406,827,Tuesday
2017,6,6,1300,458,296,754,Tuesday
2017,6,6,1200,629,281,910,Tuesday
2017,6,6,1100,649,219,868,Tuesday
2017,6,6,1000,620,151,771,Tuesday
2017,6,6,900,439,157,596,Tuesday
2017,6,6,800,301,95,396,Tuesday
2017,6,6,700,128,55,183,Tuesday
2017,6,6,600,50,36,86,Tuesday
2017,6,6,500,35,28,63,Tuesday
2017,6,6,400,33,39,72,Tuesday
2017,6,6,300,25,40,65,Tuesday
2017,6,6,200,33,66,99,Tuesday
2017,6,6,100,63,76,139,Tuesday
2017,6,5,2400,70,121,191,Monday
2017,6,5,2300,80,151,231,Monday
2017,6,5,2200,160,281,441,Monday
2017,6,5,2100,160,429,589,Monday
2017,6,5,2000,207,490,697,Monday
2017,6,5,1900,215,616,831,Monday
2017,6,5,1800,242,673,915,Monday
2017,6,5,1700,319,689,1008,Monday
2017,6,5,1600,336,643,979,Monday
2017,6,5,1500,394,569,963,Monday
2017,6,5,1400,491,427,918,Monday
2017,6,5,1300,527,390,917,Monday
2017,6,5,1200,665,316,981,Monday
2017,6,5,1100,732,238,970,Monday
2017,6,5,1000,632,168,800,Monday
2017,6,5,900,470,136,606,Monday
2017,6,5,800,286,90,376,Monday
2017,6,5,700,123,52,175,Monday
2017,6,5,600,57,23,80,Monday
2017,6,5,500,31,29,60,Monday
2017,6,5,400,23,23,46,Monday
2017,6,5,300,26,43,69,Monday
2017,6,5,200,26,50,76,Monday
2017,6,5,100,34,78,112,Monday
2017,6,4,2400,35,147,182,Sunday
2017,6,4,2300,82,194,276,Sunday
2017,6,4,2200,109,295,404,Sunday
2017,6,4,2100,180,465,645,Sunday
2017,6,4,2000,214,669,883,Sunday
2017,6,4,1900,266,1019,1285,Sunday
2017,6,4,1800,291,1134,1425,Sunday
2017,6,4,1700,389,1212,1601,Sunday
2017,6,4,1600,483,1096,1579,Sunday
2017,6,4,1500,491,935,1426,Sunday
2017,6,4,1400,626,826,1452,Sunday
2017,6,4,1300,633,644,1277,Sunday
2017,6,4,1200,741,565,1306,Sunday
2017,6,4,1100,617,362,979,Sunday
2017,6,4,1000,576,198,774,Sunday
2017,6,4,900,392,121,513,Sunday
2017,6,4,800,233,55,288,Sunday
2017,6,4,700,90,45,135,Sunday
2017,6,4,600,47,20,67,Sunday
2017,6,4,500,36,11,47,Sunday
2017,6,4,400,35,26,61,Sunday
2017,6,4,300,34,22,56,Sunday
2017,6,4,200,25,29,54,Sunday
2017,6,4,100,40,66,106,Sunday
2017,6,3,2400,69,88,157,Saturday
2017,6,3,2300,99,154,253,Saturday
2017,6,3,2200,143,236,379,Saturday
2017,6,3,2100,156,358,514,Saturday
2017,6,3,2000,151,520,671,Saturday
2017,6,3,1900,187,670,857,Saturday
2017,6,3,1800,261,746,1007,Saturday
2017,6,3,1700,330,819,1149,Saturday
2017,6,3,1600,481,637,1118,Saturday
2017,6,3,1500,543,510,1053,Saturday
2017,6,3,1400,460,479,939,Saturday
2017,6,3,1300,689,388,1077,Saturday
2017,6,3,1200,783,334,1117,Saturday
2017,6,3,1100,850,278,1128,Saturday
2017,6,3,1000,740,189,929,Saturday
2017,6,3,900,584,122,706,Saturday
2017,6,3,800,333,79,412,Saturday
2017,6,3,700,165,54,219,Saturday
2017,6,3,600,71,41,112,Saturday
2017,6,3,500,37,20,57,Saturday
2017,6,3,400,21,24,45,Saturday
2017,6,3,300,26,31,57,Saturday
2017,6,3,200,31,44,75,Saturday
2017,6,3,100,67,66,133,Saturday
2017,6,2,2400,75,87,162,Friday
2017,6,2,2300,151,141,292,Friday
2017,6,2,2200,240,208,448,Friday
2017,6,2,2100,375,304,679,Friday
2017,6,2,2000,504,439,943,Friday
2017,6,2,1900,694,557,1251,Friday
2017,6,2,1800,722,603,1325,Friday
2017,6,2,1700,664,621,1285,Friday
2017,6,2,1600,631,581,1212,Friday
2017,6,2,1500,656,580,1236,Friday
2017,6,2,1400,629,477,1106,Friday
2017,6,2,1300,620,449,1069,Friday
2017,6,2,1200,745,383,1128,Friday
2017,6,2,1100,715,263,978,Friday
2017,6,2,1000,670,204,874,Friday
2017,6,2,900,487,144,631,Friday
2017,6,2,800,326,93,419,Friday
2017,6,2,700,141,72,213,Friday
2017,6,2,600,62,47,109,Friday
2017,6,2,500,32,31,63,Friday
2017,6,2,400,63,25,88,Friday
2017,6,2,300,21,32,53,Friday
2017,6,2,200,50,59,109,Friday
2017,6,2,100,61,78,139,Friday
2017,6,1,2400,92,102,194,Thursday
2017,6,1,2300,131,139,270,Thursday
2017,6,1,2200,195,194,389,Thursday
2017,6,1,2100,246,348,594,Thursday
2017,6,1,2000,301,427,728,Thursday
2017,6,1,1900,348,490,838,Thursday
2017,6,1,1800,420,574,994,Thursday
2017,6,1,1700,427,509,936,Thursday
2017,6,1,1600,451,526,977,Thursday
2017,6,1,1500,457,431,888,Thursday
2017,6,1,1400,451,412,863,Thursday
2017,6,1,1300,515,355,870,Thursday
2017,6,1,1200,601,299,900,Thursday
2017,6,1,1100,675,242,917,Thursday
2017,6,1,1000,628,183,811,Thursday
2017,6,1,900,466,126,592,Thursday
2017,6,1,800,273,94,367,Thursday
2017,6,1,700,154,66,220,Thursday
2017,6,1,600,59,35,94,Thursday
2017,6,1,500,38,34,72,Thursday
2017,6,1,400,33,35,68,Thursday
2017,6,1,300,35,37,72,Thursday
2017,6,1,200,32,64,96,Thursday
2017,6,1,100,46,76,122,Thursday
2017,5,31,2400,90,84,174,Wednesday
2017,5,31,2300,94,120,214,Wednesday
2017,5,31,2200,144,181,325,Wednesday
2017,5,31,2100,180,274,454,Wednesday
2017,5,31,2000,201,350,551,Wednesday
2017,5,31,1900,210,504,714,Wednesday
2017,5,31,1800,252,557,809,Wednesday
2017,5,31,1700,296,505,801,Wednesday
2017,5,31,1600,322,521,843,Wednesday
2017,5,31,1500,361,455,816,Wednesday
2017,5,31,1400,360,414,774,Wednesday
2017,5,31,1300,423,380,803,Wednesday
2017,5,31,1200,694,141,835,Wednesday
2017,5,31,1100,616,231,847,Wednesday
2017,5,31,1000,505,173,678,Wednesday
2017,5,31,900,364,125,489,Wednesday
2017,5,31,800,270,81,351,Wednesday
2017,5,31,700,105,49,154,Wednesday
2017,5,31,600,50,42,92,Wednesday
2017,5,31,500,22,46,68,Wednesday
2017,5,31,400,29,29,58,Wednesday
2017,5,31,300,26,40,66,Wednesday
2017,5,31,200,32,52,84,Wednesday
2017,5,31,100,44,75,119,Wednesday
2017,5,30,2400,92,101,193,Tuesday
2017,5,30,2300,114,136,250,Tuesday
2017,5,30,2200,128,193,321,Tuesday
2017,5,30,2100,153,320,473,Tuesday
2017,5,30,2000,188,461,649,Tuesday
2017,5,30,1900,186,474,660,Tuesday
2017,5,30,1800,244,579,823,Tuesday
2017,5,30,1700,288,536,824,Tuesday
2017,5,30,1600,321,444,765,Tuesday
2017,5,30,1500,406,441,847,Tuesday
2017,5,30,1400,394,368,762,Tuesday
2017,5,30,1300,424,307,731,Tuesday
2017,5,30,1200,544,277,821,Tuesday
2017,5,30,1100,547,247,794,Tuesday
2017,5,30,1000,488,174,662,Tuesday
2017,5,30,900,383,110,493,Tuesday
2017,5,30,800,237,114,351,Tuesday
2017,5,30,700,99,56,155,Tuesday
2017,5,30,600,62,29,91,Tuesday
2017,5,30,500,36,28,64,Tuesday
2017,5,30,400,35,28,63,Tuesday
2017,5,30,300,20,42,62,Tuesday
2017,5,30,200,35,44,79,Tuesday
2017,5,30,100,48,71,119,Tuesday
2017,5,29,2400,62,103,165,Monday
2017,5,29,2300,93,177,270,Monday
2017,5,29,2200,117,214,331,Monday
2017,5,29,2100,151,346,497,Monday
2017,5,29,2000,192,422,614,Monday
2017,5,29,1900,191,640,831,Monday
2017,5,29,1800,235,662,897,Monday
2017,5,29,1700,297,636,933,Monday
2017,5,29,1600,348,641,989,Monday
2017,5,29,1500,404,576,980,Monday
2017,5,29,1400,445,388,833,Monday
2017,5,29,1300,526,384,910,Monday
2017,5,29,1200,618,308,926,Monday
2017,5,29,1100,660,231,891,Monday
2017,5,29,1000,554,196,750,Monday
2017,5,29,900,435,164,599,Monday
2017,5,29,800,254,104,358,Monday
2017,5,29,700,125,67,192,Monday
2017,5,29,600,44,25,69,Monday
2017,5,29,500,29,24,53,Monday
2017,5,29,400,20,30,50,Monday
2017,5,29,300,26,32,58,Monday
2017,5,29,200,22,50,72,Monday
2017,5,29,100,36,68,104,Monday
2017,5,28,2400,44,129,173,Sunday
2017,5,28,2300,74,229,303,Sunday
2017,5,28,2200,104,397,501,Sunday
2017,5,28,2100,165,607,772,Sunday
2017,5,28,2000,167,819,986,Sunday
2017,5,28,1900,224,1072,1296,Sunday
2017,5,28,1800,259,1115,1374,Sunday
2017,5,28,1700,400,1142,1542,Sunday
2017,5,28,1600,434,1084,1518,Sunday
2017,5,28,1500,511,873,1384,Sunday
2017,5,28,1400,555,799,1354,Sunday
2017,5,28,1300,631,666,1297,Sunday
2017,5,28,1200,726,490,1216,Sunday
2017,5,28,1100,629,345,974,Sunday
2017,5,28,1000,555,196,751,Sunday
2017,5,28,900,413,126,539,Sunday
2017,5,28,800,226,64,290,Sunday
2017,5,28,700,99,30,129,Sunday
2017,5,28,600,40,19,59,Sunday
2017,5,28,500,29,21,50,Sunday
2017,5,28,400,29,36,65,Sunday
2017,5,28,300,28,40,68,Sunday
2017,5,28,200,26,40,66,Sunday
2017,5,28,100,35,46,81,Sunday
2017,5,27,2400,44,102,146,Saturday
2017,5,27,2300,88,148,236,Saturday
2017,5,27,2200,124,252,376,Saturday
2017,5,27,2100,144,338,482,Saturday
2017,5,27,2000,185,464,649,Saturday
2017,5,27,1900,213,620,833,Saturday
2017,5,27,1800,255,637,892,Saturday
2017,5,27,1700,308,653,961,Saturday
2017,5,27,1600,405,635,1040,Saturday
2017,5,27,1500,455,559,1014,Saturday
2017,5,27,1400,543,455,998,Saturday
2017,5,27,1300,621,358,979,Saturday
2017,5,27,1200,776,301,1077,Saturday
2017,5,27,1100,746,265,1011,Saturday
2017,5,27,1000,641,180,821,Saturday
2017,5,27,900,415,104,519,Saturday
2017,5,27,800,287,76,363,Saturday
2017,5,27,700,137,59,196,Saturday
2017,5,27,600,61,37,98,Saturday
2017,5,27,500,37,25,62,Saturday
2017,5,27,400,24,42,66,Saturday
2017,5,27,300,43,35,78,Saturday
2017,5,27,200,37,39,76,Saturday
2017,5,27,100,58,67,125,Saturday
2017,5,26,2400,98,92,190,Friday
2017,5,26,2300,138,177,315,Friday
2017,5,26,2200,233,215,448,Friday
2017,5,26,2100,352,304,656,Friday
2017,5,26,2000,513,381,894,Friday
2017,5,26,1900,617,578,1195,Friday
2017,5,26,1800,647,693,1340,Friday
2017,5,26,1700,647,608,1255,Friday
2017,5,26,1600,661,551,1212,Friday
2017,5,26,1500,602,496,1098,Friday
2017,5,26,1400,595,439,1034,Friday
2017,5,26,1300,585,361,946,Friday
2017,5,26,1200,766,303,1069,Friday
2017,5,26,1100,745,238,983,Friday
2017,5,26,1000,618,172,790,Friday
2017,5,26,900,430,116,546,Friday
2017,5,26,800,290,80,370,Friday
2017,5,26,700,141,58,199,Friday
2017,5,26,600,51,37,88,Friday
2017,5,26,500,36,48,84,Friday
2017,5,26,400,30,40,70,Friday
2017,5,26,300,27,47,74,Friday
2017,5,26,200,33,51,84,Friday
2017,5,26,100,61,101,162,Friday
2017,5,25,2400,89,88,177,Thursday
2017,5,25,2300,100,150,250,Thursday
2017,5,25,2200,182,224,406,Thursday
2017,5,25,2100,214,260,474,Thursday
2017,5,25,2000,285,365,650,Thursday
2017,5,25,1900,330,465,795,Thursday
2017,5,25,1800,367,579,946,Thursday
2017,5,25,1700,378,546,924,Thursday
2017,5,25,1600,406,444,850,Thursday
2017,5,25,1500,440,427,867,Thursday
2017,5,25,1400,465,357,822,Thursday
2017,5,25,1300,487,335,822,Thursday
2017,5,25,1200,572,282,854,Thursday
2017,5,25,1100,586,278,864,Thursday
2017,5,25,1000,479,176,655,Thursday
2017,5,25,900,373,126,499,Thursday
2017,5,25,800,225,86,311,Thursday
2017,5,25,700,123,48,171,Thursday
2017,5,25,600,44,35,79,Thursday
2017,5,25,500,36,31,67,Thursday
2017,5,25,400,33,43,76,Thursday
2017,5,25,300,20,41,61,Thursday
2017,5,25,200,47,44,91,Thursday
2017,5,25,100,45,79,124,Thursday
2017,5,24,2400,59,69,128,Wednesday
2017,5,24,2300,64,112,176,Wednesday
2017,5,24,2200,97,155,252,Wednesday
2017,5,24,2100,131,214,345,Wednesday
2017,5,24,2000,145,300,445,Wednesday
2017,5,24,1900,179,436,615,Wednesday
2017,5,24,1800,195,483,678,Wednesday
2017,5,24,1700,280,587,867,Wednesday
2017,5,24,1600,254,483,737,Wednesday
2017,5,24,1500,302,456,758,Wednesday
2017,5,24,1400,323,478,801,Wednesday
2017,5,24,1300,400,426,826,Wednesday
2017,5,24,1200,450,350,800,Wednesday
2017,5,24,1100,478,306,784,Wednesday
2017,5,24,1000,418,210,628,Wednesday
2017,5,24,900,265,125,390,Wednesday
2017,5,24,800,207,76,283,Wednesday
2017,5,24,700,101,33,134,Wednesday
2017,5,24,600,43,24,67,Wednesday
2017,5,24,500,30,20,50,Wednesday
2017,5,24,400,29,39,68,Wednesday
2017,5,24,300,25,48,73,Wednesday
2017,5,24,200,38,60,98,Wednesday
2017,5,24,100,55,63,118,Wednesday
2017,5,23,2400,65,111,176,Tuesday
2017,5,23,2300,77,169,246,Tuesday
2017,5,23,2200,120,290,410,Tuesday
2017,5,23,2100,163,484,647,Tuesday
2017,5,23,2000,197,648,845,Tuesday
2017,5,23,1900,170,749,919,Tuesday
2017,5,23,1800,245,899,1144,Tuesday
2017,5,23,1700,314,870,1184,Tuesday
2017,5,23,1600,340,792,1132,Tuesday
2017,5,23,1500,415,796,1211,Tuesday
2017,5,23,1400,442,729,1171,Tuesday
2017,5,23,1300,526,518,1044,Tuesday
2017,5,23,1200,675,481,1156,Tuesday
2017,5,23,1100,657,382,1039,Tuesday
2017,5,23,1000,548,247,795,Tuesday
2017,5,23,900,387,200,587,Tuesday
2017,5,23,800,248,158,406,Tuesday
2017,5,23,700,132,102,234,Tuesday
2017,5,23,600,39,53,92,Tuesday
2017,5,23,500,26,32,58,Tuesday
2017,5,23,400,15,41,56,Tuesday
2017,5,23,300,16,60,76,Tuesday
2017,5,23,200,27,90,117,Tuesday
2017,5,23,100,25,183,208,Tuesday
2017,5,22,2400,54,238,292,Monday
2017,5,22,2300,63,470,533,Monday
2017,5,22,2200,108,838,946,Monday
2017,5,22,2100,115,1239,1354,Monday
2017,5,22,2000,158,1604,1762,Monday
2017,5,22,1900,238,1881,2119,Monday
2017,5,22,1800,308,2021,2329,Monday
2017,5,22,1700,387,2267,2654,Monday
2017,5,22,1600,427,2114,2541,Monday
2017,5,22,1500,602,2055,2657,Monday
2017,5,22,1400,645,1823,2468,Monday
2017,5,22,1300,711,1532,2243,Monday
2017,5,22,1200,790,1130,1920,Monday
2017,5,22,1100,840,725,1565,Monday
2017,5,22,1000,676,355,1031,Monday
2017,5,22,900,437,148,585,Monday
2017,5,22,800,260,75,335,Monday
2017,5,22,700,114,35,149,Monday
2017,5,22,600,57,26,83,Monday
2017,5,22,500,25,19,44,Monday
2017,5,22,400,20,22,42,Monday
2017,5,22,300,10,37,47,Monday
2017,5,22,200,19,59,78,Monday
2017,5,22,100,39,103,142,Monday
2017,5,21,2400,42,177,219,Sunday
2017,5,21,2300,80,315,395,Sunday
2017,5,21,2200,128,535,663,Sunday
2017,5,21,2100,163,728,891,Sunday
2017,5,21,2000,217,884,1101,Sunday
2017,5,21,1900,257,1166,1423,Sunday
2017,5,21,1800,324,1169,1493,Sunday
2017,5,21,1700,445,1096,1541,Sunday
2017,5,21,1600,502,1010,1512,Sunday
2017,5,21,1500,639,837,1476,Sunday
2017,5,21,1400,834,665,1499,Sunday
2017,5,21,1300,884,596,1480,Sunday
2017,5,21,1200,986,412,1398,Sunday
2017,5,21,1100,945,269,1214,Sunday
2017,5,21,1000,694,153,847,Sunday
2017,5,21,900,447,91,538,Sunday
2017,5,21,800,246,53,299,Sunday
2017,5,21,700,107,27,134,Sunday
2017,5,21,600,38,21,59,Sunday
2017,5,21,500,19,12,31,Sunday
2017,5,21,400,21,15,36,Sunday
2017,5,21,300,27,38,65,Sunday
2017,5,21,200,24,33,57,Sunday
2017,5,21,100,33,54,87,Sunday
2017,5,20,2400,72,106,178,Saturday
2017,5,20,2300,96,137,233,Saturday
2017,5,20,2200,122,255,377,Saturday
2017,5,20,2100,170,353,523,Saturday
2017,5,20,2000,256,450,706,Saturday
2017,5,20,1900,273,525,798,Saturday
2017,5,20,1800,381,703,1084,Saturday
2017,5,20,1700,476,672,1148,Saturday
2017,5,20,1600,641,593,1234,Saturday
2017,5,20,1500,757,565,1322,Saturday
2017,5,20,1400,883,448,1331,Saturday
2017,5,20,1300,989,457,1446,Saturday
2017,5,20,1200,1154,349,1503,Saturday
2017,5,20,1100,1141,249,1390,Saturday
2017,5,20,1000,858,179,1037,Saturday
2017,5,20,900,772,145,917,Saturday
2017,5,20,800,567,97,664,Saturday
2017,5,20,700,265,54,319,Saturday
2017,5,20,600,95,40,135,Saturday
2017,5,20,500,43,37,80,Saturday
2017,5,20,400,41,30,71,Saturday
2017,5,20,300,40,36,76,Saturday
2017,5,20,200,59,54,113,Saturday
2017,5,20,100,76,95,171,Saturday
2017,5,19,2400,142,121,263,Friday
2017,5,19,2300,248,133,381,Friday
2017,5,19,2200,420,220,640,Friday
2017,5,19,2100,695,240,935,Friday
2017,5,19,2000,1008,371,1379,Friday
2017,5,19,1900,1236,443,1679,Friday
2017,5,19,1800,1347,557,1904,Friday
2017,5,19,1700,1330,576,1906,Friday
2017,5,19,1600,1451,602,2053,Friday
2017,5,19,1500,1370,625,1995,Friday
2017,5,19,1400,1368,451,1819,Friday
2017,5,19,1300,1336,425,1761,Friday
2017,5,19,1200,939,347,1286,Friday
2017,5,19,1100,1318,228,1546,Friday
2017,5,19,1000,1054,186,1240,Friday
2017,5,19,900,772,128,900,Friday
2017,5,19,800,544,77,621,Friday
2017,5,19,700,260,70,330,Friday
2017,5,19,600,97,57,154,Friday
2017,5,19,500,55,41,96,Friday
2017,5,19,400,51,48,99,Friday
2017,5,19,300,55,48,103,Friday
2017,5,19,200,48,58,106,Friday
2017,5,19,100,93,82,175,Friday
2017,5,18,2400,114,108,222,Thursday
2017,5,18,2300,181,160,341,Thursday
2017,5,18,2200,305,236,541,Thursday
2017,5,18,2100,503,243,746,Thursday
2017,5,18,2000,758,291,1049,Thursday
2017,5,18,1900,794,384,1178,Thursday
2017,5,18,1800,769,523,1292,Thursday
2017,5,18,1700,711,518,1229,Thursday
2017,5,18,1600,690,532,1222,Thursday
2017,5,18,1500,734,431,1165,Thursday
2017,5,18,1400,667,386,1053,Thursday
2017,5,18,1300,675,363,1038,Thursday
2017,5,18,1200,842,283,1125,Thursday
2017,5,18,1100,743,206,949,Thursday
2017,5,18,1000,704,170,874,Thursday
2017,5,18,900,482,126,608,Thursday
2017,5,18,800,323,87,410,Thursday
2017,5,18,700,180,43,223,Thursday
2017,5,18,600,76,39,115,Thursday
2017,5,18,500,37,29,66,Thursday
2017,5,18,400,36,28,64,Thursday
2017,5,18,300,31,48,79,Thursday
2017,5,18,200,31,55,86,Thursday
2017,5,18,100,53,78,131,Thursday
2017,5,17,2400,61,91,152,Wednesday
2017,5,17,2300,100,185,285,Wednesday
2017,5,17,2200,143,262,405,Wednesday
2017,5,17,2100,207,145,352,Wednesday
2017,5,17,2000,203,174,377,Wednesday
2017,5,17,1900,247,301,548,Wednesday
2017,5,17,1800,316,386,702,Wednesday
2017,5,17,1700,304,385,689,Wednesday
2017,5,17,1600,365,368,733,Wednesday
2017,5,17,1500,343,299,642,Wednesday
2017,5,17,1400,338,319,657,Wednesday
2017,5,17,1300,389,287,676,Wednesday
2017,5,17,1200,423,194,617,Wednesday
2017,5,17,1100,431,205,636,Wednesday
2017,5,17,1000,410,161,571,Wednesday
2017,5,17,900,321,106,427,Wednesday
2017,5,17,800,217,79,296,Wednesday
2017,5,17,700,109,52,161,Wednesday
2017,5,17,600,42,32,74,Wednesday
2017,5,17,500,29,32,61,Wednesday
2017,5,17,400,27,44,71,Wednesday
2017,5,17,300,30,52,82,Wednesday
2017,5,17,200,29,53,82,Wednesday
2017,5,17,100,39,59,98,Wednesday
2017,5,16,2400,71,91,162,Tuesday
2017,5,16,2300,83,85,168,Tuesday
2017,5,16,2200,112,115,227,Tuesday
2017,5,16,2100,134,175,309,Tuesday
2017,5,16,2000,175,248,423,Tuesday
2017,5,16,1900,171,350,521,Tuesday
2017,5,16,1800,211,427,638,Tuesday
2017,5,16,1700,258,422,680,Tuesday
2017,5,16,1600,316,364,680,Tuesday
2017,5,16,1500,303,350,653,Tuesday
2017,5,16,1400,328,353,681,Tuesday
2017,5,16,1300,346,288,634,Tuesday
2017,5,16,1200,445,233,678,Tuesday
2017,5,16,1100,420,196,616,Tuesday
2017,5,16,1000,350,139,489,Tuesday
2017,5,16,900,261,108,369,Tuesday
2017,5,16,800,187,76,263,Tuesday
2017,5,16,700,108,53,161,Tuesday
2017,5,16,600,46,30,76,Tuesday
2017,5,16,500,17,28,45,Tuesday
2017,5,16,400,22,34,56,Tuesday
2017,5,16,300,29,29,58,Tuesday
2017,5,16,200,30,44,74,Tuesday
2017,5,16,100,46,54,100,Tuesday
2017,5,15,2400,66,90,156,Monday
2017,5,15,2300,81,132,213,Monday
2017,5,15,2200,128,178,306,Monday
2017,5,15,2100,134,259,393,Monday
2017,5,15,2000,160,323,483,Monday
2017,5,15,1900,169,442,611,Monday
2017,5,15,1800,243,497,740,Monday
2017,5,15,1700,310,498,808,Monday
2017,5,15,1600,323,480,803,Monday
2017,5,15,1500,383,458,841,Monday
2017,5,15,1400,403,357,760,Monday
2017,5,15,1300,408,302,710,Monday
2017,5,15,1200,496,290,786,Monday
2017,5,15,1100,522,232,754,Monday
2017,5,15,1000,445,156,601,Monday
2017,5,15,900,338,104,442,Monday
2017,5,15,800,197,65,262,Monday
2017,5,15,700,114,51,165,Monday
2017,5,15,600,42,23,65,Monday
2017,5,15,500,23,23,46,Monday
2017,5,15,400,20,31,51,Monday
2017,5,15,300,28,23,51,Monday
2017,5,15,200,22,34,56,Monday
2017,5,15,100,22,93,115,Monday
2017,5,14,2400,39,123,162,Sunday
2017,5,14,2300,71,217,288,Sunday
2017,5,14,2200,98,282,380,Sunday
2017,5,14,2100,128,343,471,Sunday
2017,5,14,2000,170,467,637,Sunday
2017,5,14,1900,224,571,795,Sunday
2017,5,14,1800,251,675,926,Sunday
2017,5,14,1700,320,799,1119,Sunday
2017,5,14,1600,361,761,1122,Sunday
2017,5,14,1500,350,746,1096,Sunday
2017,5,14,1400,436,680,1116,Sunday
2017,5,14,1300,488,576,1064,Sunday
2017,5,14,1200,517,432,949,Sunday
2017,5,14,1100,476,264,740,Sunday
2017,5,14,1000,384,137,521,Sunday
2017,5,14,900,240,91,331,Sunday
2017,5,14,800,153,54,207,Sunday
2017,5,14,700,63,27,90,Sunday
2017,5,14,600,38,14,52,Sunday
2017,5,14,500,22,12,34,Sunday
2017,5,14,400,15,14,29,Sunday
2017,5,14,300,21,23,44,Sunday
2017,5,14,200,13,22,35,Sunday
2017,5,14,100,28,38,66,Sunday
2017,5,13,2400,38,54,92,Saturday
2017,5,13,2300,63,123,186,Saturday
2017,5,13,2200,89,182,271,Saturday
2017,5,13,2100,121,260,381,Saturday
2017,5,13,2000,139,302,441,Saturday
2017,5,13,1900,185,385,570,Saturday
2017,5,13,1800,238,451,689,Saturday
2017,5,13,1700,318,480,798,Saturday
2017,5,13,1600,350,493,843,Saturday
2017,5,13,1500,378,451,829,Saturday
2017,5,13,1400,432,397,829,Saturday
2017,5,13,1300,454,388,842,Saturday
2017,5,13,1200,595,298,893,Saturday
2017,5,13,1100,544,230,774,Saturday
2017,5,13,1000,443,175,618,Saturday
2017,5,13,900,297,129,426,Saturday
2017,5,13,800,170,58,228,Saturday
2017,5,13,700,100,56,156,Saturday
2017,5,13,600,41,26,67,Saturday
2017,5,13,500,31,34,65,Saturday
2017,5,13,400,30,13,43,Saturday
2017,5,13,300,19,29,48,Saturday
2017,5,13,200,35,47,82,Saturday
2017,5,13,100,44,46,90,Saturday
2017,5,12,2400,73,84,157,Friday
2017,5,12,2300,92,109,201,Friday
2017,5,12,2200,160,142,302,Friday
2017,5,12,2100,268,204,472,Friday
2017,5,12,2000,375,236,611,Friday
2017,5,12,1900,475,332,807,Friday
2017,5,12,1800,444,473,917,Friday
2017,5,12,1700,498,519,1017,Friday
2017,5,12,1600,495,441,936,Friday
2017,5,12,1500,472,419,891,Friday
2017,5,12,1400,448,410,858,Friday
2017,5,12,1300,494,373,867,Friday
2017,5,12,1200,517,304,821,Friday
2017,5,12,1100,515,248,763,Friday
2017,5,12,1000,426,166,592,Friday
2017,5,12,900,320,121,441,Friday
2017,5,12,800,204,81,285,Friday
2017,5,12,700,114,46,160,Friday
2017,5,12,600,64,39,103,Friday
2017,5,12,500,37,48,85,Friday
2017,5,12,400,34,36,70,Friday
2017,5,12,300,23,51,74,Friday
2017,5,12,200,37,61,98,Friday
2017,5,12,100,39,56,95,Friday
2017,5,11,2400,88,71,159,Thursday
2017,5,11,2300,80,133,213,Thursday
2017,5,11,2200,126,156,282,Thursday
2017,5,11,2100,180,256,436,Thursday
2017,5,11,2000,250,295,545,Thursday
2017,5,11,1900,284,438,722,Thursday
2017,5,11,1800,284,654,938,Thursday
2017,5,11,1700,352,266,618,Thursday
2017,5,11,1600,357,401,758,Thursday
2017,5,11,1500,428,353,781,Thursday
2017,5,11,1400,429,332,761,Thursday
2017,5,11,1300,436,339,775,Thursday
2017,5,11,1200,496,298,794,Thursday
2017,5,11,1100,504,229,733,Thursday
2017,5,11,1000,409,158,567,Thursday
2017,5,11,900,318,131,449,Thursday
2017,5,11,800,216,93,309,Thursday
2017,5,11,700,121,41,162,Thursday
2017,5,11,600,56,43,99,Thursday
2017,5,11,500,25,31,56,Thursday
2017,5,11,400,29,28,57,Thursday
2017,5,11,300,28,37,65,Thursday
2017,5,11,200,30,37,67,Thursday
2017,5,11,100,46,56,102,Thursday
2017,5,10,2400,57,73,130,Wednesday
2017,5,10,2300,84,118,202,Wednesday
2017,5,10,2200,137,164,301,Wednesday
2017,5,10,2100,121,211,332,Wednesday
2017,5,10,2000,179,260,439,Wednesday
2017,5,10,1900,204,301,505,Wednesday
2017,5,10,1800,222,395,617,Wednesday
2017,5,10,1700,266,468,734,Wednesday
2017,5,10,1600,313,401,714,Wednesday
2017,5,10,1500,305,361,666,Wednesday
2017,5,10,1400,325,377,702,Wednesday
2017,5,10,1300,393,303,696,Wednesday
2017,5,10,1200,414,280,694,Wednesday
2017,5,10,1100,432,219,651,Wednesday
2017,5,10,1000,381,172,553,Wednesday
2017,5,10,900,282,129,411,Wednesday
2017,5,10,800,195,75,270,Wednesday
2017,5,10,700,92,61,153,Wednesday
2017,5,10,600,42,41,83,Wednesday
2017,5,10,500,21,29,50,Wednesday
2017,5,10,400,28,34,62,Wednesday
2017,5,10,300,42,39,81,Wednesday
2017,5,10,200,22,47,69,Wednesday
2017,5,10,100,38,56,94,Wednesday
2017,5,9,2400,66,67,133,Tuesday
2017,5,9,2300,82,104,186,Tuesday
2017,5,9,2200,95,158,253,Tuesday
2017,5,9,2100,141,262,403,Tuesday
2017,5,9,2000,137,203,340,Tuesday
2017,5,9,1900,169,284,453,Tuesday
2017,5,9,1800,219,384,603,Tuesday
2017,5,9,1700,249,385,634,Tuesday
2017,5,9,1600,256,379,635,Tuesday
2017,5,9,1500,295,351,646,Tuesday
2017,5,9,1400,289,321,610,Tuesday
2017,5,9,1300,302,288,590,Tuesday
2017,5,9,1200,393,266,659,Tuesday
2017,5,9,1100,378,218,596,Tuesday
2017,5,9,1000,329,158,487,Tuesday
2017,5,9,900,259,121,380,Tuesday
2017,5,9,800,155,84,239,Tuesday
2017,5,9,700,99,57,156,Tuesday
2017,5,9,600,44,31,75,Tuesday
2017,5,9,500,31,28,59,Tuesday
2017,5,9,400,18,23,41,Tuesday
2017,5,9,300,25,34,59,Tuesday
2017,5,9,200,20,38,58,Tuesday
2017,5,9,100,42,49,91,Tuesday
2017,5,8,2400,69,69,138,Monday
2017,5,8,2300,78,100,178,Monday
2017,5,8,2200,104,142,246,Monday
2017,5,8,2100,117,288,405,Monday
2017,5,8,2000,147,291,438,Monday
2017,5,8,1900,166,425,591,Monday
2017,5,8,1800,194,552,746,Monday
2017,5,8,1700,253,498,751,Monday
2017,5,8,1600,311,455,766,Monday
2017,5,8,1500,373,381,754,Monday
2017,5,8,1400,418,347,765,Monday
2017,5,8,1300,393,299,692,Monday
2017,5,8,1200,454,249,703,Monday
2017,5,8,1100,464,223,687,Monday
2017,5,8,1000,433,139,572,Monday
2017,5,8,900,303,91,394,Monday
2017,5,8,800,204,65,269,Monday
2017,5,8,700,86,41,127,Monday
2017,5,8,600,51,22,73,Monday
2017,5,8,500,22,26,48,Monday
2017,5,8,400,16,29,45,Monday
2017,5,8,300,20,23,43,Monday
2017,5,8,200,17,62,79,Monday
2017,5,8,100,36,121,157,Monday
2017,5,7,2400,37,76,113,Sunday
2017,5,7,2300,61,111,172,Sunday
2017,5,7,2200,88,292,380,Sunday
2017,5,7,2100,115,354,469,Sunday
2017,5,7,2000,146,442,588,Sunday
2017,5,7,1900,173,665,838,Sunday
2017,5,7,1800,231,741,972,Sunday
2017,5,7,1700,295,842,1137,Sunday
2017,5,7,1600,380,757,1137,Sunday
2017,5,7,1500,390,709,1099,Sunday
2017,5,7,1400,443,676,1119,Sunday
2017,5,7,1300,478,647,1125,Sunday
2017,5,7,1200,550,493,1043,Sunday
2017,5,7,1100,560,394,954,Sunday
2017,5,7,1000,452,387,839,Sunday
2017,5,7,900,309,171,480,Sunday
2017,5,7,800,147,17,164,Sunday
2017,5,7,700,70,15,85,Sunday
2017,5,7,600,32,7,39,Sunday
2017,5,7,500,10,1,11,Sunday
2017,5,7,400,10,2,12,Sunday
2017,5,7,300,15,6,21,Sunday
2017,5,7,200,26,12,38,Sunday
2017,5,7,100,35,18,53,Sunday
2017,5,6,2400,47,35,82,Saturday
2017,5,6,2300,61,59,120,Saturday
2017,5,6,2200,78,92,170,Saturday
2017,5,6,2100,112,161,273,Saturday
2017,5,6,2000,146,479,625,Saturday
2017,5,6,1900,163,457,620,Saturday
2017,5,6,1800,267,329,596,Saturday
2017,5,6,1700,279,436,715,Saturday
2017,5,6,1600,350,403,753,Saturday
2017,5,6,1500,443,375,818,Saturday
2017,5,6,1400,431,361,792,Saturday
2017,5,6,1300,509,327,836,Saturday
2017,5,6,1200,595,250,845,Saturday
2017,5,6,1100,560,183,743,Saturday
2017,5,6,1000,467,131,598,Saturday
2017,5,6,900,363,73,436,Saturday
2017,5,6,800,178,39,217,Saturday
2017,5,6,700,90,16,106,Saturday
2017,5,6,600,46,11,57,Saturday
2017,5,6,500,25,4,29,Saturday
2017,5,6,400,24,1,25,Saturday
2017,5,6,300,41,6,47,Saturday
2017,5,6,200,42,10,52,Saturday
2017,5,6,100,54,24,78,Saturday
2017,5,5,2400,79,61,140,Friday
2017,5,5,2300,92,164,256,Friday
2017,5,5,2200,189,134,323,Friday
2017,5,5,2100,295,79,374,Friday
2017,5,5,2000,425,276,701,Friday
2017,5,5,1900,521,323,844,Friday
2017,5,5,1800,552,475,1027,Friday
2017,5,5,1700,585,526,1111,Friday
2017,5,5,1600,500,523,1023,Friday
2017,5,5,1500,503,451,954,Friday
2017,5,5,1400,461,431,892,Friday
2017,5,5,1300,511,317,828,Friday
2017,5,5,1200,544,338,882,Friday
2017,5,5,1100,526,305,831,Friday
2017,5,5,1000,510,185,695,Friday
2017,5,5,900,379,131,510,Friday
2017,5,5,800,223,88,311,Friday
2017,5,5,700,99,46,145,Friday
2017,5,5,600,53,30,83,Friday
2017,5,5,500,27,29,56,Friday
2017,5,5,400,37,38,75,Friday
2017,5,5,300,29,30,59,Friday
2017,5,5,200,28,45,73,Friday
2017,5,5,100,53,53,106,Friday
2017,5,4,2400,86,93,179,Thursday
2017,5,4,2300,95,110,205,Thursday
2017,5,4,2200,149,155,304,Thursday
2017,5,4,2100,189,269,458,Thursday
2017,5,4,2000,220,336,556,Thursday
2017,5,4,1900,257,304,561,Thursday
2017,5,4,1800,271,417,688,Thursday
2017,5,4,1700,336,534,870,Thursday
2017,5,4,1600,369,491,860,Thursday
2017,5,4,1500,391,420,811,Thursday
2017,5,4,1400,405,378,783,Thursday
2017,5,4,1300,423,304,727,Thursday
2017,5,4,1200,547,247,794,Thursday
2017,5,4,1100,554,223,777,Thursday
2017,5,4,1000,511,161,672,Thursday
2017,5,4,900,353,113,466,Thursday
2017,5,4,800,196,94,290,Thursday
2017,5,4,700,112,52,164,Thursday
2017,5,4,600,63,41,104,Thursday
2017,5,4,500,24,32,56,Thursday
2017,5,4,400,33,32,65,Thursday
2017,5,4,300,33,32,65,Thursday
2017,5,4,200,28,44,72,Thursday
2017,5,4,100,37,60,97,Thursday
2017,5,3,2400,74,73,147,Wednesday
2017,5,3,2300,82,269,351,Wednesday
2017,5,3,2200,125,168,293,Wednesday
2017,5,3,2100,151,83,234,Wednesday
2017,5,3,2000,149,131,280,Wednesday
2017,5,3,1900,166,282,448,Wednesday
2017,5,3,1800,216,473,689,Wednesday
2017,5,3,1700,287,491,778,Wednesday
2017,5,3,1600,317,389,706,Wednesday
2017,5,3,1500,325,404,729,Wednesday
2017,5,3,1400,384,390,774,Wednesday
2017,5,3,1300,412,256,668,Wednesday
2017,5,3,1200,456,266,722,Wednesday
2017,5,3,1100,479,175,654,Wednesday
2017,5,3,1000,418,132,550,Wednesday
2017,5,3,900,343,127,470,Wednesday
2017,5,3,800,182,73,255,Wednesday
2017,5,3,700,109,55,164,Wednesday
2017,5,3,600,38,41,79,Wednesday
2017,5,3,500,28,33,61,Wednesday
2017,5,3,400,28,36,64,Wednesday
2017,5,3,300,26,35,61,Wednesday
2017,5,3,200,38,53,91,Wednesday
2017,5,3,100,44,59,103,Wednesday
2017,5,2,2400,64,67,131,Tuesday
2017,5,2,2300,102,113,215,Tuesday
2017,5,2,2200,123,171,294,Tuesday
2017,5,2,2100,134,211,345,Tuesday
2017,5,2,2000,131,282,413,Tuesday
2017,5,2,1900,160,362,522,Tuesday
2017,5,2,1800,215,444,659,Tuesday
2017,5,2,1700,261,561,822,Tuesday
2017,5,2,1600,296,395,691,Tuesday
2017,5,2,1500,265,281,546,Tuesday
2017,5,2,1400,303,306,609,Tuesday
2017,5,2,1300,393,296,689,Tuesday
2017,5,2,1200,433,247,680,Tuesday
2017,5,2,1100,463,209,672,Tuesday
2017,5,2,1000,391,162,553,Tuesday
2017,5,2,900,320,110,430,Tuesday
2017,5,2,800,206,59,265,Tuesday
2017,5,2,700,91,69,160,Tuesday
2017,5,2,600,52,32,84,Tuesday
2017,5,2,500,27,24,51,Tuesday
2017,5,2,400,28,38,66,Tuesday
2017,5,2,300,23,34,57,Tuesday
2017,5,2,200,35,45,80,Tuesday
2017,5,2,100,32,48,80,Tuesday
2017,5,1,2400,49,72,121,Monday
2017,5,1,2300,74,106,180,Monday
2017,5,1,2200,104,155,259,Monday
2017,5,1,2100,120,224,344,Monday
2017,5,1,2000,167,291,458,Monday
2017,5,1,1900,178,414,592,Monday
2017,5,1,1800,220,517,737,Monday
2017,5,1,1700,274,537,811,Monday
2017,5,1,1600,327,436,763,Monday
2017,5,1,1500,366,378,744,Monday
2017,5,1,1400,368,358,726,Monday
2017,5,1,1300,430,312,742,Monday
2017,5,1,1200,506,220,726,Monday
2017,5,1,1100,530,169,699,Monday
2017,5,1,1000,486,149,635,Monday
2017,5,1,900,367,97,464,Monday
2017,5,1,800,210,68,278,Monday
2017,5,1,700,115,33,148,Monday
2017,5,1,600,33,17,50,Monday
2017,5,1,500,27,19,46,Monday
2017,5,1,400,14,21,35,Monday
2017,5,1,300,18,35,53,Monday
2017,5,1,200,18,35,53,Monday
2017,5,1,100,34,52,86,Monday
2017,4,30,2400,53,94,147,Sunday
2017,4,30,2300,49,153,202,Sunday
2017,4,30,2200,88,251,339,Sunday
2017,4,30,2100,135,310,445,Sunday
2017,4,30,2000,178,467,645,Sunday
2017,4,30,1900,180,583,763,Sunday
2017,4,30,1800,261,846,1107,Sunday
2017,4,30,1700,331,919,1250,Sunday
2017,4,30,1600,378,819,1197,Sunday
2017,4,30,1500,376,797,1173,Sunday
2017,4,30,1400,420,722,1142,Sunday
2017,4,30,1300,535,644,1179,Sunday
2017,4,30,1200,595,534,1129,Sunday
2017,4,30,1100,620,339,959,Sunday
2017,4,30,1000,599,200,799,Sunday
2017,4,30,900,424,88,512,Sunday
2017,4,30,800,178,49,227,Sunday
2017,4,30,700,103,22,125,Sunday
2017,4,30,600,32,16,48,Sunday
2017,4,30,500,19,16,35,Sunday
2017,4,30,400,20,18,38,Sunday
2017,4,30,300,18,35,53,Sunday
2017,4,30,200,17,35,52,Sunday
2017,4,30,100,30,52,82,Sunday
2017,4,29,2400,30,62,92,Saturday
2017,4,29,2300,64,106,170,Saturday
2017,4,29,2200,111,177,288,Saturday
2017,4,29,2100,102,236,338,Saturday
2017,4,29,2000,148,354,502,Saturday
2017,4,29,1900,166,480,646,Saturday
2017,4,29,1800,250,713,963,Saturday
2017,4,29,1700,318,855,1173,Saturday
2017,4,29,1600,393,684,1077,Saturday
2017,4,29,1500,447,474,921,Saturday
2017,4,29,1400,493,471,964,Saturday
2017,4,29,1300,548,367,915,Saturday
2017,4,29,1200,600,290,890,Saturday
2017,4,29,1100,677,209,886,Saturday
2017,4,29,1000,764,177,941,Saturday
2017,4,29,900,631,123,754,Saturday
2017,4,29,800,298,76,374,Saturday
2017,4,29,700,122,31,153,Saturday
2017,4,29,600,44,31,75,Saturday
2017,4,29,500,36,32,68,Saturday
2017,4,29,400,36,23,59,Saturday
2017,4,29,300,22,41,63,Saturday
2017,4,29,200,32,45,77,Saturday
2017,4,29,100,38,58,96,Saturday
2017,4,28,2400,58,73,131,Friday
2017,4,28,2300,90,95,185,Friday
2017,4,28,2200,151,129,280,Friday
2017,4,28,2100,270,192,462,Friday
2017,4,28,2000,340,300,640,Friday
2017,4,28,1900,419,368,787,Friday
2017,4,28,1800,442,499,941,Friday
2017,4,28,1700,493,594,1087,Friday
2017,4,28,1600,474,564,1038,Friday
2017,4,28,1500,487,454,941,Friday
2017,4,28,1400,487,412,899,Friday
2017,4,28,1300,432,349,781,Friday
2017,4,28,1200,502,313,815,Friday
2017,4,28,1100,573,217,790,Friday
2017,4,28,1000,532,156,688,Friday
2017,4,28,900,478,106,584,Friday
2017,4,28,800,235,73,308,Friday
2017,4,28,700,101,47,148,Friday
2017,4,28,600,47,48,95,Friday
2017,4,28,500,38,24,62,Friday
2017,4,28,400,28,27,55,Friday
2017,4,28,300,32,48,80,Friday
2017,4,28,200,32,53,85,Friday
2017,4,28,100,48,77,125,Friday
2017,4,27,2400,67,74,141,Thursday
2017,4,27,2300,72,122,194,Thursday
2017,4,27,2200,111,169,280,Thursday
2017,4,27,2100,144,205,349,Thursday
2017,4,27,2000,196,299,495,Thursday
2017,4,27,1900,222,357,579,Thursday
2017,4,27,1800,282,492,774,Thursday
2017,4,27,1700,328,592,920,Thursday
2017,4,27,1600,332,484,816,Thursday
2017,4,27,1500,423,389,812,Thursday
2017,4,27,1400,349,363,712,Thursday
2017,4,27,1300,422,262,684,Thursday
2017,4,27,1200,442,273,715,Thursday
2017,4,27,1100,451,227,678,Thursday
2017,4,27,1000,431,158,589,Thursday
2017,4,27,900,319,116,435,Thursday
2017,4,27,800,224,64,288,Thursday
2017,4,27,700,106,40,146,Thursday
2017,4,27,600,42,40,82,Thursday
2017,4,27,500,32,26,58,Thursday
2017,4,27,400,22,36,58,Thursday
2017,4,27,300,19,43,62,Thursday
2017,4,27,200,28,28,56,Thursday
2017,4,27,100,32,48,80,Thursday
2017,4,26,2400,57,73,130,Wednesday
2017,4,26,2300,81,247,328,Wednesday
2017,4,26,2200,91,201,292,Wednesday
2017,4,26,2100,148,78,226,Wednesday
2017,4,26,2000,141,132,273,Wednesday
2017,4,26,1900,160,291,451,Wednesday
2017,4,26,1800,204,416,620,Wednesday
2017,4,26,1700,279,570,849,Wednesday
2017,4,26,1600,286,395,681,Wednesday
2017,4,26,1500,305,359,664,Wednesday
2017,4,26,1400,327,296,623,Wednesday
2017,4,26,1300,318,224,542,Wednesday
2017,4,26,1200,385,231,616,Wednesday
2017,4,26,1100,427,177,604,Wednesday
2017,4,26,1000,395,150,545,Wednesday
2017,4,26,900,362,120,482,Wednesday
2017,4,26,800,201,78,279,Wednesday
2017,4,26,700,86,39,125,Wednesday
2017,4,26,600,44,29,73,Wednesday
2017,4,26,500,23,28,51,Wednesday
2017,4,26,400,26,38,64,Wednesday
2017,4,26,300,17,44,61,Wednesday
2017,4,26,200,32,39,71,Wednesday
2017,4,26,100,42,66,108,Wednesday
2017,4,25,2400,54,81,135,Tuesday
2017,4,25,2300,82,89,171,Tuesday
2017,4,25,2200,102,122,224,Tuesday
2017,4,25,2100,110,169,279,Tuesday
2017,4,25,2000,130,223,353,Tuesday
2017,4,25,1900,169,305,474,Tuesday
2017,4,25,1800,184,401,585,Tuesday
2017,4,25,1700,209,450,659,Tuesday
2017,4,25,1600,258,384,642,Tuesday
2017,4,25,1500,272,349,621,Tuesday
2017,4,25,1400,277,287,564,Tuesday
2017,4,25,1300,305,274,579,Tuesday
2017,4,25,1200,342,228,570,Tuesday
2017,4,25,1100,434,201,635,Tuesday
2017,4,25,1000,385,111,496,Tuesday
2017,4,25,900,336,142,478,Tuesday
2017,4,25,800,232,73,305,Tuesday
2017,4,25,700,110,82,192,Tuesday
2017,4,25,600,52,41,93,Tuesday
2017,4,25,500,41,23,64,Tuesday
2017,4,25,400,11,46,57,Tuesday
2017,4,25,300,19,31,50,Tuesday
2017,4,25,200,24,53,77,Tuesday
2017,4,25,100,64,57,121,Tuesday
2017,4,24,2400,50,94,144,Monday
2017,4,24,2300,75,104,179,Monday
2017,4,24,2200,81,134,215,Monday
2017,4,24,2100,114,207,321,Monday
2017,4,24,2000,140,319,459,Monday
2017,4,24,1900,168,347,515,Monday
2017,4,24,1800,196,415,611,Monday
2017,4,24,1700,233,423,656,Monday
2017,4,24,1600,296,431,727,Monday
2017,4,24,1500,324,366,690,Monday
2017,4,24,1400,341,320,661,Monday
2017,4,24,1300,370,290,660,Monday
2017,4,24,1200,402,251,653,Monday
2017,4,24,1100,449,186,635,Monday
2017,4,24,1000,383,122,505,Monday
2017,4,24,900,267,85,352,Monday
2017,4,24,800,179,65,244,Monday
2017,4,24,700,89,31,120,Monday
2017,4,24,600,32,30,62,Monday
2017,4,24,500,19,22,41,Monday
2017,4,24,400,15,19,34,Monday
2017,4,24,300,21,35,56,Monday
2017,4,24,200,14,29,43,Monday
2017,4,24,100,27,72,99,Monday
2017,4,23,2400,29,88,117,Sunday
2017,4,23,2300,50,147,197,Sunday
2017,4,23,2200,90,194,284,Sunday
2017,4,23,2100,130,320,450,Sunday
2017,4,23,2000,162,409,571,Sunday
2017,4,23,1900,177,622,799,Sunday
2017,4,23,1800,219,882,1101,Sunday
2017,4,23,1700,291,942,1233,Sunday
2017,4,23,1600,321,841,1162,Sunday
2017,4,23,1500,355,814,1169,Sunday
2017,4,23,1400,407,612,1019,Sunday
2017,4,23,1300,440,551,991,Sunday
2017,4,23,1200,475,396,871,Sunday
2017,4,23,1100,515,268,783,Sunday
2017,4,23,1000,501,176,677,Sunday
2017,4,23,900,385,89,474,Sunday
2017,4,23,800,218,49,267,Sunday
2017,4,23,700,80,27,107,Sunday
2017,4,23,600,34,22,56,Sunday
2017,4,23,500,19,24,43,Sunday
2017,4,23,400,15,15,30,Sunday
2017,4,23,300,20,27,47,Sunday
2017,4,23,200,18,30,48,Sunday
2017,4,23,100,27,42,69,Sunday
2017,4,22,2400,27,60,87,Saturday
2017,4,22,2300,37,102,139,Saturday
2017,4,22,2200,75,134,209,Saturday
2017,4,22,2100,77,238,315,Saturday
2017,4,22,2000,104,324,428,Saturday
2017,4,22,1900,165,408,573,Saturday
2017,4,22,1800,226,642,868,Saturday
2017,4,22,1700,288,776,1064,Saturday
2017,4,22,1600,297,718,1015,Saturday
2017,4,22,1500,388,474,862,Saturday
2017,4,22,1400,404,385,789,Saturday
2017,4,22,1300,470,325,795,Saturday
2017,4,22,1200,572,305,877,Saturday
2017,4,22,1100,556,248,804,Saturday
2017,4,22,1000,585,146,731,Saturday
2017,4,22,900,574,90,664,Saturday
2017,4,22,800,294,62,356,Saturday
2017,4,22,700,98,42,140,Saturday
2017,4,22,600,56,27,83,Saturday
2017,4,22,500,26,25,51,Saturday
2017,4,22,400,25,31,56,Saturday
2017,4,22,300,20,26,46,Saturday
2017,4,22,200,31,39,70,Saturday
2017,4,22,100,36,45,81,Saturday
2017,4,21,2400,80,63,143,Friday
2017,4,21,2300,80,111,191,Friday
2017,4,21,2200,159,124,283,Friday
2017,4,21,2100,234,183,417,Friday
2017,4,21,2000,341,319,660,Friday
2017,4,21,1900,372,314,686,Friday
2017,4,21,1800,388,567,955,Friday
2017,4,21,1700,470,510,980,Friday
2017,4,21,1600,451,661,1112,Friday
2017,4,21,1500,439,367,806,Friday
2017,4,21,1400,399,332,731,Friday
2017,4,21,1300,441,288,729,Friday
2017,4,21,1200,478,286,764,Friday
2017,4,21,1100,520,212,732,Friday
2017,4,21,1000,535,147,682,Friday
2017,4,21,900,380,121,501,Friday
2017,4,21,800,226,97,323,Friday
2017,4,21,700,113,50,163,Friday
2017,4,21,600,69,43,112,Friday
2017,4,21,500,29,16,45,Friday
2017,4,21,400,31,43,74,Friday
2017,4,21,300,39,26,65,Friday
2017,4,21,200,25,58,83,Friday
2017,4,21,100,48,71,119,Friday
2017,4,20,2400,53,73,126,Thursday
2017,4,20,2300,75,114,189,Thursday
2017,4,20,2200,126,130,256,Thursday
2017,4,20,2100,183,161,344,Thursday
2017,4,20,2000,209,220,429,Thursday
2017,4,20,1900,252,292,544,Thursday
2017,4,20,1800,243,463,706,Thursday
2017,4,20,1700,266,527,793,Thursday
2017,4,20,1600,314,465,779,Thursday
2017,4,20,1500,358,345,703,Thursday
2017,4,20,1400,392,347,739,Thursday
2017,4,20,1300,406,319,725,Thursday
2017,4,20,1200,442,292,734,Thursday
2017,4,20,1100,439,223,662,Thursday
2017,4,20,1000,410,138,548,Thursday
2017,4,20,900,332,131,463,Thursday
2017,4,20,800,227,64,291,Thursday
2017,4,20,700,103,39,142,Thursday
2017,4,20,600,53,39,92,Thursday
2017,4,20,500,24,29,53,Thursday
2017,4,20,400,34,36,70,Thursday
2017,4,20,300,32,31,63,Thursday
2017,4,20,200,40,38,78,Thursday
2017,4,20,100,38,70,108,Thursday
2017,4,19,2400,44,77,121,Wednesday
2017,4,19,2300,74,79,153,Wednesday
2017,4,19,2200,120,144,264,Wednesday
2017,4,19,2100,158,187,345,Wednesday
2017,4,19,2000,145,242,387,Wednesday
2017,4,19,1900,162,345,507,Wednesday
2017,4,19,1800,202,540,742,Wednesday
2017,4,19,1700,248,531,779,Wednesday
2017,4,19,1600,280,494,774,Wednesday
2017,4,19,1500,336,383,719,Wednesday
2017,4,19,1400,354,350,704,Wednesday
2017,4,19,1300,344,307,651,Wednesday
2017,4,19,1200,450,250,700,Wednesday
2017,4,19,1100,414,193,607,Wednesday
2017,4,19,1000,438,164,602,Wednesday
2017,4,19,900,376,110,486,Wednesday
2017,4,19,800,234,76,310,Wednesday
2017,4,19,700,97,54,151,Wednesday
2017,4,19,600,44,33,77,Wednesday
2017,4,19,500,25,29,54,Wednesday
2017,4,19,400,17,29,46,Wednesday
2017,4,19,300,21,27,48,Wednesday
2017,4,19,200,23,44,67,Wednesday
2017,4,19,100,41,61,102,Wednesday
2017,4,18,2400,69,101,170,Tuesday
2017,4,18,2300,78,209,287,Tuesday
2017,4,18,2200,111,220,331,Tuesday
2017,4,18,2100,111,253,364,Tuesday
2017,4,18,2000,132,117,249,Tuesday
2017,4,18,1900,164,210,374,Tuesday
2017,4,18,1800,207,482,689,Tuesday
2017,4,18,1700,231,631,862,Tuesday
2017,4,18,1600,304,509,813,Tuesday
2017,4,18,1500,318,459,777,Tuesday
2017,4,18,1400,335,367,702,Tuesday
2017,4,18,1300,365,332,697,Tuesday
2017,4,18,1200,418,270,688,Tuesday
2017,4,18,1100,460,222,682,Tuesday
2017,4,18,1000,427,166,593,Tuesday
2017,4,18,900,318,109,427,Tuesday
2017,4,18,800,213,82,295,Tuesday
2017,4,18,700,74,43,117,Tuesday
2017,4,18,600,45,44,89,Tuesday
2017,4,18,500,30,23,53,Tuesday
2017,4,18,400,26,22,48,Tuesday
2017,4,18,300,25,16,41,Tuesday
2017,4,18,200,27,31,58,Tuesday
2017,4,18,100,43,57,100,Tuesday
2017,4,17,2400,55,103,158,Monday
2017,4,17,2300,79,135,214,Monday
2017,4,17,2200,92,170,262,Monday
2017,4,17,2100,112,317,429,Monday
2017,4,17,2000,148,488,636,Monday
2017,4,17,1900,175,635,810,Monday
2017,4,17,1800,225,961,1186,Monday
2017,4,17,1700,282,1308,1590,Monday
2017,4,17,1600,361,1236,1597,Monday
2017,4,17,1500,470,988,1458,Monday
2017,4,17,1400,541,897,1438,Monday
2017,4,17,1300,586,778,1364,Monday
2017,4,17,1200,738,538,1276,Monday
2017,4,17,1100,657,358,1015,Monday
2017,4,17,1000,573,199,772,Monday
2017,4,17,900,534,131,665,Monday
2017,4,17,800,229,68,297,Monday
2017,4,17,700,96,39,135,Monday
2017,4,17,600,36,24,60,Monday
2017,4,17,500,24,23,47,Monday
2017,4,17,400,20,33,53,Monday
2017,4,17,300,17,35,52,Monday
2017,4,17,200,14,58,72,Monday
2017,4,17,100,25,64,89,Monday
2017,4,16,2400,33,121,154,Sunday
2017,4,16,2300,48,201,249,Sunday
2017,4,16,2200,81,333,414,Sunday
2017,4,16,2100,99,546,645,Sunday
2017,4,16,2000,141,729,870,Sunday
2017,4,16,1900,149,925,1074,Sunday
2017,4,16,1800,225,1268,1493,Sunday
2017,4,16,1700,295,1402,1697,Sunday
2017,4,16,1600,365,1296,1661,Sunday
2017,4,16,1500,358,1163,1521,Sunday
2017,4,16,1400,474,953,1427,Sunday
2017,4,16,1300,511,751,1262,Sunday
2017,4,16,1200,603,505,1108,Sunday
2017,4,16,1100,603,313,916,Sunday
2017,4,16,1000,579,151,730,Sunday
2017,4,16,900,496,92,588,Sunday
2017,4,16,800,232,46,278,Sunday
2017,4,16,700,89,26,115,Sunday
2017,4,16,600,28,13,41,Sunday
2017,4,16,500,14,13,27,Sunday
2017,4,16,400,17,17,34,Sunday
2017,4,16,300,14,14,28,Sunday
2017,4,16,200,18,27,45,Sunday
2017,4,16,100,30,35,65,Sunday
2017,4,15,2400,27,51,78,Saturday
2017,4,15,2300,48,95,143,Saturday
2017,4,15,2200,79,131,210,Saturday
2017,4,15,2100,110,234,344,Saturday
2017,4,15,2000,122,305,427,Saturday
2017,4,15,1900,186,453,639,Saturday
2017,4,15,1800,220,837,1057,Saturday
2017,4,15,1700,246,946,1192,Saturday
2017,4,15,1600,362,660,1022,Saturday
2017,4,15,1500,389,550,939,Saturday
2017,4,15,1400,417,424,841,Saturday
2017,4,15,1300,537,410,947,Saturday
2017,4,15,1200,586,277,863,Saturday
2017,4,15,1100,632,190,822,Saturday
2017,4,15,1000,679,132,811,Saturday
2017,4,15,900,642,92,734,Saturday
2017,4,15,800,296,69,365,Saturday
2017,4,15,700,82,23,105,Saturday
2017,4,15,600,35,20,55,Saturday
2017,4,15,500,18,18,36,Saturday
2017,4,15,400,16,12,28,Saturday
2017,4,15,300,14,20,34,Saturday
2017,4,15,200,21,21,42,Saturday
2017,4,15,100,31,30,61,Saturday
2017,4,14,2400,34,53,87,Friday
2017,4,14,2300,63,95,158,Friday
2017,4,14,2200,116,146,262,Friday
2017,4,14,2100,132,227,359,Friday
2017,4,14,2000,198,278,476,Friday
2017,4,14,1900,254,483,737,Friday
2017,4,14,1800,364,840,1204,Friday
2017,4,14,1700,537,1085,1622,Friday
2017,4,14,1600,662,854,1516,Friday
2017,4,14,1500,823,767,1590,Friday
2017,4,14,1400,997,514,1511,Friday
2017,4,14,1300,1193,450,1643,Friday
2017,4,14,1200,1450,368,1818,Friday
2017,4,14,1100,1415,253,1668,Friday
2017,4,14,1000,1415,176,1591,Friday
2017,4,14,900,1289,115,1404,Friday
2017,4,14,800,571,78,649,Friday
2017,4,14,700,242,37,279,Friday
2017,4,14,600,80,35,115,Friday
2017,4,14,500,41,37,78,Friday
2017,4,14,400,35,26,61,Friday
2017,4,14,300,57,49,106,Friday
2017,4,14,200,37,60,97,Friday
2017,4,14,100,90,70,160,Friday
2017,4,13,2400,114,84,198,Thursday
2017,4,13,2300,205,158,363,Thursday
2017,4,13,2200,341,165,506,Thursday
2017,4,13,2100,516,217,733,Thursday
2017,4,13,2000,805,273,1078,Thursday
2017,4,13,1900,945,330,1275,Thursday
2017,4,13,1800,962,508,1470,Thursday
2017,4,13,1700,840,547,1387,Thursday
2017,4,13,1600,685,584,1269,Thursday
2017,4,13,1500,694,399,1093,Thursday
2017,4,13,1400,617,393,1010,Thursday
2017,4,13,1300,579,362,941,Thursday
2017,4,13,1200,624,289,913,Thursday
2017,4,13,1100,639,207,846,Thursday
2017,4,13,1000,535,153,688,Thursday
2017,4,13,900,382,129,511,Thursday
2017,4,13,800,238,54,292,Thursday
2017,4,13,700,133,36,169,Thursday
2017,4,13,600,57,29,86,Thursday
2017,4,13,500,43,19,62,Thursday
2017,4,13,400,28,34,62,Thursday
2017,4,13,300,37,40,77,Thursday
2017,4,13,200,39,33,72,Thursday
2017,4,13,100,46,56,102,Thursday
2017,4,12,2400,78,82,160,Wednesday
2017,4,12,2300,65,103,168,Wednesday
2017,4,12,2200,125,161,286,Wednesday
2017,4,12,2100,169,114,283,Wednesday
2017,4,12,2000,220,207,427,Wednesday
2017,4,12,1900,251,249,500,Wednesday
2017,4,12,1800,287,401,688,Wednesday
2017,4,12,1700,292,494,786,Wednesday
2017,4,12,1600,311,406,717,Wednesday
2017,4,12,1500,332,358,690,Wednesday
2017,4,12,1400,326,298,624,Wednesday
2017,4,12,1300,344,271,615,Wednesday
2017,4,12,1200,403,228,631,Wednesday
2017,4,12,1100,416,187,603,Wednesday
2017,4,12,1000,368,155,523,Wednesday
2017,4,12,900,356,118,474,Wednesday
2017,4,12,800,189,74,263,Wednesday
2017,4,12,700,104,44,148,Wednesday
2017,4,12,600,38,45,83,Wednesday
2017,4,12,500,21,26,47,Wednesday
2017,4,12,400,27,32,59,Wednesday
2017,4,12,300,19,44,63,Wednesday
2017,4,12,200,30,41,71,Wednesday
2017,4,12,100,50,58,108,Wednesday
2017,4,11,2400,73,69,142,Tuesday
2017,4,11,2300,72,87,159,Tuesday
2017,4,11,2200,82,96,178,Tuesday
2017,4,11,2100,129,150,279,Tuesday
2017,4,11,2000,150,204,354,Tuesday
2017,4,11,1900,164,314,478,Tuesday
2017,4,11,1800,165,384,549,Tuesday
2017,4,11,1700,206,419,625,Tuesday
2017,4,11,1600,243,331,574,Tuesday
2017,4,11,1500,224,303,527,Tuesday
2017,4,11,1400,257,292,549,Tuesday
2017,4,11,1300,293,219,512,Tuesday
2017,4,11,1200,361,201,562,Tuesday
2017,4,11,1100,360,197,557,Tuesday
2017,4,11,1000,312,138,450,Tuesday
2017,4,11,900,252,112,364,Tuesday
2017,4,11,800,186,75,261,Tuesday
2017,4,11,700,64,37,101,Tuesday
2017,4,11,600,28,35,63,Tuesday
2017,4,11,500,24,32,56,Tuesday
2017,4,11,400,19,25,44,Tuesday
2017,4,11,300,18,40,58,Tuesday
2017,4,11,200,26,34,60,Tuesday
2017,4,11,100,37,43,80,Tuesday
2017,4,10,2400,40,71,111,Monday
2017,4,10,2300,78,88,166,Monday
2017,4,10,2200,104,131,235,Monday
2017,4,10,2100,115,195,310,Monday
2017,4,10,2000,165,249,414,Monday
2017,4,10,1900,170,350,520,Monday
2017,4,10,1800,189,479,668,Monday
2017,4,10,1700,259,591,850,Monday
2017,4,10,1600,295,456,751,Monday
2017,4,10,1500,290,399,689,Monday
2017,4,10,1400,298,309,607,Monday
2017,4,10,1300,369,279,648,Monday
2017,4,10,1200,404,223,627,Monday
2017,4,10,1100,382,183,565,Monday
2017,4,10,1000,443,132,575,Monday
2017,4,10,900,343,93,436,Monday
2017,4,10,800,190,60,250,Monday
2017,4,10,700,91,36,127,Monday
2017,4,10,600,30,19,49,Monday
2017,4,10,500,21,18,39,Monday
2017,4,10,400,22,24,46,Monday
2017,4,10,300,16,35,51,Monday
2017,4,10,200,13,46,59,Monday
2017,4,10,100,14,59,73,Monday
2017,4,9,2400,43,63,106,Sunday
2017,4,9,2300,41,126,167,Sunday
2017,4,9,2200,77,167,244,Sunday
2017,4,9,2100,73,248,321,Sunday
2017,4,9,2000,124,389,513,Sunday
2017,4,9,1900,138,475,613,Sunday
2017,4,9,1800,177,709,886,Sunday
2017,4,9,1700,227,1070,1297,Sunday
2017,4,9,1600,218,993,1211,Sunday
2017,4,9,1500,288,756,1044,Sunday
2017,4,9,1400,341,614,955,Sunday
2017,4,9,1300,363,558,921,Sunday
2017,4,9,1200,455,411,866,Sunday
2017,4,9,1100,446,264,710,Sunday
2017,4,9,1000,466,129,595,Sunday
2017,4,9,900,567,66,633,Sunday
2017,4,9,800,258,47,305,Sunday
2017,4,9,700,81,26,107,Sunday
2017,4,9,600,29,23,52,Sunday
2017,4,9,500,19,17,36,Sunday
2017,4,9,400,11,19,30,Sunday
2017,4,9,300,21,14,35,Sunday
2017,4,9,200,17,27,44,Sunday
2017,4,9,100,24,43,67,Sunday
2017,4,8,2400,31,68,99,Saturday
2017,4,8,2300,58,88,146,Saturday
2017,4,8,2200,78,116,194,Saturday
2017,4,8,2100,102,162,264,Saturday
2017,4,8,2000,121,211,332,Saturday
2017,4,8,1900,172,418,590,Saturday
2017,4,8,1800,212,610,822,Saturday
2017,4,8,1700,223,760,983,Saturday
2017,4,8,1600,304,540,844,Saturday
2017,4,8,1500,362,417,779,Saturday
2017,4,8,1400,319,354,673,Saturday
2017,4,8,1300,423,250,673,Saturday
2017,4,8,1200,503,233,736,Saturday
2017,4,8,1100,535,203,738,Saturday
2017,4,8,1000,581,135,716,Saturday
2017,4,8,900,686,88,774,Saturday
2017,4,8,800,351,59,410,Saturday
2017,4,8,700,100,40,140,Saturday
2017,4,8,600,49,29,78,Saturday
2017,4,8,500,23,32,55,Saturday
2017,4,8,400,23,22,45,Saturday
2017,4,8,300,27,30,57,Saturday
2017,4,8,200,28,37,65,Saturday
2017,4,8,100,27,46,73,Saturday
2017,4,7,2400,60,68,128,Friday
2017,4,7,2300,110,99,209,Friday
2017,4,7,2200,147,81,228,Friday
2017,4,7,2100,259,122,381,Friday
2017,4,7,2000,338,190,528,Friday
2017,4,7,1900,405,249,654,Friday
2017,4,7,1800,453,395,848,Friday
2017,4,7,1700,461,489,950,Friday
2017,4,7,1600,413,426,839,Friday
2017,4,7,1500,420,346,766,Friday
2017,4,7,1400,388,337,725,Friday
2017,4,7,1300,364,302,666,Friday
2017,4,7,1200,450,285,735,Friday
2017,4,7,1100,439,209,648,Friday
2017,4,7,1000,477,166,643,Friday
2017,4,7,900,382,121,503,Friday
2017,4,7,800,217,59,276,Friday
2017,4,7,700,78,50,128,Friday
2017,4,7,600,48,38,86,Friday
2017,4,7,500,27,27,54,Friday
2017,4,7,400,33,28,61,Friday
2017,4,7,300,34,39,73,Friday
2017,4,7,200,26,52,78,Friday
2017,4,7,100,46,55,101,Friday
2017,4,6,2400,61,69,130,Thursday
2017,4,6,2300,95,104,199,Thursday
2017,4,6,2200,131,102,233,Thursday
2017,4,6,2100,165,155,320,Thursday
2017,4,6,2000,228,203,431,Thursday
2017,4,6,1900,225,294,519,Thursday
2017,4,6,1800,285,342,627,Thursday
2017,4,6,1700,302,464,766,Thursday
2017,4,6,1600,316,456,772,Thursday
2017,4,6,1500,362,333,695,Thursday
2017,4,6,1400,331,323,654,Thursday
2017,4,6,1300,357,193,550,Thursday
2017,4,6,1200,355,210,565,Thursday
2017,4,6,1100,368,205,573,Thursday
2017,4,6,1000,396,112,508,Thursday
2017,4,6,900,332,117,449,Thursday
2017,4,6,800,244,86,330,Thursday
2017,4,6,700,118,42,160,Thursday
2017,4,6,600,35,30,65,Thursday
2017,4,6,500,26,28,54,Thursday
2017,4,6,400,29,36,65,Thursday
2017,4,6,300,22,30,52,Thursday
2017,4,6,200,32,42,74,Thursday
2017,4,6,100,59,44,103,Thursday
2017,4,5,2400,61,71,132,Wednesday
2017,4,5,2300,84,84,168,Wednesday
2017,4,5,2200,132,107,239,Wednesday
2017,4,5,2100,179,143,322,Wednesday
2017,4,5,2000,201,187,388,Wednesday
2017,4,5,1900,195,275,470,Wednesday
2017,4,5,1800,203,379,582,Wednesday
2017,4,5,1700,268,468,736,Wednesday
2017,4,5,1600,275,394,669,Wednesday
2017,4,5,1500,298,279,577,Wednesday
2017,4,5,1400,259,273,532,Wednesday
2017,4,5,1300,310,232,542,Wednesday
2017,4,5,1200,282,184,466,Wednesday
2017,4,5,1100,373,182,555,Wednesday
2017,4,5,1000,345,143,488,Wednesday
2017,4,5,900,301,106,407,Wednesday
2017,4,5,800,167,69,236,Wednesday
2017,4,5,700,82,30,112,Wednesday
2017,4,5,600,37,34,71,Wednesday
2017,4,5,500,30,24,54,Wednesday
2017,4,5,400,30,29,59,Wednesday
2017,4,5,300,29,28,57,Wednesday
2017,4,5,200,30,36,66,Wednesday
2017,4,5,100,44,43,87,Wednesday
2017,4,4,2400,58,70,128,Tuesday
2017,4,4,2300,73,89,162,Tuesday
2017,4,4,2200,102,104,206,Tuesday
2017,4,4,2100,117,146,263,Tuesday
2017,4,4,2000,134,198,332,Tuesday
2017,4,4,1900,144,274,418,Tuesday
2017,4,4,1800,186,431,617,Tuesday
2017,4,4,1700,209,514,723,Tuesday
2017,4,4,1600,267,385,652,Tuesday
2017,4,4,1500,238,279,517,Tuesday
2017,4,4,1400,251,240,491,Tuesday
2017,4,4,1300,269,206,475,Tuesday
2017,4,4,1200,300,171,471,Tuesday
2017,4,4,1100,343,185,528,Tuesday
2017,4,4,1000,340,166,506,Tuesday
2017,4,4,900,299,130,429,Tuesday
2017,4,4,800,178,84,262,Tuesday
2017,4,4,700,86,37,123,Tuesday
2017,4,4,600,31,39,70,Tuesday
2017,4,4,500,25,21,46,Tuesday
2017,4,4,400,23,34,57,Tuesday
2017,4,4,300,22,34,56,Tuesday
2017,4,4,200,26,55,81,Tuesday
2017,4,4,100,34,67,101,Tuesday
2017,4,3,2400,51,65,116,Monday
2017,4,3,2300,58,88,146,Monday
2017,4,3,2200,97,120,217,Monday
2017,4,3,2100,113,156,269,Monday
2017,4,3,2000,146,213,359,Monday
2017,4,3,1900,170,272,442,Monday
2017,4,3,1800,169,456,625,Monday
2017,4,3,1700,203,525,728,Monday
2017,4,3,1600,226,474,700,Monday
2017,4,3,1500,277,345,622,Monday
2017,4,3,1400,299,277,576,Monday
2017,4,3,1300,319,270,589,Monday
2017,4,3,1200,363,206,569,Monday
2017,4,3,1100,401,187,588,Monday
2017,4,3,1000,386,132,518,Monday
2017,4,3,900,334,99,433,Monday
2017,4,3,800,209,49,258,Monday
2017,4,3,700,104,53,157,Monday
2017,4,3,600,32,21,53,Monday
2017,4,3,500,19,21,40,Monday
2017,4,3,400,14,18,32,Monday
2017,4,3,300,20,16,36,Monday
2017,4,3,200,18,22,40,Monday
2017,4,3,100,38,28,66,Monday
2017,4,2,2400,26,57,83,Sunday
2017,4,2,2300,46,109,155,Sunday
2017,4,2,2200,70,189,259,Sunday
2017,4,2,2100,89,323,412,Sunday
2017,4,2,2000,120,444,564,Sunday
2017,4,2,1900,120,708,828,Sunday
2017,4,2,1800,172,975,1147,Sunday
2017,4,2,1700,224,1221,1445,Sunday
2017,4,2,1600,289,1022,1311,Sunday
2017,4,2,1500,297,857,1154,Sunday
2017,4,2,1400,330,735,1065,Sunday
2017,4,2,1300,375,729,1104,Sunday
2017,4,2,1200,442,463,905,Sunday
2017,4,2,1100,443,291,734,Sunday
2017,4,2,1000,512,138,650,Sunday
2017,4,2,900,567,76,643,Sunday
2017,4,2,800,294,32,326,Sunday
2017,4,2,700,99,33,132,Sunday
2017,4,2,600,33,17,50,Sunday
2017,4,2,500,12,12,24,Sunday
2017,4,2,400,10,18,28,Sunday
2017,4,2,300,23,25,48,Sunday
2017,4,2,200,18,30,48,Sunday
2017,4,2,100,23,46,69,Sunday
2017,4,1,2400,31,60,91,Saturday
2017,4,1,2300,43,83,126,Saturday
2017,4,1,2200,71,151,222,Saturday
2017,4,1,2100,98,205,303,Saturday
2017,4,1,2000,120,287,407,Saturday
2017,4,1,1900,143,459,602,Saturday
2017,4,1,1800,175,802,977,Saturday
2017,4,1,1700,,,,Saturday
2017,4,1,1600,,,,Saturday
2017,4,1,1500,,,,Saturday
2017,4,1,1400,,,,Saturday
2017,4,1,1300,,,,Saturday
2017,4,1,1200,,,,Saturday
2017,4,1,1100,,,,Saturday
2017,4,1,1000,,,,Saturday
2017,4,1,900,,,,Saturday
2017,4,1,800,,,,Saturday
2017,4,1,700,,,,Saturday
2017,4,1,600,,,,Saturday
2017,4,1,500,,,,Saturday
2017,4,1,400,,,,Saturday
2017,4,1,300,,,,Saturday
2017,4,1,200,,,,Saturday
2017,4,1,100,,,,Saturday
2017,3,31,2400,54,73,127,Friday
2017,3,31,2300,86,109,195,Friday
2017,3,31,2200,134,139,273,Friday
2017,3,31,2100,261,205,466,Friday
2017,3,31,2000,381,290,671,Friday
2017,3,31,1900,384,397,781,Friday
2017,3,31,1800,497,717,1214,Friday
2017,3,31,1700,543,803,1346,Friday
2017,3,31,1600,520,638,1158,Friday
2017,3,31,1500,480,504,984,Friday
2017,3,31,1400,474,464,938,Friday
2017,3,31,1300,444,410,854,Friday
2017,3,31,1200,488,343,831,Friday
2017,3,31,1100,522,255,777,Friday
2017,3,31,1000,579,179,758,Friday
2017,3,31,900,596,142,738,Friday
2017,3,31,800,314,78,392,Friday
2017,3,31,700,122,43,165,Friday
2017,3,31,600,33,37,70,Friday
2017,3,31,500,37,29,66,Friday
2017,3,31,400,28,30,58,Friday
2017,3,31,300,32,35,67,Friday
2017,3,31,200,31,47,78,Friday
2017,3,31,100,49,54,103,Friday
2017,3,30,2400,54,76,130,Thursday
2017,3,30,2300,94,104,198,Thursday
2017,3,30,2200,126,139,265,Thursday
2017,3,30,2100,149,153,302,Thursday
2017,3,30,2000,235,265,500,Thursday
2017,3,30,1900,260,310,570,Thursday
2017,3,30,1800,302,601,903,Thursday
2017,3,30,1700,344,707,1051,Thursday
2017,3,30,1600,335,587,922,Thursday
2017,3,30,1500,400,486,886,Thursday
2017,3,30,1400,414,389,803,Thursday
2017,3,30,1300,402,380,782,Thursday
2017,3,30,1200,491,294,785,Thursday
2017,3,30,1100,459,213,672,Thursday
2017,3,30,1000,484,135,619,Thursday
2017,3,30,900,470,107,577,Thursday
2017,3,30,800,267,62,329,Thursday
2017,3,30,700,105,32,137,Thursday
2017,3,30,600,58,39,97,Thursday
2017,3,30,500,25,33,58,Thursday
2017,3,30,400,30,38,68,Thursday
2017,3,30,300,26,29,55,Thursday
2017,3,30,200,35,42,77,Thursday
2017,3,30,100,45,52,97,Thursday
2017,3,29,2400,66,75,141,Wednesday
2017,3,29,2300,85,89,174,Wednesday
2017,3,29,2200,118,114,232,Wednesday
2017,3,29,2100,151,143,294,Wednesday
2017,3,29,2000,190,204,394,Wednesday
2017,3,29,1900,204,375,579,Wednesday
2017,3,29,1800,267,573,840,Wednesday
2017,3,29,1700,275,719,994,Wednesday
2017,3,29,1600,304,410,714,Wednesday
2017,3,29,1500,339,452,791,Wednesday
2017,3,29,1400,347,406,753,Wednesday
2017,3,29,1300,395,318,713,Wednesday
2017,3,29,1200,452,255,707,Wednesday
2017,3,29,1100,437,213,650,Wednesday
2017,3,29,1000,435,139,574,Wednesday
2017,3,29,900,430,126,556,Wednesday
2017,3,29,800,238,81,319,Wednesday
2017,3,29,700,87,35,122,Wednesday
2017,3,29,600,36,29,65,Wednesday
2017,3,29,500,15,20,35,Wednesday
2017,3,29,400,26,37,63,Wednesday
2017,3,29,300,28,25,53,Wednesday
2017,3,29,200,31,37,68,Wednesday
2017,3,29,100,44,58,102,Wednesday
2017,3,28,2400,51,59,110,Tuesday
2017,3,28,2300,71,88,159,Tuesday
2017,3,28,2200,112,115,227,Tuesday
2017,3,28,2100,129,173,302,Tuesday
2017,3,28,2000,133,197,330,Tuesday
2017,3,28,1900,166,312,478,Tuesday
2017,3,28,1800,205,603,808,Tuesday
2017,3,28,1700,263,711,974,Tuesday
2017,3,28,1600,303,521,824,Tuesday
2017,3,28,1500,320,571,891,Tuesday
2017,3,28,1400,363,429,792,Tuesday
2017,3,28,1300,396,356,752,Tuesday
2017,3,28,1200,448,261,709,Tuesday
2017,3,28,1100,480,149,629,Tuesday
2017,3,28,1000,457,92,549,Tuesday
2017,3,28,900,486,79,565,Tuesday
2017,3,28,800,251,82,333,Tuesday
2017,3,28,700,73,35,108,Tuesday
2017,3,28,600,29,35,64,Tuesday
2017,3,28,500,19,32,51,Tuesday
2017,3,28,400,22,45,67,Tuesday
2017,3,28,300,18,46,64,Tuesday
2017,3,28,200,23,35,58,Tuesday
2017,3,28,100,36,41,77,Tuesday
2017,3,27,2400,64,65,129,Monday
2017,3,27,2300,77,89,166,Monday
2017,3,27,2200,110,115,225,Monday
2017,3,27,2100,120,136,256,Monday
2017,3,27,2000,144,204,348,Monday
2017,3,27,1900,188,344,532,Monday
2017,3,27,1800,220,623,843,Monday
2017,3,27,1700,297,747,1044,Monday
2017,3,27,1600,358,546,904,Monday
2017,3,27,1500,397,444,841,Monday
2017,3,27,1400,465,390,855,Monday
2017,3,27,1300,502,378,880,Monday
2017,3,27,1200,496,318,814,Monday
2017,3,27,1100,492,203,695,Monday
2017,3,27,1000,512,142,654,Monday
2017,3,27,900,522,93,615,Monday
2017,3,27,800,231,60,291,Monday
2017,3,27,700,92,40,132,Monday
2017,3,27,600,33,24,57,Monday
2017,3,27,500,20,14,34,Monday
2017,3,27,400,14,16,30,Monday
2017,3,27,300,20,22,42,Monday
2017,3,27,200,24,33,57,Monday
2017,3,27,100,18,63,81,Monday
2017,3,26,2400,38,64,102,Sunday
2017,3,26,2300,63,133,196,Sunday
2017,3,26,2200,93,178,271,Sunday
2017,3,26,2100,107,254,361,Sunday
2017,3,26,2000,169,460,629,Sunday
2017,3,26,1900,183,657,840,Sunday
2017,3,26,1800,277,1187,1464,Sunday
2017,3,26,1700,360,1345,1705,Sunday
2017,3,26,1600,429,1029,1458,Sunday
2017,3,26,1500,466,815,1281,Sunday
2017,3,26,1400,508,674,1182,Sunday
2017,3,26,1300,571,573,1144,Sunday
2017,3,26,1200,685,436,1121,Sunday
2017,3,26,1100,692,258,950,Sunday
2017,3,26,1000,665,137,802,Sunday
2017,3,26,900,815,76,891,Sunday
2017,3,26,800,334,38,372,Sunday
2017,3,26,700,114,17,131,Sunday
2017,3,26,600,41,20,61,Sunday
2017,3,26,500,24,17,41,Sunday
2017,3,26,400,20,23,43,Sunday
2017,3,26,300,11,25,36,Sunday
2017,3,26,200,21,43,64,Sunday
2017,3,26,100,34,49,83,Sunday
2017,3,25,2400,37,69,106,Saturday
2017,3,25,2300,43,80,123,Saturday
2017,3,25,2200,95,119,214,Saturday
2017,3,25,2100,110,151,261,Saturday
2017,3,25,2000,118,232,350,Saturday
2017,3,25,1900,165,517,682,Saturday
2017,3,25,1800,262,821,1083,Saturday
2017,3,25,1700,334,868,1202,Saturday
2017,3,25,1600,409,605,1014,Saturday
2017,3,25,1500,477,471,948,Saturday
2017,3,25,1400,513,385,898,Saturday
2017,3,25,1300,608,305,913,Saturday
2017,3,25,1200,692,290,982,Saturday
2017,3,25,1100,722,223,945,Saturday
2017,3,25,1000,804,164,968,Saturday
2017,3,25,900,916,86,1002,Saturday
2017,3,25,800,430,51,481,Saturday
2017,3,25,700,156,26,182,Saturday
2017,3,25,600,45,37,82,Saturday
2017,3,25,500,18,27,45,Saturday
2017,3,25,400,15,23,38,Saturday
2017,3,25,300,20,36,56,Saturday
2017,3,25,200,46,38,84,Saturday
2017,3,25,100,52,45,97,Saturday
2017,3,24,2400,79,43,122,Friday
2017,3,24,2300,103,65,168,Friday
2017,3,24,2200,161,98,259,Friday
2017,3,24,2100,300,145,445,Friday
2017,3,24,2000,427,178,605,Friday
2017,3,24,1900,547,281,828,Friday
2017,3,24,1800,582,517,1099,Friday
2017,3,24,1700,591,659,1250,Friday
2017,3,24,1600,575,550,1125,Friday
2017,3,24,1500,522,436,958,Friday
2017,3,24,1400,508,361,869,Friday
2017,3,24,1300,517,309,826,Friday
2017,3,24,1200,528,262,790,Friday
2017,3,24,1100,576,195,771,Friday
2017,3,24,1000,550,145,695,Friday
2017,3,24,900,554,106,660,Friday
2017,3,24,800,301,71,372,Friday
2017,3,24,700,112,38,150,Friday
2017,3,24,600,41,28,69,Friday
2017,3,24,500,30,39,69,Friday
2017,3,24,400,29,32,61,Friday
2017,3,24,300,21,29,50,Friday
2017,3,24,200,37,35,72,Friday
2017,3,24,100,43,53,96,Friday
2017,3,23,2400,66,63,129,Thursday
2017,3,23,2300,95,88,183,Thursday
2017,3,23,2200,157,89,246,Thursday
2017,3,23,2100,205,150,355,Thursday
2017,3,23,2000,251,169,420,Thursday
2017,3,23,1900,263,263,526,Thursday
2017,3,23,1800,340,416,756,Thursday
2017,3,23,1700,352,546,898,Thursday
2017,3,23,1600,399,439,838,Thursday
2017,3,23,1500,405,348,753,Thursday
2017,3,23,1400,355,288,643,Thursday
2017,3,23,1300,360,240,600,Thursday
2017,3,23,1200,429,209,638,Thursday
2017,3,23,1100,483,181,664,Thursday
2017,3,23,1000,431,142,573,Thursday
2017,3,23,900,377,90,467,Thursday
2017,3,23,800,266,72,338,Thursday
2017,3,23,700,95,48,143,Thursday
2017,3,23,600,38,36,74,Thursday
2017,3,23,500,29,35,64,Thursday
2017,3,23,400,25,51,76,Thursday
2017,3,23,300,24,49,73,Thursday
2017,3,23,200,39,41,80,Thursday
2017,3,23,100,37,58,95,Thursday
2017,3,22,2400,57,70,127,Wednesday
2017,3,22,2300,89,75,164,Wednesday
2017,3,22,2200,122,105,227,Wednesday
2017,3,22,2100,134,119,253,Wednesday
2017,3,22,2000,171,180,351,Wednesday
2017,3,22,1900,161,208,369,Wednesday
2017,3,22,1800,208,355,563,Wednesday
2017,3,22,1700,262,492,754,Wednesday
2017,3,22,1600,266,385,651,Wednesday
2017,3,22,1500,239,312,551,Wednesday
2017,3,22,1400,270,273,543,Wednesday
2017,3,22,1300,292,245,537,Wednesday
2017,3,22,1200,317,206,523,Wednesday
2017,3,22,1100,344,182,526,Wednesday
2017,3,22,1000,322,132,454,Wednesday
2017,3,22,900,291,115,406,Wednesday
2017,3,22,800,207,65,272,Wednesday
2017,3,22,700,79,33,112,Wednesday
2017,3,22,600,37,24,61,Wednesday
2017,3,22,500,25,23,48,Wednesday
2017,3,22,400,27,32,59,Wednesday
2017,3,22,300,31,38,69,Wednesday
2017,3,22,200,23,38,61,Wednesday
2017,3,22,100,37,53,90,Wednesday
2017,3,21,2400,54,58,112,Tuesday
2017,3,21,2300,66,65,131,Tuesday
2017,3,21,2200,95,90,185,Tuesday
2017,3,21,2100,104,142,246,Tuesday
2017,3,21,2000,110,184,294,Tuesday
2017,3,21,1900,146,260,406,Tuesday
2017,3,21,1800,177,393,570,Tuesday
2017,3,21,1700,199,469,668,Tuesday
2017,3,21,1600,228,415,643,Tuesday
2017,3,21,1500,217,302,519,Tuesday
2017,3,21,1400,247,261,508,Tuesday
2017,3,21,1300,261,227,488,Tuesday
2017,3,21,1200,343,226,569,Tuesday
2017,3,21,1100,337,168,505,Tuesday
2017,3,21,1000,327,149,476,Tuesday
2017,3,21,900,294,92,386,Tuesday
2017,3,21,800,215,71,286,Tuesday
2017,3,21,700,91,36,127,Tuesday
2017,3,21,600,27,27,54,Tuesday
2017,3,21,500,22,30,52,Tuesday
2017,3,21,400,19,25,44,Tuesday
2017,3,21,300,23,51,74,Tuesday
2017,3,21,200,19,38,57,Tuesday
2017,3,21,100,43,44,87,Tuesday
2017,3,20,2400,45,53,98,Monday
2017,3,20,2300,66,81,147,Monday
2017,3,20,2200,91,99,190,Monday
2017,3,20,2100,90,151,241,Monday
2017,3,20,2000,128,205,333,Monday
2017,3,20,1900,142,287,429,Monday
2017,3,20,1800,192,604,796,Monday
2017,3,20,1700,240,563,803,Monday
2017,3,20,1600,252,519,771,Monday
2017,3,20,1500,276,410,686,Monday
2017,3,20,1400,280,320,600,Monday
2017,3,20,1300,319,263,582,Monday
2017,3,20,1200,364,272,636,Monday
2017,3,20,1100,448,165,613,Monday
2017,3,20,1000,452,118,570,Monday
2017,3,20,900,459,91,550,Monday
2017,3,20,800,223,54,277,Monday
2017,3,20,700,85,34,119,Monday
2017,3,20,600,31,23,54,Monday
2017,3,20,500,16,18,34,Monday
2017,3,20,400,14,14,28,Monday
2017,3,20,300,12,22,34,Monday
2017,3,20,200,19,24,43,Monday
2017,3,20,100,30,33,63,Monday
2017,3,19,2400,33,57,90,Sunday
2017,3,19,2300,44,101,145,Sunday
2017,3,19,2200,74,140,214,Sunday
2017,3,19,2100,100,201,301,Sunday
2017,3,19,2000,123,321,444,Sunday
2017,3,19,1900,152,520,672,Sunday
2017,3,19,1800,197,1232,1429,Sunday
2017,3,19,1700,243,1544,1787,Sunday
2017,3,19,1600,303,691,994,Sunday
2017,3,19,1500,297,568,865,Sunday
2017,3,19,1400,331,647,978,Sunday
2017,3,19,1300,373,575,948,Sunday
2017,3,19,1200,422,806,1228,Sunday
2017,3,19,1100,467,73,540,Sunday
2017,3,19,1000,573,107,680,Sunday
2017,3,19,900,938,86,1024,Sunday
2017,3,19,800,426,40,466,Sunday
2017,3,19,700,76,19,95,Sunday
2017,3,19,600,27,13,40,Sunday
2017,3,19,500,17,20,37,Sunday
2017,3,19,400,12,13,25,Sunday
2017,3,19,300,11,29,40,Sunday
2017,3,19,200,15,44,59,Sunday
2017,3,19,100,22,65,87,Sunday
2017,3,18,2400,28,24,52,Saturday
2017,3,18,2300,45,106,151,Saturday
2017,3,18,2200,68,32,100,Saturday
2017,3,18,2100,73,84,157,Saturday
2017,3,18,2000,112,286,398,Saturday
2017,3,18,1900,118,197,315,Saturday
2017,3,18,1800,160,618,778,Saturday
2017,3,18,1700,239,902,1141,Saturday
2017,3,18,1600,281,645,926,Saturday
2017,3,18,1500,307,528,835,Saturday
2017,3,18,1400,349,321,670,Saturday
2017,3,18,1300,339,365,704,Saturday
2017,3,18,1200,370,291,661,Saturday
2017,3,18,1100,449,180,629,Saturday
2017,3,18,1000,596,96,692,Saturday
2017,3,18,900,814,92,906,Saturday
2017,3,18,800,431,55,486,Saturday
2017,3,18,700,93,30,123,Saturday
2017,3,18,600,43,18,61,Saturday
2017,3,18,500,36,28,64,Saturday
2017,3,18,400,22,15,37,Saturday
2017,3,18,300,20,13,33,Saturday
2017,3,18,200,34,26,60,Saturday
2017,3,18,100,34,38,72,Saturday
2017,3,17,2400,46,70,116,Friday
2017,3,17,2300,80,90,170,Friday
2017,3,17,2200,146,85,231,Friday
2017,3,17,2100,237,152,389,Friday
2017,3,17,2000,299,234,533,Friday
2017,3,17,1900,381,320,701,Friday
2017,3,17,1800,456,665,1121,Friday
2017,3,17,1700,446,828,1274,Friday
2017,3,17,1600,436,591,1027,Friday
2017,3,17,1500,436,405,841,Friday
2017,3,17,1400,332,361,693,Friday
2017,3,17,1300,349,293,642,Friday
2017,3,17,1200,401,216,617,Friday
2017,3,17,1100,429,168,597,Friday
2017,3,17,1000,622,168,790,Friday
2017,3,17,900,633,74,707,Friday
2017,3,17,800,274,55,329,Friday
2017,3,17,700,105,34,139,Friday
2017,3,17,600,29,38,67,Friday
2017,3,17,500,26,33,59,Friday
2017,3,17,400,27,21,48,Friday
2017,3,17,300,20,32,52,Friday
2017,3,17,200,40,42,82,Friday
2017,3,17,100,43,45,88,Friday
2017,3,16,2400,51,62,113,Thursday
2017,3,16,2300,79,84,163,Thursday
2017,3,16,2200,120,102,222,Thursday
2017,3,16,2100,173,138,311,Thursday
2017,3,16,2000,191,181,372,Thursday
2017,3,16,1900,230,256,486,Thursday
2017,3,16,1800,259,497,756,Thursday
2017,3,16,1700,270,610,880,Thursday
2017,3,16,1600,317,469,786,Thursday
2017,3,16,1500,317,348,665,Thursday
2017,3,16,1400,289,304,593,Thursday
2017,3,16,1300,279,262,541,Thursday
2017,3,16,1200,328,181,509,Thursday
2017,3,16,1100,392,160,552,Thursday
2017,3,16,1000,521,116,637,Thursday
2017,3,16,900,572,87,659,Thursday
2017,3,16,800,178,48,226,Thursday
2017,3,16,700,82,32,114,Thursday
2017,3,16,600,36,26,62,Thursday
2017,3,16,500,22,43,65,Thursday
2017,3,16,400,25,16,41,Thursday
2017,3,16,300,22,34,56,Thursday
2017,3,16,200,28,21,49,Thursday
2017,3,16,100,49,33,82,Thursday
2017,3,15,2400,63,54,117,Wednesday
2017,3,15,2300,73,83,156,Wednesday
2017,3,15,2200,83,113,196,Wednesday
2017,3,15,2100,116,191,307,Wednesday
2017,3,15,2000,160,101,261,Wednesday
2017,3,15,1900,145,253,398,Wednesday
2017,3,15,1800,193,320,513,Wednesday
2017,3,15,1700,236,426,662,Wednesday
2017,3,15,1600,213,383,596,Wednesday
2017,3,15,1500,236,294,530,Wednesday
2017,3,15,1400,262,333,595,Wednesday
2017,3,15,1300,283,177,460,Wednesday
2017,3,15,1200,310,244,554,Wednesday
2017,3,15,1100,322,204,526,Wednesday
2017,3,15,1000,366,123,489,Wednesday
2017,3,15,900,334,97,431,Wednesday
2017,3,15,800,213,60,273,Wednesday
2017,3,15,700,63,50,113,Wednesday
2017,3,15,600,39,78,117,Wednesday
2017,3,15,500,20,7,27,Wednesday
2017,3,15,400,28,2,30,Wednesday
2017,3,15,300,33,28,61,Wednesday
2017,3,15,200,28,56,84,Wednesday
2017,3,15,100,35,60,95,Wednesday
2017,3,14,2400,64,56,120,Tuesday
2017,3,14,2300,71,71,142,Tuesday
2017,3,14,2200,85,67,152,Tuesday
2017,3,14,2100,104,143,247,Tuesday
2017,3,14,2000,131,192,323,Tuesday
2017,3,14,1900,137,279,416,Tuesday
2017,3,14,1800,180,460,640,Tuesday
2017,3,14,1700,222,537,759,Tuesday
2017,3,14,1600,224,379,603,Tuesday
2017,3,14,1500,247,338,585,Tuesday
2017,3,14,1400,251,331,582,Tuesday
2017,3,14,1300,297,304,601,Tuesday
2017,3,14,1200,320,245,565,Tuesday
2017,3,14,1100,328,208,536,Tuesday
2017,3,14,1000,404,154,558,Tuesday
2017,3,14,900,347,98,445,Tuesday
2017,3,14,800,228,55,283,Tuesday
2017,3,14,700,84,33,117,Tuesday
2017,3,14,600,41,48,89,Tuesday
2017,3,14,500,23,28,51,Tuesday
2017,3,14,400,27,20,47,Tuesday
2017,3,14,300,31,25,56,Tuesday
2017,3,14,200,22,47,69,Tuesday
2017,3,14,100,41,51,92,Tuesday
2017,3,13,2400,55,67,122,Monday
2017,3,13,2300,65,125,190,Monday
2017,3,13,2200,91,344,435,Monday
2017,3,13,2100,123,123,246,Monday
2017,3,13,2000,152,92,244,Monday
2017,3,13,1900,133,160,293,Monday
2017,3,13,1800,189,414,603,Monday
2017,3,13,1700,230,433,663,Monday
2017,3,13,1600,231,308,539,Monday
2017,3,13,1500,220,261,481,Monday
2017,3,13,1400,263,279,542,Monday
2017,3,13,1300,293,240,533,Monday
2017,3,13,1200,353,235,588,Monday
2017,3,13,1100,339,159,498,Monday
2017,3,13,1000,393,131,524,Monday
2017,3,13,900,393,86,479,Monday
2017,3,13,800,196,45,241,Monday
2017,3,13,700,82,25,107,Monday
2017,3,13,600,32,16,48,Monday
2017,3,13,500,18,22,40,Monday
2017,3,13,400,11,26,37,Monday
2017,3,13,300,14,25,39,Monday
2017,3,13,200,25,32,57,Monday
2017,3,13,100,27,42,69,Monday
2017,3,12,2400,45,78,123,Sunday
2017,3,12,2300,53,93,146,Sunday
2017,3,12,2200,63,137,200,Sunday
2017,3,12,2100,86,317,403,Sunday
2017,3,12,2000,127,420,547,Sunday
2017,3,12,1900,124,641,765,Sunday
2017,3,12,1800,185,1052,1237,Sunday
2017,3,12,1700,215,1297,1512,Sunday
2017,3,12,1600,277,874,1151,Sunday
2017,3,12,1500,271,667,938,Sunday
2017,3,12,1400,348,648,996,Sunday
2017,3,12,1300,354,519,873,Sunday
2017,3,12,1200,408,309,717,Sunday
2017,3,12,1100,436,197,633,Sunday
2017,3,12,1000,562,152,714,Sunday
2017,3,12,900,717,88,805,Sunday
2017,3,12,800,292,35,327,Sunday
2017,3,12,700,58,19,77,Sunday
2017,3,12,600,33,16,49,Sunday
2017,3,12,500,13,26,39,Sunday
2017,3,12,400,16,19,35,Sunday
2017,3,12,300,0,0,0,Sunday
2017,3,12,200,19,22,41,Sunday
2017,3,12,100,30,25,55,Sunday
2017,3,11,2400,34,51,85,Saturday
2017,3,11,2300,44,55,99,Saturday
2017,3,11,2200,52,75,127,Saturday
2017,3,11,2100,59,107,166,Saturday
2017,3,11,2000,118,166,284,Saturday
2017,3,11,1900,117,326,443,Saturday
2017,3,11,1800,212,896,1108,Saturday
2017,3,11,1700,245,954,1199,Saturday
2017,3,11,1600,227,642,869,Saturday
2017,3,11,1500,297,458,755,Saturday
2017,3,11,1400,275,327,602,Saturday
2017,3,11,1300,332,290,622,Saturday
2017,3,11,1200,353,266,619,Saturday
2017,3,11,1100,471,181,652,Saturday
2017,3,11,1000,630,169,799,Saturday
2017,3,11,900,1048,97,1145,Saturday
2017,3,11,800,524,63,587,Saturday
2017,3,11,700,108,24,132,Saturday
2017,3,11,600,45,22,67,Saturday
2017,3,11,500,14,33,47,Saturday
2017,3,11,400,12,28,40,Saturday
2017,3,11,300,22,34,56,Saturday
2017,3,11,200,33,66,99,Saturday
2017,3,11,100,34,87,121,Saturday
2017,3,10,2400,67,30,97,Friday
2017,3,10,2300,120,81,201,Friday
2017,3,10,2200,149,87,236,Friday
2017,3,10,2100,274,114,388,Friday
2017,3,10,2000,324,132,456,Friday
2017,3,10,1900,393,267,660,Friday
2017,3,10,1800,479,485,964,Friday
2017,3,10,1700,466,538,1004,Friday
2017,3,10,1600,442,429,871,Friday
2017,3,10,1500,436,284,720,Friday
2017,3,10,1400,349,260,609,Friday
2017,3,10,1300,350,206,556,Friday
2017,3,10,1200,399,179,578,Friday
2017,3,10,1100,391,146,537,Friday
2017,3,10,1000,513,119,632,Friday
2017,3,10,900,453,86,539,Friday
2017,3,10,800,274,40,314,Friday
2017,3,10,700,72,36,108,Friday
2017,3,10,600,38,21,59,Friday
2017,3,10,500,27,24,51,Friday
2017,3,10,400,30,18,48,Friday
2017,3,10,300,20,19,39,Friday
2017,3,10,200,41,36,77,Friday
2017,3,10,100,54,34,88,Friday
2017,3,9,2400,71,34,105,Thursday
2017,3,9,2300,78,76,154,Thursday
2017,3,9,2200,126,81,207,Thursday
2017,3,9,2100,161,125,286,Thursday
2017,3,9,2000,215,131,346,Thursday
2017,3,9,1900,240,212,452,Thursday
2017,3,9,1800,278,368,646,Thursday
2017,3,9,1700,323,492,815,Thursday
2017,3,9,1600,336,356,692,Thursday
2017,3,9,1500,233,356,589,Thursday
2017,3,9,1400,259,280,539,Thursday
2017,3,9,1300,307,225,532,Thursday
2017,3,9,1200,310,122,432,Thursday
2017,3,9,1100,329,184,513,Thursday
2017,3,9,1000,394,151,545,Thursday
2017,3,9,900,363,122,485,Thursday
2017,3,9,800,250,73,323,Thursday
2017,3,9,700,111,51,162,Thursday
2017,3,9,600,57,56,113,Thursday
2017,3,9,500,23,53,76,Thursday
2017,3,9,400,18,41,59,Thursday
2017,3,9,300,22,91,113,Thursday
2017,3,9,200,28,21,49,Thursday
2017,3,9,100,33,16,49,Thursday
2017,3,8,2400,39,12,51,Wednesday
2017,3,8,2300,66,22,88,Wednesday
2017,3,8,2200,92,68,160,Wednesday
2017,3,8,2100,84,91,175,Wednesday
2017,3,8,2000,127,141,268,Wednesday
2017,3,8,1900,155,199,354,Wednesday
2017,3,8,1800,145,369,514,Wednesday
2017,3,8,1700,190,376,566,Wednesday
2017,3,8,1600,206,344,550,Wednesday
2017,3,8,1500,201,265,466,Wednesday
2017,3,8,1400,206,244,450,Wednesday
2017,3,8,1300,215,193,408,Wednesday
2017,3,8,1200,253,133,386,Wednesday
2017,3,8,1100,226,171,397,Wednesday
2017,3,8,1000,296,137,433,Wednesday
2017,3,8,900,302,98,400,Wednesday
2017,3,8,800,201,43,244,Wednesday
2017,3,8,700,67,32,99,Wednesday
2017,3,8,600,32,21,53,Wednesday
2017,3,8,500,13,15,28,Wednesday
2017,3,8,400,18,20,38,Wednesday
2017,3,8,300,22,17,39,Wednesday
2017,3,8,200,23,22,45,Wednesday
2017,3,8,100,34,54,88,Wednesday
2017,3,7,2400,25,102,127,Tuesday
2017,3,7,2300,53,247,300,Tuesday
2017,3,7,2200,65,238,303,Tuesday
2017,3,7,2100,82,172,254,Tuesday
2017,3,7,2000,107,94,201,Tuesday
2017,3,7,1900,115,150,265,Tuesday
2017,3,7,1800,182,272,454,Tuesday
2017,3,7,1700,176,343,519,Tuesday
2017,3,7,1600,185,295,480,Tuesday
2017,3,7,1500,206,209,415,Tuesday
2017,3,7,1400,234,205,439,Tuesday
2017,3,7,1300,225,122,347,Tuesday
2017,3,7,1200,253,148,401,Tuesday
2017,3,7,1100,324,162,486,Tuesday
2017,3,7,1000,323,95,418,Tuesday
2017,3,7,900,327,88,415,Tuesday
2017,3,7,800,200,40,240,Tuesday
2017,3,7,700,92,22,114,Tuesday
2017,3,7,600,36,15,51,Tuesday
2017,3,7,500,15,30,45,Tuesday
2017,3,7,400,15,23,38,Tuesday
2017,3,7,300,18,19,37,Tuesday
2017,3,7,200,30,28,58,Tuesday
2017,3,7,100,32,55,87,Tuesday
2017,3,6,2400,41,45,86,Monday
2017,3,6,2300,59,53,112,Monday
2017,3,6,2200,67,103,170,Monday
2017,3,6,2100,84,115,199,Monday
2017,3,6,2000,100,122,222,Monday
2017,3,6,1900,110,202,312,Monday
2017,3,6,1800,166,465,631,Monday
2017,3,6,1700,218,551,769,Monday
2017,3,6,1600,214,426,640,Monday
2017,3,6,1500,224,343,567,Monday
2017,3,6,1400,235,258,493,Monday
2017,3,6,1300,263,269,532,Monday
2017,3,6,1200,311,228,539,Monday
2017,3,6,1100,320,161,481,Monday
2017,3,6,1000,382,148,530,Monday
2017,3,6,900,403,97,500,Monday
2017,3,6,800,214,50,264,Monday
2017,3,6,700,94,30,124,Monday
2017,3,6,600,25,23,48,Monday
2017,3,6,500,9,20,29,Monday
2017,3,6,400,14,13,27,Monday
2017,3,6,300,13,14,27,Monday
2017,3,6,200,19,25,44,Monday
2017,3,6,100,19,50,69,Monday
2017,3,5,2400,26,73,99,Sunday
2017,3,5,2300,39,122,161,Sunday
2017,3,5,2200,50,122,172,Sunday
2017,3,5,2100,58,167,225,Sunday
2017,3,5,2000,94,242,336,Sunday
2017,3,5,1900,123,402,525,Sunday
2017,3,5,1800,139,886,1025,Sunday
2017,3,5,1700,196,1207,1403,Sunday
2017,3,5,1600,217,957,1174,Sunday
2017,3,5,1500,252,781,1033,Sunday
2017,3,5,1400,283,661,944,Sunday
2017,3,5,1300,301,554,855,Sunday
2017,3,5,1200,312,444,756,Sunday
2017,3,5,1100,415,293,708,Sunday
2017,3,5,1000,795,153,948,Sunday
2017,3,5,900,544,92,636,Sunday
2017,3,5,800,344,43,387,Sunday
2017,3,5,700,102,21,123,Sunday
2017,3,5,600,23,13,36,Sunday
2017,3,5,500,10,20,30,Sunday
2017,3,5,400,22,10,32,Sunday
2017,3,5,300,6,18,24,Sunday
2017,3,5,200,19,28,47,Sunday
2017,3,5,100,18,24,42,Sunday
2017,3,4,2400,32,35,67,Saturday
2017,3,4,2300,48,106,154,Saturday
2017,3,4,2200,43,81,124,Saturday
2017,3,4,2100,62,120,182,Saturday
2017,3,4,2000,99,202,301,Saturday
2017,3,4,1900,131,353,484,Saturday
2017,3,4,1800,187,1087,1274,Saturday
2017,3,4,1700,190,839,1029,Saturday
2017,3,4,1600,228,621,849,Saturday
2017,3,4,1500,275,342,617,Saturday
2017,3,4,1400,285,291,576,Saturday
2017,3,4,1300,287,233,520,Saturday
2017,3,4,1200,388,209,597,Saturday
2017,3,4,1100,516,210,726,Saturday
2017,3,4,1000,717,177,894,Saturday
2017,3,4,900,816,100,916,Saturday
2017,3,4,800,562,37,599,Saturday
2017,3,4,700,118,22,140,Saturday
2017,3,4,600,49,14,63,Saturday
2017,3,4,500,22,21,43,Saturday
2017,3,4,400,24,13,37,Saturday
2017,3,4,300,25,16,41,Saturday
2017,3,4,200,37,22,59,Saturday
2017,3,4,100,38,31,69,Saturday
2017,3,3,2400,50,57,107,Friday
2017,3,3,2300,102,54,156,Friday
2017,3,3,2200,145,74,219,Friday
2017,3,3,2100,231,101,332,Friday
2017,3,3,2000,345,137,482,Friday
2017,3,3,1900,427,253,680,Friday
2017,3,3,1800,514,452,966,Friday
2017,3,3,1700,503,589,1092,Friday
2017,3,3,1600,491,440,931,Friday
2017,3,3,1500,416,398,814,Friday
2017,3,3,1400,362,305,667,Friday
2017,3,3,1300,367,251,618,Friday
2017,3,3,1200,373,236,609,Friday
2017,3,3,1100,416,177,593,Friday
2017,3,3,1000,455,136,591,Friday
2017,3,3,900,523,89,612,Friday
2017,3,3,800,281,60,341,Friday
2017,3,3,700,109,40,149,Friday
2017,3,3,600,38,22,60,Friday
2017,3,3,500,23,26,49,Friday
2017,3,3,400,33,19,52,Friday
2017,3,3,300,28,31,59,Friday
2017,3,3,200,30,31,61,Friday
2017,3,3,100,43,45,88,Friday
2017,3,2,2400,58,51,109,Thursday
2017,3,2,2300,84,63,147,Thursday
2017,3,2,2200,160,85,245,Thursday
2017,3,2,2100,173,130,303,Thursday
2017,3,2,2000,218,170,388,Thursday
2017,3,2,1900,222,235,457,Thursday
2017,3,2,1800,297,420,717,Thursday
2017,3,2,1700,328,537,865,Thursday
2017,3,2,1600,301,358,659,Thursday
2017,3,2,1500,315,319,634,Thursday
2017,3,2,1400,289,241,530,Thursday
2017,3,2,1300,278,200,478,Thursday
2017,3,2,1200,285,202,487,Thursday
2017,3,2,1100,341,169,510,Thursday
2017,3,2,1000,415,118,533,Thursday
2017,3,2,900,376,99,475,Thursday
2017,3,2,800,250,70,320,Thursday
2017,3,2,700,74,43,117,Thursday
2017,3,2,600,41,25,66,Thursday
2017,3,2,500,34,24,58,Thursday
2017,3,2,400,16,31,47,Thursday
2017,3,2,300,24,41,65,Thursday
2017,3,2,200,32,31,63,Thursday
2017,3,2,100,43,39,82,Thursday
2017,3,1,2400,49,62,111,Wednesday
2017,3,1,2300,71,75,146,Wednesday
2017,3,1,2200,93,107,200,Wednesday
2017,3,1,2100,122,124,246,Wednesday
2017,3,1,2000,130,95,225,Wednesday
2017,3,1,1900,147,217,364,Wednesday
2017,3,1,1800,156,310,466,Wednesday
2017,3,1,1700,223,394,617,Wednesday
2017,3,1,1600,227,322,549,Wednesday
2017,3,1,1500,227,298,525,Wednesday
2017,3,1,1400,227,233,460,Wednesday
2017,3,1,1300,242,252,494,Wednesday
2017,3,1,1200,287,199,486,Wednesday
2017,3,1,1100,315,139,454,Wednesday
2017,3,1,1000,277,125,402,Wednesday
2017,3,1,900,313,86,399,Wednesday
2017,3,1,800,220,58,278,Wednesday
2017,3,1,700,74,38,112,Wednesday
2017,3,1,600,34,22,56,Wednesday
2017,3,1,500,27,32,59,Wednesday
2017,3,1,400,14,30,44,Wednesday
2017,3,1,300,22,32,54,Wednesday
2017,3,1,200,27,21,48,Wednesday
2017,3,1,100,42,37,79,Wednesday
2017,2,28,2400,53,64,117,Tuesday
2017,2,28,2300,66,62,128,Tuesday
2017,2,28,2200,78,93,171,Tuesday
2017,2,28,2100,88,121,209,Tuesday
2017,2,28,2000,101,155,256,Tuesday
2017,2,28,1900,139,214,353,Tuesday
2017,2,28,1800,161,371,532,Tuesday
2017,2,28,1700,215,453,668,Tuesday
2017,2,28,1600,211,364,575,Tuesday
2017,2,28,1500,227,284,511,Tuesday
2017,2,28,1400,251,238,489,Tuesday
2017,2,28,1300,256,238,494,Tuesday
2017,2,28,1200,271,212,483,Tuesday
2017,2,28,1100,295,185,480,Tuesday
2017,2,28,1000,331,152,483,Tuesday
2017,2,28,900,265,106,371,Tuesday
2017,2,28,800,189,58,247,Tuesday
2017,2,28,700,76,30,106,Tuesday
2017,2,28,600,35,25,60,Tuesday
2017,2,28,500,16,24,40,Tuesday
2017,2,28,400,21,33,54,Tuesday
2017,2,28,300,20,25,45,Tuesday
2017,2,28,200,32,42,74,Tuesday
2017,2,28,100,28,54,82,Tuesday
2017,2,27,2400,49,54,103,Monday
2017,2,27,2300,66,65,131,Monday
2017,2,27,2200,95,81,176,Monday
2017,2,27,2100,102,99,201,Monday
2017,2,27,2000,112,157,269,Monday
2017,2,27,1900,129,238,367,Monday
2017,2,27,1800,168,416,584,Monday
2017,2,27,1700,198,483,681,Monday
2017,2,27,1600,217,411,628,Monday
2017,2,27,1500,269,275,544,Monday
2017,2,27,1400,262,253,515,Monday
2017,2,27,1300,244,284,528,Monday
2017,2,27,1200,284,216,500,Monday
2017,2,27,1100,325,190,515,Monday
2017,2,27,1000,339,127,466,Monday
2017,2,27,900,322,91,413,Monday
2017,2,27,800,185,43,228,Monday
2017,2,27,700,74,24,98,Monday
2017,2,27,600,37,23,60,Monday
2017,2,27,500,18,26,44,Monday
2017,2,27,400,22,18,40,Monday
2017,2,27,300,12,28,40,Monday
2017,2,27,200,25,31,56,Monday
2017,2,27,100,21,31,52,Monday
2017,2,26,2400,25,75,100,Sunday
2017,2,26,2300,33,91,124,Sunday
2017,2,26,2200,52,115,167,Sunday
2017,2,26,2100,74,209,283,Sunday
2017,2,26,2000,100,302,402,Sunday
2017,2,26,1900,123,470,593,Sunday
2017,2,26,1800,167,869,1036,Sunday
2017,2,26,1700,224,1073,1297,Sunday
2017,2,26,1600,224,894,1118,Sunday
2017,2,26,1500,324,757,1081,Sunday
2017,2,26,1400,280,702,982,Sunday
2017,2,26,1300,319,651,970,Sunday
2017,2,26,1200,393,510,903,Sunday
2017,2,26,1100,420,256,676,Sunday
2017,2,26,1000,494,164,658,Sunday
2017,2,26,900,675,104,779,Sunday
2017,2,26,800,290,43,333,Sunday
2017,2,26,700,63,14,77,Sunday
2017,2,26,600,23,34,57,Sunday
2017,2,26,500,11,37,48,Sunday
2017,2,26,400,16,10,26,Sunday
2017,2,26,300,12,5,17,Sunday
2017,2,26,200,20,8,28,Sunday
2017,2,26,100,16,14,30,Sunday
2017,2,25,2400,32,29,61,Saturday
2017,2,25,2300,48,46,94,Saturday
2017,2,25,2200,75,93,168,Saturday
2017,2,25,2100,92,124,216,Saturday
2017,2,25,2000,105,180,285,Saturday
2017,2,25,1900,142,335,477,Saturday
2017,2,25,1800,198,858,1056,Saturday
2017,2,25,1700,245,1112,1357,Saturday
2017,2,25,1600,290,832,1122,Saturday
2017,2,25,1500,340,571,911,Saturday
2017,2,25,1400,384,459,843,Saturday
2017,2,25,1300,373,388,761,Saturday
2017,2,25,1200,463,322,785,Saturday
2017,2,25,1100,508,249,757,Saturday
2017,2,25,1000,716,188,904,Saturday
2017,2,25,900,960,117,1077,Saturday
2017,2,25,800,507,49,556,Saturday
2017,2,25,700,100,41,141,Saturday
2017,2,25,600,45,32,77,Saturday
2017,2,25,500,23,25,48,Saturday
2017,2,25,400,22,29,51,Saturday
2017,2,25,300,20,25,45,Saturday
2017,2,25,200,22,28,50,Saturday
2017,2,25,100,41,45,86,Saturday
2017,2,24,2400,59,60,119,Friday
2017,2,24,2300,77,63,140,Friday
2017,2,24,2200,149,93,242,Friday
2017,2,24,2100,256,151,407,Friday
2017,2,24,2000,339,186,525,Friday
2017,2,24,1900,384,327,711,Friday
2017,2,24,1800,409,620,1029,Friday
2017,2,24,1700,453,823,1276,Friday
2017,2,24,1600,432,636,1068,Friday
2017,2,24,1500,413,480,893,Friday
2017,2,24,1400,389,404,793,Friday
2017,2,24,1300,428,377,805,Friday
2017,2,24,1200,398,351,749,Friday
2017,2,24,1100,415,258,673,Friday
2017,2,24,1000,522,182,704,Friday
2017,2,24,900,565,108,673,Friday
2017,2,24,800,365,70,435,Friday
2017,2,24,700,96,43,139,Friday
2017,2,24,600,40,29,69,Friday
2017,2,24,500,25,34,59,Friday
2017,2,24,400,30,22,52,Friday
2017,2,24,300,30,33,63,Friday
2017,2,24,200,28,40,68,Friday
2017,2,24,100,37,50,87,Friday
2017,2,23,2400,57,57,114,Thursday
2017,2,23,2300,103,86,189,Thursday
2017,2,23,2200,141,100,241,Thursday
2017,2,23,2100,165,135,300,Thursday
2017,2,23,2000,254,196,450,Thursday
2017,2,23,1900,196,299,495,Thursday
2017,2,23,1800,296,701,997,Thursday
2017,2,23,1700,267,800,1067,Thursday
2017,2,23,1600,304,503,807,Thursday
2017,2,23,1500,335,436,771,Thursday
2017,2,23,1400,337,343,680,Thursday
2017,2,23,1300,329,314,643,Thursday
2017,2,23,1200,403,286,689,Thursday
2017,2,23,1100,417,212,629,Thursday
2017,2,23,1000,560,173,733,Thursday
2017,2,23,900,591,119,710,Thursday
2017,2,23,800,265,76,341,Thursday
2017,2,23,700,76,38,114,Thursday
2017,2,23,600,35,28,63,Thursday
2017,2,23,500,29,24,53,Thursday
2017,2,23,400,23,29,52,Thursday
2017,2,23,300,20,42,62,Thursday
2017,2,23,200,24,35,59,Thursday
2017,2,23,100,41,42,83,Thursday
2017,2,22,2400,51,50,101,Wednesday
2017,2,22,2300,82,59,141,Wednesday
2017,2,22,2200,84,94,178,Wednesday
2017,2,22,2100,139,144,283,Wednesday
2017,2,22,2000,129,185,314,Wednesday
2017,2,22,1900,167,281,448,Wednesday
2017,2,22,1800,191,551,742,Wednesday
2017,2,22,1700,251,742,993,Wednesday
2017,2,22,1600,267,495,762,Wednesday
2017,2,22,1500,275,341,616,Wednesday
2017,2,22,1400,262,313,575,Wednesday
2017,2,22,1300,306,295,601,Wednesday
2017,2,22,1200,357,250,607,Wednesday
2017,2,22,1100,389,210,599,Wednesday
2017,2,22,1000,455,180,635,Wednesday
2017,2,22,900,512,105,617,Wednesday
2017,2,22,800,272,59,331,Wednesday
2017,2,22,700,70,41,111,Wednesday
2017,2,22,600,28,23,51,Wednesday
2017,2,22,500,37,18,55,Wednesday
2017,2,22,400,38,30,68,Wednesday
2017,2,22,300,22,28,50,Wednesday
2017,2,22,200,26,39,65,Wednesday
2017,2,22,100,35,31,66,Wednesday
2017,2,21,2400,44,49,93,Tuesday
2017,2,21,2300,65,55,120,Tuesday
2017,2,21,2200,92,94,186,Tuesday
2017,2,21,2100,138,132,270,Tuesday
2017,2,21,2000,110,180,290,Tuesday
2017,2,21,1900,154,316,470,Tuesday
2017,2,21,1800,203,692,895,Tuesday
2017,2,21,1700,229,872,1101,Tuesday
2017,2,21,1600,268,665,933,Tuesday
2017,2,21,1500,330,513,843,Tuesday
2017,2,21,1400,339,400,739,Tuesday
2017,2,21,1300,350,336,686,Tuesday
2017,2,21,1200,432,240,672,Tuesday
2017,2,21,1100,444,242,686,Tuesday
2017,2,21,1000,529,152,681,Tuesday
2017,2,21,900,581,120,701,Tuesday
2017,2,21,800,287,72,359,Tuesday
2017,2,21,700,90,36,126,Tuesday
2017,2,21,600,34,39,73,Tuesday
2017,2,21,500,19,23,42,Tuesday
2017,2,21,400,11,32,43,Tuesday
2017,2,21,300,14,20,34,Tuesday
2017,2,21,200,14,38,52,Tuesday
2017,2,21,100,28,61,89,Tuesday
2017,2,20,2400,35,83,118,Monday
2017,2,20,2300,44,122,166,Monday
2017,2,20,2200,61,155,216,Monday
2017,2,20,2100,85,246,331,Monday
2017,2,20,2000,100,428,528,Monday
2017,2,20,1900,124,701,825,Monday
2017,2,20,1800,181,1446,1627,Monday
2017,2,20,1700,267,1622,1889,Monday
2017,2,20,1600,382,1617,1999,Monday
2017,2,20,1500,487,1462,1949,Monday
2017,2,20,1400,534,1338,1872,Monday
2017,2,20,1300,540,1212,1752,Monday
2017,2,20,1200,655,779,1434,Monday
2017,2,20,1100,622,452,1074,Monday
2017,2,20,1000,647,233,880,Monday
2017,2,20,900,756,99,855,Monday
2017,2,20,800,340,60,400,Monday
2017,2,20,700,90,34,124,Monday
2017,2,20,600,30,19,49,Monday
2017,2,20,500,12,18,30,Monday
2017,2,20,400,16,16,32,Monday
2017,2,20,300,19,19,38,Monday
2017,2,20,200,11,19,30,Monday
2017,2,20,100,25,35,60,Monday
2017,2,19,2400,33,67,100,Sunday
2017,2,19,2300,57,89,146,Sunday
2017,2,19,2200,95,118,213,Sunday
2017,2,19,2100,96,182,278,Sunday
2017,2,19,2000,118,315,433,Sunday
2017,2,19,1900,175,652,827,Sunday
2017,2,19,1800,271,1176,1447,Sunday
2017,2,19,1700,322,1268,1590,Sunday
2017,2,19,1600,446,999,1445,Sunday
2017,2,19,1500,563,852,1415,Sunday
2017,2,19,1400,577,663,1240,Sunday
2017,2,19,1300,679,556,1235,Sunday
2017,2,19,1200,738,371,1109,Sunday
2017,2,19,1100,690,231,921,Sunday
2017,2,19,1000,811,100,911,Sunday
2017,2,19,900,989,77,1066,Sunday
2017,2,19,800,469,31,500,Sunday
2017,2,19,700,85,11,96,Sunday
2017,2,19,600,32,12,44,Sunday
2017,2,19,500,11,7,18,Sunday
2017,2,19,400,10,18,28,Sunday
2017,2,19,300,14,16,30,Sunday
2017,2,19,200,12,19,31,Sunday
2017,2,19,100,26,36,62,Sunday
2017,2,18,2400,37,52,89,Saturday
2017,2,18,2300,61,68,129,Saturday
2017,2,18,2200,65,76,141,Saturday
2017,2,18,2100,119,113,232,Saturday
2017,2,18,2000,150,188,338,Saturday
2017,2,18,1900,202,435,637,Saturday
2017,2,18,1800,269,983,1252,Saturday
2017,2,18,1700,317,1143,1460,Saturday
2017,2,18,1600,435,761,1196,Saturday
2017,2,18,1500,594,535,1129,Saturday
2017,2,18,1400,679,438,1117,Saturday
2017,2,18,1300,763,309,1072,Saturday
2017,2,18,1200,799,265,1064,Saturday
2017,2,18,1100,787,206,993,Saturday
2017,2,18,1000,865,150,1015,Saturday
2017,2,18,900,1051,101,1152,Saturday
2017,2,18,800,564,44,608,Saturday
2017,2,18,700,172,33,205,Saturday
2017,2,18,600,46,39,85,Saturday
2017,2,18,500,28,27,55,Saturday
2017,2,18,400,29,24,53,Saturday
2017,2,18,300,16,22,38,Saturday
2017,2,18,200,25,16,41,Saturday
2017,2,18,100,46,40,86,Saturday
2017,2,17,2400,75,62,137,Friday
2017,2,17,2300,155,72,227,Friday
2017,2,17,2200,230,64,294,Friday
2017,2,17,2100,422,110,532,Friday
2017,2,17,2000,614,177,791,Friday
2017,2,17,1900,664,285,949,Friday
2017,2,17,1800,766,566,1332,Friday
2017,2,17,1700,820,766,1586,Friday
2017,2,17,1600,829,622,1451,Friday
2017,2,17,1500,813,423,1236,Friday
2017,2,17,1400,658,299,957,Friday
2017,2,17,1300,598,231,829,Friday
2017,2,17,1200,662,248,910,Friday
2017,2,17,1100,575,190,765,Friday
2017,2,17,1000,626,116,742,Friday
2017,2,17,900,681,83,764,Friday
2017,2,17,800,352,57,409,Friday
2017,2,17,700,111,39,150,Friday
2017,2,17,600,41,37,78,Friday
2017,2,17,500,33,44,77,Friday
2017,2,17,400,36,23,59,Friday
2017,2,17,300,31,9,40,Friday
2017,2,17,200,36,33,69,Friday
2017,2,17,100,49,55,104,Friday
2017,2,16,2400,80,59,139,Thursday
2017,2,16,2300,112,106,218,Thursday
2017,2,16,2200,161,269,430,Thursday
2017,2,16,2100,202,152,354,Thursday
2017,2,16,2000,281,72,353,Thursday
2017,2,16,1900,291,144,435,Thursday
2017,2,16,1800,339,289,628,Thursday
2017,2,16,1700,424,440,864,Thursday
2017,2,16,1600,405,401,806,Thursday
2017,2,16,1500,414,440,854,Thursday
2017,2,16,1400,386,381,767,Thursday
2017,2,16,1300,384,166,550,Thursday
2017,2,16,1200,431,153,584,Thursday
2017,2,16,1100,434,149,583,Thursday
2017,2,16,1000,434,124,558,Thursday
2017,2,16,900,443,76,519,Thursday
2017,2,16,800,270,56,326,Thursday
2017,2,16,700,89,39,128,Thursday
2017,2,16,600,36,13,49,Thursday
2017,2,16,500,29,22,51,Thursday
2017,2,16,400,24,28,52,Thursday
2017,2,16,300,23,45,68,Thursday
2017,2,16,200,33,25,58,Thursday
2017,2,16,100,51,42,93,Thursday
2017,2,15,2400,52,67,119,Wednesday
2017,2,15,2300,95,71,166,Wednesday
2017,2,15,2200,92,66,158,Wednesday
2017,2,15,2100,152,92,244,Wednesday
2017,2,15,2000,164,129,293,Wednesday
2017,2,15,1900,206,236,442,Wednesday
2017,2,15,1800,222,344,566,Wednesday
2017,2,15,1700,243,499,742,Wednesday
2017,2,15,1600,239,363,602,Wednesday
2017,2,15,1500,275,319,594,Wednesday
2017,2,15,1400,242,292,534,Wednesday
2017,2,15,1300,248,214,462,Wednesday
2017,2,15,1200,322,189,511,Wednesday
2017,2,15,1100,318,152,470,Wednesday
2017,2,15,1000,349,127,476,Wednesday
2017,2,15,900,283,112,395,Wednesday
2017,2,15,800,210,51,261,Wednesday
2017,2,15,700,82,42,124,Wednesday
2017,2,15,600,42,37,79,Wednesday
2017,2,15,500,18,27,45,Wednesday
2017,2,15,400,27,24,51,Wednesday
2017,2,15,300,17,36,53,Wednesday
2017,2,15,200,23,43,66,Wednesday
2017,2,15,100,31,38,69,Wednesday
2017,2,14,2400,41,50,91,Tuesday
2017,2,14,2300,58,70,128,Tuesday
2017,2,14,2200,64,81,145,Tuesday
2017,2,14,2100,96,104,200,Tuesday
2017,2,14,2000,100,158,258,Tuesday
2017,2,14,1900,121,230,351,Tuesday
2017,2,14,1800,160,402,562,Tuesday
2017,2,14,1700,190,462,652,Tuesday
2017,2,14,1600,210,377,587,Tuesday
2017,2,14,1500,218,308,526,Tuesday
2017,2,14,1400,258,248,506,Tuesday
2017,2,14,1300,288,176,464,Tuesday
2017,2,14,1200,290,169,459,Tuesday
2017,2,14,1100,334,129,463,Tuesday
2017,2,14,1000,323,104,427,Tuesday
2017,2,14,900,302,87,389,Tuesday
2017,2,14,800,210,43,253,Tuesday
2017,2,14,700,67,14,81,Tuesday
2017,2,14,600,35,30,65,Tuesday
2017,2,14,500,25,15,40,Tuesday
2017,2,14,400,16,17,33,Tuesday
2017,2,14,300,19,27,46,Tuesday
2017,2,14,200,19,26,45,Tuesday
2017,2,14,100,31,34,65,Tuesday
2017,2,13,2400,56,48,104,Monday
2017,2,13,2300,51,44,95,Monday
2017,2,13,2200,76,77,153,Monday
2017,2,13,2100,112,104,216,Monday
2017,2,13,2000,125,126,251,Monday
2017,2,13,1900,153,226,379,Monday
2017,2,13,1800,156,346,502,Monday
2017,2,13,1700,245,525,770,Monday
2017,2,13,1600,252,385,637,Monday
2017,2,13,1500,286,320,606,Monday
2017,2,13,1400,293,270,563,Monday
2017,2,13,1300,310,274,584,Monday
2017,2,13,1200,360,227,587,Monday
2017,2,13,1100,384,177,561,Monday
2017,2,13,1000,340,124,464,Monday
2017,2,13,900,373,100,473,Monday
2017,2,13,800,227,42,269,Monday
2017,2,13,700,74,26,100,Monday
2017,2,13,600,33,11,44,Monday
2017,2,13,500,13,15,28,Monday
2017,2,13,400,10,17,27,Monday
2017,2,13,300,17,16,33,Monday
2017,2,13,200,11,27,38,Monday
2017,2,13,100,23,40,63,Monday
2017,2,12,2400,18,33,51,Sunday
2017,2,12,2300,35,75,110,Sunday
2017,2,12,2200,65,116,181,Sunday
2017,2,12,2100,85,241,326,Sunday
2017,2,12,2000,87,278,365,Sunday
2017,2,12,1900,101,513,614,Sunday
2017,2,12,1800,166,1191,1357,Sunday
2017,2,12,1700,182,1225,1407,Sunday
2017,2,12,1600,276,949,1225,Sunday
2017,2,12,1500,276,773,1049,Sunday
2017,2,12,1400,301,609,910,Sunday
2017,2,12,1300,363,607,970,Sunday
2017,2,12,1200,414,433,847,Sunday
2017,2,12,1100,401,285,686,Sunday
2017,2,12,1000,555,155,710,Sunday
2017,2,12,900,851,90,941,Sunday
2017,2,12,800,368,61,429,Sunday
2017,2,12,700,77,27,104,Sunday
2017,2,12,600,21,15,36,Sunday
2017,2,12,500,9,14,23,Sunday
2017,2,12,400,13,21,34,Sunday
2017,2,12,300,15,36,51,Sunday
2017,2,12,200,13,44,57,Sunday
2017,2,12,100,9,45,54,Sunday
2017,2,11,2400,25,101,126,Saturday
2017,2,11,2300,32,120,152,Saturday
2017,2,11,2200,51,125,176,Saturday
2017,2,11,2100,69,131,200,Saturday
2017,2,11,2000,100,177,277,Saturday
2017,2,11,1900,133,413,546,Saturday
2017,2,11,1800,140,1070,1210,Saturday
2017,2,11,1700,203,1067,1270,Saturday
2017,2,11,1600,241,805,1046,Saturday
2017,2,11,1500,298,524,822,Saturday
2017,2,11,1400,329,367,696,Saturday
2017,2,11,1300,383,335,718,Saturday
2017,2,11,1200,478,216,694,Saturday
2017,2,11,1100,615,208,823,Saturday
2017,2,11,1000,805,146,951,Saturday
2017,2,11,900,1183,69,1252,Saturday
2017,2,11,800,543,31,574,Saturday
2017,2,11,700,125,22,147,Saturday
2017,2,11,600,19,7,26,Saturday
2017,2,11,500,13,17,30,Saturday
2017,2,11,400,16,12,28,Saturday
2017,2,11,300,14,17,31,Saturday
2017,2,11,200,21,15,36,Saturday
2017,2,11,100,34,51,85,Saturday
2017,2,10,2400,58,94,152,Friday
2017,2,10,2300,100,41,141,Friday
2017,2,10,2200,118,28,146,Friday
2017,2,10,2100,196,99,295,Friday
2017,2,10,2000,323,131,454,Friday
2017,2,10,1900,367,234,601,Friday
2017,2,10,1800,448,532,980,Friday
2017,2,10,1700,437,759,1196,Friday
2017,2,10,1600,408,525,933,Friday
2017,2,10,1500,387,355,742,Friday
2017,2,10,1400,282,285,567,Friday
2017,2,10,1300,307,182,489,Friday
2017,2,10,1200,376,189,565,Friday
2017,2,10,1100,428,141,569,Friday
2017,2,10,1000,582,96,678,Friday
2017,2,10,900,752,66,818,Friday
2017,2,10,800,327,44,371,Friday
2017,2,10,700,78,18,96,Friday
2017,2,10,600,29,8,37,Friday
2017,2,10,500,17,10,27,Friday
2017,2,10,400,11,6,17,Friday
2017,2,10,300,18,22,40,Friday
2017,2,10,200,21,30,51,Friday
2017,2,10,100,34,56,90,Friday
2017,2,9,2400,49,15,64,Thursday
2017,2,9,2300,55,21,76,Thursday
2017,2,9,2200,91,38,129,Thursday
2017,2,9,2100,141,183,324,Thursday
2017,2,9,2000,157,40,197,Thursday
2017,2,9,1900,178,120,298,Thursday
2017,2,9,1800,201,260,461,Thursday
2017,2,9,1700,233,355,588,Thursday
2017,2,9,1600,212,286,498,Thursday
2017,2,9,1500,216,235,451,Thursday
2017,2,9,1400,238,126,364,Thursday
2017,2,9,1300,207,172,379,Thursday
2017,2,9,1200,251,126,377,Thursday
2017,2,9,1100,254,93,347,Thursday
2017,2,9,1000,343,105,448,Thursday
2017,2,9,900,321,66,387,Thursday
2017,2,9,800,204,43,247,Thursday
2017,2,9,700,71,21,92,Thursday
2017,2,9,600,38,12,50,Thursday
2017,2,9,500,19,13,32,Thursday
2017,2,9,400,21,20,41,Thursday
2017,2,9,300,22,26,48,Thursday
2017,2,9,200,30,24,54,Thursday
2017,2,9,100,47,29,76,Thursday
2017,2,8,2400,49,55,104,Wednesday
2017,2,8,2300,57,76,133,Wednesday
2017,2,8,2200,87,78,165,Wednesday
2017,2,8,2100,126,100,226,Wednesday
2017,2,8,2000,132,146,278,Wednesday
2017,2,8,1900,129,187,316,Wednesday
2017,2,8,1800,161,315,476,Wednesday
2017,2,8,1700,197,419,616,Wednesday
2017,2,8,1600,203,435,638,Wednesday
2017,2,8,1500,236,291,527,Wednesday
2017,2,8,1400,194,162,356,Wednesday
2017,2,8,1300,232,147,379,Wednesday
2017,2,8,1200,243,128,371,Wednesday
2017,2,8,1100,227,86,313,Wednesday
2017,2,8,1000,220,97,317,Wednesday
2017,2,8,900,212,61,273,Wednesday
2017,2,8,800,188,34,222,Wednesday
2017,2,8,700,58,7,65,Wednesday
2017,2,8,600,34,6,40,Wednesday
2017,2,8,500,16,8,24,Wednesday
2017,2,8,400,21,12,33,Wednesday
2017,2,8,300,33,38,71,Wednesday
2017,2,8,200,18,23,41,Wednesday
2017,2,8,100,35,29,64,Wednesday
2017,2,7,2400,53,48,101,Tuesday
2017,2,7,2300,67,68,135,Tuesday
2017,2,7,2200,67,82,149,Tuesday
2017,2,7,2100,83,87,170,Tuesday
2017,2,7,2000,78,133,211,Tuesday
2017,2,7,1900,112,200,312,Tuesday
2017,2,7,1800,127,379,506,Tuesday
2017,2,7,1700,167,375,542,Tuesday
2017,2,7,1600,133,290,423,Tuesday
2017,2,7,1500,201,236,437,Tuesday
2017,2,7,1400,196,190,386,Tuesday
2017,2,7,1300,229,210,439,Tuesday
2017,2,7,1200,222,158,380,Tuesday
2017,2,7,1100,251,159,410,Tuesday
2017,2,7,1000,249,107,356,Tuesday
2017,2,7,900,242,74,316,Tuesday
2017,2,7,800,201,51,252,Tuesday
2017,2,7,700,71,26,97,Tuesday
2017,2,7,600,46,23,69,Tuesday
2017,2,7,500,17,9,26,Tuesday
2017,2,7,400,10,31,41,Tuesday
2017,2,7,300,20,28,48,Tuesday
2017,2,7,200,46,35,81,Tuesday
2017,2,7,100,11,46,57,Tuesday
2017,2,6,2400,40,57,97,Monday
2017,2,6,2300,65,127,192,Monday
2017,2,6,2200,50,136,186,Monday
2017,2,6,2100,89,102,191,Monday
2017,2,6,2000,106,128,234,Monday
2017,2,6,1900,116,199,315,Monday
2017,2,6,1800,127,371,498,Monday
2017,2,6,1700,169,403,572,Monday
2017,2,6,1600,161,318,479,Monday
2017,2,6,1500,197,287,484,Monday
2017,2,6,1400,188,221,409,Monday
2017,2,6,1300,164,197,361,Monday
2017,2,6,1200,225,177,402,Monday
2017,2,6,1100,215,135,350,Monday
2017,2,6,1000,222,99,321,Monday
2017,2,6,900,231,71,302,Monday
2017,2,6,800,148,45,193,Monday
2017,2,6,700,32,28,60,Monday
2017,2,6,600,22,21,43,Monday
2017,2,6,500,19,29,48,Monday
2017,2,6,400,18,27,45,Monday
2017,2,6,300,12,24,36,Monday
2017,2,6,200,17,24,41,Monday
2017,2,6,100,14,42,56,Monday
2017,2,5,2400,23,78,101,Sunday
2017,2,5,2300,33,114,147,Sunday
2017,2,5,2200,43,176,219,Sunday
2017,2,5,2100,65,178,243,Sunday
2017,2,5,2000,83,214,297,Sunday
2017,2,5,1900,114,406,520,Sunday
2017,2,5,1800,115,785,900,Sunday
2017,2,5,1700,165,1089,1254,Sunday
2017,2,5,1600,190,828,1018,Sunday
2017,2,5,1500,199,760,959,Sunday
2017,2,5,1400,250,644,894,Sunday
2017,2,5,1300,249,538,787,Sunday
2017,2,5,1200,307,336,643,Sunday
2017,2,5,1100,259,212,471,Sunday
2017,2,5,1000,463,97,560,Sunday
2017,2,5,900,645,67,712,Sunday
2017,2,5,800,325,37,362,Sunday
2017,2,5,700,58,17,75,Sunday
2017,2,5,600,21,9,30,Sunday
2017,2,5,500,12,12,24,Sunday
2017,2,5,400,8,23,31,Sunday
2017,2,5,300,9,23,32,Sunday
2017,2,5,200,17,22,39,Sunday
2017,2,5,100,17,32,49,Sunday
2017,2,4,2400,19,36,55,Saturday
2017,2,4,2300,37,73,110,Saturday
2017,2,4,2200,67,100,167,Saturday
2017,2,4,2100,67,44,111,Saturday
2017,2,4,2000,80,74,154,Saturday
2017,2,4,1900,105,228,333,Saturday
2017,2,4,1800,147,624,771,Saturday
2017,2,4,1700,197,882,1079,Saturday
2017,2,4,1600,220,526,746,Saturday
2017,2,4,1500,238,378,616,Saturday
2017,2,4,1400,292,289,581,Saturday
2017,2,4,1300,332,257,589,Saturday
2017,2,4,1200,354,166,520,Saturday
2017,2,4,1100,408,113,521,Saturday
2017,2,4,1000,526,95,621,Saturday
2017,2,4,900,761,69,830,Saturday
2017,2,4,800,384,41,425,Saturday
2017,2,4,700,78,29,107,Saturday
2017,2,4,600,37,17,54,Saturday
2017,2,4,500,12,18,30,Saturday
2017,2,4,400,14,12,26,Saturday
2017,2,4,300,20,33,53,Saturday
2017,2,4,200,26,30,56,Saturday
2017,2,4,100,36,48,84,Saturday
2017,2,3,2400,52,36,88,Friday
2017,2,3,2300,85,33,118,Friday
2017,2,3,2200,150,49,199,Friday
2017,2,3,2100,243,68,311,Friday
2017,2,3,2000,411,118,529,Friday
2017,2,3,1900,299,185,484,Friday
2017,2,3,1800,360,336,696,Friday
2017,2,3,1700,481,530,1011,Friday
2017,2,3,1600,482,501,983,Friday
2017,2,3,1500,483,349,832,Friday
2017,2,3,1400,417,287,704,Friday
2017,2,3,1300,414,261,675,Friday
2017,2,3,1200,423,249,672,Friday
2017,2,3,1100,405,176,581,Friday
2017,2,3,1000,384,126,510,Friday
2017,2,3,900,358,106,464,Friday
2017,2,3,800,266,76,342,Friday
2017,2,3,700,85,30,115,Friday
2017,2,3,600,40,20,60,Friday
2017,2,3,500,21,25,46,Friday
2017,2,3,400,29,24,53,Friday
2017,2,3,300,21,32,53,Friday
2017,2,3,200,30,49,79,Friday
2017,2,3,100,37,52,89,Friday
2017,2,2,2400,56,40,96,Thursday
2017,2,2,2300,81,63,144,Thursday
2017,2,2,2200,101,107,208,Thursday
2017,2,2,2100,164,108,272,Thursday
2017,2,2,2000,218,164,382,Thursday
2017,2,2,1900,210,202,412,Thursday
2017,2,2,1800,259,388,647,Thursday
2017,2,2,1700,289,412,701,Thursday
2017,2,2,1600,290,308,598,Thursday
2017,2,2,1500,301,270,571,Thursday
2017,2,2,1400,268,238,506,Thursday
2017,2,2,1300,294,185,479,Thursday
2017,2,2,1200,300,169,469,Thursday
2017,2,2,1100,269,147,416,Thursday
2017,2,2,1000,290,136,426,Thursday
2017,2,2,900,232,97,329,Thursday
2017,2,2,800,227,58,285,Thursday
2017,2,2,700,76,32,108,Thursday
2017,2,2,600,38,26,64,Thursday
2017,2,2,500,21,26,47,Thursday
2017,2,2,400,22,31,53,Thursday
2017,2,2,300,24,37,61,Thursday
2017,2,2,200,26,32,58,Thursday
2017,2,2,100,39,41,80,Thursday
2017,2,1,2400,64,49,113,Wednesday
2017,2,1,2300,87,59,146,Wednesday
2017,2,1,2200,91,103,194,Wednesday
2017,2,1,2100,109,81,190,Wednesday
2017,2,1,2000,81,70,151,Wednesday
2017,2,1,1900,126,152,278,Wednesday
2017,2,1,1800,160,261,421,Wednesday
2017,2,1,1700,159,373,532,Wednesday
2017,2,1,1600,185,346,531,Wednesday
2017,2,1,1500,230,261,491,Wednesday
2017,2,1,1400,218,209,427,Wednesday
2017,2,1,1300,201,194,395,Wednesday
2017,2,1,1200,279,188,467,Wednesday
2017,2,1,1100,296,154,450,Wednesday
2017,2,1,1000,254,124,378,Wednesday
2017,2,1,900,241,113,354,Wednesday
2017,2,1,800,238,76,314,Wednesday
2017,2,1,700,95,44,139,Wednesday
2017,2,1,600,41,31,72,Wednesday
2017,2,1,500,25,30,55,Wednesday
2017,2,1,400,18,26,44,Wednesday
2017,2,1,300,18,38,56,Wednesday
2017,2,1,200,21,36,57,Wednesday
2017,2,1,100,35,38,73,Wednesday
2017,1,31,2400,33,47,80,Tuesday
2017,1,31,2300,54,59,113,Tuesday
2017,1,31,2200,76,61,137,Tuesday
2017,1,31,2100,78,89,167,Tuesday
2017,1,31,2000,113,129,242,Tuesday
2017,1,31,1900,97,186,283,Tuesday
2017,1,31,1800,144,264,408,Tuesday
2017,1,31,1700,173,466,639,Tuesday
2017,1,31,1600,203,374,577,Tuesday
2017,1,31,1500,207,324,531,Tuesday
2017,1,31,1400,228,286,514,Tuesday
2017,1,31,1300,215,228,443,Tuesday
2017,1,31,1200,262,213,475,Tuesday
2017,1,31,1100,309,161,470,Tuesday
2017,1,31,1000,274,145,419,Tuesday
2017,1,31,900,337,115,452,Tuesday
2017,1,31,800,236,77,313,Tuesday
2017,1,31,700,95,39,134,Tuesday
2017,1,31,600,43,36,79,Tuesday
2017,1,31,500,14,28,42,Tuesday
2017,1,31,400,19,27,46,Tuesday
2017,1,31,300,24,32,56,Tuesday
2017,1,31,200,22,39,61,Tuesday
2017,1,31,100,26,48,74,Tuesday
2017,1,30,2400,34,40,74,Monday
2017,1,30,2300,46,55,101,Monday
2017,1,30,2200,54,68,122,Monday
2017,1,30,2100,92,93,185,Monday
2017,1,30,2000,92,95,187,Monday
2017,1,30,1900,119,172,291,Monday
2017,1,30,1800,171,358,529,Monday
2017,1,30,1700,175,529,704,Monday
2017,1,30,1600,231,430,661,Monday
2017,1,30,1500,241,393,634,Monday
2017,1,30,1400,272,336,608,Monday
2017,1,30,1300,259,259,518,Monday
2017,1,30,1200,346,221,567,Monday
2017,1,30,1100,340,175,515,Monday
2017,1,30,1000,380,121,501,Monday
2017,1,30,900,368,108,476,Monday
2017,1,30,800,249,58,307,Monday
2017,1,30,700,89,29,118,Monday
2017,1,30,600,39,26,65,Monday
2017,1,30,500,23,16,39,Monday
2017,1,30,400,20,15,35,Monday
2017,1,30,300,15,21,36,Monday
2017,1,30,200,12,35,47,Monday
2017,1,30,100,14,36,50,Monday
2017,1,29,2400,29,51,80,Sunday
2017,1,29,2300,38,70,108,Sunday
2017,1,29,2200,49,85,134,Sunday
2017,1,29,2100,79,135,214,Sunday
2017,1,29,2000,76,262,338,Sunday
2017,1,29,1900,123,461,584,Sunday
2017,1,29,1800,114,855,969,Sunday
2017,1,29,1700,218,1550,1768,Sunday
2017,1,29,1600,261,1392,1653,Sunday
2017,1,29,1500,417,1172,1589,Sunday
2017,1,29,1400,477,974,1451,Sunday
2017,1,29,1300,615,810,1425,Sunday
2017,1,29,1200,718,552,1270,Sunday
2017,1,29,1100,728,307,1035,Sunday
2017,1,29,1000,648,147,795,Sunday
2017,1,29,900,820,108,928,Sunday
2017,1,29,800,422,51,473,Sunday
2017,1,29,700,113,20,133,Sunday
2017,1,29,600,29,14,43,Sunday
2017,1,29,500,18,13,31,Sunday
2017,1,29,400,10,17,27,Sunday
2017,1,29,300,10,20,30,Sunday
2017,1,29,200,17,22,39,Sunday
2017,1,29,100,20,28,48,Sunday
2017,1,28,2400,29,37,66,Saturday
2017,1,28,2300,28,64,92,Saturday
2017,1,28,2200,39,62,101,Saturday
2017,1,28,2100,74,127,201,Saturday
2017,1,28,2000,117,207,324,Saturday
2017,1,28,1900,113,534,647,Saturday
2017,1,28,1800,181,845,1026,Saturday
2017,1,28,1700,265,1387,1652,Saturday
2017,1,28,1600,352,1116,1468,Saturday
2017,1,28,1500,451,758,1209,Saturday
2017,1,28,1400,560,612,1172,Saturday
2017,1,28,1300,725,434,1159,Saturday
2017,1,28,1200,871,286,1157,Saturday
2017,1,28,1100,856,183,1039,Saturday
2017,1,28,1000,867,130,997,Saturday
2017,1,28,900,1022,127,1149,Saturday
2017,1,28,800,659,63,722,Saturday
2017,1,28,700,171,39,210,Saturday
2017,1,28,600,48,24,72,Saturday
2017,1,28,500,25,30,55,Saturday
2017,1,28,400,12,21,33,Saturday
2017,1,28,300,20,21,41,Saturday
2017,1,28,200,23,26,49,Saturday
2017,1,28,100,24,26,50,Saturday
2017,1,27,2400,46,44,90,Friday
2017,1,27,2300,77,58,135,Friday
2017,1,27,2200,106,82,188,Friday
2017,1,27,2100,206,122,328,Friday
2017,1,27,2000,330,102,432,Friday
2017,1,27,1900,425,258,683,Friday
2017,1,27,1800,461,354,815,Friday
2017,1,27,1700,512,647,1159,Friday
2017,1,27,1600,527,634,1161,Friday
2017,1,27,1500,508,502,1010,Friday
2017,1,27,1400,468,359,827,Friday
2017,1,27,1300,444,290,734,Friday
2017,1,27,1200,516,218,734,Friday
2017,1,27,1100,509,174,683,Friday
2017,1,27,1000,482,134,616,Friday
2017,1,27,900,473,95,568,Friday
2017,1,27,800,331,75,406,Friday
2017,1,27,700,110,53,163,Friday
2017,1,27,600,43,27,70,Friday
2017,1,27,500,20,26,46,Friday
2017,1,27,400,26,42,68,Friday
2017,1,27,300,20,30,50,Friday
2017,1,27,200,26,87,113,Friday
2017,1,27,100,34,6,40,Friday
2017,1,26,2400,66,19,85,Thursday
2017,1,26,2300,72,49,121,Thursday
2017,1,26,2200,111,76,187,Thursday
2017,1,26,2100,165,85,250,Thursday
2017,1,26,2000,193,133,326,Thursday
2017,1,26,1900,214,191,405,Thursday
2017,1,26,1800,230,283,513,Thursday
2017,1,26,1700,283,545,828,Thursday
2017,1,26,1600,307,461,768,Thursday
2017,1,26,1500,293,378,671,Thursday
2017,1,26,1400,336,304,640,Thursday
2017,1,26,1300,321,265,586,Thursday
2017,1,26,1200,315,210,525,Thursday
2017,1,26,1100,355,146,501,Thursday
2017,1,26,1000,387,143,530,Thursday
2017,1,26,900,346,103,449,Thursday
2017,1,26,800,243,83,326,Thursday
2017,1,26,700,120,46,166,Thursday
2017,1,26,600,53,25,78,Thursday
2017,1,26,500,29,23,52,Thursday
2017,1,26,400,18,22,40,Thursday
2017,1,26,300,24,34,58,Thursday
2017,1,26,200,22,35,57,Thursday
2017,1,26,100,30,61,91,Thursday
2017,1,25,2400,44,48,92,Wednesday
2017,1,25,2300,58,65,123,Wednesday
2017,1,25,2200,93,58,151,Wednesday
2017,1,25,2100,96,91,187,Wednesday
2017,1,25,2000,110,88,198,Wednesday
2017,1,25,1900,142,180,322,Wednesday
2017,1,25,1800,132,256,388,Wednesday
2017,1,25,1700,230,474,704,Wednesday
2017,1,25,1600,262,418,680,Wednesday
2017,1,25,1500,225,375,600,Wednesday
2017,1,25,1400,254,286,540,Wednesday
2017,1,25,1300,231,224,455,Wednesday
2017,1,25,1200,308,168,476,Wednesday
2017,1,25,1100,328,136,464,Wednesday
2017,1,25,1000,309,109,418,Wednesday
2017,1,25,900,303,124,427,Wednesday
2017,1,25,800,225,57,282,Wednesday
2017,1,25,700,95,53,148,Wednesday
2017,1,25,600,56,41,97,Wednesday
2017,1,25,500,30,23,53,Wednesday
2017,1,25,400,19,24,43,Wednesday
2017,1,25,300,22,28,50,Wednesday
2017,1,25,200,19,41,60,Wednesday
2017,1,25,100,36,50,86,Wednesday
2017,1,24,2400,45,35,80,Tuesday
2017,1,24,2300,52,58,110,Tuesday
2017,1,24,2200,68,62,130,Tuesday
2017,1,24,2100,87,96,183,Tuesday
2017,1,24,2000,97,133,230,Tuesday
2017,1,24,1900,123,157,280,Tuesday
2017,1,24,1800,132,261,393,Tuesday
2017,1,24,1700,176,439,615,Tuesday
2017,1,24,1600,187,385,572,Tuesday
2017,1,24,1500,203,312,515,Tuesday
2017,1,24,1400,256,246,502,Tuesday
2017,1,24,1300,252,205,457,Tuesday
2017,1,24,1200,297,191,488,Tuesday
2017,1,24,1100,318,135,453,Tuesday
2017,1,24,1000,286,147,433,Tuesday
2017,1,24,900,270,112,382,Tuesday
2017,1,24,800,204,60,264,Tuesday
2017,1,24,700,95,47,142,Tuesday
2017,1,24,600,25,33,58,Tuesday
2017,1,24,500,42,24,66,Tuesday
2017,1,24,400,13,22,35,Tuesday
2017,1,24,300,16,38,54,Tuesday
2017,1,24,200,16,26,42,Tuesday
2017,1,24,100,27,38,65,Tuesday
2017,1,23,2400,46,56,102,Monday
2017,1,23,2300,48,59,107,Monday
2017,1,23,2200,64,68,132,Monday
2017,1,23,2100,80,82,162,Monday
2017,1,23,2000,98,112,210,Monday
2017,1,23,1900,96,175,271,Monday
2017,1,23,1800,151,289,440,Monday
2017,1,23,1700,174,532,706,Monday
2017,1,23,1600,230,389,619,Monday
2017,1,23,1500,205,316,521,Monday
2017,1,23,1400,271,308,579,Monday
2017,1,23,1300,272,324,596,Monday
2017,1,23,1200,308,141,449,Monday
2017,1,23,1100,318,102,420,Monday
2017,1,23,1000,305,110,415,Monday
2017,1,23,900,282,97,379,Monday
2017,1,23,800,196,66,262,Monday
2017,1,23,700,90,32,122,Monday
2017,1,23,600,39,19,58,Monday
2017,1,23,500,18,13,31,Monday
2017,1,23,400,16,19,35,Monday
2017,1,23,300,19,20,39,Monday
2017,1,23,200,15,70,85,Monday
2017,1,23,100,18,19,37,Monday
2017,1,22,2400,19,13,32,Sunday
2017,1,22,2300,33,57,90,Sunday
2017,1,22,2200,55,118,173,Sunday
2017,1,22,2100,79,157,236,Sunday
2017,1,22,2000,88,240,328,Sunday
2017,1,22,1900,101,436,537,Sunday
2017,1,22,1800,106,763,869,Sunday
2017,1,22,1700,177,1533,1710,Sunday
2017,1,22,1600,226,1365,1591,Sunday
2017,1,22,1500,320,1084,1404,Sunday
2017,1,22,1400,390,825,1215,Sunday
2017,1,22,1300,561,728,1289,Sunday
2017,1,22,1200,607,510,1117,Sunday
2017,1,22,1100,650,286,936,Sunday
2017,1,22,1000,616,152,768,Sunday
2017,1,22,900,811,114,925,Sunday
2017,1,22,800,557,23,580,Sunday
2017,1,22,700,168,16,184,Sunday
2017,1,22,600,29,12,41,Sunday
2017,1,22,500,10,19,29,Sunday
2017,1,22,400,10,6,16,Sunday
2017,1,22,300,22,11,33,Sunday
2017,1,22,200,10,14,24,Sunday
2017,1,22,100,26,27,53,Sunday
2017,1,21,2400,,,,Saturday
2017,1,21,2300,,,,Saturday
2017,1,21,2200,,,,Saturday
2017,1,21,2100,,,,Saturday
2017,1,21,2000,,,,Saturday
2017,1,21,1900,,,,Saturday
2017,1,21,1800,,,,Saturday
2017,1,21,1700,,,,Saturday
2017,1,21,1600,,,,Saturday
2017,1,21,1500,,,,Saturday
2017,1,21,1400,,,,Saturday
2017,1,21,1300,,,,Saturday
2017,1,21,1200,,,,Saturday
2017,1,21,1100,,,,Saturday
2017,1,21,1000,,,,Saturday
2017,1,21,900,,,,Saturday
2017,1,21,800,,,,Saturday
2017,1,21,700,,,,Saturday
2017,1,21,600,,,,Saturday
2017,1,21,500,,,,Saturday
2017,1,21,400,,,,Saturday
2017,1,21,300,,,,Saturday
2017,1,21,200,,,,Saturday
2017,1,21,100,,,,Saturday
2017,1,20,2400,,,,Friday
2017,1,20,2300,,,,Friday
2017,1,20,2200,,,,Friday
2017,1,20,2100,,,,Friday
2017,1,20,2000,,,,Friday
2017,1,20,1900,,,,Friday
2017,1,20,1800,,,,Friday
2017,1,20,1700,,,,Friday
2017,1,20,1600,,,,Friday
2017,1,20,1500,,,,Friday
2017,1,20,1400,,,,Friday
2017,1,20,1300,,,,Friday
2017,1,20,1200,,,,Friday
2017,1,20,1100,,,,Friday
2017,1,20,1000,,,,Friday
2017,1,20,900,,,,Friday
2017,1,20,800,,,,Friday
2017,1,20,700,,,,Friday
2017,1,20,600,,,,Friday
2017,1,20,500,,,,Friday
2017,1,20,400,,,,Friday
2017,1,20,300,,,,Friday
2017,1,20,200,,,,Friday
2017,1,20,100,,,,Friday
2017,1,19,2400,,,,Thursday
2017,1,19,2300,,,,Thursday
2017,1,19,2200,,,,Thursday
2017,1,19,2100,,,,Thursday
2017,1,19,2000,,,,Thursday
2017,1,19,1900,,,,Thursday
2017,1,19,1800,,,,Thursday
2017,1,19,1700,,,,Thursday
2017,1,19,1600,,,,Thursday
2017,1,19,1500,,,,Thursday
2017,1,19,1400,,,,Thursday
2017,1,19,1300,,,,Thursday
2017,1,19,1200,,,,Thursday
2017,1,19,1100,,,,Thursday
2017,1,19,1000,,,,Thursday
2017,1,19,900,,,,Thursday
2017,1,19,800,,,,Thursday
2017,1,19,700,,,,Thursday
2017,1,19,600,,,,Thursday
2017,1,19,500,,,,Thursday
2017,1,19,400,,,,Thursday
2017,1,19,300,,,,Thursday
2017,1,19,200,,,,Thursday
2017,1,19,100,,,,Thursday
2017,1,18,2400,,,,Wednesday
2017,1,18,2300,,,,Wednesday
2017,1,18,2200,,,,Wednesday
2017,1,18,2100,,,,Wednesday
2017,1,18,2000,,,,Wednesday
2017,1,18,1900,,,,Wednesday
2017,1,18,1800,,,,Wednesday
2017,1,18,1700,,,,Wednesday
2017,1,18,1600,,,,Wednesday
2017,1,18,1500,,,,Wednesday
2017,1,18,1400,,,,Wednesday
2017,1,18,1300,,,,Wednesday
2017,1,18,1200,,,,Wednesday
2017,1,18,1100,,,,Wednesday
2017,1,18,1000,,,,Wednesday
2017,1,18,900,,,,Wednesday
2017,1,18,800,,,,Wednesday
2017,1,18,700,,,,Wednesday
2017,1,18,600,,,,Wednesday
2017,1,18,500,,,,Wednesday
2017,1,18,400,,,,Wednesday
2017,1,18,300,,,,Wednesday
2017,1,18,200,,,,Wednesday
2017,1,18,100,,,,Wednesday
2017,1,17,2400,,,,Tuesday
2017,1,17,2300,,,,Tuesday
2017,1,17,2200,,,,Tuesday
2017,1,17,2100,,,,Tuesday
2017,1,17,2000,,,,Tuesday
2017,1,17,1900,,,,Tuesday
2017,1,17,1800,,,,Tuesday
2017,1,17,1700,,,,Tuesday
2017,1,17,1600,,,,Tuesday
2017,1,17,1500,,,,Tuesday
2017,1,17,1400,,,,Tuesday
2017,1,17,1300,,,,Tuesday
2017,1,17,1200,,,,Tuesday
2017,1,17,1100,,,,Tuesday
2017,1,17,1000,,,,Tuesday
2017,1,17,900,,,,Tuesday
2017,1,17,800,,,,Tuesday
2017,1,17,700,,,,Tuesday
2017,1,17,600,,,,Tuesday
2017,1,17,500,,,,Tuesday
2017,1,17,400,,,,Tuesday
2017,1,17,300,,,,Tuesday
2017,1,17,200,,,,Tuesday
2017,1,17,100,,,,Tuesday
2017,1,16,2400,,,,Monday
2017,1,16,2300,,,,Monday
2017,1,16,2200,,,,Monday
2017,1,16,2100,,,,Monday
2017,1,16,2000,,,,Monday
2017,1,16,1900,,,,Monday
2017,1,16,1800,,,,Monday
2017,1,16,1700,,,,Monday
2017,1,16,1600,,,,Monday
2017,1,16,1500,,,,Monday
2017,1,16,1400,,,,Monday
2017,1,16,1300,,,,Monday
2017,1,16,1200,,,,Monday
2017,1,16,1100,,,,Monday
2017,1,16,1000,,,,Monday
2017,1,16,900,,,,Monday
2017,1,16,800,,,,Monday
2017,1,16,700,,,,Monday
2017,1,16,600,,,,Monday
2017,1,16,500,,,,Monday
2017,1,16,400,,,,Monday
2017,1,16,300,,,,Monday
2017,1,16,200,,,,Monday
2017,1,16,100,,,,Monday
2017,1,15,2400,,,,Sunday
2017,1,15,2300,,,,Sunday
2017,1,15,2200,,,,Sunday
2017,1,15,2100,,,,Sunday
2017,1,15,2000,,,,Sunday
2017,1,15,1900,,,,Sunday
2017,1,15,1800,,,,Sunday
2017,1,15,1700,,,,Sunday
2017,1,15,1600,,,,Sunday
2017,1,15,1500,,,,Sunday
2017,1,15,1400,,,,Sunday
2017,1,15,1300,,,,Sunday
2017,1,15,1200,,,,Sunday
2017,1,15,1100,,,,Sunday
2017,1,15,1000,,,,Sunday
2017,1,15,900,,,,Sunday
2017,1,15,800,,,,Sunday
2017,1,15,700,,,,Sunday
2017,1,15,600,,,,Sunday
2017,1,15,500,,,,Sunday
2017,1,15,400,,,,Sunday
2017,1,15,300,,,,Sunday
2017,1,15,200,,,,Sunday
2017,1,15,100,,,,Sunday
2017,1,14,2400,,,,Saturday
2017,1,14,2300,,,,Saturday
2017,1,14,2200,,,,Saturday
2017,1,14,2100,,,,Saturday
2017,1,14,2000,,,,Saturday
2017,1,14,1900,,,,Saturday
2017,1,14,1800,,,,Saturday
2017,1,14,1700,,,,Saturday
2017,1,14,1600,,,,Saturday
2017,1,14,1500,,,,Saturday
2017,1,14,1400,,,,Saturday
2017,1,14,1300,,,,Saturday
2017,1,14,1200,,,,Saturday
2017,1,14,1100,,,,Saturday
2017,1,14,1000,,,,Saturday
2017,1,14,900,,,,Saturday
2017,1,14,800,,,,Saturday
2017,1,14,700,,,,Saturday
2017,1,14,600,,,,Saturday
2017,1,14,500,,,,Saturday
2017,1,14,400,,,,Saturday
2017,1,14,300,,,,Saturday
2017,1,14,200,,,,Saturday
2017,1,14,100,,,,Saturday
2017,1,13,2400,,,,Friday
2017,1,13,2300,,,,Friday
2017,1,13,2200,,,,Friday
2017,1,13,2100,,,,Friday
2017,1,13,2000,,,,Friday
2017,1,13,1900,,,,Friday
2017,1,13,1800,,,,Friday
2017,1,13,1700,,,,Friday
2017,1,13,1600,,,,Friday
2017,1,13,1500,,,,Friday
2017,1,13,1400,,,,Friday
2017,1,13,1300,,,,Friday
2017,1,13,1200,,,,Friday
2017,1,13,1100,,,,Friday
2017,1,13,1000,,,,Friday
2017,1,13,900,,,,Friday
2017,1,13,800,,,,Friday
2017,1,13,700,,,,Friday
2017,1,13,600,,,,Friday
2017,1,13,500,,,,Friday
2017,1,13,400,,,,Friday
2017,1,13,300,,,,Friday
2017,1,13,200,,,,Friday
2017,1,13,100,,,,Friday
2017,1,12,2400,,,,Thursday
2017,1,12,2300,,,,Thursday
2017,1,12,2200,,,,Thursday
2017,1,12,2100,,,,Thursday
2017,1,12,2000,,,,Thursday
2017,1,12,1900,,,,Thursday
2017,1,12,1800,,,,Thursday
2017,1,12,1700,,,,Thursday
2017,1,12,1600,,,,Thursday
2017,1,12,1500,,,,Thursday
2017,1,12,1400,,,,Thursday
2017,1,12,1300,,,,Thursday
2017,1,12,1200,,,,Thursday
2017,1,12,1100,,,,Thursday
2017,1,12,1000,,,,Thursday
2017,1,12,900,,,,Thursday
2017,1,12,800,,,,Thursday
2017,1,12,700,,,,Thursday
2017,1,12,600,,,,Thursday
2017,1,12,500,,,,Thursday
2017,1,12,400,,,,Thursday
2017,1,12,300,,,,Thursday
2017,1,12,200,,,,Thursday
2017,1,12,100,,,,Thursday
2017,1,11,2400,,,,Wednesday
2017,1,11,2300,,,,Wednesday
2017,1,11,2200,,,,Wednesday
2017,1,11,2100,,,,Wednesday
2017,1,11,2000,,,,Wednesday
2017,1,11,1900,,,,Wednesday
2017,1,11,1800,,,,Wednesday
2017,1,11,1700,,,,Wednesday
2017,1,11,1600,,,,Wednesday
2017,1,11,1500,,,,Wednesday
2017,1,11,1400,,,,Wednesday
2017,1,11,1300,,,,Wednesday
2017,1,11,1200,,,,Wednesday
2017,1,11,1100,,,,Wednesday
2017,1,11,1000,,,,Wednesday
2017,1,11,900,,,,Wednesday
2017,1,11,800,,,,Wednesday
2017,1,11,700,,,,Wednesday
2017,1,11,600,,,,Wednesday
2017,1,11,500,,,,Wednesday
2017,1,11,400,,,,Wednesday
2017,1,11,300,,,,Wednesday
2017,1,11,200,,,,Wednesday
2017,1,11,100,,,,Wednesday
2017,1,10,2400,,,,Tuesday
2017,1,10,2300,,,,Tuesday
2017,1,10,2200,,,,Tuesday
2017,1,10,2100,,,,Tuesday
2017,1,10,2000,,,,Tuesday
2017,1,10,1900,,,,Tuesday
2017,1,10,1800,,,,Tuesday
2017,1,10,1700,,,,Tuesday
2017,1,10,1600,,,,Tuesday
2017,1,10,1500,,,,Tuesday
2017,1,10,1400,,,,Tuesday
2017,1,10,1300,,,,Tuesday
2017,1,10,1200,,,,Tuesday
2017,1,10,1100,,,,Tuesday
2017,1,10,1000,,,,Tuesday
2017,1,10,900,,,,Tuesday
2017,1,10,800,,,,Tuesday
2017,1,10,700,,,,Tuesday
2017,1,10,600,,,,Tuesday
2017,1,10,500,,,,Tuesday
2017,1,10,400,,,,Tuesday
2017,1,10,300,,,,Tuesday
2017,1,10,200,,,,Tuesday
2017,1,10,100,,,,Tuesday
2017,1,9,2400,,,,Monday
2017,1,9,2300,,,,Monday
2017,1,9,2200,,,,Monday
2017,1,9,2100,,,,Monday
2017,1,9,2000,,,,Monday
2017,1,9,1900,,,,Monday
2017,1,9,1800,,,,Monday
2017,1,9,1700,,,,Monday
2017,1,9,1600,,,,Monday
2017,1,9,1500,,,,Monday
2017,1,9,1400,,,,Monday
2017,1,9,1300,,,,Monday
2017,1,9,1200,,,,Monday
2017,1,9,1100,,,,Monday
2017,1,9,1000,,,,Monday
2017,1,9,900,,,,Monday
2017,1,9,800,,,,Monday
2017,1,9,700,,,,Monday
2017,1,9,600,,,,Monday
2017,1,9,500,,,,Monday
2017,1,9,400,,,,Monday
2017,1,9,300,,,,Monday
2017,1,9,200,,,,Monday
2017,1,9,100,,,,Monday
2017,1,8,2400,,,,Sunday
2017,1,8,2300,,,,Sunday
2017,1,8,2200,,,,Sunday
2017,1,8,2100,,,,Sunday
2017,1,8,2000,,,,Sunday
2017,1,8,1900,,,,Sunday
2017,1,8,1800,,,,Sunday
2017,1,8,1700,,,,Sunday
2017,1,8,1600,,,,Sunday
2017,1,8,1500,,,,Sunday
2017,1,8,1400,,,,Sunday
2017,1,8,1300,,,,Sunday
2017,1,8,1200,,,,Sunday
2017,1,8,1100,,,,Sunday
2017,1,8,1000,,,,Sunday
2017,1,8,900,,,,Sunday
2017,1,8,800,,,,Sunday
2017,1,8,700,,,,Sunday
2017,1,8,600,,,,Sunday
2017,1,8,500,,,,Sunday
2017,1,8,400,,,,Sunday
2017,1,8,300,,,,Sunday
2017,1,8,200,,,,Sunday
2017,1,8,100,,,,Sunday
2017,1,7,2400,,,,Saturday
2017,1,7,2300,,,,Saturday
2017,1,7,2200,,,,Saturday
2017,1,7,2100,,,,Saturday
2017,1,7,2000,,,,Saturday
2017,1,7,1900,,,,Saturday
2017,1,7,1800,,,,Saturday
2017,1,7,1700,,,,Saturday
2017,1,7,1600,,,,Saturday
2017,1,7,1500,,,,Saturday
2017,1,7,1400,,,,Saturday
2017,1,7,1300,,,,Saturday
2017,1,7,1200,,,,Saturday
2017,1,7,1100,,,,Saturday
2017,1,7,1000,,,,Saturday
2017,1,7,900,,,,Saturday
2017,1,7,800,,,,Saturday
2017,1,7,700,,,,Saturday
2017,1,7,600,,,,Saturday
2017,1,7,500,,,,Saturday
2017,1,7,400,,,,Saturday
2017,1,7,300,,,,Saturday
2017,1,7,200,,,,Saturday
2017,1,7,100,,,,Saturday
2017,1,6,2400,,,,Friday
2017,1,6,2300,,,,Friday
2017,1,6,2200,,,,Friday
2017,1,6,2100,,,,Friday
2017,1,6,2000,,,,Friday
2017,1,6,1900,,,,Friday
2017,1,6,1800,,,,Friday
2017,1,6,1700,,,,Friday
2017,1,6,1600,,,,Friday
2017,1,6,1500,,,,Friday
2017,1,6,1400,,,,Friday
2017,1,6,1300,,,,Friday
2017,1,6,1200,,,,Friday
2017,1,6,1100,,,,Friday
2017,1,6,1000,,,,Friday
2017,1,6,900,,,,Friday
2017,1,6,800,,,,Friday
2017,1,6,700,,,,Friday
2017,1,6,600,,,,Friday
2017,1,6,500,,,,Friday
2017,1,6,400,,,,Friday
2017,1,6,300,,,,Friday
2017,1,6,200,,,,Friday
2017,1,6,100,,,,Friday
2017,1,5,2400,,,,Thursday
2017,1,5,2300,,,,Thursday
2017,1,5,2200,,,,Thursday
2017,1,5,2100,,,,Thursday
2017,1,5,2000,,,,Thursday
2017,1,5,1900,,,,Thursday
2017,1,5,1800,,,,Thursday
2017,1,5,1700,,,,Thursday
2017,1,5,1600,,,,Thursday
2017,1,5,1500,,,,Thursday
2017,1,5,1400,,,,Thursday
2017,1,5,1300,,,,Thursday
2017,1,5,1200,,,,Thursday
2017,1,5,1100,,,,Thursday
2017,1,5,1000,,,,Thursday
2017,1,5,900,,,,Thursday
2017,1,5,800,,,,Thursday
2017,1,5,700,,,,Thursday
2017,1,5,600,,,,Thursday
2017,1,5,500,,,,Thursday
2017,1,5,400,,,,Thursday
2017,1,5,300,,,,Thursday
2017,1,5,200,,,,Thursday
2017,1,5,100,,,,Thursday
2017,1,4,2400,,,,Wednesday
2017,1,4,2300,,,,Wednesday
2017,1,4,2200,,,,Wednesday
2017,1,4,2100,,,,Wednesday
2017,1,4,2000,,,,Wednesday
2017,1,4,1900,,,,Wednesday
2017,1,4,1800,,,,Wednesday
2017,1,4,1700,,,,Wednesday
2017,1,4,1600,,,,Wednesday
2017,1,4,1500,,,,Wednesday
2017,1,4,1400,,,,Wednesday
2017,1,4,1300,,,,Wednesday
2017,1,4,1200,,,,Wednesday
2017,1,4,1100,,,,Wednesday
2017,1,4,1000,,,,Wednesday
2017,1,4,900,,,,Wednesday
2017,1,4,800,,,,Wednesday
2017,1,4,700,,,,Wednesday
2017,1,4,600,,,,Wednesday
2017,1,4,500,,,,Wednesday
2017,1,4,400,,,,Wednesday
2017,1,4,300,,,,Wednesday
2017,1,4,200,,,,Wednesday
2017,1,4,100,,,,Wednesday
2017,1,3,2400,,,,Tuesday
2017,1,3,2300,,,,Tuesday
2017,1,3,2200,,,,Tuesday
2017,1,3,2100,,,,Tuesday
2017,1,3,2000,,,,Tuesday
2017,1,3,1900,,,,Tuesday
2017,1,3,1800,,,,Tuesday
2017,1,3,1700,,,,Tuesday
2017,1,3,1600,,,,Tuesday
2017,1,3,1500,,,,Tuesday
2017,1,3,1400,,,,Tuesday
2017,1,3,1300,,,,Tuesday
2017,1,3,1200,,,,Tuesday
2017,1,3,1100,,,,Tuesday
2017,1,3,1000,,,,Tuesday
2017,1,3,900,,,,Tuesday
2017,1,3,800,,,,Tuesday
2017,1,3,700,,,,Tuesday
2017,1,3,600,,,,Tuesday
2017,1,3,500,,,,Tuesday
2017,1,3,400,,,,Tuesday
2017,1,3,300,,,,Tuesday
2017,1,3,200,,,,Tuesday
2017,1,3,100,,,,Tuesday
2017,1,2,2400,,,,Monday
2017,1,2,2300,,,,Monday
2017,1,2,2200,,,,Monday
2017,1,2,2100,,,,Monday
2017,1,2,2000,,,,Monday
2017,1,2,1900,,,,Monday
2017,1,2,1800,,,,Monday
2017,1,2,1700,,,,Monday
2017,1,2,1600,,,,Monday
2017,1,2,1500,,,,Monday
2017,1,2,1400,,,,Monday
2017,1,2,1300,,,,Monday
2017,1,2,1200,,,,Monday
2017,1,2,1100,,,,Monday
2017,1,2,1000,,,,Monday
2017,1,2,900,,,,Monday
2017,1,2,800,,,,Monday
2017,1,2,700,,,,Monday
2017,1,2,600,,,,Monday
2017,1,2,500,,,,Monday
2017,1,2,400,,,,Monday
2017,1,2,300,,,,Monday
2017,1,2,200,,,,Monday
2017,1,2,100,,,,Monday
2017,1,1,2400,,,,Sunday
2017,1,1,2300,,,,Sunday
2017,1,1,2200,,,,Sunday
2017,1,1,2100,,,,Sunday
2017,1,1,2000,,,,Sunday
2017,1,1,1900,,,,Sunday
2017,1,1,1800,,,,Sunday
2017,1,1,1700,,,,Sunday
2017,1,1,1600,,,,Sunday
2017,1,1,1500,,,,Sunday
2017,1,1,1400,,,,Sunday
2017,1,1,1300,,,,Sunday
2017,1,1,1200,,,,Sunday
2017,1,1,1100,,,,Sunday
2017,1,1,1000,,,,Sunday
2017,1,1,900,,,,Sunday
2017,1,1,800,,,,Sunday
2017,1,1,700,,,,Sunday
2017,1,1,600,,,,Sunday
2017,1,1,500,,,,Sunday
2017,1,1,400,,,,Sunday
2017,1,1,300,,,,Sunday
2017,1,1,200,,,,Sunday
2017,1,1,100,,,,Sunday
2016,12,31,2400,13,19,32,Saturday
2016,12,31,2300,24,48,72,Saturday
2016,12,31,2200,30,82,112,Saturday
2016,12,31,2100,49,95,144,Saturday
2016,12,31,2000,68,156,224,Saturday
2016,12,31,1900,83,260,343,Saturday
2016,12,31,1800,148,733,881,Saturday
2016,12,31,1700,201,946,1147,Saturday
2016,12,31,1600,272,846,1118,Saturday
2016,12,31,1500,382,655,1037,Saturday
2016,12,31,1400,423,575,998,Saturday
2016,12,31,1300,498,505,1003,Saturday
2016,12,31,1200,502,388,890,Saturday
2016,12,31,1100,526,297,823,Saturday
2016,12,31,1000,574,158,732,Saturday
2016,12,31,900,717,84,801,Saturday
2016,12,31,800,448,51,499,Saturday
2016,12,31,700,88,33,121,Saturday
2016,12,31,600,46,29,75,Saturday
2016,12,31,500,25,31,56,Saturday
2016,12,31,400,15,29,44,Saturday
2016,12,31,300,22,36,58,Saturday
2016,12,31,200,28,33,61,Saturday
2016,12,31,100,37,69,106,Saturday
2016,12,30,2400,49,88,137,Friday
2016,12,30,2300,71,268,339,Friday
2016,12,30,2200,102,415,517,Friday
2016,12,30,2100,155,410,565,Friday
2016,12,30,2000,202,168,370,Friday
2016,12,30,1900,239,527,766,Friday
2016,12,30,1800,338,1249,1587,Friday
2016,12,30,1700,477,1657,2134,Friday
2016,12,30,1600,627,1218,1845,Friday
2016,12,30,1500,745,628,1373,Friday
2016,12,30,1400,776,564,1340,Friday
2016,12,30,1300,785,504,1289,Friday
2016,12,30,1200,779,463,1242,Friday
2016,12,30,1100,887,335,1222,Friday
2016,12,30,1000,1095,163,1258,Friday
2016,12,30,900,1228,108,1336,Friday
2016,12,30,800,632,41,673,Friday
2016,12,30,700,144,35,179,Friday
2016,12,30,600,51,18,69,Friday
2016,12,30,500,22,10,32,Friday
2016,12,30,400,21,13,34,Friday
2016,12,30,300,33,18,51,Friday
2016,12,30,200,25,21,46,Friday
2016,12,30,100,48,70,118,Friday
2016,12,29,2400,41,16,57,Thursday
2016,12,29,2300,69,85,154,Thursday
2016,12,29,2200,98,265,363,Thursday
2016,12,29,2100,141,193,334,Thursday
2016,12,29,2000,175,135,310,Thursday
2016,12,29,1900,210,403,613,Thursday
2016,12,29,1800,245,1099,1344,Thursday
2016,12,29,1700,426,1163,1589,Thursday
2016,12,29,1600,533,1037,1570,Thursday
2016,12,29,1500,687,802,1489,Thursday
2016,12,29,1400,701,590,1291,Thursday
2016,12,29,1300,715,535,1250,Thursday
2016,12,29,1200,739,370,1109,Thursday
2016,12,29,1100,784,304,1088,Thursday
2016,12,29,1000,905,211,1116,Thursday
2016,12,29,900,1141,122,1263,Thursday
2016,12,29,800,514,49,563,Thursday
2016,12,29,700,124,36,160,Thursday
2016,12,29,600,50,34,84,Thursday
2016,12,29,500,26,28,54,Thursday
2016,12,29,400,26,44,70,Thursday
2016,12,29,300,23,36,59,Thursday
2016,12,29,200,25,40,65,Thursday
2016,12,29,100,42,65,107,Thursday
2016,12,28,2400,55,104,159,Wednesday
2016,12,28,2300,61,79,140,Wednesday
2016,12,28,2200,134,157,291,Wednesday
2016,12,28,2100,116,175,291,Wednesday
2016,12,28,2000,164,240,404,Wednesday
2016,12,28,1900,195,440,635,Wednesday
2016,12,28,1800,314,1273,1587,Wednesday
2016,12,28,1700,423,1337,1760,Wednesday
2016,12,28,1600,574,1073,1647,Wednesday
2016,12,28,1500,696,793,1489,Wednesday
2016,12,28,1400,753,657,1410,Wednesday
2016,12,28,1300,914,492,1406,Wednesday
2016,12,28,1200,963,323,1286,Wednesday
2016,12,28,1100,1060,253,1313,Wednesday
2016,12,28,1000,1075,159,1234,Wednesday
2016,12,28,900,1117,83,1200,Wednesday
2016,12,28,800,477,62,539,Wednesday
2016,12,28,700,121,22,143,Wednesday
2016,12,28,600,46,31,77,Wednesday
2016,12,28,500,30,29,59,Wednesday
2016,12,28,400,32,19,51,Wednesday
2016,12,28,300,16,35,51,Wednesday
2016,12,28,200,28,53,81,Wednesday
2016,12,28,100,30,49,79,Wednesday
2016,12,27,2400,65,65,130,Tuesday
2016,12,27,2300,65,130,195,Tuesday
2016,12,27,2200,94,327,421,Tuesday
2016,12,27,2100,125,284,409,Tuesday
2016,12,27,2000,174,264,438,Tuesday
2016,12,27,1900,252,378,630,Tuesday
2016,12,27,1800,281,931,1212,Tuesday
2016,12,27,1700,533,912,1445,Tuesday
2016,12,27,1600,763,1066,1829,Tuesday
2016,12,27,1500,896,803,1699,Tuesday
2016,12,27,1400,927,611,1538,Tuesday
2016,12,27,1300,1098,456,1554,Tuesday
2016,12,27,1200,990,330,1320,Tuesday
2016,12,27,1100,927,197,1124,Tuesday
2016,12,27,1000,1085,116,1201,Tuesday
2016,12,27,900,1040,63,1103,Tuesday
2016,12,27,800,404,36,440,Tuesday
2016,12,27,700,108,21,129,Tuesday
2016,12,27,600,38,14,52,Tuesday
2016,12,27,500,28,9,37,Tuesday
2016,12,27,400,15,22,37,Tuesday
2016,12,27,300,14,22,36,Tuesday
2016,12,27,200,21,23,44,Tuesday
2016,12,27,100,21,31,52,Tuesday
2016,12,26,2400,40,34,74,Monday
2016,12,26,2300,61,57,118,Monday
2016,12,26,2200,81,81,162,Monday
2016,12,26,2100,113,105,218,Monday
2016,12,26,2000,149,142,291,Monday
2016,12,26,1900,206,284,490,Monday
2016,12,26,1800,254,619,873,Monday
2016,12,26,1700,498,839,1337,Monday
2016,12,26,1600,722,728,1450,Monday
2016,12,26,1500,734,586,1320,Monday
2016,12,26,1400,812,498,1310,Monday
2016,12,26,1300,816,339,1155,Monday
2016,12,26,1200,751,290,1041,Monday
2016,12,26,1100,606,156,762,Monday
2016,12,26,1000,591,77,668,Monday
2016,12,26,900,574,44,618,Monday
2016,12,26,800,220,27,247,Monday
2016,12,26,700,73,15,88,Monday
2016,12,26,600,41,15,56,Monday
2016,12,26,500,15,7,22,Monday
2016,12,26,400,19,5,24,Monday
2016,12,26,300,17,13,30,Monday
2016,12,26,200,16,12,28,Monday
2016,12,26,100,26,17,43,Monday
2016,12,25,2400,19,17,36,Sunday
2016,12,25,2300,36,32,68,Sunday
2016,12,25,2200,36,46,82,Sunday
2016,12,25,2100,52,64,116,Sunday
2016,12,25,2000,57,91,148,Sunday
2016,12,25,1900,56,145,201,Sunday
2016,12,25,1800,105,395,500,Sunday
2016,12,25,1700,170,510,680,Sunday
2016,12,25,1600,244,378,622,Sunday
2016,12,25,1500,314,295,609,Sunday
2016,12,25,1400,348,212,560,Sunday
2016,12,25,1300,337,133,470,Sunday
2016,12,25,1200,373,100,473,Sunday
2016,12,25,1100,338,75,413,Sunday
2016,12,25,1000,320,50,370,Sunday
2016,12,25,900,273,24,297,Sunday
2016,12,25,800,102,10,112,Sunday
2016,12,25,700,34,11,45,Sunday
2016,12,25,600,18,6,24,Sunday
2016,12,25,500,4,8,12,Sunday
2016,12,25,400,8,9,17,Sunday
2016,12,25,300,4,14,18,Sunday
2016,12,25,200,12,11,23,Sunday
2016,12,25,100,21,18,39,Sunday
2016,12,24,2400,21,27,48,Saturday
2016,12,24,2300,26,43,69,Saturday
2016,12,24,2200,42,48,90,Saturday
2016,12,24,2100,56,63,119,Saturday
2016,12,24,2000,64,91,155,Saturday
2016,12,24,1900,91,154,245,Saturday
2016,12,24,1800,134,283,417,Saturday
2016,12,24,1700,193,408,601,Saturday
2016,12,24,1600,285,344,629,Saturday
2016,12,24,1500,389,369,758,Saturday
2016,12,24,1400,379,303,682,Saturday
2016,12,24,1300,407,261,668,Saturday
2016,12,24,1200,411,196,607,Saturday
2016,12,24,1100,377,146,523,Saturday
2016,12,24,1000,488,133,621,Saturday
2016,12,24,900,374,70,444,Saturday
2016,12,24,800,178,56,234,Saturday
2016,12,24,700,74,34,108,Saturday
2016,12,24,600,36,14,50,Saturday
2016,12,24,500,17,27,44,Saturday
2016,12,24,400,20,29,49,Saturday
2016,12,24,300,24,40,64,Saturday
2016,12,24,200,37,38,75,Saturday
2016,12,24,100,38,40,78,Saturday
2016,12,23,2400,68,54,122,Friday
2016,12,23,2300,90,83,173,Friday
2016,12,23,2200,131,86,217,Friday
2016,12,23,2100,129,130,259,Friday
2016,12,23,2000,293,184,477,Friday
2016,12,23,1900,327,310,637,Friday
2016,12,23,1800,354,579,933,Friday
2016,12,23,1700,543,682,1225,Friday
2016,12,23,1600,492,685,1177,Friday
2016,12,23,1500,414,538,952,Friday
2016,12,23,1400,450,475,925,Friday
2016,12,23,1300,488,431,919,Friday
2016,12,23,1200,727,381,1108,Friday
2016,12,23,1100,681,259,940,Friday
2016,12,23,1000,745,184,929,Friday
2016,12,23,900,747,114,861,Friday
2016,12,23,800,351,65,416,Friday
2016,12,23,700,146,50,196,Friday
2016,12,23,600,70,35,105,Friday
2016,12,23,500,31,17,48,Friday
2016,12,23,400,34,37,71,Friday
2016,12,23,300,30,38,68,Friday
2016,12,23,200,37,37,74,Friday
2016,12,23,100,61,47,108,Friday
2016,12,22,2400,84,88,172,Thursday
2016,12,22,2300,93,111,204,Thursday
2016,12,22,2200,129,104,233,Thursday
2016,12,22,2100,168,152,320,Thursday
2016,12,22,2000,222,335,557,Thursday
2016,12,22,1900,246,453,699,Thursday
2016,12,22,1800,315,539,854,Thursday
2016,12,22,1700,355,565,920,Thursday
2016,12,22,1600,425,654,1079,Thursday
2016,12,22,1500,437,581,1018,Thursday
2016,12,22,1400,501,440,941,Thursday
2016,12,22,1300,445,369,814,Thursday
2016,12,22,1200,543,346,889,Thursday
2016,12,22,1100,579,214,793,Thursday
2016,12,22,1000,670,132,802,Thursday
2016,12,22,900,636,114,750,Thursday
2016,12,22,800,315,63,378,Thursday
2016,12,22,700,106,35,141,Thursday
2016,12,22,600,57,35,92,Thursday
2016,12,22,500,31,31,62,Thursday
2016,12,22,400,34,35,69,Thursday
2016,12,22,300,23,38,61,Thursday
2016,12,22,200,45,47,92,Thursday
2016,12,22,100,52,57,109,Thursday
2016,12,21,2400,71,60,131,Wednesday
2016,12,21,2300,95,78,173,Wednesday
2016,12,21,2200,108,107,215,Wednesday
2016,12,21,2100,144,162,306,Wednesday
2016,12,21,2000,173,239,412,Wednesday
2016,12,21,1900,188,366,554,Wednesday
2016,12,21,1800,221,494,715,Wednesday
2016,12,21,1700,284,868,1152,Wednesday
2016,12,21,1600,305,554,859,Wednesday
2016,12,21,1500,343,372,715,Wednesday
2016,12,21,1400,399,565,964,Wednesday
2016,12,21,1300,396,232,628,Wednesday
2016,12,21,1200,417,251,668,Wednesday
2016,12,21,1100,462,223,685,Wednesday
2016,12,21,1000,556,118,674,Wednesday
2016,12,21,900,542,84,626,Wednesday
2016,12,21,800,278,64,342,Wednesday
2016,12,21,700,100,33,133,Wednesday
2016,12,21,600,40,24,64,Wednesday
2016,12,21,500,22,26,48,Wednesday
2016,12,21,400,27,47,74,Wednesday
2016,12,21,300,19,50,69,Wednesday
2016,12,21,200,25,43,68,Wednesday
2016,12,21,100,35,44,79,Wednesday
2016,12,20,2400,62,45,107,Tuesday
2016,12,20,2300,82,86,168,Tuesday
2016,12,20,2200,94,108,202,Tuesday
2016,12,20,2100,135,180,315,Tuesday
2016,12,20,2000,137,183,320,Tuesday
2016,12,20,1900,148,290,438,Tuesday
2016,12,20,1800,165,748,913,Tuesday
2016,12,20,1700,235,583,818,Tuesday
2016,12,20,1600,247,352,599,Tuesday
2016,12,20,1500,316,236,552,Tuesday
2016,12,20,1400,305,268,573,Tuesday
2016,12,20,1300,320,241,561,Tuesday
2016,12,20,1200,381,266,647,Tuesday
2016,12,20,1100,374,187,561,Tuesday
2016,12,20,1000,435,124,559,Tuesday
2016,12,20,900,457,99,556,Tuesday
2016,12,20,800,221,91,312,Tuesday
2016,12,20,700,82,41,123,Tuesday
2016,12,20,600,43,53,96,Tuesday
2016,12,20,500,21,48,69,Tuesday
2016,12,20,400,14,4,18,Tuesday
2016,12,20,300,15,7,22,Tuesday
2016,12,20,200,30,5,35,Tuesday
2016,12,20,100,42,16,58,Tuesday
2016,12,19,2400,57,44,101,Monday
2016,12,19,2300,63,78,141,Monday
2016,12,19,2200,97,83,180,Monday
2016,12,19,2100,130,91,221,Monday
2016,12,19,2000,134,137,271,Monday
2016,12,19,1900,154,216,370,Monday
2016,12,19,1800,196,478,674,Monday
2016,12,19,1700,247,585,832,Monday
2016,12,19,1600,268,347,615,Monday
2016,12,19,1500,280,259,539,Monday
2016,12,19,1400,305,308,613,Monday
2016,12,19,1300,347,164,511,Monday
2016,12,19,1200,342,137,479,Monday
2016,12,19,1100,364,150,514,Monday
2016,12,19,1000,393,98,491,Monday
2016,12,19,900,394,84,478,Monday
2016,12,19,800,217,34,251,Monday
2016,12,19,700,80,16,96,Monday
2016,12,19,600,33,16,49,Monday
2016,12,19,500,16,8,24,Monday
2016,12,19,400,16,14,30,Monday
2016,12,19,300,13,16,29,Monday
2016,12,19,200,28,27,55,Monday
2016,12,19,100,38,42,80,Monday
2016,12,18,2400,28,50,78,Sunday
2016,12,18,2300,43,71,114,Sunday
2016,12,18,2200,90,118,208,Sunday
2016,12,18,2100,104,129,233,Sunday
2016,12,18,2000,104,238,342,Sunday
2016,12,18,1900,142,352,494,Sunday
2016,12,18,1800,204,627,831,Sunday
2016,12,18,1700,254,904,1158,Sunday
2016,12,18,1600,310,679,989,Sunday
2016,12,18,1500,357,590,947,Sunday
2016,12,18,1400,367,437,804,Sunday
2016,12,18,1300,386,421,807,Sunday
2016,12,18,1200,382,274,656,Sunday
2016,12,18,1100,411,166,577,Sunday
2016,12,18,1000,427,95,522,Sunday
2016,12,18,900,402,58,460,Sunday
2016,12,18,800,241,44,285,Sunday
2016,12,18,700,74,20,94,Sunday
2016,12,18,600,31,14,45,Sunday
2016,12,18,500,13,17,30,Sunday
2016,12,18,400,17,20,37,Sunday
2016,12,18,300,15,17,32,Sunday
2016,12,18,200,21,33,54,Sunday
2016,12,18,100,21,42,63,Sunday
2016,12,17,2400,26,51,77,Saturday
2016,12,17,2300,52,62,114,Saturday
2016,12,17,2200,76,66,142,Saturday
2016,12,17,2100,87,86,173,Saturday
2016,12,17,2000,112,118,230,Saturday
2016,12,17,1900,124,201,325,Saturday
2016,12,17,1800,160,320,480,Saturday
2016,12,17,1700,234,510,744,Saturday
2016,12,17,1600,276,414,690,Saturday
2016,12,17,1500,313,353,666,Saturday
2016,12,17,1400,337,282,619,Saturday
2016,12,17,1300,363,234,597,Saturday
2016,12,17,1200,375,177,552,Saturday
2016,12,17,1100,352,142,494,Saturday
2016,12,17,1000,357,123,480,Saturday
2016,12,17,900,321,88,409,Saturday
2016,12,17,800,239,40,279,Saturday
2016,12,17,700,85,29,114,Saturday
2016,12,17,600,48,37,85,Saturday
2016,12,17,500,25,27,52,Saturday
2016,12,17,400,26,23,49,Saturday
2016,12,17,300,21,37,58,Saturday
2016,12,17,200,34,38,72,Saturday
2016,12,17,100,36,35,71,Saturday
2016,12,16,2400,58,54,112,Friday
2016,12,16,2300,75,64,139,Friday
2016,12,16,2200,109,68,177,Friday
2016,12,16,2100,198,121,319,Friday
2016,12,16,2000,264,112,376,Friday
2016,12,16,1900,268,165,433,Friday
2016,12,16,1800,331,262,593,Friday
2016,12,16,1700,307,358,665,Friday
2016,12,16,1600,386,284,670,Friday
2016,12,16,1500,384,278,662,Friday
2016,12,16,1400,307,242,549,Friday
2016,12,16,1300,305,219,524,Friday
2016,12,16,1200,298,178,476,Friday
2016,12,16,1100,308,158,466,Friday
2016,12,16,1000,244,120,364,Friday
2016,12,16,900,195,87,282,Friday
2016,12,16,800,149,56,205,Friday
2016,12,16,700,61,25,86,Friday
2016,12,16,600,40,35,75,Friday
2016,12,16,500,19,27,46,Friday
2016,12,16,400,28,28,56,Friday
2016,12,16,300,27,37,64,Friday
2016,12,16,200,39,47,86,Friday
2016,12,16,100,52,42,94,Friday
2016,12,15,2400,55,48,103,Thursday
2016,12,15,2300,81,77,158,Thursday
2016,12,15,2200,112,95,207,Thursday
2016,12,15,2100,156,104,260,Thursday
2016,12,15,2000,164,142,306,Thursday
2016,12,15,1900,150,167,317,Thursday
2016,12,15,1800,178,241,419,Thursday
2016,12,15,1700,204,290,494,Thursday
2016,12,15,1600,231,288,519,Thursday
2016,12,15,1500,224,243,467,Thursday
2016,12,15,1400,213,223,436,Thursday
2016,12,15,1300,207,188,395,Thursday
2016,12,15,1200,235,183,418,Thursday
2016,12,15,1100,214,126,340,Thursday
2016,12,15,1000,216,106,322,Thursday
2016,12,15,900,170,86,256,Thursday
2016,12,15,800,144,61,205,Thursday
2016,12,15,700,76,51,127,Thursday
2016,12,15,600,33,27,60,Thursday
2016,12,15,500,27,22,49,Thursday
2016,12,15,400,31,35,66,Thursday
2016,12,15,300,34,32,66,Thursday
2016,12,15,200,36,35,71,Thursday
2016,12,15,100,31,47,78,Thursday
2016,12,14,2400,45,35,80,Wednesday
2016,12,14,2300,60,60,120,Wednesday
2016,12,14,2200,95,71,166,Wednesday
2016,12,14,2100,114,88,202,Wednesday
2016,12,14,2000,128,112,240,Wednesday
2016,12,14,1900,120,138,258,Wednesday
2016,12,14,1800,123,240,363,Wednesday
2016,12,14,1700,194,353,547,Wednesday
2016,12,14,1600,180,251,431,Wednesday
2016,12,14,1500,186,267,453,Wednesday
2016,12,14,1400,171,231,402,Wednesday
2016,12,14,1300,200,204,404,Wednesday
2016,12,14,1200,233,186,419,Wednesday
2016,12,14,1100,242,135,377,Wednesday
2016,12,14,1000,199,110,309,Wednesday
2016,12,14,900,181,68,249,Wednesday
2016,12,14,800,145,46,191,Wednesday
2016,12,14,700,70,33,103,Wednesday
2016,12,14,600,25,34,59,Wednesday
2016,12,14,500,18,19,37,Wednesday
2016,12,14,400,21,25,46,Wednesday
2016,12,14,300,19,45,64,Wednesday
2016,12,14,200,25,31,56,Wednesday
2016,12,14,100,38,52,90,Wednesday
2016,12,13,2400,45,43,88,Tuesday
2016,12,13,2300,65,62,127,Tuesday
2016,12,13,2200,77,62,139,Tuesday
2016,12,13,2100,84,96,180,Tuesday
2016,12,13,2000,110,104,214,Tuesday
2016,12,13,1900,118,135,253,Tuesday
2016,12,13,1800,132,234,366,Tuesday
2016,12,13,1700,168,311,479,Tuesday
2016,12,13,1600,192,271,463,Tuesday
2016,12,13,1500,170,238,408,Tuesday
2016,12,13,1400,221,198,419,Tuesday
2016,12,13,1300,198,198,396,Tuesday
2016,12,13,1200,208,134,342,Tuesday
2016,12,13,1100,227,129,356,Tuesday
2016,12,13,1000,211,126,337,Tuesday
2016,12,13,900,161,75,236,Tuesday
2016,12,13,800,137,58,195,Tuesday
2016,12,13,700,70,39,109,Tuesday
2016,12,13,600,34,31,65,Tuesday
2016,12,13,500,19,15,34,Tuesday
2016,12,13,400,20,22,42,Tuesday
2016,12,13,300,18,25,43,Tuesday
2016,12,13,200,27,32,59,Tuesday
2016,12,13,100,35,46,81,Tuesday
2016,12,12,2400,37,99,136,Monday
2016,12,12,2300,63,15,78,Monday
2016,12,12,2200,77,84,161,Monday
2016,12,12,2100,115,75,190,Monday
2016,12,12,2000,104,110,214,Monday
2016,12,12,1900,108,184,292,Monday
2016,12,12,1800,124,252,376,Monday
2016,12,12,1700,182,335,517,Monday
2016,12,12,1600,202,312,514,Monday
2016,12,12,1500,208,283,491,Monday
2016,12,12,1400,178,248,426,Monday
2016,12,12,1300,220,215,435,Monday
2016,12,12,1200,250,209,459,Monday
2016,12,12,1100,239,178,417,Monday
2016,12,12,1000,197,139,336,Monday
2016,12,12,900,165,85,250,Monday
2016,12,12,800,126,58,184,Monday
2016,12,12,700,67,47,114,Monday
2016,12,12,600,24,40,64,Monday
2016,12,12,500,18,50,68,Monday
2016,12,12,400,12,50,62,Monday
2016,12,12,300,28,70,98,Monday
2016,12,12,200,13,22,35,Monday
2016,12,12,100,25,9,34,Monday
2016,12,11,2400,19,15,34,Sunday
2016,12,11,2300,31,24,55,Sunday
2016,12,11,2200,46,134,180,Sunday
2016,12,11,2100,72,322,394,Sunday
2016,12,11,2000,86,320,406,Sunday
2016,12,11,1900,96,193,289,Sunday
2016,12,11,1800,132,469,601,Sunday
2016,12,11,1700,165,582,747,Sunday
2016,12,11,1600,192,402,594,Sunday
2016,12,11,1500,201,427,628,Sunday
2016,12,11,1400,213,397,610,Sunday
2016,12,11,1300,245,337,582,Sunday
2016,12,11,1200,268,262,530,Sunday
2016,12,11,1100,252,157,409,Sunday
2016,12,11,1000,292,80,372,Sunday
2016,12,11,900,371,62,433,Sunday
2016,12,11,800,239,21,260,Sunday
2016,12,11,700,63,18,81,Sunday
2016,12,11,600,23,13,36,Sunday
2016,12,11,500,15,10,25,Sunday
2016,12,11,400,10,12,22,Sunday
2016,12,11,300,10,9,19,Sunday
2016,12,11,200,9,15,24,Sunday
2016,12,11,100,20,25,45,Sunday
2016,12,10,2400,17,38,55,Saturday
2016,12,10,2300,31,51,82,Saturday
2016,12,10,2200,61,45,106,Saturday
2016,12,10,2100,53,95,148,Saturday
2016,12,10,2000,93,124,217,Saturday
2016,12,10,1900,87,155,242,Saturday
2016,12,10,1800,112,360,472,Saturday
2016,12,10,1700,160,531,691,Saturday
2016,12,10,1600,185,301,486,Saturday
2016,12,10,1500,206,245,451,Saturday
2016,12,10,1400,235,206,441,Saturday
2016,12,10,1300,227,178,405,Saturday
2016,12,10,1200,278,175,453,Saturday
2016,12,10,1100,247,132,379,Saturday
2016,12,10,1000,279,83,362,Saturday
2016,12,10,900,350,74,424,Saturday
2016,12,10,800,263,42,305,Saturday
2016,12,10,700,62,37,99,Saturday
2016,12,10,600,38,17,55,Saturday
2016,12,10,500,14,25,39,Saturday
2016,12,10,400,13,17,30,Saturday
2016,12,10,300,19,14,33,Saturday
2016,12,10,200,24,39,63,Saturday
2016,12,10,100,37,39,76,Saturday
2016,12,9,2400,64,39,103,Friday
2016,12,9,2300,80,50,130,Friday
2016,12,9,2200,120,65,185,Friday
2016,12,9,2100,175,84,259,Friday
2016,12,9,2000,240,95,335,Friday
2016,12,9,1900,258,165,423,Friday
2016,12,9,1800,312,287,599,Friday
2016,12,9,1700,329,342,671,Friday
2016,12,9,1600,362,292,654,Friday
2016,12,9,1500,357,210,567,Friday
2016,12,9,1400,315,197,512,Friday
2016,12,9,1300,292,214,506,Friday
2016,12,9,1200,296,165,461,Friday
2016,12,9,1100,249,142,391,Friday
2016,12,9,1000,192,110,302,Friday
2016,12,9,900,208,90,298,Friday
2016,12,9,800,198,57,255,Friday
2016,12,9,700,133,28,161,Friday
2016,12,9,600,33,36,69,Friday
2016,12,9,500,27,25,52,Friday
2016,12,9,400,29,29,58,Friday
2016,12,9,300,23,33,56,Friday
2016,12,9,200,33,34,67,Friday
2016,12,9,100,34,45,79,Friday
2016,12,8,2400,80,52,132,Thursday
2016,12,8,2300,81,64,145,Thursday
2016,12,8,2200,124,75,199,Thursday
2016,12,8,2100,162,103,265,Thursday
2016,12,8,2000,198,114,312,Thursday
2016,12,8,1900,173,147,320,Thursday
2016,12,8,1800,210,194,404,Thursday
2016,12,8,1700,232,277,509,Thursday
2016,12,8,1600,236,238,474,Thursday
2016,12,8,1500,224,235,459,Thursday
2016,12,8,1400,232,198,430,Thursday
2016,12,8,1300,214,199,413,Thursday
2016,12,8,1200,231,159,390,Thursday
2016,12,8,1100,223,143,366,Thursday
2016,12,8,1000,212,112,324,Thursday
2016,12,8,900,167,84,251,Thursday
2016,12,8,800,148,64,212,Thursday
2016,12,8,700,73,41,114,Thursday
2016,12,8,600,35,30,65,Thursday
2016,12,8,500,20,14,34,Thursday
2016,12,8,400,23,38,61,Thursday
2016,12,8,300,23,30,53,Thursday
2016,12,8,200,28,35,63,Thursday
2016,12,8,100,43,44,87,Thursday
2016,12,7,2400,51,41,92,Wednesday
2016,12,7,2300,62,67,129,Wednesday
2016,12,7,2200,66,82,148,Wednesday
2016,12,7,2100,89,103,192,Wednesday
2016,12,7,2000,86,114,200,Wednesday
2016,12,7,1900,141,187,328,Wednesday
2016,12,7,1800,123,221,344,Wednesday
2016,12,7,1700,193,312,505,Wednesday
2016,12,7,1600,164,258,422,Wednesday
2016,12,7,1500,171,205,376,Wednesday
2016,12,7,1400,174,237,411,Wednesday
2016,12,7,1300,179,199,378,Wednesday
2016,12,7,1200,201,152,353,Wednesday
2016,12,7,1100,181,160,341,Wednesday
2016,12,7,1000,167,100,267,Wednesday
2016,12,7,900,165,86,251,Wednesday
2016,12,7,800,138,58,196,Wednesday
2016,12,7,700,79,37,116,Wednesday
2016,12,7,600,32,39,71,Wednesday
2016,12,7,500,14,24,38,Wednesday
2016,12,7,400,25,25,50,Wednesday
2016,12,7,300,14,30,44,Wednesday
2016,12,7,200,26,21,47,Wednesday
2016,12,7,100,38,44,82,Wednesday
2016,12,6,2400,54,51,105,Tuesday
2016,12,6,2300,43,67,110,Tuesday
2016,12,6,2200,66,83,149,Tuesday
2016,12,6,2100,96,99,195,Tuesday
2016,12,6,2000,108,129,237,Tuesday
2016,12,6,1900,96,152,248,Tuesday
2016,12,6,1800,155,241,396,Tuesday
2016,12,6,1700,170,306,476,Tuesday
2016,12,6,1600,180,239,419,Tuesday
2016,12,6,1500,183,207,390,Tuesday
2016,12,6,1400,183,189,372,Tuesday
2016,12,6,1300,184,174,358,Tuesday
2016,12,6,1200,210,152,362,Tuesday
2016,12,6,1100,211,141,352,Tuesday
2016,12,6,1000,195,123,318,Tuesday
2016,12,6,900,189,79,268,Tuesday
2016,12,6,800,149,52,201,Tuesday
2016,12,6,700,53,37,90,Tuesday
2016,12,6,600,31,20,51,Tuesday
2016,12,6,500,19,25,44,Tuesday
2016,12,6,400,20,24,44,Tuesday
2016,12,6,300,17,34,51,Tuesday
2016,12,6,200,20,29,49,Tuesday
2016,12,6,100,40,44,84,Tuesday
2016,12,5,2400,44,48,92,Monday
2016,12,5,2300,62,55,117,Monday
2016,12,5,2200,65,93,158,Monday
2016,12,5,2100,98,122,220,Monday
2016,12,5,2000,114,97,211,Monday
2016,12,5,1900,97,158,255,Monday
2016,12,5,1800,168,243,411,Monday
2016,12,5,1700,165,329,494,Monday
2016,12,5,1600,212,311,523,Monday
2016,12,5,1500,221,331,552,Monday
2016,12,5,1400,213,245,458,Monday
2016,12,5,1300,239,133,372,Monday
2016,12,5,1200,229,167,396,Monday
2016,12,5,1100,290,144,434,Monday
2016,12,5,1000,249,126,375,Monday
2016,12,5,900,263,96,359,Monday
2016,12,5,800,106,51,157,Monday
2016,12,5,700,76,31,107,Monday
2016,12,5,600,39,28,67,Monday
2016,12,5,500,11,14,25,Monday
2016,12,5,400,16,27,43,Monday
2016,12,5,300,18,20,38,Monday
2016,12,5,200,17,42,59,Monday
2016,12,5,100,28,46,74,Monday
2016,12,4,2400,37,57,94,Sunday
2016,12,4,2300,25,94,119,Sunday
2016,12,4,2200,52,162,214,Sunday
2016,12,4,2100,83,203,286,Sunday
2016,12,4,2000,107,246,353,Sunday
2016,12,4,1900,97,296,393,Sunday
2016,12,4,1800,164,611,775,Sunday
2016,12,4,1700,172,834,1006,Sunday
2016,12,4,1600,238,829,1067,Sunday
2016,12,4,1500,226,730,956,Sunday
2016,12,4,1400,212,551,763,Sunday
2016,12,4,1300,248,356,604,Sunday
2016,12,4,1200,290,269,559,Sunday
2016,12,4,1100,341,128,469,Sunday
2016,12,4,1000,427,99,526,Sunday
2016,12,4,900,600,68,668,Sunday
2016,12,4,800,335,41,376,Sunday
2016,12,4,700,65,23,88,Sunday
2016,12,4,600,22,23,45,Sunday
2016,12,4,500,22,9,31,Sunday
2016,12,4,400,14,22,36,Sunday
2016,12,4,300,13,17,30,Sunday
2016,12,4,200,16,14,30,Sunday
2016,12,4,100,31,33,64,Sunday
2016,12,3,2400,25,54,79,Saturday
2016,12,3,2300,47,46,93,Saturday
2016,12,3,2200,56,72,128,Saturday
2016,12,3,2100,86,110,196,Saturday
2016,12,3,2000,98,128,226,Saturday
2016,12,3,1900,107,168,275,Saturday
2016,12,3,1800,139,462,601,Saturday
2016,12,3,1700,164,823,987,Saturday
2016,12,3,1600,243,650,893,Saturday
2016,12,3,1500,263,524,787,Saturday
2016,12,3,1400,291,371,662,Saturday
2016,12,3,1300,326,263,589,Saturday
2016,12,3,1200,412,180,592,Saturday
2016,12,3,1100,446,116,562,Saturday
2016,12,3,1000,572,119,691,Saturday
2016,12,3,900,693,60,753,Saturday
2016,12,3,800,389,47,436,Saturday
2016,12,3,700,89,30,119,Saturday
2016,12,3,600,32,24,56,Saturday
2016,12,3,500,26,22,48,Saturday
2016,12,3,400,18,29,47,Saturday
2016,12,3,300,15,22,37,Saturday
2016,12,3,200,30,24,54,Saturday
2016,12,3,100,31,29,60,Saturday
2016,12,2,2400,52,34,86,Friday
2016,12,2,2300,66,50,116,Friday
2016,12,2,2200,118,58,176,Friday
2016,12,2,2100,167,82,249,Friday
2016,12,2,2000,273,116,389,Friday
2016,12,2,1900,302,183,485,Friday
2016,12,2,1800,381,294,675,Friday
2016,12,2,1700,365,418,783,Friday
2016,12,2,1600,380,402,782,Friday
2016,12,2,1500,364,321,685,Friday
2016,12,2,1400,359,238,597,Friday
2016,12,2,1300,318,247,565,Friday
2016,12,2,1200,343,191,534,Friday
2016,12,2,1100,334,149,483,Friday
2016,12,2,1000,346,135,481,Friday
2016,12,2,900,311,86,397,Friday
2016,12,2,800,215,65,280,Friday
2016,12,2,700,77,48,125,Friday
2016,12,2,600,50,30,80,Friday
2016,12,2,500,21,43,64,Friday
2016,12,2,400,26,38,64,Friday
2016,12,2,300,19,34,53,Friday
2016,12,2,200,38,36,74,Friday
2016,12,2,100,40,64,104,Friday
2016,12,1,2400,58,53,111,Thursday
2016,12,1,2300,82,91,173,Thursday
2016,12,1,2200,85,101,186,Thursday
2016,12,1,2100,143,109,252,Thursday
2016,12,1,2000,167,136,303,Thursday
2016,12,1,1900,161,164,325,Thursday
2016,12,1,1800,208,234,442,Thursday
2016,12,1,1700,228,328,556,Thursday
2016,12,1,1600,245,288,533,Thursday
2016,12,1,1500,235,262,497,Thursday
2016,12,1,1400,264,237,501,Thursday
2016,12,1,1300,235,167,402,Thursday
2016,12,1,1200,268,167,435,Thursday
2016,12,1,1100,256,124,380,Thursday
2016,12,1,1000,279,120,399,Thursday
2016,12,1,900,207,93,300,Thursday
2016,12,1,800,157,58,215,Thursday
2016,12,1,700,70,24,94,Thursday
2016,12,1,600,44,27,71,Thursday
2016,12,1,500,34,20,54,Thursday
2016,12,1,400,35,40,75,Thursday
2016,12,1,300,31,36,67,Thursday
2016,12,1,200,29,35,64,Thursday
2016,12,1,100,44,67,111,Thursday
2016,11,30,2400,53,75,128,Wednesday
2016,11,30,2300,48,56,104,Wednesday
2016,11,30,2200,62,68,130,Wednesday
2016,11,30,2100,100,79,179,Wednesday
2016,11,30,2000,122,114,236,Wednesday
2016,11,30,1900,94,131,225,Wednesday
2016,11,30,1800,151,212,363,Wednesday
2016,11,30,1700,197,265,462,Wednesday
2016,11,30,1600,219,280,499,Wednesday
2016,11,30,1500,190,233,423,Wednesday
2016,11,30,1400,234,232,466,Wednesday
2016,11,30,1300,192,183,375,Wednesday
2016,11,30,1200,238,166,404,Wednesday
2016,11,30,1100,234,147,381,Wednesday
2016,11,30,1000,241,109,350,Wednesday
2016,11,30,900,177,81,258,Wednesday
2016,11,30,800,135,57,192,Wednesday
2016,11,30,700,74,49,123,Wednesday
2016,11,30,600,30,28,58,Wednesday
2016,11,30,500,13,28,41,Wednesday
2016,11,30,400,25,35,60,Wednesday
2016,11,30,300,16,29,45,Wednesday
2016,11,30,200,22,30,52,Wednesday
2016,11,30,100,42,32,74,Wednesday
2016,11,29,2400,50,48,98,Tuesday
2016,11,29,2300,56,77,133,Tuesday
2016,11,29,2200,94,89,183,Tuesday
2016,11,29,2100,121,114,235,Tuesday
2016,11,29,2000,110,130,240,Tuesday
2016,11,29,1900,105,144,249,Tuesday
2016,11,29,1800,133,237,370,Tuesday
2016,11,29,1700,175,304,479,Tuesday
2016,11,29,1600,203,336,539,Tuesday
2016,11,29,1500,201,269,470,Tuesday
2016,11,29,1400,201,228,429,Tuesday
2016,11,29,1300,213,166,379,Tuesday
2016,11,29,1200,242,195,437,Tuesday
2016,11,29,1100,234,142,376,Tuesday
2016,11,29,1000,250,120,370,Tuesday
2016,11,29,900,195,90,285,Tuesday
2016,11,29,800,136,68,204,Tuesday
2016,11,29,700,75,39,114,Tuesday
2016,11,29,600,26,29,55,Tuesday
2016,11,29,500,21,17,38,Tuesday
2016,11,29,400,27,34,61,Tuesday
2016,11,29,300,13,23,36,Tuesday
2016,11,29,200,31,38,69,Tuesday
2016,11,29,100,38,44,82,Tuesday
2016,11,28,2400,51,51,102,Monday
2016,11,28,2300,58,70,128,Monday
2016,11,28,2200,56,86,142,Monday
2016,11,28,2100,79,98,177,Monday
2016,11,28,2000,127,138,265,Monday
2016,11,28,1900,138,166,304,Monday
2016,11,28,1800,131,271,402,Monday
2016,11,28,1700,179,291,470,Monday
2016,11,28,1600,197,317,514,Monday
2016,11,28,1500,215,272,487,Monday
2016,11,28,1400,269,249,518,Monday
2016,11,28,1300,256,189,445,Monday
2016,11,28,1200,316,158,474,Monday
2016,11,28,1100,297,134,431,Monday
2016,11,28,1000,255,105,360,Monday
2016,11,28,900,235,69,304,Monday
2016,11,28,800,131,60,191,Monday
2016,11,28,700,77,29,106,Monday
2016,11,28,600,25,21,46,Monday
2016,11,28,500,8,13,21,Monday
2016,11,28,400,14,21,35,Monday
2016,11,28,300,25,30,55,Monday
2016,11,28,200,14,40,54,Monday
2016,11,28,100,21,72,93,Monday
2016,11,27,2400,33,146,179,Sunday
2016,11,27,2300,49,83,132,Sunday
2016,11,27,2200,51,25,76,Sunday
2016,11,27,2100,83,72,155,Sunday
2016,11,27,2000,85,298,383,Sunday
2016,11,27,1900,122,264,386,Sunday
2016,11,27,1800,152,469,621,Sunday
2016,11,27,1700,195,802,997,Sunday
2016,11,27,1600,248,736,984,Sunday
2016,11,27,1500,283,627,910,Sunday
2016,11,27,1400,283,537,820,Sunday
2016,11,27,1300,339,417,756,Sunday
2016,11,27,1200,421,234,655,Sunday
2016,11,27,1100,442,188,630,Sunday
2016,11,27,1000,436,101,537,Sunday
2016,11,27,900,527,61,588,Sunday
2016,11,27,800,276,41,317,Sunday
2016,11,27,700,104,16,120,Sunday
2016,11,27,600,31,7,38,Sunday
2016,11,27,500,14,18,32,Sunday
2016,11,27,400,24,21,45,Sunday
2016,11,27,300,17,11,28,Sunday
2016,11,27,200,18,22,40,Sunday
2016,11,27,100,22,26,48,Sunday
2016,11,26,2400,29,35,64,Saturday
2016,11,26,2300,42,50,92,Saturday
2016,11,26,2200,54,79,133,Saturday
2016,11,26,2100,91,81,172,Saturday
2016,11,26,2000,86,133,219,Saturday
2016,11,26,1900,109,197,306,Saturday
2016,11,26,1800,129,452,581,Saturday
2016,11,26,1700,205,760,965,Saturday
2016,11,26,1600,178,658,836,Saturday
2016,11,26,1500,254,401,655,Saturday
2016,11,26,1400,295,316,611,Saturday
2016,11,26,1300,338,253,591,Saturday
2016,11,26,1200,395,225,620,Saturday
2016,11,26,1100,425,178,603,Saturday
2016,11,26,1000,518,117,635,Saturday
2016,11,26,900,580,93,673,Saturday
2016,11,26,800,300,39,339,Saturday
2016,11,26,700,73,34,107,Saturday
2016,11,26,600,25,25,50,Saturday
2016,11,26,500,15,24,39,Saturday
2016,11,26,400,18,19,37,Saturday
2016,11,26,300,21,36,57,Saturday
2016,11,26,200,28,29,57,Saturday
2016,11,26,100,31,41,72,Saturday
2016,11,25,2400,48,40,88,Friday
2016,11,25,2300,67,66,133,Friday
2016,11,25,2200,127,73,200,Friday
2016,11,25,2100,151,88,239,Friday
2016,11,25,2000,215,144,359,Friday
2016,11,25,1900,234,191,425,Friday
2016,11,25,1800,295,368,663,Friday
2016,11,25,1700,316,466,782,Friday
2016,11,25,1600,313,381,694,Friday
2016,11,25,1500,294,358,652,Friday
2016,11,25,1400,294,349,643,Friday
2016,11,25,1300,322,220,542,Friday
2016,11,25,1200,363,199,562,Friday
2016,11,25,1100,347,165,512,Friday
2016,11,25,1000,327,129,456,Friday
2016,11,25,900,326,95,421,Friday
2016,11,25,800,205,59,264,Friday
2016,11,25,700,86,41,127,Friday
2016,11,25,600,46,38,84,Friday
2016,11,25,500,23,28,51,Friday
2016,11,25,400,18,33,51,Friday
2016,11,25,300,40,36,76,Friday
2016,11,25,200,26,31,57,Friday
2016,11,25,100,40,48,88,Friday
2016,11,24,2400,54,44,98,Thursday
2016,11,24,2300,66,61,127,Thursday
2016,11,24,2200,88,76,164,Thursday
2016,11,24,2100,147,102,249,Thursday
2016,11,24,2000,162,142,304,Thursday
2016,11,24,1900,183,162,345,Thursday
2016,11,24,1800,219,300,519,Thursday
2016,11,24,1700,283,369,652,Thursday
2016,11,24,1600,278,309,587,Thursday
2016,11,24,1500,248,332,580,Thursday
2016,11,24,1400,236,288,524,Thursday
2016,11,24,1300,243,245,488,Thursday
2016,11,24,1200,257,180,437,Thursday
2016,11,24,1100,263,158,421,Thursday
2016,11,24,1000,257,140,397,Thursday
2016,11,24,900,234,76,310,Thursday
2016,11,24,800,167,55,222,Thursday
2016,11,24,700,95,41,136,Thursday
2016,11,24,600,45,42,87,Thursday
2016,11,24,500,24,27,51,Thursday
2016,11,24,400,20,29,49,Thursday
2016,11,24,300,29,38,67,Thursday
2016,11,24,200,33,58,91,Thursday
2016,11,24,100,57,56,113,Thursday
2016,11,23,2400,49,43,92,Wednesday
2016,11,23,2300,67,65,132,Wednesday
2016,11,23,2200,90,78,168,Wednesday
2016,11,23,2100,113,109,222,Wednesday
2016,11,23,2000,122,115,237,Wednesday
2016,11,23,1900,128,189,317,Wednesday
2016,11,23,1800,169,234,403,Wednesday
2016,11,23,1700,217,322,539,Wednesday
2016,11,23,1600,220,337,557,Wednesday
2016,11,23,1500,172,269,441,Wednesday
2016,11,23,1400,215,239,454,Wednesday
2016,11,23,1300,212,200,412,Wednesday
2016,11,23,1200,264,185,449,Wednesday
2016,11,23,1100,259,149,408,Wednesday
2016,11,23,1000,239,120,359,Wednesday
2016,11,23,900,227,76,303,Wednesday
2016,11,23,800,201,69,270,Wednesday
2016,11,23,700,80,49,129,Wednesday
2016,11,23,600,29,44,73,Wednesday
2016,11,23,500,31,30,61,Wednesday
2016,11,23,400,19,32,51,Wednesday
2016,11,23,300,25,29,54,Wednesday
2016,11,23,200,22,40,62,Wednesday
2016,11,23,100,36,35,71,Wednesday
2016,11,22,2400,54,47,101,Tuesday
2016,11,22,2300,67,54,121,Tuesday
2016,11,22,2200,88,77,165,Tuesday
2016,11,22,2100,106,89,195,Tuesday
2016,11,22,2000,116,112,228,Tuesday
2016,11,22,1900,124,186,310,Tuesday
2016,11,22,1800,133,266,399,Tuesday
2016,11,22,1700,214,325,539,Tuesday
2016,11,22,1600,158,335,493,Tuesday
2016,11,22,1500,189,277,466,Tuesday
2016,11,22,1400,199,230,429,Tuesday
2016,11,22,1300,267,203,470,Tuesday
2016,11,22,1200,224,178,402,Tuesday
2016,11,22,1100,291,139,430,Tuesday
2016,11,22,1000,271,128,399,Tuesday
2016,11,22,900,177,102,279,Tuesday
2016,11,22,800,154,46,200,Tuesday
2016,11,22,700,79,40,119,Tuesday
2016,11,22,600,26,35,61,Tuesday
2016,11,22,500,25,20,45,Tuesday
2016,11,22,400,18,29,47,Tuesday
2016,11,22,300,25,30,55,Tuesday
2016,11,22,200,19,35,54,Tuesday
2016,11,22,100,28,47,75,Tuesday
2016,11,21,2400,48,47,95,Monday
2016,11,21,2300,38,77,115,Monday
2016,11,21,2200,89,88,177,Monday
2016,11,21,2100,104,96,200,Monday
2016,11,21,2000,102,126,228,Monday
2016,11,21,1900,146,196,342,Monday
2016,11,21,1800,155,262,417,Monday
2016,11,21,1700,195,323,518,Monday
2016,11,21,1600,233,322,555,Monday
2016,11,21,1500,213,291,504,Monday
2016,11,21,1400,240,227,467,Monday
2016,11,21,1300,279,196,475,Monday
2016,11,21,1200,309,175,484,Monday
2016,11,21,1100,295,133,428,Monday
2016,11,21,1000,275,113,388,Monday
2016,11,21,900,198,73,271,Monday
2016,11,21,800,149,40,189,Monday
2016,11,21,700,74,36,110,Monday
2016,11,21,600,43,20,63,Monday
2016,11,21,500,25,12,37,Monday
2016,11,21,400,12,21,33,Monday
2016,11,21,300,15,15,30,Monday
2016,11,21,200,19,25,44,Monday
2016,11,21,100,19,42,61,Monday
2016,11,20,2400,34,52,86,Sunday
2016,11,20,2300,44,64,108,Sunday
2016,11,20,2200,77,106,183,Sunday
2016,11,20,2100,98,123,221,Sunday
2016,11,20,2000,116,202,318,Sunday
2016,11,20,1900,128,303,431,Sunday
2016,11,20,1800,160,471,631,Sunday
2016,11,20,1700,199,667,866,Sunday
2016,11,20,1600,230,631,861,Sunday
2016,11,20,1500,274,583,857,Sunday
2016,11,20,1400,283,488,771,Sunday
2016,11,20,1300,339,378,717,Sunday
2016,11,20,1200,384,251,635,Sunday
2016,11,20,1100,323,168,491,Sunday
2016,11,20,1000,311,97,408,Sunday
2016,11,20,900,398,56,454,Sunday
2016,11,20,800,197,34,231,Sunday
2016,11,20,700,59,23,82,Sunday
2016,11,20,600,21,16,37,Sunday
2016,11,20,500,12,20,32,Sunday
2016,11,20,400,19,17,36,Sunday
2016,11,20,300,20,23,43,Sunday
2016,11,20,200,19,10,29,Sunday
2016,11,20,100,20,29,49,Sunday
2016,11,19,2400,31,29,60,Saturday
2016,11,19,2300,47,64,111,Saturday
2016,11,19,2200,65,137,202,Saturday
2016,11,19,2100,74,140,214,Saturday
2016,11,19,2000,98,53,151,Saturday
2016,11,19,1900,125,139,264,Saturday
2016,11,19,1800,130,394,524,Saturday
2016,11,19,1700,205,524,729,Saturday
2016,11,19,1600,205,478,683,Saturday
2016,11,19,1500,266,461,727,Saturday
2016,11,19,1400,298,315,613,Saturday
2016,11,19,1300,338,285,623,Saturday
2016,11,19,1200,372,236,608,Saturday
2016,11,19,1100,366,168,534,Saturday
2016,11,19,1000,403,93,496,Saturday
2016,11,19,900,411,97,508,Saturday
2016,11,19,800,239,52,291,Saturday
2016,11,19,700,70,35,105,Saturday
2016,11,19,600,43,35,78,Saturday
2016,11,19,500,25,24,49,Saturday
2016,11,19,400,17,24,41,Saturday
2016,11,19,300,20,31,51,Saturday
2016,11,19,200,28,34,62,Saturday
2016,11,19,100,38,49,87,Saturday
2016,11,18,2400,53,53,106,Friday
2016,11,18,2300,58,62,120,Friday
2016,11,18,2200,107,93,200,Friday
2016,11,18,2100,132,91,223,Friday
2016,11,18,2000,190,128,318,Friday
2016,11,18,1900,234,177,411,Friday
2016,11,18,1800,256,299,555,Friday
2016,11,18,1700,340,392,732,Friday
2016,11,18,1600,330,440,770,Friday
2016,11,18,1500,304,338,642,Friday
2016,11,18,1400,341,341,682,Friday
2016,11,18,1300,305,298,603,Friday
2016,11,18,1200,296,222,518,Friday
2016,11,18,1100,311,166,477,Friday
2016,11,18,1000,268,124,392,Friday
2016,11,18,900,403,89,492,Friday
2016,11,18,800,213,50,263,Friday
2016,11,18,700,90,41,131,Friday
2016,11,18,600,35,31,66,Friday
2016,11,18,500,27,24,51,Friday
2016,11,18,400,33,34,67,Friday
2016,11,18,300,32,34,66,Friday
2016,11,18,200,29,42,71,Friday
2016,11,18,100,34,59,93,Friday
2016,11,17,2400,57,49,106,Thursday
2016,11,17,2300,71,57,128,Thursday
2016,11,17,2200,83,70,153,Thursday
2016,11,17,2100,98,104,202,Thursday
2016,11,17,2000,130,128,258,Thursday
2016,11,17,1900,146,156,302,Thursday
2016,11,17,1800,156,212,368,Thursday
2016,11,17,1700,205,278,483,Thursday
2016,11,17,1600,230,252,482,Thursday
2016,11,17,1500,197,271,468,Thursday
2016,11,17,1400,253,220,473,Thursday
2016,11,17,1300,259,225,484,Thursday
2016,11,17,1200,218,174,392,Thursday
2016,11,17,1100,209,156,365,Thursday
2016,11,17,1000,204,133,337,Thursday
2016,11,17,900,170,99,269,Thursday
2016,11,17,800,137,65,202,Thursday
2016,11,17,700,73,35,108,Thursday
2016,11,17,600,29,20,49,Thursday
2016,11,17,500,26,32,58,Thursday
2016,11,17,400,35,35,70,Thursday
2016,11,17,300,20,41,61,Thursday
2016,11,17,200,28,35,63,Thursday
2016,11,17,100,38,43,81,Thursday
2016,11,16,2400,52,54,106,Wednesday
2016,11,16,2300,61,84,145,Wednesday
2016,11,16,2200,91,78,169,Wednesday
2016,11,16,2100,89,113,202,Wednesday
2016,11,16,2000,117,113,230,Wednesday
2016,11,16,1900,117,199,316,Wednesday
2016,11,16,1800,145,217,362,Wednesday
2016,11,16,1700,188,296,484,Wednesday
2016,11,16,1600,231,257,488,Wednesday
2016,11,16,1500,224,235,459,Wednesday
2016,11,16,1400,207,201,408,Wednesday
2016,11,16,1300,226,220,446,Wednesday
2016,11,16,1200,228,161,389,Wednesday
2016,11,16,1100,215,229,444,Wednesday
2016,11,16,1000,179,65,244,Wednesday
2016,11,16,900,167,99,266,Wednesday
2016,11,16,800,138,55,193,Wednesday
2016,11,16,700,67,34,101,Wednesday
2016,11,16,600,35,35,70,Wednesday
2016,11,16,500,27,30,57,Wednesday
2016,11,16,400,22,25,47,Wednesday
2016,11,16,300,18,32,50,Wednesday
2016,11,16,200,24,50,74,Wednesday
2016,11,16,100,46,42,88,Wednesday
2016,11,15,2400,37,69,106,Tuesday
2016,11,15,2300,46,87,133,Tuesday
2016,11,15,2200,81,101,182,Tuesday
2016,11,15,2100,88,82,170,Tuesday
2016,11,15,2000,100,144,244,Tuesday
2016,11,15,1900,96,177,273,Tuesday
2016,11,15,1800,143,261,404,Tuesday
2016,11,15,1700,178,230,408,Tuesday
2016,11,15,1600,185,203,388,Tuesday
2016,11,15,1500,180,237,417,Tuesday
2016,11,15,1400,195,256,451,Tuesday
2016,11,15,1300,236,194,430,Tuesday
2016,11,15,1200,250,188,438,Tuesday
2016,11,15,1100,230,156,386,Tuesday
2016,11,15,1000,205,121,326,Tuesday
2016,11,15,900,155,100,255,Tuesday
2016,11,15,800,143,61,204,Tuesday
2016,11,15,700,77,51,128,Tuesday
2016,11,15,600,29,41,70,Tuesday
2016,11,15,500,26,28,54,Tuesday
2016,11,15,400,27,37,64,Tuesday
2016,11,15,300,24,37,61,Tuesday
2016,11,15,200,25,33,58,Tuesday
2016,11,15,100,42,46,88,Tuesday
2016,11,14,2400,58,65,123,Monday
2016,11,14,2300,57,80,137,Monday
2016,11,14,2200,67,101,168,Monday
2016,11,14,2100,100,123,223,Monday
2016,11,14,2000,130,187,317,Monday
2016,11,14,1900,127,229,356,Monday
2016,11,14,1800,150,320,470,Monday
2016,11,14,1700,235,361,596,Monday
2016,11,14,1600,232,344,576,Monday
2016,11,14,1500,249,341,590,Monday
2016,11,14,1400,266,298,564,Monday
2016,11,14,1300,311,274,585,Monday
2016,11,14,1200,333,239,572,Monday
2016,11,14,1100,315,167,482,Monday
2016,11,14,1000,272,116,388,Monday
2016,11,14,900,218,103,321,Monday
2016,11,14,800,134,63,197,Monday
2016,11,14,700,86,36,122,Monday
2016,11,14,600,43,26,69,Monday
2016,11,14,500,21,25,46,Monday
2016,11,14,400,16,21,37,Monday
2016,11,14,300,16,24,40,Monday
2016,11,14,200,20,34,54,Monday
2016,11,14,100,29,40,69,Monday
2016,11,13,2400,41,66,107,Sunday
2016,11,13,2300,50,87,137,Sunday
2016,11,13,2200,71,142,213,Sunday
2016,11,13,2100,85,216,301,Sunday
2016,11,13,2000,118,346,464,Sunday
2016,11,13,1900,146,501,647,Sunday
2016,11,13,1800,199,729,928,Sunday
2016,11,13,1700,295,969,1264,Sunday
2016,11,13,1600,302,1045,1347,Sunday
2016,11,13,1500,444,973,1417,Sunday
2016,11,13,1400,448,839,1287,Sunday
2016,11,13,1300,472,757,1229,Sunday
2016,11,13,1200,536,494,1030,Sunday
2016,11,13,1100,426,284,710,Sunday
2016,11,13,1000,299,143,442,Sunday
2016,11,13,900,203,90,293,Sunday
2016,11,13,800,123,38,161,Sunday
2016,11,13,700,54,31,85,Sunday
2016,11,13,600,26,10,36,Sunday
2016,11,13,500,15,15,30,Sunday
2016,11,13,400,8,12,20,Sunday
2016,11,13,300,16,18,34,Sunday
2016,11,13,200,21,15,36,Sunday
2016,11,13,100,29,24,53,Sunday
2016,11,12,2400,30,39,69,Saturday
2016,11,12,2300,42,48,90,Saturday
2016,11,12,2200,57,85,142,Saturday
2016,11,12,2100,106,96,202,Saturday
2016,11,12,2000,94,162,256,Saturday
2016,11,12,1900,123,232,355,Saturday
2016,11,12,1800,209,375,584,Saturday
2016,11,12,1700,263,477,740,Saturday
2016,11,12,1600,291,583,874,Saturday
2016,11,12,1500,374,492,866,Saturday
2016,11,12,1400,450,538,988,Saturday
2016,11,12,1300,489,435,924,Saturday
2016,11,12,1200,541,324,865,Saturday
2016,11,12,1100,402,244,646,Saturday
2016,11,12,1000,304,171,475,Saturday
2016,11,12,900,207,118,325,Saturday
2016,11,12,800,107,57,164,Saturday
2016,11,12,700,62,20,82,Saturday
2016,11,12,600,25,14,39,Saturday
2016,11,12,500,24,22,46,Saturday
2016,11,12,400,14,14,28,Saturday
2016,11,12,300,17,20,37,Saturday
2016,11,12,200,13,20,33,Saturday
2016,11,12,100,22,34,56,Saturday
2016,11,11,2400,27,43,70,Friday
2016,11,11,2300,43,64,107,Friday
2016,11,11,2200,70,70,140,Friday
2016,11,11,2100,121,105,226,Friday
2016,11,11,2000,171,142,313,Friday
2016,11,11,1900,194,309,503,Friday
2016,11,11,1800,340,531,871,Friday
2016,11,11,1700,425,640,1065,Friday
2016,11,11,1600,532,560,1092,Friday
2016,11,11,1500,659,583,1242,Friday
2016,11,11,1400,719,478,1197,Friday
2016,11,11,1300,811,417,1228,Friday
2016,11,11,1200,881,286,1167,Friday
2016,11,11,1100,724,245,969,Friday
2016,11,11,1000,544,172,716,Friday
2016,11,11,900,326,97,423,Friday
2016,11,11,800,208,49,257,Friday
2016,11,11,700,134,31,165,Friday
2016,11,11,600,66,28,94,Friday
2016,11,11,500,31,35,66,Friday
2016,11,11,400,18,35,53,Friday
2016,11,11,300,35,31,66,Friday
2016,11,11,200,35,40,75,Friday
2016,11,11,100,46,57,103,Friday
2016,11,10,2400,85,75,160,Thursday
2016,11,10,2300,111,100,211,Thursday
2016,11,10,2200,173,124,297,Thursday
2016,11,10,2100,299,152,451,Thursday
2016,11,10,2000,389,205,594,Thursday
2016,11,10,1900,457,272,729,Thursday
2016,11,10,1800,415,370,785,Thursday
2016,11,10,1700,495,360,855,Thursday
2016,11,10,1600,450,399,849,Thursday
2016,11,10,1500,435,387,822,Thursday
2016,11,10,1400,428,307,735,Thursday
2016,11,10,1300,411,337,748,Thursday
2016,11,10,1200,383,272,655,Thursday
2016,11,10,1100,357,166,523,Thursday
2016,11,10,1000,282,158,440,Thursday
2016,11,10,900,227,127,354,Thursday
2016,11,10,800,180,70,250,Thursday
2016,11,10,700,115,44,159,Thursday
2016,11,10,600,46,37,83,Thursday
2016,11,10,500,28,21,49,Thursday
2016,11,10,400,19,25,44,Thursday
2016,11,10,300,18,29,47,Thursday
2016,11,10,200,33,35,68,Thursday
2016,11,10,100,39,55,94,Thursday
2016,11,9,2400,53,56,109,Wednesday
2016,11,9,2300,66,75,141,Wednesday
2016,11,9,2200,115,95,210,Wednesday
2016,11,9,2100,130,126,256,Wednesday
2016,11,9,2000,167,145,312,Wednesday
2016,11,9,1900,139,244,383,Wednesday
2016,11,9,1800,220,319,539,Wednesday
2016,11,9,1700,238,308,546,Wednesday
2016,11,9,1600,246,299,545,Wednesday
2016,11,9,1500,292,300,592,Wednesday
2016,11,9,1400,302,217,519,Wednesday
2016,11,9,1300,263,215,478,Wednesday
2016,11,9,1200,303,183,486,Wednesday
2016,11,9,1100,275,156,431,Wednesday
2016,11,9,1000,223,127,350,Wednesday
2016,11,9,900,177,89,266,Wednesday
2016,11,9,800,150,66,216,Wednesday
2016,11,9,700,105,30,135,Wednesday
2016,11,9,600,38,49,87,Wednesday
2016,11,9,500,18,36,54,Wednesday
2016,11,9,400,28,20,48,Wednesday
2016,11,9,300,17,32,49,Wednesday
2016,11,9,200,30,37,67,Wednesday
2016,11,9,100,42,52,94,Wednesday
2016,11,8,2400,51,49,100,Tuesday
2016,11,8,2300,55,95,150,Tuesday
2016,11,8,2200,70,114,184,Tuesday
2016,11,8,2100,126,113,239,Tuesday
2016,11,8,2000,135,137,272,Tuesday
2016,11,8,1900,118,213,331,Tuesday
2016,11,8,1800,159,314,473,Tuesday
2016,11,8,1700,216,281,497,Tuesday
2016,11,8,1600,222,294,516,Tuesday
2016,11,8,1500,210,291,501,Tuesday
2016,11,8,1400,247,273,520,Tuesday
2016,11,8,1300,258,242,500,Tuesday
2016,11,8,1200,275,175,450,Tuesday
2016,11,8,1100,297,140,437,Tuesday
2016,11,8,1000,221,141,362,Tuesday
2016,11,8,900,184,94,278,Tuesday
2016,11,8,800,160,71,231,Tuesday
2016,11,8,700,98,53,151,Tuesday
2016,11,8,600,29,34,63,Tuesday
2016,11,8,500,22,31,53,Tuesday
2016,11,8,400,30,48,78,Tuesday
2016,11,8,300,8,29,37,Tuesday
2016,11,8,200,17,36,53,Tuesday
2016,11,8,100,35,38,73,Tuesday
2016,11,7,2400,57,55,112,Monday
2016,11,7,2300,64,73,137,Monday
2016,11,7,2200,62,89,151,Monday
2016,11,7,2100,101,89,190,Monday
2016,11,7,2000,106,144,250,Monday
2016,11,7,1900,127,208,335,Monday
2016,11,7,1800,170,273,443,Monday
2016,11,7,1700,245,308,553,Monday
2016,11,7,1600,288,296,584,Monday
2016,11,7,1500,313,289,602,Monday
2016,11,7,1400,300,225,525,Monday
2016,11,7,1300,280,197,477,Monday
2016,11,7,1200,335,184,519,Monday
2016,11,7,1100,258,150,408,Monday
2016,11,7,1000,256,115,371,Monday
2016,11,7,900,187,98,285,Monday
2016,11,7,800,139,54,193,Monday
2016,11,7,700,96,36,132,Monday
2016,11,7,600,27,23,50,Monday
2016,11,7,500,12,28,40,Monday
2016,11,7,400,25,14,39,Monday
2016,11,7,300,16,19,35,Monday
2016,11,7,200,16,34,50,Monday
2016,11,7,100,33,36,69,Monday
2016,11,6,2400,39,51,90,Sunday
2016,11,6,2300,38,92,130,Sunday
2016,11,6,2200,61,103,164,Sunday
2016,11,6,2100,86,163,249,Sunday
2016,11,6,2000,119,267,386,Sunday
2016,11,6,1900,142,306,448,Sunday
2016,11,6,1800,192,424,616,Sunday
2016,11,6,1700,245,558,803,Sunday
2016,11,6,1600,252,588,840,Sunday
2016,11,6,1500,297,572,869,Sunday
2016,11,6,1400,317,503,820,Sunday
2016,11,6,1300,354,451,805,Sunday
2016,11,6,1200,329,312,641,Sunday
2016,11,6,1100,351,192,543,Sunday
2016,11,6,1000,249,116,365,Sunday
2016,11,6,900,187,61,248,Sunday
2016,11,6,800,90,27,117,Sunday
2016,11,6,700,89,21,110,Sunday
2016,11,6,600,25,18,43,Sunday
2016,11,6,500,11,15,26,Sunday
2016,11,6,400,13,19,32,Sunday
2016,11,6,300,17,22,39,Sunday
2016,11,6,200,14,18,32,Sunday
2016,11,6,100,24,38,62,Sunday
2016,11,5,2400,38,50,88,Saturday
2016,11,5,2300,46,55,101,Saturday
2016,11,5,2200,67,63,130,Saturday
2016,11,5,2100,84,117,201,Saturday
2016,11,5,2000,115,183,298,Saturday
2016,11,5,1900,124,317,441,Saturday
2016,11,5,1800,167,394,561,Saturday
2016,11,5,1700,207,512,719,Saturday
2016,11,5,1600,270,497,767,Saturday
2016,11,5,1500,340,354,694,Saturday
2016,11,5,1400,401,320,721,Saturday
2016,11,5,1300,451,279,730,Saturday
2016,11,5,1200,440,185,625,Saturday
2016,11,5,1100,365,143,508,Saturday
2016,11,5,1000,268,115,383,Saturday
2016,11,5,900,190,71,261,Saturday
2016,11,5,800,162,54,216,Saturday
2016,11,5,700,92,32,124,Saturday
2016,11,5,600,41,38,79,Saturday
2016,11,5,500,9,29,38,Saturday
2016,11,5,400,13,41,54,Saturday
2016,11,5,300,26,26,52,Saturday
2016,11,5,200,23,38,61,Saturday
2016,11,5,100,31,35,66,Saturday
2016,11,4,2400,48,54,102,Friday
2016,11,4,2300,81,65,146,Friday
2016,11,4,2200,97,96,193,Friday
2016,11,4,2100,167,122,289,Friday
2016,11,4,2000,241,184,425,Friday
2016,11,4,1900,306,279,585,Friday
2016,11,4,1800,343,339,682,Friday
2016,11,4,1700,363,342,705,Friday
2016,11,4,1600,373,366,739,Friday
2016,11,4,1500,375,335,710,Friday
2016,11,4,1400,372,299,671,Friday
2016,11,4,1300,350,227,577,Friday
2016,11,4,1200,341,195,536,Friday
2016,11,4,1100,321,174,495,Friday
2016,11,4,1000,261,111,372,Friday
2016,11,4,900,199,97,296,Friday
2016,11,4,800,159,70,229,Friday
2016,11,4,700,79,30,109,Friday
2016,11,4,600,34,43,77,Friday
2016,11,4,500,23,34,57,Friday
2016,11,4,400,22,37,59,Friday
2016,11,4,300,21,32,53,Friday
2016,11,4,200,27,39,66,Friday
2016,11,4,100,44,50,94,Friday
2016,11,3,2400,49,69,118,Thursday
2016,11,3,2300,65,76,141,Thursday
2016,11,3,2200,101,96,197,Thursday
2016,11,3,2100,129,109,238,Thursday
2016,11,3,2000,147,173,320,Thursday
2016,11,3,1900,162,276,438,Thursday
2016,11,3,1800,215,259,474,Thursday
2016,11,3,1700,243,266,509,Thursday
2016,11,3,1600,282,279,561,Thursday
2016,11,3,1500,276,272,548,Thursday
2016,11,3,1400,284,225,509,Thursday
2016,11,3,1300,295,203,498,Thursday
2016,11,3,1200,299,197,496,Thursday
2016,11,3,1100,285,148,433,Thursday
2016,11,3,1000,243,127,370,Thursday
2016,11,3,900,184,123,307,Thursday
2016,11,3,800,166,63,229,Thursday
2016,11,3,700,94,37,131,Thursday
2016,11,3,600,33,29,62,Thursday
2016,11,3,500,22,34,56,Thursday
2016,11,3,400,29,32,61,Thursday
2016,11,3,300,20,22,42,Thursday
2016,11,3,200,21,36,57,Thursday
2016,11,3,100,36,51,87,Thursday
2016,11,2,2400,58,50,108,Wednesday
2016,11,2,2300,65,59,124,Wednesday
2016,11,2,2200,75,83,158,Wednesday
2016,11,2,2100,101,117,218,Wednesday
2016,11,2,2000,119,150,269,Wednesday
2016,11,2,1900,133,215,348,Wednesday
2016,11,2,1800,169,258,427,Wednesday
2016,11,2,1700,201,313,514,Wednesday
2016,11,2,1600,222,154,376,Wednesday
2016,11,2,1500,249,269,518,Wednesday
2016,11,2,1400,220,201,421,Wednesday
2016,11,2,1300,220,173,393,Wednesday
2016,11,2,1200,253,145,398,Wednesday
2016,11,2,1100,238,146,384,Wednesday
2016,11,2,1000,205,113,318,Wednesday
2016,11,2,900,187,83,270,Wednesday
2016,11,2,800,162,62,224,Wednesday
2016,11,2,700,76,43,119,Wednesday
2016,11,2,600,34,38,72,Wednesday
2016,11,2,500,13,31,44,Wednesday
2016,11,2,400,26,36,62,Wednesday
2016,11,2,300,22,31,53,Wednesday
2016,11,2,200,27,34,61,Wednesday
2016,11,2,100,42,50,92,Wednesday
2016,11,1,2400,51,54,105,Tuesday
2016,11,1,2300,77,65,142,Tuesday
2016,11,1,2200,66,89,155,Tuesday
2016,11,1,2100,89,175,264,Tuesday
2016,11,1,2000,108,194,302,Tuesday
2016,11,1,1900,128,185,313,Tuesday
2016,11,1,1800,151,240,391,Tuesday
2016,11,1,1700,186,267,453,Tuesday
2016,11,1,1600,218,255,473,Tuesday
2016,11,1,1500,219,204,423,Tuesday
2016,11,1,1400,223,202,425,Tuesday
2016,11,1,1300,242,225,467,Tuesday
2016,11,1,1200,273,178,451,Tuesday
2016,11,1,1100,247,162,409,Tuesday
2016,11,1,1000,208,131,339,Tuesday
2016,11,1,900,160,83,243,Tuesday
2016,11,1,800,126,46,172,Tuesday
2016,11,1,700,66,52,118,Tuesday
2016,11,1,600,36,37,73,Tuesday
2016,11,1,500,24,26,50,Tuesday
2016,11,1,400,24,20,44,Tuesday
2016,11,1,300,17,31,48,Tuesday
2016,11,1,200,29,39,68,Tuesday
2016,11,1,100,36,56,92,Tuesday
2016,10,31,2400,54,60,114,Monday
2016,10,31,2300,58,56,114,Monday
2016,10,31,2200,64,87,151,Monday
2016,10,31,2100,87,82,169,Monday
2016,10,31,2000,107,135,242,Monday
2016,10,31,1900,108,189,297,Monday
2016,10,31,1800,148,281,429,Monday
2016,10,31,1700,161,261,422,Monday
2016,10,31,1600,201,272,473,Monday
2016,10,31,1500,200,258,458,Monday
2016,10,31,1400,235,207,442,Monday
2016,10,31,1300,229,191,420,Monday
2016,10,31,1200,292,147,439,Monday
2016,10,31,1100,268,109,377,Monday
2016,10,31,1000,198,76,274,Monday
2016,10,31,900,168,66,234,Monday
2016,10,31,800,134,47,181,Monday
2016,10,31,700,90,33,123,Monday
2016,10,31,600,30,14,44,Monday
2016,10,31,500,18,27,45,Monday
2016,10,31,400,13,18,31,Monday
2016,10,31,300,14,24,38,Monday
2016,10,31,200,19,29,48,Monday
2016,10,31,100,22,47,69,Monday
2016,10,30,2400,35,57,92,Sunday
2016,10,30,2300,50,160,210,Sunday
2016,10,30,2200,63,202,265,Sunday
2016,10,30,2100,104,243,347,Sunday
2016,10,30,2000,114,139,253,Sunday
2016,10,30,1900,137,355,492,Sunday
2016,10,30,1800,159,379,538,Sunday
2016,10,30,1700,213,544,757,Sunday
2016,10,30,1600,274,492,766,Sunday
2016,10,30,1500,292,519,811,Sunday
2016,10,30,1400,319,465,784,Sunday
2016,10,30,1300,301,314,615,Sunday
2016,10,30,1200,362,254,616,Sunday
2016,10,30,1100,297,167,464,Sunday
2016,10,30,1000,237,91,328,Sunday
2016,10,30,900,178,52,230,Sunday
2016,10,30,800,108,25,133,Sunday
2016,10,30,700,66,18,84,Sunday
2016,10,30,600,33,16,49,Sunday
2016,10,30,500,17,14,31,Sunday
2016,10,30,400,12,12,24,Sunday
2016,10,30,300,20,19,39,Sunday
2016,10,30,200,29,27,56,Sunday
2016,10,30,100,20,31,51,Sunday
2016,10,29,2400,22,53,75,Saturday
2016,10,29,2300,49,55,104,Saturday
2016,10,29,2200,58,139,197,Saturday
2016,10,29,2100,70,227,297,Saturday
2016,10,29,2000,92,416,508,Saturday
2016,10,29,1900,112,198,310,Saturday
2016,10,29,1800,180,240,420,Saturday
2016,10,29,1700,200,232,432,Saturday
2016,10,29,1600,228,244,472,Saturday
2016,10,29,1500,256,269,525,Saturday
2016,10,29,1400,296,317,613,Saturday
2016,10,29,1300,326,234,560,Saturday
2016,10,29,1200,330,192,522,Saturday
2016,10,29,1100,339,140,479,Saturday
2016,10,29,1000,254,100,354,Saturday
2016,10,29,900,190,75,265,Saturday
2016,10,29,800,146,47,193,Saturday
2016,10,29,700,83,38,121,Saturday
2016,10,29,600,27,33,60,Saturday
2016,10,29,500,19,27,46,Saturday
2016,10,29,400,30,26,56,Saturday
2016,10,29,300,14,35,49,Saturday
2016,10,29,200,27,37,64,Saturday
2016,10,29,100,44,62,106,Saturday
2016,10,28,2400,65,54,119,Friday
2016,10,28,2300,69,79,148,Friday
2016,10,28,2200,98,67,165,Friday
2016,10,28,2100,112,112,224,Friday
2016,10,28,2000,195,219,414,Friday
2016,10,28,1900,248,283,531,Friday
2016,10,28,1800,309,321,630,Friday
2016,10,28,1700,311,298,609,Friday
2016,10,28,1600,319,344,663,Friday
2016,10,28,1500,314,247,561,Friday
2016,10,28,1400,335,248,583,Friday
2016,10,28,1300,314,221,535,Friday
2016,10,28,1200,348,180,528,Friday
2016,10,28,1100,290,170,460,Friday
2016,10,28,1000,225,113,338,Friday
2016,10,28,900,204,88,292,Friday
2016,10,28,800,151,60,211,Friday
2016,10,28,700,85,51,136,Friday
2016,10,28,600,40,35,75,Friday
2016,10,28,500,39,31,70,Friday
2016,10,28,400,26,22,48,Friday
2016,10,28,300,35,38,73,Friday
2016,10,28,200,27,33,60,Friday
2016,10,28,100,44,66,110,Friday
2016,10,27,2400,68,124,192,Thursday
2016,10,27,2300,75,89,164,Thursday
2016,10,27,2200,90,93,183,Thursday
2016,10,27,2100,112,110,222,Thursday
2016,10,27,2000,145,141,286,Thursday
2016,10,27,1900,165,253,418,Thursday
2016,10,27,1800,180,268,448,Thursday
2016,10,27,1700,219,292,511,Thursday
2016,10,27,1600,238,237,475,Thursday
2016,10,27,1500,203,258,461,Thursday
2016,10,27,1400,227,192,419,Thursday
2016,10,27,1300,221,203,424,Thursday
2016,10,27,1200,255,174,429,Thursday
2016,10,27,1100,239,127,366,Thursday
2016,10,27,1000,202,95,297,Thursday
2016,10,27,900,166,76,242,Thursday
2016,10,27,800,143,40,183,Thursday
2016,10,27,700,93,37,130,Thursday
2016,10,27,600,37,24,61,Thursday
2016,10,27,500,20,35,55,Thursday
2016,10,27,400,27,24,51,Thursday
2016,10,27,300,21,30,51,Thursday
2016,10,27,200,24,58,82,Thursday
2016,10,27,100,36,40,76,Thursday
2016,10,26,2400,58,59,117,Wednesday
2016,10,26,2300,63,81,144,Wednesday
2016,10,26,2200,83,86,169,Wednesday
2016,10,26,2100,90,111,201,Wednesday
2016,10,26,2000,102,156,258,Wednesday
2016,10,26,1900,116,255,371,Wednesday
2016,10,26,1800,159,298,457,Wednesday
2016,10,26,1700,199,325,524,Wednesday
2016,10,26,1600,242,258,500,Wednesday
2016,10,26,1500,210,217,427,Wednesday
2016,10,26,1400,215,227,442,Wednesday
2016,10,26,1300,277,190,467,Wednesday
2016,10,26,1200,270,200,470,Wednesday
2016,10,26,1100,272,132,404,Wednesday
2016,10,26,1000,217,124,341,Wednesday
2016,10,26,900,185,69,254,Wednesday
2016,10,26,800,166,54,220,Wednesday
2016,10,26,700,84,40,124,Wednesday
2016,10,26,600,43,38,81,Wednesday
2016,10,26,500,23,27,50,Wednesday
2016,10,26,400,25,41,66,Wednesday
2016,10,26,300,21,35,56,Wednesday
2016,10,26,200,19,39,58,Wednesday
2016,10,26,100,32,68,100,Wednesday
2016,10,25,2400,58,63,121,Tuesday
2016,10,25,2300,58,88,146,Tuesday
2016,10,25,2200,74,99,173,Tuesday
2016,10,25,2100,93,153,246,Tuesday
2016,10,25,2000,132,203,335,Tuesday
2016,10,25,1900,137,251,388,Tuesday
2016,10,25,1800,137,290,427,Tuesday
2016,10,25,1700,199,310,509,Tuesday
2016,10,25,1600,168,310,478,Tuesday
2016,10,25,1500,233,280,513,Tuesday
2016,10,25,1400,262,278,540,Tuesday
2016,10,25,1300,276,240,516,Tuesday
2016,10,25,1200,278,225,503,Tuesday
2016,10,25,1100,277,126,403,Tuesday
2016,10,25,1000,264,117,381,Tuesday
2016,10,25,900,175,77,252,Tuesday
2016,10,25,800,136,47,183,Tuesday
2016,10,25,700,85,39,124,Tuesday
2016,10,25,600,35,31,66,Tuesday
2016,10,25,500,30,23,53,Tuesday
2016,10,25,400,19,18,37,Tuesday
2016,10,25,300,11,53,64,Tuesday
2016,10,25,200,30,37,67,Tuesday
2016,10,25,100,30,16,46,Tuesday
2016,10,24,2400,57,13,70,Monday
2016,10,24,2300,50,13,63,Monday
2016,10,24,2200,81,58,139,Monday
2016,10,24,2100,101,134,235,Monday
2016,10,24,2000,125,222,347,Monday
2016,10,24,1900,112,294,406,Monday
2016,10,24,1800,162,355,517,Monday
2016,10,24,1700,238,367,605,Monday
2016,10,24,1600,263,318,581,Monday
2016,10,24,1500,256,284,540,Monday
2016,10,24,1400,342,262,604,Monday
2016,10,24,1300,322,240,562,Monday
2016,10,24,1200,358,193,551,Monday
2016,10,24,1100,375,146,521,Monday
2016,10,24,1000,265,109,374,Monday
2016,10,24,900,197,83,280,Monday
2016,10,24,800,150,61,211,Monday
2016,10,24,700,81,35,116,Monday
2016,10,24,600,34,28,62,Monday
2016,10,24,500,29,19,48,Monday
2016,10,24,400,26,23,49,Monday
2016,10,24,300,25,27,52,Monday
2016,10,24,200,17,28,45,Monday
2016,10,24,100,32,39,71,Monday
2016,10,23,2400,30,57,87,Sunday
2016,10,23,2300,39,107,146,Sunday
2016,10,23,2200,73,147,220,Sunday
2016,10,23,2100,105,205,310,Sunday
2016,10,23,2000,131,312,443,Sunday
2016,10,23,1900,145,496,641,Sunday
2016,10,23,1800,204,614,818,Sunday
2016,10,23,1700,235,726,961,Sunday
2016,10,23,1600,295,707,1002,Sunday
2016,10,23,1500,356,652,1008,Sunday
2016,10,23,1400,438,518,956,Sunday
2016,10,23,1300,434,422,856,Sunday
2016,10,23,1200,458,330,788,Sunday
2016,10,23,1100,367,181,548,Sunday
2016,10,23,1000,263,99,362,Sunday
2016,10,23,900,182,57,239,Sunday
2016,10,23,800,99,34,133,Sunday
2016,10,23,700,59,20,79,Sunday
2016,10,23,600,23,14,37,Sunday
2016,10,23,500,19,13,32,Sunday
2016,10,23,400,7,19,26,Sunday
2016,10,23,300,19,25,44,Sunday
2016,10,23,200,18,29,47,Sunday
2016,10,23,100,17,35,52,Sunday
2016,10,22,2400,27,58,85,Saturday
2016,10,22,2300,54,54,108,Saturday
2016,10,22,2200,66,78,144,Saturday
2016,10,22,2100,77,138,215,Saturday
2016,10,22,2000,109,223,332,Saturday
2016,10,22,1900,143,387,530,Saturday
2016,10,22,1800,194,458,652,Saturday
2016,10,22,1700,233,492,725,Saturday
2016,10,22,1600,300,442,742,Saturday
2016,10,22,1500,398,419,817,Saturday
2016,10,22,1400,400,349,749,Saturday
2016,10,22,1300,476,320,796,Saturday
2016,10,22,1200,535,236,771,Saturday
2016,10,22,1100,406,196,602,Saturday
2016,10,22,1000,337,93,430,Saturday
2016,10,22,900,242,79,321,Saturday
2016,10,22,800,149,44,193,Saturday
2016,10,22,700,74,26,100,Saturday
2016,10,22,600,25,24,49,Saturday
2016,10,22,500,32,20,52,Saturday
2016,10,22,400,16,24,40,Saturday
2016,10,22,300,21,26,47,Saturday
2016,10,22,200,32,43,75,Saturday
2016,10,22,100,35,29,64,Saturday
2016,10,21,2400,56,63,119,Friday
2016,10,21,2300,61,83,144,Friday
2016,10,21,2200,111,89,200,Friday
2016,10,21,2100,169,145,314,Friday
2016,10,21,2000,263,264,527,Friday
2016,10,21,1900,324,348,672,Friday
2016,10,21,1800,387,418,805,Friday
2016,10,21,1700,400,451,851,Friday
2016,10,21,1600,437,398,835,Friday
2016,10,21,1500,436,486,922,Friday
2016,10,21,1400,416,241,657,Friday
2016,10,21,1300,427,288,715,Friday
2016,10,21,1200,450,260,710,Friday
2016,10,21,1100,477,166,643,Friday
2016,10,21,1000,319,141,460,Friday
2016,10,21,900,219,92,311,Friday
2016,10,21,800,169,69,238,Friday
2016,10,21,700,92,48,140,Friday
2016,10,21,600,43,45,88,Friday
2016,10,21,500,37,28,65,Friday
2016,10,21,400,27,36,63,Friday
2016,10,21,300,25,39,64,Friday
2016,10,21,200,35,44,79,Friday
2016,10,21,100,38,55,93,Friday
2016,10,20,2400,64,58,122,Thursday
2016,10,20,2300,65,88,153,Thursday
2016,10,20,2200,104,112,216,Thursday
2016,10,20,2100,145,152,297,Thursday
2016,10,20,2000,153,216,369,Thursday
2016,10,20,1900,210,282,492,Thursday
2016,10,20,1800,233,263,496,Thursday
2016,10,20,1700,301,391,692,Thursday
2016,10,20,1600,276,333,609,Thursday
2016,10,20,1500,319,411,730,Thursday
2016,10,20,1400,329,234,563,Thursday
2016,10,20,1300,311,275,586,Thursday
2016,10,20,1200,369,201,570,Thursday
2016,10,20,1100,325,189,514,Thursday
2016,10,20,1000,258,120,378,Thursday
2016,10,20,900,180,105,285,Thursday
2016,10,20,800,151,61,212,Thursday
2016,10,20,700,102,45,147,Thursday
2016,10,20,600,38,41,79,Thursday
2016,10,20,500,21,29,50,Thursday
2016,10,20,400,29,33,62,Thursday
2016,10,20,300,26,48,74,Thursday
2016,10,20,200,31,34,65,Thursday
2016,10,20,100,47,64,111,Thursday
2016,10,19,2400,69,71,140,Wednesday
2016,10,19,2300,61,75,136,Wednesday
2016,10,19,2200,94,102,196,Wednesday
2016,10,19,2100,108,118,226,Wednesday
2016,10,19,2000,133,219,352,Wednesday
2016,10,19,1900,149,253,402,Wednesday
2016,10,19,1800,202,326,528,Wednesday
2016,10,19,1700,192,325,517,Wednesday
2016,10,19,1600,228,325,553,Wednesday
2016,10,19,1500,270,352,622,Wednesday
2016,10,19,1400,291,183,474,Wednesday
2016,10,19,1300,310,234,544,Wednesday
2016,10,19,1200,352,221,573,Wednesday
2016,10,19,1100,354,167,521,Wednesday
2016,10,19,1000,271,128,399,Wednesday
2016,10,19,900,208,89,297,Wednesday
2016,10,19,800,153,72,225,Wednesday
2016,10,19,700,113,45,158,Wednesday
2016,10,19,600,36,32,68,Wednesday
2016,10,19,500,22,26,48,Wednesday
2016,10,19,400,24,35,59,Wednesday
2016,10,19,300,18,33,51,Wednesday
2016,10,19,200,27,39,66,Wednesday
2016,10,19,100,41,56,97,Wednesday
2016,10,18,2400,57,55,112,Tuesday
2016,10,18,2300,52,81,133,Tuesday
2016,10,18,2200,95,89,184,Tuesday
2016,10,18,2100,88,130,218,Tuesday
2016,10,18,2000,110,181,291,Tuesday
2016,10,18,1900,137,264,401,Tuesday
2016,10,18,1800,179,312,491,Tuesday
2016,10,18,1700,220,301,521,Tuesday
2016,10,18,1600,226,272,498,Tuesday
2016,10,18,1500,250,345,595,Tuesday
2016,10,18,1400,259,243,502,Tuesday
2016,10,18,1300,305,247,552,Tuesday
2016,10,18,1200,317,239,556,Tuesday
2016,10,18,1100,342,160,502,Tuesday
2016,10,18,1000,254,127,381,Tuesday
2016,10,18,900,194,85,279,Tuesday
2016,10,18,800,134,65,199,Tuesday
2016,10,18,700,100,39,139,Tuesday
2016,10,18,600,36,26,62,Tuesday
2016,10,18,500,19,28,47,Tuesday
2016,10,18,400,26,38,64,Tuesday
2016,10,18,300,12,33,45,Tuesday
2016,10,18,200,25,30,55,Tuesday
2016,10,18,100,45,60,105,Tuesday
2016,10,17,2400,47,49,96,Monday
2016,10,17,2300,57,68,125,Monday
2016,10,17,2200,91,90,181,Monday
2016,10,17,2100,111,130,241,Monday
2016,10,17,2000,137,204,341,Monday
2016,10,17,1900,147,313,460,Monday
2016,10,17,1800,196,343,539,Monday
2016,10,17,1700,250,360,610,Monday
2016,10,17,1600,290,348,638,Monday
2016,10,17,1500,281,450,731,Monday
2016,10,17,1400,324,194,518,Monday
2016,10,17,1300,373,266,639,Monday
2016,10,17,1200,399,210,609,Monday
2016,10,17,1100,412,182,594,Monday
2016,10,17,1000,273,153,426,Monday
2016,10,17,900,204,88,292,Monday
2016,10,17,800,141,65,206,Monday
2016,10,17,700,93,37,130,Monday
2016,10,17,600,46,21,67,Monday
2016,10,17,500,21,10,31,Monday
2016,10,17,400,17,26,43,Monday
2016,10,17,300,17,26,43,Monday
2016,10,17,200,17,24,41,Monday
2016,10,17,100,44,63,107,Monday
2016,10,16,2400,48,59,107,Sunday
2016,10,16,2300,64,72,136,Sunday
2016,10,16,2200,89,148,237,Sunday
2016,10,16,2100,103,233,336,Sunday
2016,10,16,2000,121,293,414,Sunday
2016,10,16,1900,158,481,639,Sunday
2016,10,16,1800,192,583,775,Sunday
2016,10,16,1700,240,702,942,Sunday
2016,10,16,1600,305,736,1041,Sunday
2016,10,16,1500,374,619,993,Sunday
2016,10,16,1400,435,567,1002,Sunday
2016,10,16,1300,464,449,913,Sunday
2016,10,16,1200,477,343,820,Sunday
2016,10,16,1100,423,208,631,Sunday
2016,10,16,1000,305,106,411,Sunday
2016,10,16,900,199,55,254,Sunday
2016,10,16,800,114,30,144,Sunday
2016,10,16,700,50,18,68,Sunday
2016,10,16,600,23,15,38,Sunday
2016,10,16,500,13,13,26,Sunday
2016,10,16,400,19,11,30,Sunday
2016,10,16,300,13,18,31,Sunday
2016,10,16,200,16,24,40,Sunday
2016,10,16,100,38,39,77,Sunday
2016,10,15,2400,25,31,56,Saturday
2016,10,15,2300,41,73,114,Saturday
2016,10,15,2200,54,83,137,Saturday
2016,10,15,2100,82,115,197,Saturday
2016,10,15,2000,111,223,334,Saturday
2016,10,15,1900,147,380,527,Saturday
2016,10,15,1800,162,520,682,Saturday
2016,10,15,1700,246,509,755,Saturday
2016,10,15,1600,289,497,786,Saturday
2016,10,15,1500,387,539,926,Saturday
2016,10,15,1400,404,249,653,Saturday
2016,10,15,1300,463,302,765,Saturday
2016,10,15,1200,505,243,748,Saturday
2016,10,15,1100,486,191,677,Saturday
2016,10,15,1000,394,127,521,Saturday
2016,10,15,900,253,89,342,Saturday
2016,10,15,800,123,51,174,Saturday
2016,10,15,700,102,40,142,Saturday
2016,10,15,600,29,30,59,Saturday
2016,10,15,500,27,25,52,Saturday
2016,10,15,400,20,25,45,Saturday
2016,10,15,300,19,26,45,Saturday
2016,10,15,200,25,45,70,Saturday
2016,10,15,100,48,40,88,Saturday
2016,10,14,2400,56,52,108,Friday
2016,10,14,2300,68,72,140,Friday
2016,10,14,2200,95,97,192,Friday
2016,10,14,2100,138,131,269,Friday
2016,10,14,2000,230,190,420,Friday
2016,10,14,1900,303,271,574,Friday
2016,10,14,1800,352,409,761,Friday
2016,10,14,1700,373,476,849,Friday
2016,10,14,1600,437,537,974,Friday
2016,10,14,1500,390,610,1000,Friday
2016,10,14,1400,433,419,852,Friday
2016,10,14,1300,385,193,578,Friday
2016,10,14,1200,408,173,581,Friday
2016,10,14,1100,370,138,508,Friday
2016,10,14,1000,343,118,461,Friday
2016,10,14,900,238,86,324,Friday
2016,10,14,800,130,46,176,Friday
2016,10,14,700,115,38,153,Friday
2016,10,14,600,43,19,62,Friday
2016,10,14,500,23,29,52,Friday
2016,10,14,400,20,33,53,Friday
2016,10,14,300,31,34,65,Friday
2016,10,14,200,31,54,85,Friday
2016,10,14,100,50,60,110,Friday
2016,10,13,2400,57,91,148,Thursday
2016,10,13,2300,56,99,155,Thursday
2016,10,13,2200,108,109,217,Thursday
2016,10,13,2100,151,160,311,Thursday
2016,10,13,2000,161,237,398,Thursday
2016,10,13,1900,207,307,514,Thursday
2016,10,13,1800,238,491,729,Thursday
2016,10,13,1700,262,459,721,Thursday
2016,10,13,1600,304,417,721,Thursday
2016,10,13,1500,362,517,879,Thursday
2016,10,13,1400,353,234,587,Thursday
2016,10,13,1300,358,341,699,Thursday
2016,10,13,1200,469,246,715,Thursday
2016,10,13,1100,430,214,644,Thursday
2016,10,13,1000,336,169,505,Thursday
2016,10,13,900,259,128,387,Thursday
2016,10,13,800,160,65,225,Thursday
2016,10,13,700,116,36,152,Thursday
2016,10,13,600,44,40,84,Thursday
2016,10,13,500,29,40,69,Thursday
2016,10,13,400,21,34,55,Thursday
2016,10,13,300,33,38,71,Thursday
2016,10,13,200,42,46,88,Thursday
2016,10,13,100,48,46,94,Thursday
2016,10,12,2400,64,61,125,Wednesday
2016,10,12,2300,69,105,174,Wednesday
2016,10,12,2200,87,138,225,Wednesday
2016,10,12,2100,116,172,288,Wednesday
2016,10,12,2000,148,273,421,Wednesday
2016,10,12,1900,154,560,714,Wednesday
2016,10,12,1800,197,541,738,Wednesday
2016,10,12,1700,228,548,776,Wednesday
2016,10,12,1600,319,433,752,Wednesday
2016,10,12,1500,293,504,797,Wednesday
2016,10,12,1400,317,223,540,Wednesday
2016,10,12,1300,392,339,731,Wednesday
2016,10,12,1200,432,349,781,Wednesday
2016,10,12,1100,453,337,790,Wednesday
2016,10,12,1000,323,233,556,Wednesday
2016,10,12,900,286,132,418,Wednesday
2016,10,12,800,162,55,217,Wednesday
2016,10,12,700,119,18,137,Wednesday
2016,10,12,600,47,12,59,Wednesday
2016,10,12,500,18,27,45,Wednesday
2016,10,12,400,23,136,159,Wednesday
2016,10,12,300,23,90,113,Wednesday
2016,10,12,200,44,48,92,Wednesday
2016,10,12,100,31,41,72,Wednesday
2016,10,11,2400,49,75,124,Tuesday
2016,10,11,2300,52,75,127,Tuesday
2016,10,11,2200,86,49,135,Tuesday
2016,10,11,2100,109,103,212,Tuesday
2016,10,11,2000,136,248,384,Tuesday
2016,10,11,1900,171,311,482,Tuesday
2016,10,11,1800,232,364,596,Tuesday
2016,10,11,1700,257,653,910,Tuesday
2016,10,11,1600,327,643,970,Tuesday
2016,10,11,1500,345,488,833,Tuesday
2016,10,11,1400,450,421,871,Tuesday
2016,10,11,1300,536,326,862,Tuesday
2016,10,11,1200,649,278,927,Tuesday
2016,10,11,1100,640,199,839,Tuesday
2016,10,11,1000,464,152,616,Tuesday
2016,10,11,900,319,118,437,Tuesday
2016,10,11,800,205,60,265,Tuesday
2016,10,11,700,122,44,166,Tuesday
2016,10,11,600,43,28,71,Tuesday
2016,10,11,500,15,26,41,Tuesday
2016,10,11,400,15,31,46,Tuesday
2016,10,11,300,29,31,60,Tuesday
2016,10,11,200,46,36,82,Tuesday
2016,10,11,100,22,55,77,Tuesday
2016,10,10,2400,17,90,107,Monday
2016,10,10,2300,27,136,163,Monday
2016,10,10,2200,40,242,282,Monday
2016,10,10,2100,82,398,480,Monday
2016,10,10,2000,116,755,871,Monday
2016,10,10,1900,151,1078,1229,Monday
2016,10,10,1800,235,1258,1493,Monday
2016,10,10,1700,289,1622,1911,Monday
2016,10,10,1600,385,1643,2028,Monday
2016,10,10,1500,532,1438,1970,Monday
2016,10,10,1400,614,1304,1918,Monday
2016,10,10,1300,724,1074,1798,Monday
2016,10,10,1200,766,763,1529,Monday
2016,10,10,1100,643,353,996,Monday
2016,10,10,1000,427,182,609,Monday
2016,10,10,900,355,79,434,Monday
2016,10,10,800,127,32,159,Monday
2016,10,10,700,58,23,81,Monday
2016,10,10,600,35,15,50,Monday
2016,10,10,500,13,11,24,Monday
2016,10,10,400,14,18,32,Monday
2016,10,10,300,14,17,31,Monday
2016,10,10,200,19,33,52,Monday
2016,10,10,100,18,55,73,Monday
2016,10,9,2400,24,64,88,Sunday
2016,10,9,2300,43,92,135,Sunday
2016,10,9,2200,59,144,203,Sunday
2016,10,9,2100,87,222,309,Sunday
2016,10,9,2000,107,341,448,Sunday
2016,10,9,1900,137,591,728,Sunday
2016,10,9,1800,139,661,800,Sunday
2016,10,9,1700,245,723,968,Sunday
2016,10,9,1600,332,709,1041,Sunday
2016,10,9,1500,389,587,976,Sunday
2016,10,9,1400,454,486,940,Sunday
2016,10,9,1300,515,397,912,Sunday
2016,10,9,1200,609,311,920,Sunday
2016,10,9,1100,565,177,742,Sunday
2016,10,9,1000,380,141,521,Sunday
2016,10,9,900,225,72,297,Sunday
2016,10,9,800,97,39,136,Sunday
2016,10,9,700,40,21,61,Sunday
2016,10,9,600,13,25,38,Sunday
2016,10,9,500,14,24,38,Sunday
2016,10,9,400,16,13,29,Sunday
2016,10,9,300,14,17,31,Sunday
2016,10,9,200,19,21,40,Sunday
2016,10,9,100,28,43,71,Sunday
2016,10,8,2400,37,63,100,Saturday
2016,10,8,2300,41,86,127,Saturday
2016,10,8,2200,72,106,178,Saturday
2016,10,8,2100,85,149,234,Saturday
2016,10,8,2000,128,253,381,Saturday
2016,10,8,1900,169,380,549,Saturday
2016,10,8,1800,244,529,773,Saturday
2016,10,8,1700,322,659,981,Saturday
2016,10,8,1600,457,664,1121,Saturday
2016,10,8,1500,589,615,1204,Saturday
2016,10,8,1400,713,450,1163,Saturday
2016,10,8,1300,856,406,1262,Saturday
2016,10,8,1200,930,338,1268,Saturday
2016,10,8,1100,841,211,1052,Saturday
2016,10,8,1000,642,167,809,Saturday
2016,10,8,900,422,94,516,Saturday
2016,10,8,800,221,67,288,Saturday
2016,10,8,700,112,37,149,Saturday
2016,10,8,600,54,33,87,Saturday
2016,10,8,500,30,26,56,Saturday
2016,10,8,400,27,32,59,Saturday
2016,10,8,300,21,47,68,Saturday
2016,10,8,200,42,61,103,Saturday
2016,10,8,100,51,81,132,Saturday
2016,10,7,2400,105,128,233,Friday
2016,10,7,2300,139,114,253,Friday
2016,10,7,2200,201,188,389,Friday
2016,10,7,2100,337,230,567,Friday
2016,10,7,2000,612,329,941,Friday
2016,10,7,1900,840,490,1330,Friday
2016,10,7,1800,883,571,1454,Friday
2016,10,7,1700,919,667,1586,Friday
2016,10,7,1600,922,656,1578,Friday
2016,10,7,1500,889,570,1459,Friday
2016,10,7,1400,828,522,1350,Friday
2016,10,7,1300,785,533,1318,Friday
2016,10,7,1200,880,328,1208,Friday
2016,10,7,1100,909,294,1203,Friday
2016,10,7,1000,712,218,930,Friday
2016,10,7,900,487,147,634,Friday
2016,10,7,800,323,90,413,Friday
2016,10,7,700,169,49,218,Friday
2016,10,7,600,70,34,104,Friday
2016,10,7,500,39,45,84,Friday
2016,10,7,400,39,46,85,Friday
2016,10,7,300,30,61,91,Friday
2016,10,7,200,38,74,112,Friday
2016,10,7,100,68,82,150,Friday
2016,10,6,2400,72,88,160,Thursday
2016,10,6,2300,115,110,225,Thursday
2016,10,6,2200,186,139,325,Thursday
2016,10,6,2100,330,263,593,Thursday
2016,10,6,2000,376,400,776,Thursday
2016,10,6,1900,458,639,1097,Thursday
2016,10,6,1800,513,775,1288,Thursday
2016,10,6,1700,476,688,1164,Thursday
2016,10,6,1600,468,458,926,Thursday
2016,10,6,1500,484,343,827,Thursday
2016,10,6,1400,496,280,776,Thursday
2016,10,6,1300,534,361,895,Thursday
2016,10,6,1200,648,265,913,Thursday
2016,10,6,1100,755,244,999,Thursday
2016,10,6,1000,435,149,584,Thursday
2016,10,6,900,327,101,428,Thursday
2016,10,6,800,201,70,271,Thursday
2016,10,6,700,154,35,189,Thursday
2016,10,6,600,60,52,112,Thursday
2016,10,6,500,32,37,69,Thursday
2016,10,6,400,31,38,69,Thursday
2016,10,6,300,29,50,79,Thursday
2016,10,6,200,34,66,100,Thursday
2016,10,6,100,34,56,90,Thursday
2016,10,5,2400,81,74,155,Wednesday
2016,10,5,2300,73,87,160,Wednesday
2016,10,5,2200,123,118,241,Wednesday
2016,10,5,2100,139,207,346,Wednesday
2016,10,5,2000,163,334,497,Wednesday
2016,10,5,1900,218,482,700,Wednesday
2016,10,5,1800,237,505,742,Wednesday
2016,10,5,1700,280,554,834,Wednesday
2016,10,5,1600,346,431,777,Wednesday
2016,10,5,1500,362,398,760,Wednesday
2016,10,5,1400,395,275,670,Wednesday
2016,10,5,1300,423,297,720,Wednesday
2016,10,5,1200,478,260,738,Wednesday
2016,10,5,1100,513,193,706,Wednesday
2016,10,5,1000,424,147,571,Wednesday
2016,10,5,900,305,119,424,Wednesday
2016,10,5,800,205,77,282,Wednesday
2016,10,5,700,117,55,172,Wednesday
2016,10,5,600,52,30,82,Wednesday
2016,10,5,500,28,32,60,Wednesday
2016,10,5,400,24,38,62,Wednesday
2016,10,5,300,24,36,60,Wednesday
2016,10,5,200,33,48,81,Wednesday
2016,10,5,100,48,58,106,Wednesday
2016,10,4,2400,57,64,121,Tuesday
2016,10,4,2300,100,97,197,Tuesday
2016,10,4,2200,110,123,233,Tuesday
2016,10,4,2100,111,204,315,Tuesday
2016,10,4,2000,171,343,514,Tuesday
2016,10,4,1900,164,500,664,Tuesday
2016,10,4,1800,214,544,758,Tuesday
2016,10,4,1700,284,546,830,Tuesday
2016,10,4,1600,315,471,786,Tuesday
2016,10,4,1500,346,375,721,Tuesday
2016,10,4,1400,368,371,739,Tuesday
2016,10,4,1300,406,296,702,Tuesday
2016,10,4,1200,426,225,651,Tuesday
2016,10,4,1100,507,194,701,Tuesday
2016,10,4,1000,460,157,617,Tuesday
2016,10,4,900,299,116,415,Tuesday
2016,10,4,800,194,91,285,Tuesday
2016,10,4,700,127,50,177,Tuesday
2016,10,4,600,58,51,109,Tuesday
2016,10,4,500,29,30,59,Tuesday
2016,10,4,400,28,38,66,Tuesday
2016,10,4,300,21,34,55,Tuesday
2016,10,4,200,37,51,88,Tuesday
2016,10,4,100,39,53,92,Tuesday
2016,10,3,2400,60,75,135,Monday
2016,10,3,2300,69,99,168,Monday
2016,10,3,2200,90,140,230,Monday
2016,10,3,2100,118,270,388,Monday
2016,10,3,2000,172,418,590,Monday
2016,10,3,1900,201,582,783,Monday
2016,10,3,1800,231,817,1048,Monday
2016,10,3,1700,309,621,930,Monday
2016,10,3,1600,347,558,905,Monday
2016,10,3,1500,364,458,822,Monday
2016,10,3,1400,444,365,809,Monday
2016,10,3,1300,469,306,775,Monday
2016,10,3,1200,615,268,883,Monday
2016,10,3,1100,614,236,850,Monday
2016,10,3,1000,566,147,713,Monday
2016,10,3,900,386,117,503,Monday
2016,10,3,800,213,80,293,Monday
2016,10,3,700,142,46,188,Monday
2016,10,3,600,47,26,73,Monday
2016,10,3,500,25,28,53,Monday
2016,10,3,400,15,30,45,Monday
2016,10,3,300,27,78,105,Monday
2016,10,3,200,23,94,117,Monday
2016,10,3,100,44,19,63,Monday
2016,10,2,2400,29,23,52,Sunday
2016,10,2,2300,69,96,165,Sunday
2016,10,2,2200,121,242,363,Sunday
2016,10,2,2100,134,358,492,Sunday
2016,10,2,2000,132,669,801,Sunday
2016,10,2,1900,185,934,1119,Sunday
2016,10,2,1800,272,1090,1362,Sunday
2016,10,2,1700,360,1191,1551,Sunday
2016,10,2,1600,423,1070,1493,Sunday
2016,10,2,1500,525,841,1366,Sunday
2016,10,2,1400,602,696,1298,Sunday
2016,10,2,1300,588,501,1089,Sunday
2016,10,2,1200,698,366,1064,Sunday
2016,10,2,1100,720,237,957,Sunday
2016,10,2,1000,657,146,803,Sunday
2016,10,2,900,473,72,545,Sunday
2016,10,2,800,191,43,234,Sunday
2016,10,2,700,116,16,132,Sunday
2016,10,2,600,30,14,44,Sunday
2016,10,2,500,22,24,46,Sunday
2016,10,2,400,24,16,40,Sunday
2016,10,2,300,18,29,47,Sunday
2016,10,2,200,21,36,57,Sunday
2016,10,2,100,39,47,86,Sunday
2016,10,1,2400,35,78,113,Saturday
2016,10,1,2300,46,91,137,Saturday
2016,10,1,2200,87,113,200,Saturday
2016,10,1,2100,95,198,293,Saturday
2016,10,1,2000,122,312,434,Saturday
2016,10,1,1900,179,447,626,Saturday
2016,10,1,1800,233,732,965,Saturday
2016,10,1,1700,307,598,905,Saturday
2016,10,1,1600,363,542,905,Saturday
2016,10,1,1500,415,426,841,Saturday
2016,10,1,1400,449,399,848,Saturday
2016,10,1,1300,522,345,867,Saturday
2016,10,1,1200,633,338,971,Saturday
2016,10,1,1100,639,271,910,Saturday
2016,10,1,1000,474,176,650,Saturday
2016,10,1,900,363,112,475,Saturday
2016,10,1,800,210,72,282,Saturday
2016,10,1,700,117,36,153,Saturday
2016,10,1,600,48,36,84,Saturday
2016,10,1,500,22,32,54,Saturday
2016,10,1,400,28,35,63,Saturday
2016,10,1,300,11,27,38,Saturday
2016,10,1,200,33,50,83,Saturday
2016,10,1,100,62,62,124,Saturday
2016,9,30,2400,69,71,140,Friday
2016,9,30,2300,86,117,203,Friday
2016,9,30,2200,146,140,286,Friday
2016,9,30,2100,245,270,515,Friday
2016,9,30,2000,412,419,831,Friday
2016,9,30,1900,475,596,1071,Friday
2016,9,30,1800,516,741,1257,Friday
2016,9,30,1700,550,722,1272,Friday
2016,9,30,1600,598,721,1319,Friday
2016,9,30,1500,607,560,1167,Friday
2016,9,30,1400,564,410,974,Friday
2016,9,30,1300,592,387,979,Friday
2016,9,30,1200,666,371,1037,Friday
2016,9,30,1100,666,274,940,Friday
2016,9,30,1000,610,203,813,Friday
2016,9,30,900,504,123,627,Friday
2016,9,30,800,255,89,344,Friday
2016,9,30,700,190,45,235,Friday
2016,9,30,600,51,39,90,Friday
2016,9,30,500,27,40,67,Friday
2016,9,30,400,33,54,87,Friday
2016,9,30,300,33,40,73,Friday
2016,9,30,200,36,55,91,Friday
2016,9,30,100,45,52,97,Friday
2016,9,29,2400,75,114,189,Thursday
2016,9,29,2300,104,122,226,Thursday
2016,9,29,2200,131,171,302,Thursday
2016,9,29,2100,163,299,462,Thursday
2016,9,29,2000,231,527,758,Thursday
2016,9,29,1900,262,863,1125,Thursday
2016,9,29,1800,314,813,1127,Thursday
2016,9,29,1700,349,513,862,Thursday
2016,9,29,1600,347,397,744,Thursday
2016,9,29,1500,441,341,782,Thursday
2016,9,29,1400,436,300,736,Thursday
2016,9,29,1300,516,366,882,Thursday
2016,9,29,1200,632,209,841,Thursday
2016,9,29,1100,696,237,933,Thursday
2016,9,29,1000,596,184,780,Thursday
2016,9,29,900,451,122,573,Thursday
2016,9,29,800,264,88,352,Thursday
2016,9,29,700,137,47,184,Thursday
2016,9,29,600,41,36,77,Thursday
2016,9,29,500,33,40,73,Thursday
2016,9,29,400,32,39,71,Thursday
2016,9,29,300,31,41,72,Thursday
2016,9,29,200,42,48,90,Thursday
2016,9,29,100,60,62,122,Thursday
2016,9,28,2400,72,73,145,Wednesday
2016,9,28,2300,73,87,160,Wednesday
2016,9,28,2200,106,170,276,Wednesday
2016,9,28,2100,143,260,403,Wednesday
2016,9,28,2000,161,363,524,Wednesday
2016,9,28,1900,206,522,728,Wednesday
2016,9,28,1800,243,635,878,Wednesday
2016,9,28,1700,325,587,912,Wednesday
2016,9,28,1600,351,576,927,Wednesday
2016,9,28,1500,357,461,818,Wednesday
2016,9,28,1400,426,374,800,Wednesday
2016,9,28,1300,431,339,770,Wednesday
2016,9,28,1200,582,276,858,Wednesday
2016,9,28,1100,610,284,894,Wednesday
2016,9,28,1000,523,177,700,Wednesday
2016,9,28,900,462,133,595,Wednesday
2016,9,28,800,221,89,310,Wednesday
2016,9,28,700,141,53,194,Wednesday
2016,9,28,600,58,48,106,Wednesday
2016,9,28,500,27,23,50,Wednesday
2016,9,28,400,37,52,89,Wednesday
2016,9,28,300,21,36,57,Wednesday
2016,9,28,200,24,54,78,Wednesday
2016,9,28,100,54,57,111,Wednesday
2016,9,27,2400,68,80,148,Tuesday
2016,9,27,2300,87,105,192,Tuesday
2016,9,27,2200,119,138,257,Tuesday
2016,9,27,2100,123,254,377,Tuesday
2016,9,27,2000,156,426,582,Tuesday
2016,9,27,1900,172,516,688,Tuesday
2016,9,27,1800,226,689,915,Tuesday
2016,9,27,1700,256,655,911,Tuesday
2016,9,27,1600,312,528,840,Tuesday
2016,9,27,1500,387,597,984,Tuesday
2016,9,27,1400,413,386,799,Tuesday
2016,9,27,1300,459,384,843,Tuesday
2016,9,27,1200,609,246,855,Tuesday
2016,9,27,1100,641,191,832,Tuesday
2016,9,27,1000,584,199,783,Tuesday
2016,9,27,900,389,163,552,Tuesday
2016,9,27,800,232,83,315,Tuesday
2016,9,27,700,127,54,181,Tuesday
2016,9,27,600,49,40,89,Tuesday
2016,9,27,500,20,40,60,Tuesday
2016,9,27,400,22,37,59,Tuesday
2016,9,27,300,27,40,67,Tuesday
2016,9,27,200,29,43,72,Tuesday
2016,9,27,100,40,77,117,Tuesday
2016,9,26,2400,54,85,139,Monday
2016,9,26,2300,83,111,194,Monday
2016,9,26,2200,100,194,294,Monday
2016,9,26,2100,144,356,500,Monday
2016,9,26,2000,163,558,721,Monday
2016,9,26,1900,202,795,997,Monday
2016,9,26,1800,238,897,1135,Monday
2016,9,26,1700,307,764,1071,Monday
2016,9,26,1600,405,700,1105,Monday
2016,9,26,1500,395,601,996,Monday
2016,9,26,1400,512,482,994,Monday
2016,9,26,1300,509,438,947,Monday
2016,9,26,1200,763,321,1084,Monday
2016,9,26,1100,792,268,1060,Monday
2016,9,26,1000,684,161,845,Monday
2016,9,26,900,479,136,615,Monday
2016,9,26,800,282,65,347,Monday
2016,9,26,700,162,54,216,Monday
2016,9,26,600,41,33,74,Monday
2016,9,26,500,25,16,41,Monday
2016,9,26,400,16,21,37,Monday
2016,9,26,300,20,28,48,Monday
2016,9,26,200,23,54,77,Monday
2016,9,26,100,32,76,108,Monday
2016,9,25,2400,29,106,135,Sunday
2016,9,25,2300,70,153,223,Sunday
2016,9,25,2200,124,287,411,Sunday
2016,9,25,2100,113,541,654,Sunday
2016,9,25,2000,186,834,1020,Sunday
2016,9,25,1900,229,1118,1347,Sunday
2016,9,25,1800,307,1512,1819,Sunday
2016,9,25,1700,402,1498,1900,Sunday
2016,9,25,1600,514,1412,1926,Sunday
2016,9,25,1500,533,1107,1640,Sunday
2016,9,25,1400,562,925,1487,Sunday
2016,9,25,1300,711,792,1503,Sunday
2016,9,25,1200,826,503,1329,Sunday
2016,9,25,1100,885,364,1249,Sunday
2016,9,25,1000,832,205,1037,Sunday
2016,9,25,900,589,93,682,Sunday
2016,9,25,800,284,46,330,Sunday
2016,9,25,700,122,39,161,Sunday
2016,9,25,600,46,16,62,Sunday
2016,9,25,500,18,18,36,Sunday
2016,9,25,400,16,15,31,Sunday
2016,9,25,300,19,21,40,Sunday
2016,9,25,200,21,45,66,Sunday
2016,9,25,100,26,47,73,Sunday
2016,9,24,2400,46,77,123,Saturday
2016,9,24,2300,75,107,182,Saturday
2016,9,24,2200,103,190,293,Saturday
2016,9,24,2100,115,325,440,Saturday
2016,9,24,2000,114,567,681,Saturday
2016,9,24,1900,200,790,990,Saturday
2016,9,24,1800,268,1031,1299,Saturday
2016,9,24,1700,380,868,1248,Saturday
2016,9,24,1600,425,804,1229,Saturday
2016,9,24,1500,434,666,1100,Saturday
2016,9,24,1400,557,557,1114,Saturday
2016,9,24,1300,683,405,1088,Saturday
2016,9,24,1200,900,376,1276,Saturday
2016,9,24,1100,891,265,1156,Saturday
2016,9,24,1000,915,214,1129,Saturday
2016,9,24,900,665,119,784,Saturday
2016,9,24,800,365,55,420,Saturday
2016,9,24,700,168,39,207,Saturday
2016,9,24,600,53,38,91,Saturday
2016,9,24,500,30,28,58,Saturday
2016,9,24,400,20,39,59,Saturday
2016,9,24,300,33,28,61,Saturday
2016,9,24,200,40,39,79,Saturday
2016,9,24,100,54,58,112,Saturday
2016,9,23,2400,62,83,145,Friday
2016,9,23,2300,92,98,190,Friday
2016,9,23,2200,201,167,368,Friday
2016,9,23,2100,313,291,604,Friday
2016,9,23,2000,527,412,939,Friday
2016,9,23,1900,569,653,1222,Friday
2016,9,23,1800,559,787,1346,Friday
2016,9,23,1700,623,782,1405,Friday
2016,9,23,1600,615,770,1385,Friday
2016,9,23,1500,674,624,1298,Friday
2016,9,23,1400,758,491,1249,Friday
2016,9,23,1300,691,499,1190,Friday
2016,9,23,1200,810,411,1221,Friday
2016,9,23,1100,868,285,1153,Friday
2016,9,23,1000,792,192,984,Friday
2016,9,23,900,572,144,716,Friday
2016,9,23,800,324,93,417,Friday
2016,9,23,700,140,47,187,Friday
2016,9,23,600,55,40,95,Friday
2016,9,23,500,36,38,74,Friday
2016,9,23,400,34,32,66,Friday
2016,9,23,300,31,55,86,Friday
2016,9,23,200,35,55,90,Friday
2016,9,23,100,41,65,106,Friday
2016,9,22,2400,69,88,157,Thursday
2016,9,22,2300,101,109,210,Thursday
2016,9,22,2200,141,183,324,Thursday
2016,9,22,2100,230,283,513,Thursday
2016,9,22,2000,267,404,671,Thursday
2016,9,22,1900,296,493,789,Thursday
2016,9,22,1800,370,650,1020,Thursday
2016,9,22,1700,383,637,1020,Thursday
2016,9,22,1600,412,564,976,Thursday
2016,9,22,1500,460,603,1063,Thursday
2016,9,22,1400,454,484,938,Thursday
2016,9,22,1300,500,416,916,Thursday
2016,9,22,1200,678,326,1004,Thursday
2016,9,22,1100,704,253,957,Thursday
2016,9,22,1000,621,174,795,Thursday
2016,9,22,900,449,135,584,Thursday
2016,9,22,800,278,89,367,Thursday
2016,9,22,700,130,44,174,Thursday
2016,9,22,600,58,32,90,Thursday
2016,9,22,500,37,26,63,Thursday
2016,9,22,400,26,40,66,Thursday
2016,9,22,300,26,48,74,Thursday
2016,9,22,200,28,49,77,Thursday
2016,9,22,100,53,66,119,Thursday
2016,9,21,2400,56,73,129,Wednesday
2016,9,21,2300,80,87,167,Wednesday
2016,9,21,2200,123,184,307,Wednesday
2016,9,21,2100,138,299,437,Wednesday
2016,9,21,2000,171,466,637,Wednesday
2016,9,21,1900,212,493,705,Wednesday
2016,9,21,1800,252,678,930,Wednesday
2016,9,21,1700,317,684,1001,Wednesday
2016,9,21,1600,353,606,959,Wednesday
2016,9,21,1500,387,517,904,Wednesday
2016,9,21,1400,450,396,846,Wednesday
2016,9,21,1300,481,338,819,Wednesday
2016,9,21,1200,665,289,954,Wednesday
2016,9,21,1100,719,205,924,Wednesday
2016,9,21,1000,606,209,815,Wednesday
2016,9,21,900,424,142,566,Wednesday
2016,9,21,800,266,84,350,Wednesday
2016,9,21,700,125,57,182,Wednesday
2016,9,21,600,49,41,90,Wednesday
2016,9,21,500,21,26,47,Wednesday
2016,9,21,400,20,27,47,Wednesday
2016,9,21,300,32,45,77,Wednesday
2016,9,21,200,38,40,78,Wednesday
2016,9,21,100,47,69,116,Wednesday
2016,9,20,2400,70,165,235,Tuesday
2016,9,20,2300,70,114,184,Tuesday
2016,9,20,2200,117,77,194,Tuesday
2016,9,20,2100,128,196,324,Tuesday
2016,9,20,2000,188,393,581,Tuesday
2016,9,20,1900,179,532,711,Tuesday
2016,9,20,1800,234,656,890,Tuesday
2016,9,20,1700,307,727,1034,Tuesday
2016,9,20,1600,319,442,761,Tuesday
2016,9,20,1500,381,333,714,Tuesday
2016,9,20,1400,414,326,740,Tuesday
2016,9,20,1300,450,410,860,Tuesday
2016,9,20,1200,562,416,978,Tuesday
2016,9,20,1100,605,359,964,Tuesday
2016,9,20,1000,549,186,735,Tuesday
2016,9,20,900,375,115,490,Tuesday
2016,9,20,800,218,112,330,Tuesday
2016,9,20,700,138,49,187,Tuesday
2016,9,20,600,47,35,82,Tuesday
2016,9,20,500,24,28,52,Tuesday
2016,9,20,400,28,45,73,Tuesday
2016,9,20,300,21,37,58,Tuesday
2016,9,20,200,30,66,96,Tuesday
2016,9,20,100,44,63,107,Tuesday
2016,9,19,2400,61,88,149,Monday
2016,9,19,2300,87,109,196,Monday
2016,9,19,2200,89,219,308,Monday
2016,9,19,2100,132,487,619,Monday
2016,9,19,2000,164,452,616,Monday
2016,9,19,1900,184,698,882,Monday
2016,9,19,1800,256,906,1162,Monday
2016,9,19,1700,357,877,1234,Monday
2016,9,19,1600,384,756,1140,Monday
2016,9,19,1500,454,712,1166,Monday
2016,9,19,1400,530,533,1063,Monday
2016,9,19,1300,591,465,1056,Monday
2016,9,19,1200,755,380,1135,Monday
2016,9,19,1100,893,280,1173,Monday
2016,9,19,1000,754,203,957,Monday
2016,9,19,900,587,137,724,Monday
2016,9,19,800,279,90,369,Monday
2016,9,19,700,135,34,169,Monday
2016,9,19,600,55,28,83,Monday
2016,9,19,500,27,27,54,Monday
2016,9,19,400,20,27,47,Monday
2016,9,19,300,19,36,55,Monday
2016,9,19,200,25,54,79,Monday
2016,9,19,100,37,72,109,Monday
2016,9,18,2400,40,115,155,Sunday
2016,9,18,2300,65,214,279,Sunday
2016,9,18,2200,87,235,322,Sunday
2016,9,18,2100,140,519,659,Sunday
2016,9,18,2000,174,880,1054,Sunday
2016,9,18,1900,224,1223,1447,Sunday
2016,9,18,1800,297,1370,1667,Sunday
2016,9,18,1700,404,1433,1837,Sunday
2016,9,18,1600,454,1527,1981,Sunday
2016,9,18,1500,612,1242,1854,Sunday
2016,9,18,1400,746,1076,1822,Sunday
2016,9,18,1300,605,1025,1630,Sunday
2016,9,18,1200,869,785,1654,Sunday
2016,9,18,1100,977,543,1520,Sunday
2016,9,18,1000,890,309,1199,Sunday
2016,9,18,900,630,148,778,Sunday
2016,9,18,800,318,54,372,Sunday
2016,9,18,700,127,26,153,Sunday
2016,9,18,600,51,23,74,Sunday
2016,9,18,500,19,17,36,Sunday
2016,9,18,400,15,33,48,Sunday
2016,9,18,300,19,31,50,Sunday
2016,9,18,200,25,18,43,Sunday
2016,9,18,100,27,32,59,Sunday
2016,9,17,2400,34,70,104,Saturday
2016,9,17,2300,71,125,196,Saturday
2016,9,17,2200,95,205,300,Saturday
2016,9,17,2100,110,369,479,Saturday
2016,9,17,2000,161,530,691,Saturday
2016,9,17,1900,188,872,1060,Saturday
2016,9,17,1800,266,1168,1434,Saturday
2016,9,17,1700,330,1259,1589,Saturday
2016,9,17,1600,398,1045,1443,Saturday
2016,9,17,1500,553,785,1338,Saturday
2016,9,17,1400,684,601,1285,Saturday
2016,9,17,1300,770,499,1269,Saturday
2016,9,17,1200,959,428,1387,Saturday
2016,9,17,1100,1030,321,1351,Saturday
2016,9,17,1000,1306,244,1550,Saturday
2016,9,17,900,584,150,734,Saturday
2016,9,17,800,424,80,504,Saturday
2016,9,17,700,182,46,228,Saturday
2016,9,17,600,66,37,103,Saturday
2016,9,17,500,34,26,60,Saturday
2016,9,17,400,27,28,55,Saturday
2016,9,17,300,28,24,52,Saturday
2016,9,17,200,45,44,89,Saturday
2016,9,17,100,56,64,120,Saturday
2016,9,16,2400,64,95,159,Friday
2016,9,16,2300,114,115,229,Friday
2016,9,16,2200,212,217,429,Friday
2016,9,16,2100,387,380,767,Friday
2016,9,16,2000,512,612,1124,Friday
2016,9,16,1900,626,813,1439,Friday
2016,9,16,1800,762,922,1684,Friday
2016,9,16,1700,921,877,1798,Friday
2016,9,16,1600,728,750,1478,Friday
2016,9,16,1500,629,654,1283,Friday
2016,9,16,1400,790,521,1311,Friday
2016,9,16,1300,870,502,1372,Friday
2016,9,16,1200,1011,433,1444,Friday
2016,9,16,1100,1059,295,1354,Friday
2016,9,16,1000,918,223,1141,Friday
2016,9,16,900,695,138,833,Friday
2016,9,16,800,385,80,465,Friday
2016,9,16,700,173,66,239,Friday
2016,9,16,600,83,33,116,Friday
2016,9,16,500,37,38,75,Friday
2016,9,16,400,38,53,91,Friday
2016,9,16,300,21,46,67,Friday
2016,9,16,200,39,63,102,Friday
2016,9,16,100,70,78,148,Friday
2016,9,15,2400,81,87,168,Thursday
2016,9,15,2300,120,136,256,Thursday
2016,9,15,2200,148,220,368,Thursday
2016,9,15,2100,249,350,599,Thursday
2016,9,15,2000,307,565,872,Thursday
2016,9,15,1900,374,699,1073,Thursday
2016,9,15,1800,420,876,1296,Thursday
2016,9,15,1700,458,785,1243,Thursday
2016,9,15,1600,520,716,1236,Thursday
2016,9,15,1500,616,595,1211,Thursday
2016,9,15,1400,608,468,1076,Thursday
2016,9,15,1300,663,440,1103,Thursday
2016,9,15,1200,835,348,1183,Thursday
2016,9,15,1100,945,327,1272,Thursday
2016,9,15,1000,738,203,941,Thursday
2016,9,15,900,593,160,753,Thursday
2016,9,15,800,335,86,421,Thursday
2016,9,15,700,170,60,230,Thursday
2016,9,15,600,69,38,107,Thursday
2016,9,15,500,33,43,76,Thursday
2016,9,15,400,31,33,64,Thursday
2016,9,15,300,22,53,75,Thursday
2016,9,15,200,27,51,78,Thursday
2016,9,15,100,53,61,114,Thursday
2016,9,14,2400,64,89,153,Wednesday
2016,9,14,2300,94,107,201,Wednesday
2016,9,14,2200,121,197,318,Wednesday
2016,9,14,2100,166,376,542,Wednesday
2016,9,14,2000,188,531,719,Wednesday
2016,9,14,1900,236,627,863,Wednesday
2016,9,14,1800,327,858,1185,Wednesday
2016,9,14,1700,338,805,1143,Wednesday
2016,9,14,1600,408,693,1101,Wednesday
2016,9,14,1500,445,517,962,Wednesday
2016,9,14,1400,443,474,917,Wednesday
2016,9,14,1300,577,376,953,Wednesday
2016,9,14,1200,813,363,1176,Wednesday
2016,9,14,1100,785,263,1048,Wednesday
2016,9,14,1000,696,193,889,Wednesday
2016,9,14,900,561,165,726,Wednesday
2016,9,14,800,306,100,406,Wednesday
2016,9,14,700,153,43,196,Wednesday
2016,9,14,600,59,34,93,Wednesday
2016,9,14,500,29,33,62,Wednesday
2016,9,14,400,26,49,75,Wednesday
2016,9,14,300,30,41,71,Wednesday
2016,9,14,200,36,49,85,Wednesday
2016,9,14,100,51,70,121,Wednesday
2016,9,13,2400,64,84,148,Tuesday
2016,9,13,2300,81,133,214,Tuesday
2016,9,13,2200,124,430,554,Tuesday
2016,9,13,2100,142,439,581,Tuesday
2016,9,13,2000,161,356,517,Tuesday
2016,9,13,1900,198,513,711,Tuesday
2016,9,13,1800,300,702,1002,Tuesday
2016,9,13,1700,339,714,1053,Tuesday
2016,9,13,1600,427,660,1087,Tuesday
2016,9,13,1500,467,483,950,Tuesday
2016,9,13,1400,439,423,862,Tuesday
2016,9,13,1300,488,347,835,Tuesday
2016,9,13,1200,750,312,1062,Tuesday
2016,9,13,1100,806,268,1074,Tuesday
2016,9,13,1000,685,187,872,Tuesday
2016,9,13,900,545,136,681,Tuesday
2016,9,13,800,296,77,373,Tuesday
2016,9,13,700,128,63,191,Tuesday
2016,9,13,600,50,52,102,Tuesday
2016,9,13,500,32,34,66,Tuesday
2016,9,13,400,27,46,73,Tuesday
2016,9,13,300,27,39,66,Tuesday
2016,9,13,200,37,60,97,Tuesday
2016,9,13,100,38,65,103,Tuesday
2016,9,12,2400,57,92,149,Monday
2016,9,12,2300,79,156,235,Monday
2016,9,12,2200,121,210,331,Monday
2016,9,12,2100,145,418,563,Monday
2016,9,12,2000,184,603,787,Monday
2016,9,12,1900,199,934,1133,Monday
2016,9,12,1800,270,990,1260,Monday
2016,9,12,1700,373,545,918,Monday
2016,9,12,1600,427,612,1039,Monday
2016,9,12,1500,476,603,1079,Monday
2016,9,12,1400,541,536,1077,Monday
2016,9,12,1300,631,420,1051,Monday
2016,9,12,1200,795,320,1115,Monday
2016,9,12,1100,835,277,1112,Monday
2016,9,12,1000,735,206,941,Monday
2016,9,12,900,529,123,652,Monday
2016,9,12,800,280,72,352,Monday
2016,9,12,700,156,33,189,Monday
2016,9,12,600,48,17,65,Monday
2016,9,12,500,29,19,48,Monday
2016,9,12,400,18,32,50,Monday
2016,9,12,300,22,25,47,Monday
2016,9,12,200,23,43,66,Monday
2016,9,12,100,35,83,118,Monday
2016,9,11,2400,47,109,156,Sunday
2016,9,11,2300,43,158,201,Sunday
2016,9,11,2200,88,307,395,Sunday
2016,9,11,2100,122,485,607,Sunday
2016,9,11,2000,178,685,863,Sunday
2016,9,11,1900,261,975,1236,Sunday
2016,9,11,1800,299,1140,1439,Sunday
2016,9,11,1700,356,1088,1444,Sunday
2016,9,11,1600,416,1207,1623,Sunday
2016,9,11,1500,589,1024,1613,Sunday
2016,9,11,1400,614,890,1504,Sunday
2016,9,11,1300,629,839,1468,Sunday
2016,9,11,1200,697,609,1306,Sunday
2016,9,11,1100,691,421,1112,Sunday
2016,9,11,1000,592,245,837,Sunday
2016,9,11,900,402,135,537,Sunday
2016,9,11,800,212,57,269,Sunday
2016,9,11,700,82,24,106,Sunday
2016,9,11,600,31,18,49,Sunday
2016,9,11,500,17,19,36,Sunday
2016,9,11,400,19,17,36,Sunday
2016,9,11,300,24,32,56,Sunday
2016,9,11,200,17,37,54,Sunday
2016,9,11,100,27,50,77,Sunday
2016,9,10,2400,42,92,134,Saturday
2016,9,10,2300,77,122,199,Saturday
2016,9,10,2200,95,209,304,Saturday
2016,9,10,2100,120,353,473,Saturday
2016,9,10,2000,178,563,741,Saturday
2016,9,10,1900,233,928,1161,Saturday
2016,9,10,1800,323,1025,1348,Saturday
2016,9,10,1700,398,1019,1417,Saturday
2016,9,10,1600,417,941,1358,Saturday
2016,9,10,1500,529,662,1191,Saturday
2016,9,10,1400,679,630,1309,Saturday
2016,9,10,1300,793,529,1322,Saturday
2016,9,10,1200,931,356,1287,Saturday
2016,9,10,1100,1029,310,1339,Saturday
2016,9,10,1000,962,218,1180,Saturday
2016,9,10,900,691,151,842,Saturday
2016,9,10,800,331,84,415,Saturday
2016,9,10,700,145,55,200,Saturday
2016,9,10,600,75,40,115,Saturday
2016,9,10,500,29,28,57,Saturday
2016,9,10,400,27,22,49,Saturday
2016,9,10,300,23,23,46,Saturday
2016,9,10,200,41,44,85,Saturday
2016,9,10,100,60,71,131,Saturday
2016,9,9,2400,62,109,171,Friday
2016,9,9,2300,112,129,241,Friday
2016,9,9,2200,186,208,394,Friday
2016,9,9,2100,317,333,650,Friday
2016,9,9,2000,516,559,1075,Friday
2016,9,9,1900,544,796,1340,Friday
2016,9,9,1800,595,956,1551,Friday
2016,9,9,1700,659,995,1654,Friday
2016,9,9,1600,618,807,1425,Friday
2016,9,9,1500,661,625,1286,Friday
2016,9,9,1400,669,530,1199,Friday
2016,9,9,1300,727,521,1248,Friday
2016,9,9,1200,920,383,1303,Friday
2016,9,9,1100,1085,272,1357,Friday
2016,9,9,1000,866,199,1065,Friday
2016,9,9,900,668,139,807,Friday
2016,9,9,800,350,90,440,Friday
2016,9,9,700,162,45,207,Friday
2016,9,9,600,63,38,101,Friday
2016,9,9,500,40,36,76,Friday
2016,9,9,400,36,43,79,Friday
2016,9,9,300,29,47,76,Friday
2016,9,9,200,32,57,89,Friday
2016,9,9,100,51,69,120,Friday
2016,9,8,2400,54,124,178,Thursday
2016,9,8,2300,129,132,261,Thursday
2016,9,8,2200,142,150,292,Thursday
2016,9,8,2100,218,292,510,Thursday
2016,9,8,2000,302,432,734,Thursday
2016,9,8,1900,303,629,932,Thursday
2016,9,8,1800,379,739,1118,Thursday
2016,9,8,1700,377,695,1072,Thursday
2016,9,8,1600,448,689,1137,Thursday
2016,9,8,1500,513,595,1108,Thursday
2016,9,8,1400,527,477,1004,Thursday
2016,9,8,1300,586,398,984,Thursday
2016,9,8,1200,773,369,1142,Thursday
2016,9,8,1100,806,291,1097,Thursday
2016,9,8,1000,684,176,860,Thursday
2016,9,8,900,522,155,677,Thursday
2016,9,8,800,246,94,340,Thursday
2016,9,8,700,136,40,176,Thursday
2016,9,8,600,61,38,99,Thursday
2016,9,8,500,26,37,63,Thursday
2016,9,8,400,24,35,59,Thursday
2016,9,8,300,24,47,71,Thursday
2016,9,8,200,24,41,65,Thursday
2016,9,8,100,50,65,115,Thursday
2016,9,7,2400,87,90,177,Wednesday
2016,9,7,2300,101,130,231,Wednesday
2016,9,7,2200,105,182,287,Wednesday
2016,9,7,2100,152,303,455,Wednesday
2016,9,7,2000,183,494,677,Wednesday
2016,9,7,1900,239,699,938,Wednesday
2016,9,7,1800,312,885,1197,Wednesday
2016,9,7,1700,323,901,1224,Wednesday
2016,9,7,1600,368,824,1192,Wednesday
2016,9,7,1500,423,638,1061,Wednesday
2016,9,7,1400,439,483,922,Wednesday
2016,9,7,1300,532,437,969,Wednesday
2016,9,7,1200,766,317,1083,Wednesday
2016,9,7,1100,822,270,1092,Wednesday
2016,9,7,1000,745,240,985,Wednesday
2016,9,7,900,528,150,678,Wednesday
2016,9,7,800,326,87,413,Wednesday
2016,9,7,700,125,49,174,Wednesday
2016,9,7,600,36,38,74,Wednesday
2016,9,7,500,24,29,53,Wednesday
2016,9,7,400,21,37,58,Wednesday
2016,9,7,300,28,43,71,Wednesday
2016,9,7,200,29,75,104,Wednesday
2016,9,7,100,46,90,136,Wednesday
2016,9,6,2400,58,86,144,Tuesday
2016,9,6,2300,75,152,227,Tuesday
2016,9,6,2200,114,270,384,Tuesday
2016,9,6,2100,144,398,542,Tuesday
2016,9,6,2000,171,674,845,Tuesday
2016,9,6,1900,229,745,974,Tuesday
2016,9,6,1800,306,1043,1349,Tuesday
2016,9,6,1700,353,1044,1397,Tuesday
2016,9,6,1600,447,938,1385,Tuesday
2016,9,6,1500,454,830,1284,Tuesday
2016,9,6,1400,538,627,1165,Tuesday
2016,9,6,1300,676,606,1282,Tuesday
2016,9,6,1200,772,494,1266,Tuesday
2016,9,6,1100,845,378,1223,Tuesday
2016,9,6,1000,763,250,1013,Tuesday
2016,9,6,900,595,160,755,Tuesday
2016,9,6,800,298,120,418,Tuesday
2016,9,6,700,124,47,171,Tuesday
2016,9,6,600,58,49,107,Tuesday
2016,9,6,500,25,24,49,Tuesday
2016,9,6,400,19,32,51,Tuesday
2016,9,6,300,21,38,59,Tuesday
2016,9,6,200,25,56,81,Tuesday
2016,9,6,100,38,101,139,Tuesday
2016,9,5,2400,34,165,199,Monday
2016,9,5,2300,63,345,408,Monday
2016,9,5,2200,98,851,949,Monday
2016,9,5,2100,121,1423,1544,Monday
2016,9,5,2000,161,1705,1866,Monday
2016,9,5,1900,202,1928,2130,Monday
2016,9,5,1800,306,2179,2485,Monday
2016,9,5,1700,408,2288,2696,Monday
2016,9,5,1600,490,2157,2647,Monday
2016,9,5,1500,650,1759,2409,Monday
2016,9,5,1400,725,1452,2177,Monday
2016,9,5,1300,872,1587,2459,Monday
2016,9,5,1200,1075,1097,2172,Monday
2016,9,5,1100,1110,736,1846,Monday
2016,9,5,1000,964,385,1349,Monday
2016,9,5,900,683,204,887,Monday
2016,9,5,800,346,91,437,Monday
2016,9,5,700,135,56,191,Monday
2016,9,5,600,70,30,100,Monday
2016,9,5,500,32,28,60,Monday
2016,9,5,400,19,46,65,Monday
2016,9,5,300,13,54,67,Monday
2016,9,5,200,23,75,98,Monday
2016,9,5,100,39,125,164,Monday
2016,9,4,2400,53,189,242,Sunday
2016,9,4,2300,100,331,431,Sunday
2016,9,4,2200,130,606,736,Sunday
2016,9,4,2100,134,946,1080,Sunday
2016,9,4,2000,219,1204,1423,Sunday
2016,9,4,1900,253,1467,1720,Sunday
2016,9,4,1800,368,1575,1943,Sunday
2016,9,4,1700,497,1434,1931,Sunday
2016,9,4,1600,601,1314,1915,Sunday
2016,9,4,1500,729,1037,1766,Sunday
2016,9,4,1400,863,873,1736,Sunday
2016,9,4,1300,1019,773,1792,Sunday
2016,9,4,1200,1128,514,1642,Sunday
2016,9,4,1100,1046,336,1382,Sunday
2016,9,4,1000,933,217,1150,Sunday
2016,9,4,900,739,109,848,Sunday
2016,9,4,800,353,66,419,Sunday
2016,9,4,700,135,20,155,Sunday
2016,9,4,600,50,18,68,Sunday
2016,9,4,500,40,24,64,Sunday
2016,9,4,400,26,37,63,Sunday
2016,9,4,300,26,32,58,Sunday
2016,9,4,200,16,45,61,Sunday
2016,9,4,100,48,84,132,Sunday
2016,9,3,2400,61,111,172,Saturday
2016,9,3,2300,89,192,281,Saturday
2016,9,3,2200,155,327,482,Saturday
2016,9,3,2100,197,607,804,Saturday
2016,9,3,2000,228,878,1106,Saturday
2016,9,3,1900,355,1074,1429,Saturday
2016,9,3,1800,390,1144,1534,Saturday
2016,9,3,1700,547,1097,1644,Saturday
2016,9,3,1600,791,937,1728,Saturday
2016,9,3,1500,854,830,1684,Saturday
2016,9,3,1400,1047,565,1612,Saturday
2016,9,3,1300,1267,580,1847,Saturday
2016,9,3,1200,1501,443,1944,Saturday
2016,9,3,1100,1415,296,1711,Saturday
2016,9,3,1000,1282,204,1486,Saturday
2016,9,3,900,940,119,1059,Saturday
2016,9,3,800,536,61,597,Saturday
2016,9,3,700,220,46,266,Saturday
2016,9,3,600,101,34,135,Saturday
2016,9,3,500,57,30,87,Saturday
2016,9,3,400,50,37,87,Saturday
2016,9,3,300,35,56,91,Saturday
2016,9,3,200,45,58,103,Saturday
2016,9,3,100,107,100,207,Saturday
2016,9,2,2400,141,134,275,Friday
2016,9,2,2300,258,162,420,Friday
2016,9,2,2200,402,293,695,Friday
2016,9,2,2100,721,342,1063,Friday
2016,9,2,2000,1095,638,1733,Friday
2016,9,2,1900,1242,731,1973,Friday
2016,9,2,1800,1266,790,2056,Friday
2016,9,2,1700,1319,923,2242,Friday
2016,9,2,1600,1224,855,2079,Friday
2016,9,2,1500,1220,773,1993,Friday
2016,9,2,1400,1074,639,1713,Friday
2016,9,2,1300,1168,693,1861,Friday
2016,9,2,1200,1287,500,1787,Friday
2016,9,2,1100,1237,354,1591,Friday
2016,9,2,1000,1038,248,1286,Friday
2016,9,2,900,768,149,917,Friday
2016,9,2,800,505,99,604,Friday
2016,9,2,700,227,67,294,Friday
2016,9,2,600,111,41,152,Friday
2016,9,2,500,58,34,92,Friday
2016,9,2,400,53,65,118,Friday
2016,9,2,300,48,52,100,Friday
2016,9,2,200,41,61,102,Friday
2016,9,2,100,92,65,157,Friday
2016,9,1,2400,105,115,220,Thursday
2016,9,1,2300,194,155,349,Thursday
2016,9,1,2200,279,335,614,Thursday
2016,9,1,2100,442,461,903,Thursday
2016,9,1,2000,652,649,1301,Thursday
2016,9,1,1900,671,876,1547,Thursday
2016,9,1,1800,752,978,1730,Thursday
2016,9,1,1700,678,896,1574,Thursday
2016,9,1,1600,724,854,1578,Thursday
2016,9,1,1500,845,729,1574,Thursday
2016,9,1,1400,866,587,1453,Thursday
2016,9,1,1300,1034,546,1580,Thursday
2016,9,1,1200,1023,455,1478,Thursday
2016,9,1,1100,1114,365,1479,Thursday
2016,9,1,1000,985,250,1235,Thursday
2016,9,1,900,874,150,1024,Thursday
2016,9,1,800,506,105,611,Thursday
2016,9,1,700,225,81,306,Thursday
2016,9,1,600,86,40,126,Thursday
2016,9,1,500,55,36,91,Thursday
2016,9,1,400,37,52,89,Thursday
2016,9,1,300,42,49,91,Thursday
2016,9,1,200,42,82,124,Thursday
2016,9,1,100,69,87,156,Thursday
2016,8,31,2400,99,104,203,Wednesday
2016,8,31,2300,133,191,324,Wednesday
2016,8,31,2200,183,292,475,Wednesday
2016,8,31,2100,232,524,756,Wednesday
2016,8,31,2000,299,708,1007,Wednesday
2016,8,31,1900,334,884,1218,Wednesday
2016,8,31,1800,425,931,1356,Wednesday
2016,8,31,1700,506,968,1474,Wednesday
2016,8,31,1600,541,831,1372,Wednesday
2016,8,31,1500,647,632,1279,Wednesday
2016,8,31,1400,713,567,1280,Wednesday
2016,8,31,1300,740,497,1237,Wednesday
2016,8,31,1200,950,421,1371,Wednesday
2016,8,31,1100,898,347,1245,Wednesday
2016,8,31,1000,876,206,1082,Wednesday
2016,8,31,900,701,173,874,Wednesday
2016,8,31,800,392,94,486,Wednesday
2016,8,31,700,182,69,251,Wednesday
2016,8,31,600,75,37,112,Wednesday
2016,8,31,500,45,30,75,Wednesday
2016,8,31,400,37,37,74,Wednesday
2016,8,31,300,23,58,81,Wednesday
2016,8,31,200,58,65,123,Wednesday
2016,8,31,100,64,75,139,Wednesday
2016,8,30,2400,86,138,224,Tuesday
2016,8,30,2300,99,184,283,Tuesday
2016,8,30,2200,157,352,509,Tuesday
2016,8,30,2100,183,550,733,Tuesday
2016,8,30,2000,242,732,974,Tuesday
2016,8,30,1900,251,1039,1290,Tuesday
2016,8,30,1800,345,1072,1417,Tuesday
2016,8,30,1700,410,990,1400,Tuesday
2016,8,30,1600,496,879,1375,Tuesday
2016,8,30,1500,579,716,1295,Tuesday
2016,8,30,1400,600,613,1213,Tuesday
2016,8,30,1300,746,528,1274,Tuesday
2016,8,30,1200,823,401,1224,Tuesday
2016,8,30,1100,865,310,1175,Tuesday
2016,8,30,1000,871,247,1118,Tuesday
2016,8,30,900,649,165,814,Tuesday
2016,8,30,800,381,97,478,Tuesday
2016,8,30,700,150,64,214,Tuesday
2016,8,30,600,63,48,111,Tuesday
2016,8,30,500,31,55,86,Tuesday
2016,8,30,400,33,82,115,Tuesday
2016,8,30,300,25,66,91,Tuesday
2016,8,30,200,39,87,126,Tuesday
2016,8,30,100,62,108,170,Tuesday
2016,8,29,2400,74,126,200,Monday
2016,8,29,2300,91,207,298,Monday
2016,8,29,2200,164,395,559,Monday
2016,8,29,2100,174,639,813,Monday
2016,8,29,2000,263,921,1184,Monday
2016,8,29,1900,291,1069,1360,Monday
2016,8,29,1800,353,1117,1470,Monday
2016,8,29,1700,492,1262,1754,Monday
2016,8,29,1600,514,967,1481,Monday
2016,8,29,1500,641,832,1473,Monday
2016,8,29,1400,722,823,1545,Monday
2016,8,29,1300,894,641,1535,Monday
2016,8,29,1200,1091,513,1604,Monday
2016,8,29,1100,1060,382,1442,Monday
2016,8,29,1000,936,229,1165,Monday
2016,8,29,900,674,165,839,Monday
2016,8,29,800,389,120,509,Monday
2016,8,29,700,171,59,230,Monday
2016,8,29,600,73,39,112,Monday
2016,8,29,500,38,32,70,Monday
2016,8,29,400,18,39,57,Monday
2016,8,29,300,30,38,68,Monday
2016,8,29,200,27,63,90,Monday
2016,8,29,100,40,109,149,Monday
2016,8,28,2400,60,175,235,Sunday
2016,8,28,2300,82,317,399,Sunday
2016,8,28,2200,177,560,737,Sunday
2016,8,28,2100,184,918,1102,Sunday
2016,8,28,2000,288,1331,1619,Sunday
2016,8,28,1900,320,1658,1978,Sunday
2016,8,28,1800,391,1752,2143,Sunday
2016,8,28,1700,537,1811,2348,Sunday
2016,8,28,1600,635,1689,2324,Sunday
2016,8,28,1500,749,1522,2271,Sunday
2016,8,28,1400,898,1310,2208,Sunday
2016,8,28,1300,982,1085,2067,Sunday
2016,8,28,1200,1126,769,1895,Sunday
2016,8,28,1100,1145,488,1633,Sunday
2016,8,28,1000,878,234,1112,Sunday
2016,8,28,900,637,151,788,Sunday
2016,8,28,800,378,59,437,Sunday
2016,8,28,700,151,43,194,Sunday
2016,8,28,600,58,17,75,Sunday
2016,8,28,500,25,19,44,Sunday
2016,8,28,400,25,30,55,Sunday
2016,8,28,300,20,35,55,Sunday
2016,8,28,200,22,60,82,Sunday
2016,8,28,100,28,146,174,Sunday
2016,8,27,2400,41,163,204,Saturday
2016,8,27,2300,95,179,274,Saturday
2016,8,27,2200,129,330,459,Saturday
2016,8,27,2100,176,535,711,Saturday
2016,8,27,2000,209,875,1084,Saturday
2016,8,27,1900,329,1322,1651,Saturday
2016,8,27,1800,345,1423,1768,Saturday
2016,8,27,1700,500,1392,1892,Saturday
2016,8,27,1600,590,1353,1943,Saturday
2016,8,27,1500,706,1086,1792,Saturday
2016,8,27,1400,837,873,1710,Saturday
2016,8,27,1300,1037,856,1893,Saturday
2016,8,27,1200,1219,576,1795,Saturday
2016,8,27,1100,1284,382,1666,Saturday
2016,8,27,1000,1149,271,1420,Saturday
2016,8,27,900,800,193,993,Saturday
2016,8,27,800,490,102,592,Saturday
2016,8,27,700,197,51,248,Saturday
2016,8,27,600,90,57,147,Saturday
2016,8,27,500,43,32,75,Saturday
2016,8,27,400,27,52,79,Saturday
2016,8,27,300,26,59,85,Saturday
2016,8,27,200,38,94,132,Saturday
2016,8,27,100,46,125,171,Saturday
2016,8,26,2400,102,177,279,Friday
2016,8,26,2300,136,406,542,Friday
2016,8,26,2200,279,762,1041,Friday
2016,8,26,2100,420,910,1330,Friday
2016,8,26,2000,731,1236,1967,Friday
2016,8,26,1900,728,1338,2066,Friday
2016,8,26,1800,876,1106,1982,Friday
2016,8,26,1700,853,1026,1879,Friday
2016,8,26,1600,977,657,1634,Friday
2016,8,26,1500,922,562,1484,Friday
2016,8,26,1400,963,676,1639,Friday
2016,8,26,1300,1146,702,1848,Friday
2016,8,26,1200,1302,510,1812,Friday
2016,8,26,1100,1316,380,1696,Friday
2016,8,26,1000,1109,277,1386,Friday
2016,8,26,900,886,138,1024,Friday
2016,8,26,800,465,100,565,Friday
2016,8,26,700,253,51,304,Friday
2016,8,26,600,92,48,140,Friday
2016,8,26,500,54,43,97,Friday
2016,8,26,400,47,47,94,Friday
2016,8,26,300,35,61,96,Friday
2016,8,26,200,42,72,114,Friday
2016,8,26,100,63,104,167,Friday
2016,8,25,2400,91,138,229,Thursday
2016,8,25,2300,157,246,403,Thursday
2016,8,25,2200,220,372,592,Thursday
2016,8,25,2100,321,536,857,Thursday
2016,8,25,2000,560,748,1308,Thursday
2016,8,25,1900,351,1047,1398,Thursday
2016,8,25,1800,504,1183,1687,Thursday
2016,8,25,1700,640,1040,1680,Thursday
2016,8,25,1600,662,877,1539,Thursday
2016,8,25,1500,707,790,1497,Thursday
2016,8,25,1400,736,691,1427,Thursday
2016,8,25,1300,888,622,1510,Thursday
2016,8,25,1200,1066,467,1533,Thursday
2016,8,25,1100,1045,340,1385,Thursday
2016,8,25,1000,867,239,1106,Thursday
2016,8,25,900,702,144,846,Thursday
2016,8,25,800,405,111,516,Thursday
2016,8,25,700,176,48,224,Thursday
2016,8,25,600,86,43,129,Thursday
2016,8,25,500,36,46,82,Thursday
2016,8,25,400,40,38,78,Thursday
2016,8,25,300,32,60,92,Thursday
2016,8,25,200,50,79,129,Thursday
2016,8,25,100,67,94,161,Thursday
2016,8,24,2400,88,138,226,Wednesday
2016,8,24,2300,114,213,327,Wednesday
2016,8,24,2200,177,449,626,Wednesday
2016,8,24,2100,255,672,927,Wednesday
2016,8,24,2000,286,947,1233,Wednesday
2016,8,24,1900,348,1057,1405,Wednesday
2016,8,24,1800,391,1115,1506,Wednesday
2016,8,24,1700,477,1101,1578,Wednesday
2016,8,24,1600,561,963,1524,Wednesday
2016,8,24,1500,662,807,1469,Wednesday
2016,8,24,1400,895,655,1550,Wednesday
2016,8,24,1300,819,554,1373,Wednesday
2016,8,24,1200,942,450,1392,Wednesday
2016,8,24,1100,1021,321,1342,Wednesday
2016,8,24,1000,1023,239,1262,Wednesday
2016,8,24,900,812,180,992,Wednesday
2016,8,24,800,428,102,530,Wednesday
2016,8,24,700,200,70,270,Wednesday
2016,8,24,600,88,50,138,Wednesday
2016,8,24,500,36,41,77,Wednesday
2016,8,24,400,32,36,68,Wednesday
2016,8,24,300,34,43,77,Wednesday
2016,8,24,200,34,69,103,Wednesday
2016,8,24,100,54,99,153,Wednesday
2016,8,23,2400,74,141,215,Tuesday
2016,8,23,2300,117,218,335,Tuesday
2016,8,23,2200,142,377,519,Tuesday
2016,8,23,2100,172,556,728,Tuesday
2016,8,23,2000,215,712,927,Tuesday
2016,8,23,1900,303,899,1202,Tuesday
2016,8,23,1800,378,1137,1515,Tuesday
2016,8,23,1700,454,989,1443,Tuesday
2016,8,23,1600,577,908,1485,Tuesday
2016,8,23,1500,599,695,1294,Tuesday
2016,8,23,1400,636,615,1251,Tuesday
2016,8,23,1300,861,555,1416,Tuesday
2016,8,23,1200,956,365,1321,Tuesday
2016,8,23,1100,968,328,1296,Tuesday
2016,8,23,1000,878,230,1108,Tuesday
2016,8,23,900,605,156,761,Tuesday
2016,8,23,800,365,98,463,Tuesday
2016,8,23,700,146,66,212,Tuesday
2016,8,23,600,72,48,120,Tuesday
2016,8,23,500,31,43,74,Tuesday
2016,8,23,400,33,37,70,Tuesday
2016,8,23,300,34,56,90,Tuesday
2016,8,23,200,33,66,99,Tuesday
2016,8,23,100,47,106,153,Tuesday
2016,8,22,2400,54,134,188,Monday
2016,8,22,2300,93,246,339,Monday
2016,8,22,2200,150,326,476,Monday
2016,8,22,2100,186,650,836,Monday
2016,8,22,2000,269,934,1203,Monday
2016,8,22,1900,362,1136,1498,Monday
2016,8,22,1800,391,1233,1624,Monday
2016,8,22,1700,621,1232,1853,Monday
2016,8,22,1600,706,1292,1998,Monday
2016,8,22,1500,810,1086,1896,Monday
2016,8,22,1400,930,1056,1986,Monday
2016,8,22,1300,995,861,1856,Monday
2016,8,22,1200,1115,700,1815,Monday
2016,8,22,1100,1111,496,1607,Monday
2016,8,22,1000,934,279,1213,Monday
2016,8,22,900,701,206,907,Monday
2016,8,22,800,429,141,570,Monday
2016,8,22,700,223,88,311,Monday
2016,8,22,600,92,44,136,Monday
2016,8,22,500,34,31,65,Monday
2016,8,22,400,31,35,66,Monday
2016,8,22,300,26,52,78,Monday
2016,8,22,200,36,72,108,Monday
2016,8,22,100,51,134,185,Monday
2016,8,21,2400,69,214,283,Sunday
2016,8,21,2300,104,407,511,Sunday
2016,8,21,2200,159,799,958,Sunday
2016,8,21,2100,187,1246,1433,Sunday
2016,8,21,2000,260,1865,2125,Sunday
2016,8,21,1900,347,1979,2326,Sunday
2016,8,21,1800,500,2193,2693,Sunday
2016,8,21,1700,578,2076,2654,Sunday
2016,8,21,1600,791,1933,2724,Sunday
2016,8,21,1500,894,1607,2501,Sunday
2016,8,21,1400,1038,1347,2385,Sunday
2016,8,21,1300,1222,1162,2384,Sunday
2016,8,21,1200,1254,799,2053,Sunday
2016,8,21,1100,1362,492,1854,Sunday
2016,8,21,1000,1122,292,1414,Sunday
2016,8,21,900,833,156,989,Sunday
2016,8,21,800,512,84,596,Sunday
2016,8,21,700,187,40,227,Sunday
2016,8,21,600,85,34,119,Sunday
2016,8,21,500,35,24,59,Sunday
2016,8,21,400,26,33,59,Sunday
2016,8,21,300,21,37,58,Sunday
2016,8,21,200,31,47,78,Sunday
2016,8,21,100,38,117,155,Sunday
2016,8,20,2400,70,166,236,Saturday
2016,8,20,2300,90,340,430,Saturday
2016,8,20,2200,134,555,689,Saturday
2016,8,20,2100,172,855,1027,Saturday
2016,8,20,2000,261,1117,1378,Saturday
2016,8,20,1900,328,1515,1843,Saturday
2016,8,20,1800,455,1571,2026,Saturday
2016,8,20,1700,505,1425,1930,Saturday
2016,8,20,1600,701,1200,1901,Saturday
2016,8,20,1500,913,1046,1959,Saturday
2016,8,20,1400,1142,977,2119,Saturday
2016,8,20,1300,1373,877,2250,Saturday
2016,8,20,1200,1582,611,2193,Saturday
2016,8,20,1100,1751,470,2221,Saturday
2016,8,20,1000,1465,290,1755,Saturday
2016,8,20,900,1139,178,1317,Saturday
2016,8,20,800,554,102,656,Saturday
2016,8,20,700,296,80,376,Saturday
2016,8,20,600,112,48,160,Saturday
2016,8,20,500,49,28,77,Saturday
2016,8,20,400,35,40,75,Saturday
2016,8,20,300,28,58,86,Saturday
2016,8,20,200,47,62,109,Saturday
2016,8,20,100,61,120,181,Saturday
2016,8,19,2400,132,169,301,Friday
2016,8,19,2300,204,294,498,Friday
2016,8,19,2200,304,554,858,Friday
2016,8,19,2100,521,599,1120,Friday
2016,8,19,2000,841,875,1716,Friday
2016,8,19,1900,1014,1007,2021,Friday
2016,8,19,1800,1001,1246,2247,Friday
2016,8,19,1700,999,1246,2245,Friday
2016,8,19,1600,1137,1142,2279,Friday
2016,8,19,1500,1291,1004,2295,Friday
2016,8,19,1400,1143,790,1933,Friday
2016,8,19,1300,1269,750,2019,Friday
2016,8,19,1200,1369,593,1962,Friday
2016,8,19,1100,1280,409,1689,Friday
2016,8,19,1000,1220,272,1492,Friday
2016,8,19,900,992,172,1164,Friday
2016,8,19,800,593,109,702,Friday
2016,8,19,700,272,62,334,Friday
2016,8,19,600,102,51,153,Friday
2016,8,19,500,55,45,100,Friday
2016,8,19,400,47,41,88,Friday
2016,8,19,300,40,52,92,Friday
2016,8,19,200,42,81,123,Friday
2016,8,19,100,91,106,197,Friday
2016,8,18,2400,106,179,285,Thursday
2016,8,18,2300,163,256,419,Thursday
2016,8,18,2200,248,363,611,Thursday
2016,8,18,2100,345,629,974,Thursday
2016,8,18,2000,553,823,1376,Thursday
2016,8,18,1900,576,1058,1634,Thursday
2016,8,18,1800,609,1139,1748,Thursday
2016,8,18,1700,644,1069,1713,Thursday
2016,8,18,1600,749,963,1712,Thursday
2016,8,18,1500,793,804,1597,Thursday
2016,8,18,1400,875,739,1614,Thursday
2016,8,18,1300,998,591,1589,Thursday
2016,8,18,1200,1030,502,1532,Thursday
2016,8,18,1100,1132,330,1462,Thursday
2016,8,18,1000,988,220,1208,Thursday
2016,8,18,900,786,175,961,Thursday
2016,8,18,800,490,110,600,Thursday
2016,8,18,700,214,50,264,Thursday
2016,8,18,600,80,48,128,Thursday
2016,8,18,500,55,52,107,Thursday
2016,8,18,400,43,53,96,Thursday
2016,8,18,300,42,50,92,Thursday
2016,8,18,200,40,57,97,Thursday
2016,8,18,100,62,102,164,Thursday
2016,8,17,2400,90,142,232,Wednesday
2016,8,17,2300,123,261,384,Wednesday
2016,8,17,2200,183,418,601,Wednesday
2016,8,17,2100,271,669,940,Wednesday
2016,8,17,2000,312,893,1205,Wednesday
2016,8,17,1900,391,980,1371,Wednesday
2016,8,17,1800,410,1130,1540,Wednesday
2016,8,17,1700,614,1016,1630,Wednesday
2016,8,17,1600,643,928,1571,Wednesday
2016,8,17,1500,679,753,1432,Wednesday
2016,8,17,1400,757,644,1401,Wednesday
2016,8,17,1300,834,610,1444,Wednesday
2016,8,17,1200,1009,466,1475,Wednesday
2016,8,17,1100,1122,335,1457,Wednesday
2016,8,17,1000,915,258,1173,Wednesday
2016,8,17,900,768,179,947,Wednesday
2016,8,17,800,465,104,569,Wednesday
2016,8,17,700,213,66,279,Wednesday
2016,8,17,600,87,43,130,Wednesday
2016,8,17,500,41,44,85,Wednesday
2016,8,17,400,36,45,81,Wednesday
2016,8,17,300,40,54,94,Wednesday
2016,8,17,200,47,78,125,Wednesday
2016,8,17,100,64,91,155,Wednesday
2016,8,16,2400,89,109,198,Tuesday
2016,8,16,2300,133,252,385,Tuesday
2016,8,16,2200,174,425,599,Tuesday
2016,8,16,2100,240,686,926,Tuesday
2016,8,16,2000,254,922,1176,Tuesday
2016,8,16,1900,309,1118,1427,Tuesday
2016,8,16,1800,406,1200,1606,Tuesday
2016,8,16,1700,484,1118,1602,Tuesday
2016,8,16,1600,560,1018,1578,Tuesday
2016,8,16,1500,635,796,1431,Tuesday
2016,8,16,1400,711,633,1344,Tuesday
2016,8,16,1300,1012,606,1618,Tuesday
2016,8,16,1200,1079,472,1551,Tuesday
2016,8,16,1100,1048,349,1397,Tuesday
2016,8,16,1000,957,241,1198,Tuesday
2016,8,16,900,856,153,1009,Tuesday
2016,8,16,800,469,110,579,Tuesday
2016,8,16,700,174,61,235,Tuesday
2016,8,16,600,69,54,123,Tuesday
2016,8,16,500,37,40,77,Tuesday
2016,8,16,400,41,45,86,Tuesday
2016,8,16,300,33,71,104,Tuesday
2016,8,16,200,27,75,102,Tuesday
2016,8,16,100,55,117,172,Tuesday
2016,8,15,2400,84,179,263,Monday
2016,8,15,2300,113,298,411,Monday
2016,8,15,2200,160,497,657,Monday
2016,8,15,2100,204,793,997,Monday
2016,8,15,2000,274,1077,1351,Monday
2016,8,15,1900,340,1353,1693,Monday
2016,8,15,1800,432,1398,1830,Monday
2016,8,15,1700,565,1362,1927,Monday
2016,8,15,1600,681,1068,1749,Monday
2016,8,15,1500,793,1013,1806,Monday
2016,8,15,1400,932,812,1744,Monday
2016,8,15,1300,1041,719,1760,Monday
2016,8,15,1200,1285,558,1843,Monday
2016,8,15,1100,1296,394,1690,Monday
2016,8,15,1000,1180,323,1503,Monday
2016,8,15,900,895,200,1095,Monday
2016,8,15,800,491,178,669,Monday
2016,8,15,700,171,125,296,Monday
2016,8,15,600,88,51,139,Monday
2016,8,15,500,47,36,83,Monday
2016,8,15,400,33,44,77,Monday
2016,8,15,300,23,37,60,Monday
2016,8,15,200,26,81,107,Monday
2016,8,15,100,45,138,183,Monday
2016,8,14,2400,59,224,283,Sunday
2016,8,14,2300,97,478,575,Sunday
2016,8,14,2200,143,872,1015,Sunday
2016,8,14,2100,222,1574,1796,Sunday
2016,8,14,2000,267,1886,2153,Sunday
2016,8,14,1900,362,1871,2233,Sunday
2016,8,14,1800,472,1891,2363,Sunday
2016,8,14,1700,579,1743,2322,Sunday
2016,8,14,1600,770,1644,2414,Sunday
2016,8,14,1500,910,1261,2171,Sunday
2016,8,14,1400,975,1049,2024,Sunday
2016,8,14,1300,1086,1113,2199,Sunday
2016,8,14,1200,1321,789,2110,Sunday
2016,8,14,1100,1238,499,1737,Sunday
2016,8,14,1000,1078,281,1359,Sunday
2016,8,14,900,782,141,923,Sunday
2016,8,14,800,470,87,557,Sunday
2016,8,14,700,183,40,223,Sunday
2016,8,14,600,66,28,94,Sunday
2016,8,14,500,26,19,45,Sunday
2016,8,14,400,26,33,59,Sunday
2016,8,14,300,33,42,75,Sunday
2016,8,14,200,32,74,106,Sunday
2016,8,14,100,42,113,155,Sunday
2016,8,13,2400,63,185,248,Saturday
2016,8,13,2300,92,405,497,Saturday
2016,8,13,2200,150,582,732,Saturday
2016,8,13,2100,191,965,1156,Saturday
2016,8,13,2000,247,1267,1514,Saturday
2016,8,13,1900,310,1517,1827,Saturday
2016,8,13,1800,455,1739,2194,Saturday
2016,8,13,1700,621,1685,2306,Saturday
2016,8,13,1600,831,1328,2159,Saturday
2016,8,13,1500,1045,1027,2072,Saturday
2016,8,13,1400,1095,876,1971,Saturday
2016,8,13,1300,1198,738,1936,Saturday
2016,8,13,1200,1407,572,1979,Saturday
2016,8,13,1100,1650,432,2082,Saturday
2016,8,13,1000,1555,266,1821,Saturday
2016,8,13,900,1114,165,1279,Saturday
2016,8,13,800,680,68,748,Saturday
2016,8,13,700,288,56,344,Saturday
2016,8,13,600,122,47,169,Saturday
2016,8,13,500,36,49,85,Saturday
2016,8,13,400,31,50,81,Saturday
2016,8,13,300,29,57,86,Saturday
2016,8,13,200,52,80,132,Saturday
2016,8,13,100,76,119,195,Saturday
2016,8,12,2400,141,174,315,Friday
2016,8,12,2300,204,303,507,Friday
2016,8,12,2200,303,467,770,Friday
2016,8,12,2100,487,731,1218,Friday
2016,8,12,2000,781,880,1661,Friday
2016,8,12,1900,936,1157,2093,Friday
2016,8,12,1800,1049,1313,2362,Friday
2016,8,12,1700,1017,1269,2286,Friday
2016,8,12,1600,1055,1078,2133,Friday
2016,8,12,1500,1103,961,2064,Friday
2016,8,12,1400,1158,859,2017,Friday
2016,8,12,1300,1245,745,1990,Friday
2016,8,12,1200,1525,555,2080,Friday
2016,8,12,1100,1356,424,1780,Friday
2016,8,12,1000,1203,261,1464,Friday
2016,8,12,900,1026,166,1192,Friday
2016,8,12,800,660,131,791,Friday
2016,8,12,700,266,54,320,Friday
2016,8,12,600,100,37,137,Friday
2016,8,12,500,47,34,81,Friday
2016,8,12,400,42,54,96,Friday
2016,8,12,300,40,60,100,Friday
2016,8,12,200,52,63,115,Friday
2016,8,12,100,70,135,205,Friday
2016,8,11,2400,94,151,245,Thursday
2016,8,11,2300,139,254,393,Thursday
2016,8,11,2200,259,391,650,Thursday
2016,8,11,2100,338,646,984,Thursday
2016,8,11,2000,483,817,1300,Thursday
2016,8,11,1900,522,1093,1615,Thursday
2016,8,11,1800,600,1120,1720,Thursday
2016,8,11,1700,640,1143,1783,Thursday
2016,8,11,1600,753,931,1684,Thursday
2016,8,11,1500,826,862,1688,Thursday
2016,8,11,1400,842,716,1558,Thursday
2016,8,11,1300,921,641,1562,Thursday
2016,8,11,1200,1226,493,1719,Thursday
2016,8,11,1100,1242,349,1591,Thursday
2016,8,11,1000,1153,233,1386,Thursday
2016,8,11,900,998,141,1139,Thursday
2016,8,11,800,529,105,634,Thursday
2016,8,11,700,200,58,258,Thursday
2016,8,11,600,68,33,101,Thursday
2016,8,11,500,45,29,74,Thursday
2016,8,11,400,30,51,81,Thursday
2016,8,11,300,34,58,92,Thursday
2016,8,11,200,48,70,118,Thursday
2016,8,11,100,50,93,143,Thursday
2016,8,10,2400,116,112,228,Wednesday
2016,8,10,2300,138,229,367,Wednesday
2016,8,10,2200,185,352,537,Wednesday
2016,8,10,2100,264,538,802,Wednesday
2016,8,10,2000,288,811,1099,Wednesday
2016,8,10,1900,355,1002,1357,Wednesday
2016,8,10,1800,429,1037,1466,Wednesday
2016,8,10,1700,520,1026,1546,Wednesday
2016,8,10,1600,591,911,1502,Wednesday
2016,8,10,1500,704,812,1516,Wednesday
2016,8,10,1400,700,704,1404,Wednesday
2016,8,10,1300,884,605,1489,Wednesday
2016,8,10,1200,1029,456,1485,Wednesday
2016,8,10,1100,1051,340,1391,Wednesday
2016,8,10,1000,903,238,1141,Wednesday
2016,8,10,900,746,149,895,Wednesday
2016,8,10,800,446,97,543,Wednesday
2016,8,10,700,185,69,254,Wednesday
2016,8,10,600,75,54,129,Wednesday
2016,8,10,500,47,32,79,Wednesday
2016,8,10,400,38,43,81,Wednesday
2016,8,10,300,31,51,82,Wednesday
2016,8,10,200,35,60,95,Wednesday
2016,8,10,100,72,90,162,Wednesday
2016,8,9,2400,86,147,233,Tuesday
2016,8,9,2300,115,233,348,Tuesday
2016,8,9,2200,164,450,614,Tuesday
2016,8,9,2100,224,721,945,Tuesday
2016,8,9,2000,297,890,1187,Tuesday
2016,8,9,1900,292,1087,1379,Tuesday
2016,8,9,1800,363,1184,1547,Tuesday
2016,8,9,1700,474,1130,1604,Tuesday
2016,8,9,1600,582,1014,1596,Tuesday
2016,8,9,1500,660,855,1515,Tuesday
2016,8,9,1400,750,678,1428,Tuesday
2016,8,9,1300,852,595,1447,Tuesday
2016,8,9,1200,1108,505,1613,Tuesday
2016,8,9,1100,1026,306,1332,Tuesday
2016,8,9,1000,1092,244,1336,Tuesday
2016,8,9,900,839,194,1033,Tuesday
2016,8,9,800,442,129,571,Tuesday
2016,8,9,700,172,61,233,Tuesday
2016,8,9,600,68,42,110,Tuesday
2016,8,9,500,39,34,73,Tuesday
2016,8,9,400,38,51,89,Tuesday
2016,8,9,300,36,62,98,Tuesday
2016,8,9,200,39,76,115,Tuesday
2016,8,9,100,58,98,156,Tuesday
2016,8,8,2400,73,173,246,Monday
2016,8,8,2300,115,311,426,Monday
2016,8,8,2200,153,510,663,Monday
2016,8,8,2100,187,697,884,Monday
2016,8,8,2000,274,916,1190,Monday
2016,8,8,1900,345,1148,1493,Monday
2016,8,8,1800,383,1347,1730,Monday
2016,8,8,1700,543,1261,1804,Monday
2016,8,8,1600,676,1095,1771,Monday
2016,8,8,1500,736,1056,1792,Monday
2016,8,8,1400,859,925,1784,Monday
2016,8,8,1300,935,819,1754,Monday
2016,8,8,1200,1170,596,1766,Monday
2016,8,8,1100,1270,404,1674,Monday
2016,8,8,1000,922,305,1227,Monday
2016,8,8,900,700,188,888,Monday
2016,8,8,800,422,143,565,Monday
2016,8,8,700,188,94,282,Monday
2016,8,8,600,67,52,119,Monday
2016,8,8,500,43,17,60,Monday
2016,8,8,400,21,34,55,Monday
2016,8,8,300,33,41,74,Monday
2016,8,8,200,21,78,99,Monday
2016,8,8,100,46,245,291,Monday
2016,8,7,2400,54,551,605,Sunday
2016,8,7,2300,93,732,825,Sunday
2016,8,7,2200,145,922,1067,Sunday
2016,8,7,2100,201,1311,1512,Sunday
2016,8,7,2000,289,1554,1843,Sunday
2016,8,7,1900,351,1538,1889,Sunday
2016,8,7,1800,476,1649,2125,Sunday
2016,8,7,1700,560,1836,2396,Sunday
2016,8,7,1600,802,1710,2512,Sunday
2016,8,7,1500,915,1486,2401,Sunday
2016,8,7,1400,966,1265,2231,Sunday
2016,8,7,1300,1176,1146,2322,Sunday
2016,8,7,1200,1325,815,2140,Sunday
2016,8,7,1100,1367,478,1845,Sunday
2016,8,7,1000,1240,259,1499,Sunday
2016,8,7,900,855,132,987,Sunday
2016,8,7,800,484,60,544,Sunday
2016,8,7,700,178,38,216,Sunday
2016,8,7,600,84,17,101,Sunday
2016,8,7,500,28,23,51,Sunday
2016,8,7,400,29,24,53,Sunday
2016,8,7,300,25,36,61,Sunday
2016,8,7,200,33,66,99,Sunday
2016,8,7,100,45,95,140,Sunday
2016,8,6,2400,58,170,228,Saturday
2016,8,6,2300,90,311,401,Saturday
2016,8,6,2200,159,472,631,Saturday
2016,8,6,2100,182,686,868,Saturday
2016,8,6,2000,237,963,1200,Saturday
2016,8,6,1900,289,1302,1591,Saturday
2016,8,6,1800,432,1595,2027,Saturday
2016,8,6,1700,550,1496,2046,Saturday
2016,8,6,1600,636,1411,2047,Saturday
2016,8,6,1500,775,1241,2016,Saturday
2016,8,6,1400,1035,934,1969,Saturday
2016,8,6,1300,1365,767,2132,Saturday
2016,8,6,1200,1347,609,1956,Saturday
2016,8,6,1100,1215,390,1605,Saturday
2016,8,6,1000,1226,264,1490,Saturday
2016,8,6,900,965,164,1129,Saturday
2016,8,6,800,550,88,638,Saturday
2016,8,6,700,279,72,351,Saturday
2016,8,6,600,94,46,140,Saturday
2016,8,6,500,37,43,80,Saturday
2016,8,6,400,28,50,78,Saturday
2016,8,6,300,39,48,87,Saturday
2016,8,6,200,46,43,89,Saturday
2016,8,6,100,92,105,197,Saturday
2016,8,5,2400,100,185,285,Friday
2016,8,5,2300,171,301,472,Friday
2016,8,5,2200,303,529,832,Friday
2016,8,5,2100,452,749,1201,Friday
2016,8,5,2000,723,1060,1783,Friday
2016,8,5,1900,845,1241,2086,Friday
2016,8,5,1800,954,1315,2269,Friday
2016,8,5,1700,880,1189,2069,Friday
2016,8,5,1600,1044,1214,2258,Friday
2016,8,5,1500,1103,955,2058,Friday
2016,8,5,1400,1107,844,1951,Friday
2016,8,5,1300,1218,739,1957,Friday
2016,8,5,1200,1465,571,2036,Friday
2016,8,5,1100,1467,405,1872,Friday
2016,8,5,1000,1309,258,1567,Friday
2016,8,5,900,1023,179,1202,Friday
2016,8,5,800,652,112,764,Friday
2016,8,5,700,263,65,328,Friday
2016,8,5,600,128,49,177,Friday
2016,8,5,500,59,50,109,Friday
2016,8,5,400,55,56,111,Friday
2016,8,5,300,38,54,92,Friday
2016,8,5,200,67,81,148,Friday
2016,8,5,100,82,102,184,Friday
2016,8,4,2400,103,174,277,Thursday
2016,8,4,2300,159,322,481,Thursday
2016,8,4,2200,269,464,733,Thursday
2016,8,4,2100,341,696,1037,Thursday
2016,8,4,2000,444,922,1366,Thursday
2016,8,4,1900,548,1205,1753,Thursday
2016,8,4,1800,550,1275,1825,Thursday
2016,8,4,1700,672,1220,1892,Thursday
2016,8,4,1600,755,1159,1914,Thursday
2016,8,4,1500,842,906,1748,Thursday
2016,8,4,1400,976,727,1703,Thursday
2016,8,4,1300,1105,659,1764,Thursday
2016,8,4,1200,1295,549,1844,Thursday
2016,8,4,1100,1460,383,1843,Thursday
2016,8,4,1000,1174,260,1434,Thursday
2016,8,4,900,969,177,1146,Thursday
2016,8,4,800,610,111,721,Thursday
2016,8,4,700,198,68,266,Thursday
2016,8,4,600,84,33,117,Thursday
2016,8,4,500,56,56,112,Thursday
2016,8,4,400,45,48,93,Thursday
2016,8,4,300,34,48,82,Thursday
2016,8,4,200,59,47,106,Thursday
2016,8,4,100,77,92,169,Thursday
2016,8,3,2400,98,165,263,Wednesday
2016,8,3,2300,139,281,420,Wednesday
2016,8,3,2200,181,428,609,Wednesday
2016,8,3,2100,231,674,905,Wednesday
2016,8,3,2000,315,738,1053,Wednesday
2016,8,3,1900,393,997,1390,Wednesday
2016,8,3,1800,454,1140,1594,Wednesday
2016,8,3,1700,518,1056,1574,Wednesday
2016,8,3,1600,588,834,1422,Wednesday
2016,8,3,1500,677,895,1572,Wednesday
2016,8,3,1400,746,639,1385,Wednesday
2016,8,3,1300,841,698,1539,Wednesday
2016,8,3,1200,1038,516,1554,Wednesday
2016,8,3,1100,999,397,1396,Wednesday
2016,8,3,1000,934,268,1202,Wednesday
2016,8,3,900,721,185,906,Wednesday
2016,8,3,800,409,92,501,Wednesday
2016,8,3,700,170,67,237,Wednesday
2016,8,3,600,60,58,118,Wednesday
2016,8,3,500,29,36,65,Wednesday
2016,8,3,400,35,40,75,Wednesday
2016,8,3,300,44,54,98,Wednesday
2016,8,3,200,41,93,134,Wednesday
2016,8,3,100,61,119,180,Wednesday
2016,8,2,2400,88,178,266,Tuesday
2016,8,2,2300,104,319,423,Tuesday
2016,8,2,2200,188,497,685,Tuesday
2016,8,2,2100,230,799,1029,Tuesday
2016,8,2,2000,287,1301,1588,Tuesday
2016,8,2,1900,362,1556,1918,Tuesday
2016,8,2,1800,437,1405,1842,Tuesday
2016,8,2,1700,622,1387,2009,Tuesday
2016,8,2,1600,669,1330,1999,Tuesday
2016,8,2,1500,807,1085,1892,Tuesday
2016,8,2,1400,935,891,1826,Tuesday
2016,8,2,1300,1075,802,1877,Tuesday
2016,8,2,1200,1255,575,1830,Tuesday
2016,8,2,1100,1314,440,1754,Tuesday
2016,8,2,1000,1228,318,1546,Tuesday
2016,8,2,900,989,232,1221,Tuesday
2016,8,2,800,571,178,749,Tuesday
2016,8,2,700,208,138,346,Tuesday
2016,8,2,600,76,71,147,Tuesday
2016,8,2,500,32,44,76,Tuesday
2016,8,2,400,37,47,84,Tuesday
2016,8,2,300,30,71,101,Tuesday
2016,8,2,200,39,121,160,Tuesday
2016,8,2,100,51,243,294,Tuesday
2016,8,1,2400,63,373,436,Monday
2016,8,1,2300,102,767,869,Monday
2016,8,1,2200,159,1210,1369,Monday
2016,8,1,2100,230,1822,2052,Monday
2016,8,1,2000,266,1946,2212,Monday
2016,8,1,1900,405,2219,2624,Monday
2016,8,1,1800,523,2366,2889,Monday
2016,8,1,1700,621,2227,2848,Monday
2016,8,1,1600,872,2189,3061,Monday
2016,8,1,1500,1065,1912,2977,Monday
2016,8,1,1400,1273,1677,2950,Monday
2016,8,1,1300,1483,1465,2948,Monday
2016,8,1,1200,1555,1129,2684,Monday
2016,8,1,1100,1542,649,2191,Monday
2016,8,1,1000,1386,369,1755,Monday
2016,8,1,900,1116,217,1333,Monday
2016,8,1,800,662,101,763,Monday
2016,8,1,700,222,42,264,Monday
2016,8,1,600,94,40,134,Monday
2016,8,1,500,44,29,73,Monday
2016,8,1,400,25,36,61,Monday
2016,8,1,300,22,62,84,Monday
2016,8,1,200,38,78,116,Monday
2016,8,1,100,50,152,202,Monday
2016,7,31,2400,72,256,328,Sunday
2016,7,31,2300,126,439,565,Sunday
2016,7,31,2200,157,753,910,Sunday
2016,7,31,2100,235,1081,1316,Sunday
2016,7,31,2000,294,1307,1601,Sunday
2016,7,31,1900,390,1728,2118,Sunday
2016,7,31,1800,509,1842,2351,Sunday
2016,7,31,1700,632,1685,2317,Sunday
2016,7,31,1600,809,1412,2221,Sunday
2016,7,31,1500,992,1144,2136,Sunday
2016,7,31,1400,1087,971,2058,Sunday
2016,7,31,1300,1260,854,2114,Sunday
2016,7,31,1200,1426,598,2024,Sunday
2016,7,31,1100,1455,384,1839,Sunday
2016,7,31,1000,1144,263,1407,Sunday
2016,7,31,900,915,154,1069,Sunday
2016,7,31,800,502,64,566,Sunday
2016,7,31,700,212,39,251,Sunday
2016,7,31,600,78,36,114,Sunday
2016,7,31,500,36,28,64,Sunday
2016,7,31,400,33,30,63,Sunday
2016,7,31,300,29,34,63,Sunday
2016,7,31,200,35,70,105,Sunday
2016,7,31,100,46,123,169,Sunday
2016,7,30,2400,57,215,272,Saturday
2016,7,30,2300,114,279,393,Saturday
2016,7,30,2200,176,568,744,Saturday
2016,7,30,2100,242,757,999,Saturday
2016,7,30,2000,329,990,1319,Saturday
2016,7,30,1900,419,1124,1543,Saturday
2016,7,30,1800,587,1610,2197,Saturday
2016,7,30,1700,752,1397,2149,Saturday
2016,7,30,1600,1306,1308,2614,Saturday
2016,7,30,1500,1135,1020,2155,Saturday
2016,7,30,1400,1216,882,2098,Saturday
2016,7,30,1300,1425,701,2126,Saturday
2016,7,30,1200,1594,548,2142,Saturday
2016,7,30,1100,1903,420,2323,Saturday
2016,7,30,1000,1794,272,2066,Saturday
2016,7,30,900,1487,188,1675,Saturday
2016,7,30,800,922,100,1022,Saturday
2016,7,30,700,460,65,525,Saturday
2016,7,30,600,205,51,256,Saturday
2016,7,30,500,96,57,153,Saturday
2016,7,30,400,66,53,119,Saturday
2016,7,30,300,58,68,126,Saturday
2016,7,30,200,91,90,181,Saturday
2016,7,30,100,137,101,238,Saturday
2016,7,29,2400,172,242,414,Friday
2016,7,29,2300,330,354,684,Friday
2016,7,29,2200,475,512,987,Friday
2016,7,29,2100,791,746,1537,Friday
2016,7,29,2000,1116,957,2073,Friday
2016,7,29,1900,1338,1207,2545,Friday
2016,7,29,1800,1388,1304,2692,Friday
2016,7,29,1700,1520,1205,2725,Friday
2016,7,29,1600,1576,1116,2692,Friday
2016,7,29,1500,1552,992,2544,Friday
2016,7,29,1400,1383,769,2152,Friday
2016,7,29,1300,1604,693,2297,Friday
2016,7,29,1200,1819,596,2415,Friday
2016,7,29,1100,1877,463,2340,Friday
2016,7,29,1000,1628,297,1925,Friday
2016,7,29,900,1337,198,1535,Friday
2016,7,29,800,923,132,1055,Friday
2016,7,29,700,377,75,452,Friday
2016,7,29,600,205,66,271,Friday
2016,7,29,500,75,37,112,Friday
2016,7,29,400,50,64,114,Friday
2016,7,29,300,57,76,133,Friday
2016,7,29,200,53,87,140,Friday
2016,7,29,100,112,120,232,Friday
2016,7,28,2400,159,213,372,Thursday
2016,7,28,2300,249,384,633,Thursday
2016,7,28,2200,376,403,779,Thursday
2016,7,28,2100,591,687,1278,Thursday
2016,7,28,2000,789,920,1709,Thursday
2016,7,28,1900,902,970,1872,Thursday
2016,7,28,1800,865,1166,2031,Thursday
2016,7,28,1700,990,1240,2230,Thursday
2016,7,28,1600,1009,986,1995,Thursday
2016,7,28,1500,981,883,1864,Thursday
2016,7,28,1400,1067,725,1792,Thursday
2016,7,28,1300,1259,686,1945,Thursday
2016,7,28,1200,1492,510,2002,Thursday
2016,7,28,1100,1424,389,1813,Thursday
2016,7,28,1000,1311,226,1537,Thursday
2016,7,28,900,1026,174,1200,Thursday
2016,7,28,800,619,99,718,Thursday
2016,7,28,700,296,61,357,Thursday
2016,7,28,600,133,50,183,Thursday
2016,7,28,500,63,47,110,Thursday
2016,7,28,400,42,57,99,Thursday
2016,7,28,300,33,50,83,Thursday
2016,7,28,200,49,66,115,Thursday
2016,7,28,100,94,89,183,Thursday
2016,7,27,2400,106,124,230,Wednesday
2016,7,27,2300,157,240,397,Wednesday
2016,7,27,2200,224,413,637,Wednesday
2016,7,27,2100,323,581,904,Wednesday
2016,7,27,2000,396,770,1166,Wednesday
2016,7,27,1900,392,783,1175,Wednesday
2016,7,27,1800,485,1166,1651,Wednesday
2016,7,27,1700,565,1016,1581,Wednesday
2016,7,27,1600,647,838,1485,Wednesday
2016,7,27,1500,717,797,1514,Wednesday
2016,7,27,1400,758,669,1427,Wednesday
2016,7,27,1300,962,544,1506,Wednesday
2016,7,27,1200,1117,450,1567,Wednesday
2016,7,27,1100,1130,333,1463,Wednesday
2016,7,27,1000,963,231,1194,Wednesday
2016,7,27,900,797,174,971,Wednesday
2016,7,27,800,510,102,612,Wednesday
2016,7,27,700,204,52,256,Wednesday
2016,7,27,600,77,49,126,Wednesday
2016,7,27,500,35,44,79,Wednesday
2016,7,27,400,44,54,98,Wednesday
2016,7,27,300,21,59,80,Wednesday
2016,7,27,200,38,73,111,Wednesday
2016,7,27,100,64,103,167,Wednesday
2016,7,26,2400,99,174,273,Tuesday
2016,7,26,2300,129,276,405,Tuesday
2016,7,26,2200,169,451,620,Tuesday
2016,7,26,2100,212,659,871,Tuesday
2016,7,26,2000,318,1095,1413,Tuesday
2016,7,26,1900,296,1329,1625,Tuesday
2016,7,26,1800,387,826,1213,Tuesday
2016,7,26,1700,473,878,1351,Tuesday
2016,7,26,1600,553,707,1260,Tuesday
2016,7,26,1500,666,773,1439,Tuesday
2016,7,26,1400,795,665,1460,Tuesday
2016,7,26,1300,869,592,1461,Tuesday
2016,7,26,1200,1053,453,1506,Tuesday
2016,7,26,1100,1125,326,1451,Tuesday
2016,7,26,1000,1067,217,1284,Tuesday
2016,7,26,900,771,175,946,Tuesday
2016,7,26,800,453,105,558,Tuesday
2016,7,26,700,184,76,260,Tuesday
2016,7,26,600,83,47,130,Tuesday
2016,7,26,500,33,43,76,Tuesday
2016,7,26,400,34,47,81,Tuesday
2016,7,26,300,23,38,61,Tuesday
2016,7,26,200,31,78,109,Tuesday
2016,7,26,100,56,92,148,Tuesday
2016,7,25,2400,83,171,254,Monday
2016,7,25,2300,104,304,408,Monday
2016,7,25,2200,144,492,636,Monday
2016,7,25,2100,193,692,885,Monday
2016,7,25,2000,267,965,1232,Monday
2016,7,25,1900,301,1206,1507,Monday
2016,7,25,1800,417,1358,1775,Monday
2016,7,25,1700,605,1273,1878,Monday
2016,7,25,1600,670,1142,1812,Monday
2016,7,25,1500,786,1108,1894,Monday
2016,7,25,1400,998,840,1838,Monday
2016,7,25,1300,1043,771,1814,Monday
2016,7,25,1200,1383,614,1997,Monday
2016,7,25,1100,1347,447,1794,Monday
2016,7,25,1000,1196,261,1457,Monday
2016,7,25,900,877,188,1065,Monday
2016,7,25,800,533,135,668,Monday
2016,7,25,700,200,94,294,Monday
2016,7,25,600,89,45,134,Monday
2016,7,25,500,49,31,80,Monday
2016,7,25,400,32,55,87,Monday
2016,7,25,300,31,59,90,Monday
2016,7,25,200,33,109,142,Monday
2016,7,25,100,41,163,204,Monday
2016,7,24,2400,64,248,312,Sunday
2016,7,24,2300,108,486,594,Sunday
2016,7,24,2200,149,796,945,Sunday
2016,7,24,2100,206,1304,1510,Sunday
2016,7,24,2000,300,1686,1986,Sunday
2016,7,24,1900,391,1925,2316,Sunday
2016,7,24,1800,494,1931,2425,Sunday
2016,7,24,1700,661,1950,2611,Sunday
2016,7,24,1600,834,1706,2540,Sunday
2016,7,24,1500,1051,1472,2523,Sunday
2016,7,24,1400,1288,1245,2533,Sunday
2016,7,24,1300,1172,991,2163,Sunday
2016,7,24,1200,1300,789,2089,Sunday
2016,7,24,1100,1442,480,1922,Sunday
2016,7,24,1000,1331,314,1645,Sunday
2016,7,24,900,1013,129,1142,Sunday
2016,7,24,800,512,79,591,Sunday
2016,7,24,700,197,34,231,Sunday
2016,7,24,600,91,24,115,Sunday
2016,7,24,500,54,23,77,Sunday
2016,7,24,400,28,26,54,Sunday
2016,7,24,300,32,39,71,Sunday
2016,7,24,200,27,57,84,Sunday
2016,7,24,100,37,134,171,Sunday
2016,7,23,2400,58,172,230,Saturday
2016,7,23,2300,117,313,430,Saturday
2016,7,23,2200,137,507,644,Saturday
2016,7,23,2100,205,722,927,Saturday
2016,7,23,2000,273,1078,1351,Saturday
2016,7,23,1900,358,1471,1829,Saturday
2016,7,23,1800,473,1389,1862,Saturday
2016,7,23,1700,604,1338,1942,Saturday
2016,7,23,1600,799,1258,2057,Saturday
2016,7,23,1500,902,1031,1933,Saturday
2016,7,23,1400,1266,792,2058,Saturday
2016,7,23,1300,1328,760,2088,Saturday
2016,7,23,1200,1507,566,2073,Saturday
2016,7,23,1100,1645,370,2015,Saturday
2016,7,23,1000,1546,250,1796,Saturday
2016,7,23,900,1202,181,1383,Saturday
2016,7,23,800,664,96,760,Saturday
2016,7,23,700,311,49,360,Saturday
2016,7,23,600,116,39,155,Saturday
2016,7,23,500,57,49,106,Saturday
2016,7,23,400,41,43,84,Saturday
2016,7,23,300,52,57,109,Saturday
2016,7,23,200,59,66,125,Saturday
2016,7,23,100,72,117,189,Saturday
2016,7,22,2400,110,156,266,Friday
2016,7,22,2300,231,239,470,Friday
2016,7,22,2200,294,441,735,Friday
2016,7,22,2100,539,544,1083,Friday
2016,7,22,2000,813,771,1584,Friday
2016,7,22,1900,1009,1033,2042,Friday
2016,7,22,1800,1034,1242,2276,Friday
2016,7,22,1700,1081,1225,2306,Friday
2016,7,22,1600,1168,1106,2274,Friday
2016,7,22,1500,1174,956,2130,Friday
2016,7,22,1400,1158,855,2013,Friday
2016,7,22,1300,1327,723,2050,Friday
2016,7,22,1200,1444,555,1999,Friday
2016,7,22,1100,1431,379,1810,Friday
2016,7,22,1000,1333,267,1600,Friday
2016,7,22,900,977,167,1144,Friday
2016,7,22,800,620,93,713,Friday
2016,7,22,700,259,61,320,Friday
2016,7,22,600,106,55,161,Friday
2016,7,22,500,50,32,82,Friday
2016,7,22,400,67,52,119,Friday
2016,7,22,300,48,56,104,Friday
2016,7,22,200,56,72,128,Friday
2016,7,22,100,80,89,169,Friday
2016,7,21,2400,137,180,317,Thursday
2016,7,21,2300,196,307,503,Thursday
2016,7,21,2200,281,434,715,Thursday
2016,7,21,2100,402,598,1000,Thursday
2016,7,21,2000,550,828,1378,Thursday
2016,7,21,1900,615,1066,1681,Thursday
2016,7,21,1800,631,1023,1654,Thursday
2016,7,21,1700,628,1137,1765,Thursday
2016,7,21,1600,755,970,1725,Thursday
2016,7,21,1500,846,811,1657,Thursday
2016,7,21,1400,917,723,1640,Thursday
2016,7,21,1300,1081,532,1613,Thursday
2016,7,21,1200,1267,485,1752,Thursday
2016,7,21,1100,1271,363,1634,Thursday
2016,7,21,1000,1199,236,1435,Thursday
2016,7,21,900,910,179,1089,Thursday
2016,7,21,800,532,101,633,Thursday
2016,7,21,700,227,64,291,Thursday
2016,7,21,600,75,46,121,Thursday
2016,7,21,500,61,31,92,Thursday
2016,7,21,400,46,53,99,Thursday
2016,7,21,300,42,52,94,Thursday
2016,7,21,200,45,60,105,Thursday
2016,7,21,100,63,91,154,Thursday
2016,7,20,2400,92,195,287,Wednesday
2016,7,20,2300,134,279,413,Wednesday
2016,7,20,2200,212,407,619,Wednesday
2016,7,20,2100,273,570,843,Wednesday
2016,7,20,2000,316,777,1093,Wednesday
2016,7,20,1900,368,915,1283,Wednesday
2016,7,20,1800,477,1072,1549,Wednesday
2016,7,20,1700,573,1021,1594,Wednesday
2016,7,20,1600,705,844,1549,Wednesday
2016,7,20,1500,688,789,1477,Wednesday
2016,7,20,1400,755,632,1387,Wednesday
2016,7,20,1300,922,515,1437,Wednesday
2016,7,20,1200,1147,462,1609,Wednesday
2016,7,20,1100,1162,331,1493,Wednesday
2016,7,20,1000,1103,246,1349,Wednesday
2016,7,20,900,845,177,1022,Wednesday
2016,7,20,800,481,141,622,Wednesday
2016,7,20,700,191,61,252,Wednesday
2016,7,20,600,67,50,117,Wednesday
2016,7,20,500,37,35,72,Wednesday
2016,7,20,400,35,51,86,Wednesday
2016,7,20,300,31,66,97,Wednesday
2016,7,20,200,35,63,98,Wednesday
2016,7,20,100,49,108,157,Wednesday
2016,7,19,2400,100,167,267,Tuesday
2016,7,19,2300,105,275,380,Tuesday
2016,7,19,2200,164,410,574,Tuesday
2016,7,19,2100,226,688,914,Tuesday
2016,7,19,2000,288,881,1169,Tuesday
2016,7,19,1900,326,906,1232,Tuesday
2016,7,19,1800,408,851,1259,Tuesday
2016,7,19,1700,483,1027,1510,Tuesday
2016,7,19,1600,569,964,1533,Tuesday
2016,7,19,1500,683,862,1545,Tuesday
2016,7,19,1400,867,624,1491,Tuesday
2016,7,19,1300,861,603,1464,Tuesday
2016,7,19,1200,1052,486,1538,Tuesday
2016,7,19,1100,1167,370,1537,Tuesday
2016,7,19,1000,994,231,1225,Tuesday
2016,7,19,900,803,142,945,Tuesday
2016,7,19,800,463,128,591,Tuesday
2016,7,19,700,202,71,273,Tuesday
2016,7,19,600,63,53,116,Tuesday
2016,7,19,500,59,45,104,Tuesday
2016,7,19,400,33,44,77,Tuesday
2016,7,19,300,30,73,103,Tuesday
2016,7,19,200,23,91,114,Tuesday
2016,7,19,100,52,158,210,Tuesday
2016,7,18,2400,91,254,345,Monday
2016,7,18,2300,100,400,500,Monday
2016,7,18,2200,163,669,832,Monday
2016,7,18,2100,232,853,1085,Monday
2016,7,18,2000,305,931,1236,Monday
2016,7,18,1900,313,1093,1406,Monday
2016,7,18,1800,415,1417,1832,Monday
2016,7,18,1700,596,1194,1790,Monday
2016,7,18,1600,762,1007,1769,Monday
2016,7,18,1500,834,823,1657,Monday
2016,7,18,1400,1006,750,1756,Monday
2016,7,18,1300,1166,602,1768,Monday
2016,7,18,1200,1310,465,1775,Monday
2016,7,18,1100,1483,320,1803,Monday
2016,7,18,1000,1186,231,1417,Monday
2016,7,18,900,871,126,997,Monday
2016,7,18,800,546,145,691,Monday
2016,7,18,700,234,88,322,Monday
2016,7,18,600,76,43,119,Monday
2016,7,18,500,51,35,86,Monday
2016,7,18,400,21,27,48,Monday
2016,7,18,300,33,32,65,Monday
2016,7,18,200,27,70,97,Monday
2016,7,18,100,41,123,164,Monday
2016,7,17,2400,53,222,275,Sunday
2016,7,17,2300,115,373,488,Sunday
2016,7,17,2200,133,596,729,Sunday
2016,7,17,2100,222,1001,1223,Sunday
2016,7,17,2000,288,1127,1415,Sunday
2016,7,17,1900,369,1583,1952,Sunday
2016,7,17,1800,463,1654,2117,Sunday
2016,7,17,1700,649,1711,2360,Sunday
2016,7,17,1600,795,1444,2239,Sunday
2016,7,17,1500,1054,1239,2293,Sunday
2016,7,17,1400,1155,1092,2247,Sunday
2016,7,17,1300,1002,865,1867,Sunday
2016,7,17,1200,1235,675,1910,Sunday
2016,7,17,1100,1300,397,1697,Sunday
2016,7,17,1000,1098,233,1331,Sunday
2016,7,17,900,761,137,898,Sunday
2016,7,17,800,431,47,478,Sunday
2016,7,17,700,188,30,218,Sunday
2016,7,17,600,62,27,89,Sunday
2016,7,17,500,35,20,55,Sunday
2016,7,17,400,23,20,43,Sunday
2016,7,17,300,39,38,77,Sunday
2016,7,17,200,32,48,80,Sunday
2016,7,17,100,37,75,112,Sunday
2016,7,16,2400,58,147,205,Saturday
2016,7,16,2300,97,265,362,Saturday
2016,7,16,2200,146,382,528,Saturday
2016,7,16,2100,190,577,767,Saturday
2016,7,16,2000,239,668,907,Saturday
2016,7,16,1900,306,907,1213,Saturday
2016,7,16,1800,439,1052,1491,Saturday
2016,7,16,1700,546,1132,1678,Saturday
2016,7,16,1600,721,843,1564,Saturday
2016,7,16,1500,911,853,1764,Saturday
2016,7,16,1400,1099,804,1903,Saturday
2016,7,16,1300,1115,686,1801,Saturday
2016,7,16,1200,1445,590,2035,Saturday
2016,7,16,1100,1355,366,1721,Saturday
2016,7,16,1000,1108,235,1343,Saturday
2016,7,16,900,776,133,909,Saturday
2016,7,16,800,474,88,562,Saturday
2016,7,16,700,234,42,276,Saturday
2016,7,16,600,85,39,124,Saturday
2016,7,16,500,38,31,69,Saturday
2016,7,16,400,34,35,69,Saturday
2016,7,16,300,40,41,81,Saturday
2016,7,16,200,49,61,110,Saturday
2016,7,16,100,72,113,185,Saturday
2016,7,15,2400,108,189,297,Friday
2016,7,15,2300,135,214,349,Friday
2016,7,15,2200,254,321,575,Friday
2016,7,15,2100,437,451,888,Friday
2016,7,15,2000,606,608,1214,Friday
2016,7,15,1900,741,900,1641,Friday
2016,7,15,1800,872,1201,2073,Friday
2016,7,15,1700,976,1265,2241,Friday
2016,7,15,1600,1068,960,2028,Friday
2016,7,15,1500,1105,852,1957,Friday
2016,7,15,1400,1151,724,1875,Friday
2016,7,15,1300,1315,686,2001,Friday
2016,7,15,1200,1142,518,1660,Friday
2016,7,15,1100,1291,378,1669,Friday
2016,7,15,1000,1056,252,1308,Friday
2016,7,15,900,752,175,927,Friday
2016,7,15,800,451,120,571,Friday
2016,7,15,700,214,56,270,Friday
2016,7,15,600,83,40,123,Friday
2016,7,15,500,52,45,97,Friday
2016,7,15,400,36,37,73,Friday
2016,7,15,300,35,65,100,Friday
2016,7,15,200,52,68,120,Friday
2016,7,15,100,66,102,168,Friday
2016,7,14,2400,121,165,286,Thursday
2016,7,14,2300,160,285,445,Thursday
2016,7,14,2200,210,420,630,Thursday
2016,7,14,2100,339,587,926,Thursday
2016,7,14,2000,456,820,1276,Thursday
2016,7,14,1900,449,954,1403,Thursday
2016,7,14,1800,551,974,1525,Thursday
2016,7,14,1700,704,976,1680,Thursday
2016,7,14,1600,752,956,1708,Thursday
2016,7,14,1500,818,749,1567,Thursday
2016,7,14,1400,926,642,1568,Thursday
2016,7,14,1300,1009,600,1609,Thursday
2016,7,14,1200,1337,448,1785,Thursday
2016,7,14,1100,1152,333,1485,Thursday
2016,7,14,1000,1058,201,1259,Thursday
2016,7,14,900,817,185,1002,Thursday
2016,7,14,800,411,104,515,Thursday
2016,7,14,700,179,52,231,Thursday
2016,7,14,600,66,43,109,Thursday
2016,7,14,500,54,45,99,Thursday
2016,7,14,400,40,37,77,Thursday
2016,7,14,300,31,51,82,Thursday
2016,7,14,200,51,56,107,Thursday
2016,7,14,100,72,85,157,Thursday
2016,7,13,2400,106,126,232,Wednesday
2016,7,13,2300,144,231,375,Wednesday
2016,7,13,2200,191,297,488,Wednesday
2016,7,13,2100,222,508,730,Wednesday
2016,7,13,2000,329,669,998,Wednesday
2016,7,13,1900,358,748,1106,Wednesday
2016,7,13,1800,445,876,1321,Wednesday
2016,7,13,1700,529,1007,1536,Wednesday
2016,7,13,1600,568,849,1417,Wednesday
2016,7,13,1500,700,710,1410,Wednesday
2016,7,13,1400,789,666,1455,Wednesday
2016,7,13,1300,863,569,1432,Wednesday
2016,7,13,1200,925,498,1423,Wednesday
2016,7,13,1100,1076,317,1393,Wednesday
2016,7,13,1000,888,231,1119,Wednesday
2016,7,13,900,630,169,799,Wednesday
2016,7,13,800,420,108,528,Wednesday
2016,7,13,700,208,59,267,Wednesday
2016,7,13,600,91,54,145,Wednesday
2016,7,13,500,59,49,108,Wednesday
2016,7,13,400,63,54,117,Wednesday
2016,7,13,300,45,56,101,Wednesday
2016,7,13,200,58,66,124,Wednesday
2016,7,13,100,68,86,154,Wednesday
2016,7,12,2400,104,130,234,Tuesday
2016,7,12,2300,123,265,388,Tuesday
2016,7,12,2200,180,380,560,Tuesday
2016,7,12,2100,254,523,777,Tuesday
2016,7,12,2000,290,704,994,Tuesday
2016,7,12,1900,348,854,1202,Tuesday
2016,7,12,1800,394,872,1266,Tuesday
2016,7,12,1700,462,941,1403,Tuesday
2016,7,12,1600,585,925,1510,Tuesday
2016,7,12,1500,654,710,1364,Tuesday
2016,7,12,1400,786,643,1429,Tuesday
2016,7,12,1300,829,553,1382,Tuesday
2016,7,12,1200,1047,400,1447,Tuesday
2016,7,12,1100,1063,361,1424,Tuesday
2016,7,12,1000,903,229,1132,Tuesday
2016,7,12,900,675,166,841,Tuesday
2016,7,12,800,395,101,496,Tuesday
2016,7,12,700,168,47,215,Tuesday
2016,7,12,600,70,49,119,Tuesday
2016,7,12,500,35,32,67,Tuesday
2016,7,12,400,24,43,67,Tuesday
2016,7,12,300,28,64,92,Tuesday
2016,7,12,200,36,65,101,Tuesday
2016,7,12,100,40,123,163,Tuesday
2016,7,11,2400,85,173,258,Monday
2016,7,11,2300,111,215,326,Monday
2016,7,11,2200,165,398,563,Monday
2016,7,11,2100,195,648,843,Monday
2016,7,11,2000,254,786,1040,Monday
2016,7,11,1900,309,992,1301,Monday
2016,7,11,1800,406,1182,1588,Monday
2016,7,11,1700,485,1073,1558,Monday
2016,7,11,1600,645,1084,1729,Monday
2016,7,11,1500,809,958,1767,Monday
2016,7,11,1400,1008,749,1757,Monday
2016,7,11,1300,1046,695,1741,Monday
2016,7,11,1200,1026,527,1553,Monday
2016,7,11,1100,1102,404,1506,Monday
2016,7,11,1000,938,287,1225,Monday
2016,7,11,900,663,182,845,Monday
2016,7,11,800,392,112,504,Monday
2016,7,11,700,184,69,253,Monday
2016,7,11,600,77,37,114,Monday
2016,7,11,500,33,31,64,Monday
2016,7,11,400,24,26,50,Monday
2016,7,11,300,24,34,58,Monday
2016,7,11,200,30,58,88,Monday
2016,7,11,100,32,106,138,Monday
2016,7,10,2400,64,190,254,Sunday
2016,7,10,2300,102,350,452,Sunday
2016,7,10,2200,142,591,733,Sunday
2016,7,10,2100,184,972,1156,Sunday
2016,7,10,2000,305,1197,1502,Sunday
2016,7,10,1900,399,1532,1931,Sunday
2016,7,10,1800,473,1534,2007,Sunday
2016,7,10,1700,601,1587,2188,Sunday
2016,7,10,1600,738,1335,2073,Sunday
2016,7,10,1500,824,1314,2138,Sunday
2016,7,10,1400,987,1125,2112,Sunday
2016,7,10,1300,1096,923,2019,Sunday
2016,7,10,1200,1199,734,1933,Sunday
2016,7,10,1100,1173,466,1639,Sunday
2016,7,10,1000,993,240,1233,Sunday
2016,7,10,900,720,148,868,Sunday
2016,7,10,800,423,80,503,Sunday
2016,7,10,700,139,32,171,Sunday
2016,7,10,600,62,19,81,Sunday
2016,7,10,500,25,20,45,Sunday
2016,7,10,400,15,25,40,Sunday
2016,7,10,300,24,27,51,Sunday
2016,7,10,200,30,49,79,Sunday
2016,7,10,100,37,91,128,Sunday
2016,7,9,2400,50,112,162,Saturday
2016,7,9,2300,85,212,297,Saturday
2016,7,9,2200,147,387,534,Saturday
2016,7,9,2100,171,561,732,Saturday
2016,7,9,2000,213,759,972,Saturday
2016,7,9,1900,316,1097,1413,Saturday
2016,7,9,1800,385,1313,1698,Saturday
2016,7,9,1700,518,1282,1800,Saturday
2016,7,9,1600,667,1160,1827,Saturday
2016,7,9,1500,732,857,1589,Saturday
2016,7,9,1400,914,760,1674,Saturday
2016,7,9,1300,1031,592,1623,Saturday
2016,7,9,1200,1178,501,1679,Saturday
2016,7,9,1100,1216,386,1602,Saturday
2016,7,9,1000,1123,220,1343,Saturday
2016,7,9,900,785,145,930,Saturday
2016,7,9,800,427,109,536,Saturday
2016,7,9,700,209,55,264,Saturday
2016,7,9,600,80,36,116,Saturday
2016,7,9,500,40,25,65,Saturday
2016,7,9,400,34,40,74,Saturday
2016,7,9,300,27,59,86,Saturday
2016,7,9,200,39,63,102,Saturday
2016,7,9,100,63,111,174,Saturday
2016,7,8,2400,102,222,324,Friday
2016,7,8,2300,187,230,417,Friday
2016,7,8,2200,255,351,606,Friday
2016,7,8,2100,395,640,1035,Friday
2016,7,8,2000,535,813,1348,Friday
2016,7,8,1900,661,1098,1759,Friday
2016,7,8,1800,751,1049,1800,Friday
2016,7,8,1700,807,1140,1947,Friday
2016,7,8,1600,895,1112,2007,Friday
2016,7,8,1500,1009,916,1925,Friday
2016,7,8,1400,981,795,1776,Friday
2016,7,8,1300,1120,669,1789,Friday
2016,7,8,1200,1167,543,1710,Friday
2016,7,8,1100,1272,407,1679,Friday
2016,7,8,1000,1078,250,1328,Friday
2016,7,8,900,888,159,1047,Friday
2016,7,8,800,492,122,614,Friday
2016,7,8,700,225,56,281,Friday
2016,7,8,600,94,45,139,Friday
2016,7,8,500,47,32,79,Friday
2016,7,8,400,35,50,85,Friday
2016,7,8,300,47,53,100,Friday
2016,7,8,200,57,73,130,Friday
2016,7,8,100,51,107,158,Friday
2016,7,7,2400,112,153,265,Thursday
2016,7,7,2300,158,284,442,Thursday
2016,7,7,2200,213,434,647,Thursday
2016,7,7,2100,372,761,1133,Thursday
2016,7,7,2000,408,976,1384,Thursday
2016,7,7,1900,534,1188,1722,Thursday
2016,7,7,1800,568,1238,1806,Thursday
2016,7,7,1700,559,1155,1714,Thursday
2016,7,7,1600,733,991,1724,Thursday
2016,7,7,1500,738,940,1678,Thursday
2016,7,7,1400,814,825,1639,Thursday
2016,7,7,1300,981,689,1670,Thursday
2016,7,7,1200,1203,531,1734,Thursday
2016,7,7,1100,1265,385,1650,Thursday
2016,7,7,1000,1139,219,1358,Thursday
2016,7,7,900,873,183,1056,Thursday
2016,7,7,800,491,115,606,Thursday
2016,7,7,700,164,74,238,Thursday
2016,7,7,600,83,46,129,Thursday
2016,7,7,500,52,37,89,Thursday
2016,7,7,400,37,37,74,Thursday
2016,7,7,300,31,40,71,Thursday
2016,7,7,200,35,70,105,Thursday
2016,7,7,100,72,104,176,Thursday
2016,7,6,2400,102,172,274,Wednesday
2016,7,6,2300,127,245,372,Wednesday
2016,7,6,2200,178,444,622,Wednesday
2016,7,6,2100,229,586,815,Wednesday
2016,7,6,2000,304,820,1124,Wednesday
2016,7,6,1900,342,970,1312,Wednesday
2016,7,6,1800,378,981,1359,Wednesday
2016,7,6,1700,492,1037,1529,Wednesday
2016,7,6,1600,541,876,1417,Wednesday
2016,7,6,1500,633,649,1282,Wednesday
2016,7,6,1400,691,689,1380,Wednesday
2016,7,6,1300,944,591,1535,Wednesday
2016,7,6,1200,1048,387,1435,Wednesday
2016,7,6,1100,996,319,1315,Wednesday
2016,7,6,1000,887,207,1094,Wednesday
2016,7,6,900,685,186,871,Wednesday
2016,7,6,800,353,102,455,Wednesday
2016,7,6,700,168,62,230,Wednesday
2016,7,6,600,58,49,107,Wednesday
2016,7,6,500,31,33,64,Wednesday
2016,7,6,400,34,39,73,Wednesday
2016,7,6,300,29,51,80,Wednesday
2016,7,6,200,33,69,102,Wednesday
2016,7,6,100,51,95,146,Wednesday
2016,7,5,2400,87,135,222,Tuesday
2016,7,5,2300,125,223,348,Tuesday
2016,7,5,2200,127,394,521,Tuesday
2016,7,5,2100,211,695,906,Tuesday
2016,7,5,2000,238,760,998,Tuesday
2016,7,5,1900,297,1165,1462,Tuesday
2016,7,5,1800,359,1021,1380,Tuesday
2016,7,5,1700,443,999,1442,Tuesday
2016,7,5,1600,491,1032,1523,Tuesday
2016,7,5,1500,599,886,1485,Tuesday
2016,7,5,1400,590,675,1265,Tuesday
2016,7,5,1300,820,622,1442,Tuesday
2016,7,5,1200,972,513,1485,Tuesday
2016,7,5,1100,1001,367,1368,Tuesday
2016,7,5,1000,890,263,1153,Tuesday
2016,7,5,900,726,203,929,Tuesday
2016,7,5,800,392,135,527,Tuesday
2016,7,5,700,198,77,275,Tuesday
2016,7,5,600,82,58,140,Tuesday
2016,7,5,500,42,43,85,Tuesday
2016,7,5,400,22,48,70,Tuesday
2016,7,5,300,26,47,73,Tuesday
2016,7,5,200,32,66,98,Tuesday
2016,7,5,100,47,94,141,Tuesday
2016,7,4,2400,80,170,250,Monday
2016,7,4,2300,89,332,421,Monday
2016,7,4,2200,153,604,757,Monday
2016,7,4,2100,193,834,1027,Monday
2016,7,4,2000,245,1100,1345,Monday
2016,7,4,1900,301,1404,1705,Monday
2016,7,4,1800,414,1556,1970,Monday
2016,7,4,1700,447,1547,1994,Monday
2016,7,4,1600,605,1509,2114,Monday
2016,7,4,1500,774,1383,2157,Monday
2016,7,4,1400,857,1034,1891,Monday
2016,7,4,1300,981,881,1862,Monday
2016,7,4,1200,1147,693,1840,Monday
2016,7,4,1100,1189,480,1669,Monday
2016,7,4,1000,1086,313,1399,Monday
2016,7,4,900,816,254,1070,Monday
2016,7,4,800,446,174,620,Monday
2016,7,4,700,180,103,283,Monday
2016,7,4,600,87,53,140,Monday
2016,7,4,500,49,37,86,Monday
2016,7,4,400,19,33,52,Monday
2016,7,4,300,20,64,84,Monday
2016,7,4,200,22,104,126,Monday
2016,7,4,100,36,162,198,Monday
2016,7,3,2400,58,326,384,Sunday
2016,7,3,2300,105,518,623,Sunday
2016,7,3,2200,147,977,1124,Sunday
2016,7,3,2100,172,1576,1748,Sunday
2016,7,3,2000,240,2042,2282,Sunday
2016,7,3,1900,321,2039,2360,Sunday
2016,7,3,1800,420,2243,2663,Sunday
2016,7,3,1700,507,2289,2796,Sunday
2016,7,3,1600,674,2257,2931,Sunday
2016,7,3,1500,833,2063,2896,Sunday
2016,7,3,1400,1018,1438,2456,Sunday
2016,7,3,1300,1145,1413,2558,Sunday
2016,7,3,1200,1286,1155,2441,Sunday
2016,7,3,1100,1151,698,1849,Sunday
2016,7,3,1000,1043,313,1356,Sunday
2016,7,3,900,809,195,1004,Sunday
2016,7,3,800,449,88,537,Sunday
2016,7,3,700,193,50,243,Sunday
2016,7,3,600,75,33,108,Sunday
2016,7,3,500,43,24,67,Sunday
2016,7,3,400,18,42,60,Sunday
2016,7,3,300,22,34,56,Sunday
2016,7,3,200,24,75,99,Sunday
2016,7,3,100,47,120,167,Sunday
2016,7,2,2400,96,221,317,Saturday
2016,7,2,2300,108,420,528,Saturday
2016,7,2,2200,145,731,876,Saturday
2016,7,2,2100,192,979,1171,Saturday
2016,7,2,2000,268,1035,1303,Saturday
2016,7,2,1900,341,1231,1572,Saturday
2016,7,2,1800,455,1208,1663,Saturday
2016,7,2,1700,602,1197,1799,Saturday
2016,7,2,1600,783,1088,1871,Saturday
2016,7,2,1500,970,887,1857,Saturday
2016,7,2,1400,1086,779,1865,Saturday
2016,7,2,1300,1011,700,1711,Saturday
2016,7,2,1200,1478,484,1962,Saturday
2016,7,2,1100,1479,314,1793,Saturday
2016,7,2,1000,1269,183,1452,Saturday
2016,7,2,900,924,122,1046,Saturday
2016,7,2,800,487,68,555,Saturday
2016,7,2,700,199,34,233,Saturday
2016,7,2,600,92,21,113,Saturday
2016,7,2,500,37,22,59,Saturday
2016,7,2,400,23,37,60,Saturday
2016,7,2,300,18,28,46,Saturday
2016,7,2,200,30,56,86,Saturday
2016,7,2,100,50,70,120,Saturday
2016,7,1,2400,117,107,224,Friday
2016,7,1,2300,92,229,321,Friday
2016,7,1,2200,165,360,525,Friday
2016,7,1,2100,204,491,695,Friday
2016,7,1,2000,315,673,988,Friday
2016,7,1,1900,399,1041,1440,Friday
2016,7,1,1800,491,1116,1607,Friday
2016,7,1,1700,730,1020,1750,Friday
2016,7,1,1600,1170,990,2160,Friday
2016,7,1,1500,1543,772,2315,Friday
2016,7,1,1400,1596,785,2381,Friday
2016,7,1,1300,1703,585,2288,Friday
2016,7,1,1200,1644,481,2125,Friday
2016,7,1,1100,1261,353,1614,Friday
2016,7,1,1000,2104,249,2353,Friday
2016,7,1,900,1390,162,1552,Friday
2016,7,1,800,1045,98,1143,Friday
2016,7,1,700,529,53,582,Friday
2016,7,1,600,262,45,307,Friday
2016,7,1,500,106,41,147,Friday
2016,7,1,400,78,49,127,Friday
2016,7,1,300,101,53,154,Friday
2016,7,1,200,94,81,175,Friday
2016,7,1,100,153,126,279,Friday
2016,6,30,2400,223,174,397,Thursday
2016,6,30,2300,393,220,613,Thursday
2016,6,30,2200,726,341,1067,Thursday
2016,6,30,2100,1131,500,1631,Thursday
2016,6,30,2000,1451,564,2015,Thursday
2016,6,30,1900,1649,848,2497,Thursday
2016,6,30,1800,1557,829,2386,Thursday
2016,6,30,1700,1491,810,2301,Thursday
2016,6,30,1600,1573,698,2271,Thursday
2016,6,30,1500,1442,667,2109,Thursday
2016,6,30,1400,1453,764,2217,Thursday
2016,6,30,1300,1277,567,1844,Thursday
2016,6,30,1200,1710,540,2250,Thursday
2016,6,30,1100,1634,402,2036,Thursday
2016,6,30,1000,1446,237,1683,Thursday
2016,6,30,900,1100,193,1293,Thursday
2016,6,30,800,739,111,850,Thursday
2016,6,30,700,323,70,393,Thursday
2016,6,30,600,161,45,206,Thursday
2016,6,30,500,64,50,114,Thursday
2016,6,30,400,41,58,99,Thursday
2016,6,30,300,54,60,114,Thursday
2016,6,30,200,57,66,123,Thursday
2016,6,30,100,74,88,162,Thursday
2016,6,29,2400,154,150,304,Wednesday
2016,6,29,2300,204,203,407,Wednesday
2016,6,29,2200,295,343,638,Wednesday
2016,6,29,2100,418,493,911,Wednesday
2016,6,29,2000,605,599,1204,Wednesday
2016,6,29,1900,616,778,1394,Wednesday
2016,6,29,1800,685,832,1517,Wednesday
2016,6,29,1700,763,711,1474,Wednesday
2016,6,29,1600,891,705,1596,Wednesday
2016,6,29,1500,1627,604,2231,Wednesday
2016,6,29,1400,924,493,1417,Wednesday
2016,6,29,1300,813,423,1236,Wednesday
2016,6,29,1200,800,357,1157,Wednesday
2016,6,29,1100,878,306,1184,Wednesday
2016,6,29,1000,827,258,1085,Wednesday
2016,6,29,900,740,192,932,Wednesday
2016,6,29,800,444,120,564,Wednesday
2016,6,29,700,224,85,309,Wednesday
2016,6,29,600,83,54,137,Wednesday
2016,6,29,500,39,52,91,Wednesday
2016,6,29,400,39,51,90,Wednesday
2016,6,29,300,41,47,88,Wednesday
2016,6,29,200,40,70,110,Wednesday
2016,6,29,100,74,78,152,Wednesday
2016,6,28,2400,110,110,220,Tuesday
2016,6,28,2300,114,175,289,Tuesday
2016,6,28,2200,174,301,475,Tuesday
2016,6,28,2100,222,413,635,Tuesday
2016,6,28,2000,283,549,832,Tuesday
2016,6,28,1900,306,746,1052,Tuesday
2016,6,28,1800,433,807,1240,Tuesday
2016,6,28,1700,517,766,1283,Tuesday
2016,6,28,1600,552,694,1246,Tuesday
2016,6,28,1500,585,555,1140,Tuesday
2016,6,28,1400,630,476,1106,Tuesday
2016,6,28,1300,824,424,1248,Tuesday
2016,6,28,1200,865,370,1235,Tuesday
2016,6,28,1100,839,310,1149,Tuesday
2016,6,28,1000,726,223,949,Tuesday
2016,6,28,900,564,170,734,Tuesday
2016,6,28,800,339,108,447,Tuesday
2016,6,28,700,165,63,228,Tuesday
2016,6,28,600,84,60,144,Tuesday
2016,6,28,500,46,41,87,Tuesday
2016,6,28,400,33,47,80,Tuesday
2016,6,28,300,33,55,88,Tuesday
2016,6,28,200,33,61,94,Tuesday
2016,6,28,100,50,96,146,Tuesday
2016,6,27,2400,88,134,222,Monday
2016,6,27,2300,127,246,373,Monday
2016,6,27,2200,154,361,515,Monday
2016,6,27,2100,197,540,737,Monday
2016,6,27,2000,206,668,874,Monday
2016,6,27,1900,279,837,1116,Monday
2016,6,27,1800,385,909,1294,Monday
2016,6,27,1700,444,894,1338,Monday
2016,6,27,1600,562,772,1334,Monday
2016,6,27,1500,655,629,1284,Monday
2016,6,27,1400,1163,515,1678,Monday
2016,6,27,1300,743,499,1242,Monday
2016,6,27,1200,751,359,1110,Monday
2016,6,27,1100,688,291,979,Monday
2016,6,27,1000,707,226,933,Monday
2016,6,27,900,575,186,761,Monday
2016,6,27,800,335,124,459,Monday
2016,6,27,700,161,75,236,Monday
2016,6,27,600,63,53,116,Monday
2016,6,27,500,38,28,66,Monday
2016,6,27,400,24,19,43,Monday
2016,6,27,300,20,29,49,Monday
2016,6,27,200,41,62,103,Monday
2016,6,27,100,37,99,136,Monday
2016,6,26,2400,57,168,225,Sunday
2016,6,26,2300,96,280,376,Sunday
2016,6,26,2200,151,528,679,Sunday
2016,6,26,2100,196,741,937,Sunday
2016,6,26,2000,271,1116,1387,Sunday
2016,6,26,1900,293,1355,1648,Sunday
2016,6,26,1800,364,1446,1810,Sunday
2016,6,26,1700,463,1362,1825,Sunday
2016,6,26,1600,628,1242,1870,Sunday
2016,6,26,1500,699,1099,1798,Sunday
2016,6,26,1400,719,882,1601,Sunday
2016,6,26,1300,813,785,1598,Sunday
2016,6,26,1200,1038,523,1561,Sunday
2016,6,26,1100,952,434,1386,Sunday
2016,6,26,1000,884,242,1126,Sunday
2016,6,26,900,638,131,769,Sunday
2016,6,26,800,296,60,356,Sunday
2016,6,26,700,112,27,139,Sunday
2016,6,26,600,46,19,65,Sunday
2016,6,26,500,28,16,44,Sunday
2016,6,26,400,24,22,46,Sunday
2016,6,26,300,33,35,68,Sunday
2016,6,26,200,23,37,60,Sunday
2016,6,26,100,30,54,84,Sunday
2016,6,25,2400,58,103,161,Saturday
2016,6,25,2300,98,178,276,Saturday
2016,6,25,2200,127,264,391,Saturday
2016,6,25,2100,187,408,595,Saturday
2016,6,25,2000,207,587,794,Saturday
2016,6,25,1900,244,879,1123,Saturday
2016,6,25,1800,338,900,1238,Saturday
2016,6,25,1700,445,734,1179,Saturday
2016,6,25,1600,593,676,1269,Saturday
2016,6,25,1500,838,534,1372,Saturday
2016,6,25,1400,611,470,1081,Saturday
2016,6,25,1300,771,421,1192,Saturday
2016,6,25,1200,1096,362,1458,Saturday
2016,6,25,1100,1133,271,1404,Saturday
2016,6,25,1000,888,217,1105,Saturday
2016,6,25,900,641,141,782,Saturday
2016,6,25,800,362,80,442,Saturday
2016,6,25,700,180,60,240,Saturday
2016,6,25,600,66,32,98,Saturday
2016,6,25,500,41,36,77,Saturday
2016,6,25,400,29,33,62,Saturday
2016,6,25,300,27,36,63,Saturday
2016,6,25,200,25,39,64,Saturday
2016,6,25,100,62,63,125,Saturday
2016,6,24,2400,101,91,192,Friday
2016,6,24,2300,196,175,371,Friday
2016,6,24,2200,238,252,490,Friday
2016,6,24,2100,499,341,840,Friday
2016,6,24,2000,707,456,1163,Friday
2016,6,24,1900,787,689,1476,Friday
2016,6,24,1800,759,700,1459,Friday
2016,6,24,1700,774,798,1572,Friday
2016,6,24,1600,878,679,1557,Friday
2016,6,24,1500,884,636,1520,Friday
2016,6,24,1400,803,538,1341,Friday
2016,6,24,1300,803,463,1266,Friday
2016,6,24,1200,859,410,1269,Friday
2016,6,24,1100,939,281,1220,Friday
2016,6,24,1000,845,221,1066,Friday
2016,6,24,900,678,138,816,Friday
2016,6,24,800,397,118,515,Friday
2016,6,24,700,193,57,250,Friday
2016,6,24,600,67,49,116,Friday
2016,6,24,500,47,31,78,Friday
2016,6,24,400,40,38,78,Friday
2016,6,24,300,27,42,69,Friday
2016,6,24,200,41,41,82,Friday
2016,6,24,100,57,72,129,Friday
2016,6,23,2400,99,107,206,Thursday
2016,6,23,2300,135,187,322,Thursday
2016,6,23,2200,216,260,476,Thursday
2016,6,23,2100,311,342,653,Thursday
2016,6,23,2000,375,424,799,Thursday
2016,6,23,1900,381,605,986,Thursday
2016,6,23,1800,464,748,1212,Thursday
2016,6,23,1700,502,858,1360,Thursday
2016,6,23,1600,520,740,1260,Thursday
2016,6,23,1500,571,594,1165,Thursday
2016,6,23,1400,706,503,1209,Thursday
2016,6,23,1300,670,434,1104,Thursday
2016,6,23,1200,731,344,1075,Thursday
2016,6,23,1100,800,308,1108,Thursday
2016,6,23,1000,741,200,941,Thursday
2016,6,23,900,580,162,742,Thursday
2016,6,23,800,344,107,451,Thursday
2016,6,23,700,177,63,240,Thursday
2016,6,23,600,57,47,104,Thursday
2016,6,23,500,33,29,62,Thursday
2016,6,23,400,36,40,76,Thursday
2016,6,23,300,36,39,75,Thursday
2016,6,23,200,44,52,96,Thursday
2016,6,23,100,52,57,109,Thursday
2016,6,22,2400,87,110,197,Wednesday
2016,6,22,2300,123,172,295,Wednesday
2016,6,22,2200,185,277,462,Wednesday
2016,6,22,2100,204,446,650,Wednesday
2016,6,22,2000,256,492,748,Wednesday
2016,6,22,1900,283,649,932,Wednesday
2016,6,22,1800,339,658,997,Wednesday
2016,6,22,1700,437,726,1163,Wednesday
2016,6,22,1600,466,634,1100,Wednesday
2016,6,22,1500,466,537,1003,Wednesday
2016,6,22,1400,487,453,940,Wednesday
2016,6,22,1300,657,403,1060,Wednesday
2016,6,22,1200,638,293,931,Wednesday
2016,6,22,1100,708,256,964,Wednesday
2016,6,22,1000,702,201,903,Wednesday
2016,6,22,900,594,151,745,Wednesday
2016,6,22,800,310,119,429,Wednesday
2016,6,22,700,157,72,229,Wednesday
2016,6,22,600,55,42,97,Wednesday
2016,6,22,500,32,37,69,Wednesday
2016,6,22,400,30,46,76,Wednesday
2016,6,22,300,29,42,71,Wednesday
2016,6,22,200,43,39,82,Wednesday
2016,6,22,100,49,64,113,Wednesday
2016,6,21,2400,75,82,157,Tuesday
2016,6,21,2300,118,169,287,Tuesday
2016,6,21,2200,134,251,385,Tuesday
2016,6,21,2100,202,413,615,Tuesday
2016,6,21,2000,186,473,659,Tuesday
2016,6,21,1900,233,602,835,Tuesday
2016,6,21,1800,280,734,1014,Tuesday
2016,6,21,1700,351,624,975,Tuesday
2016,6,21,1600,420,684,1104,Tuesday
2016,6,21,1500,445,523,968,Tuesday
2016,6,21,1400,547,458,1005,Tuesday
2016,6,21,1300,637,401,1038,Tuesday
2016,6,21,1200,644,322,966,Tuesday
2016,6,21,1100,586,234,820,Tuesday
2016,6,21,1000,625,226,851,Tuesday
2016,6,21,900,522,175,697,Tuesday
2016,6,21,800,292,116,408,Tuesday
2016,6,21,700,161,76,237,Tuesday
2016,6,21,600,46,57,103,Tuesday
2016,6,21,500,41,38,79,Tuesday
2016,6,21,400,20,36,56,Tuesday
2016,6,21,300,29,51,80,Tuesday
2016,6,21,200,28,77,105,Tuesday
2016,6,21,100,45,70,115,Tuesday
2016,6,20,2400,69,131,200,Monday
2016,6,20,2300,103,215,318,Monday
2016,6,20,2200,129,342,471,Monday
2016,6,20,2100,192,515,707,Monday
2016,6,20,2000,224,643,867,Monday
2016,6,20,1900,241,783,1024,Monday
2016,6,20,1800,309,797,1106,Monday
2016,6,20,1700,431,808,1239,Monday
2016,6,20,1600,551,678,1229,Monday
2016,6,20,1500,525,523,1048,Monday
2016,6,20,1400,595,438,1033,Monday
2016,6,20,1300,816,341,1157,Monday
2016,6,20,1200,795,336,1131,Monday
2016,6,20,1100,668,248,916,Monday
2016,6,20,1000,669,204,873,Monday
2016,6,20,900,525,145,670,Monday
2016,6,20,800,309,103,412,Monday
2016,6,20,700,139,67,206,Monday
2016,6,20,600,65,27,92,Monday
2016,6,20,500,27,27,54,Monday
2016,6,20,400,18,29,47,Monday
2016,6,20,300,22,27,49,Monday
2016,6,20,200,19,43,62,Monday
2016,6,20,100,38,78,116,Monday
2016,6,19,2400,49,118,167,Sunday
2016,6,19,2300,83,213,296,Sunday
2016,6,19,2200,119,380,499,Sunday
2016,6,19,2100,201,652,853,Sunday
2016,6,19,2000,202,852,1054,Sunday
2016,6,19,1900,243,967,1210,Sunday
2016,6,19,1800,310,1108,1418,Sunday
2016,6,19,1700,347,1215,1562,Sunday
2016,6,19,1600,483,1164,1647,Sunday
2016,6,19,1500,517,1117,1634,Sunday
2016,6,19,1400,601,894,1495,Sunday
2016,6,19,1300,672,829,1501,Sunday
2016,6,19,1200,741,622,1363,Sunday
2016,6,19,1100,713,421,1134,Sunday
2016,6,19,1000,580,252,832,Sunday
2016,6,19,900,339,117,456,Sunday
2016,6,19,800,191,80,271,Sunday
2016,6,19,700,96,27,123,Sunday
2016,6,19,600,39,15,54,Sunday
2016,6,19,500,29,20,49,Sunday
2016,6,19,400,11,21,32,Sunday
2016,6,19,300,17,22,39,Sunday
2016,6,19,200,25,27,52,Sunday
2016,6,19,100,36,70,106,Sunday
2016,6,18,2400,40,84,124,Saturday
2016,6,18,2300,83,163,246,Saturday
2016,6,18,2200,119,253,372,Saturday
2016,6,18,2100,159,312,471,Saturday
2016,6,18,2000,191,440,631,Saturday
2016,6,18,1900,220,644,864,Saturday
2016,6,18,1800,255,818,1073,Saturday
2016,6,18,1700,372,1003,1375,Saturday
2016,6,18,1600,427,887,1314,Saturday
2016,6,18,1500,474,612,1086,Saturday
2016,6,18,1400,577,518,1095,Saturday
2016,6,18,1300,627,443,1070,Saturday
2016,6,18,1200,891,349,1240,Saturday
2016,6,18,1100,861,268,1129,Saturday
2016,6,18,1000,813,204,1017,Saturday
2016,6,18,900,574,124,698,Saturday
2016,6,18,800,291,80,371,Saturday
2016,6,18,700,171,56,227,Saturday
2016,6,18,600,52,28,80,Saturday
2016,6,18,500,34,34,68,Saturday
2016,6,18,400,36,32,68,Saturday
2016,6,18,300,26,35,61,Saturday
2016,6,18,200,40,45,85,Saturday
2016,6,18,100,58,69,127,Saturday
2016,6,17,2400,76,123,199,Friday
2016,6,17,2300,151,175,326,Friday
2016,6,17,2200,266,246,512,Friday
2016,6,17,2100,437,429,866,Friday
2016,6,17,2000,617,552,1169,Friday
2016,6,17,1900,703,607,1310,Friday
2016,6,17,1800,756,744,1500,Friday
2016,6,17,1700,781,718,1499,Friday
2016,6,17,1600,765,618,1383,Friday
2016,6,17,1500,786,544,1330,Friday
2016,6,17,1400,702,468,1170,Friday
2016,6,17,1300,708,397,1105,Friday
2016,6,17,1200,962,334,1296,Friday
2016,6,17,1100,905,304,1209,Friday
2016,6,17,1000,771,209,980,Friday
2016,6,17,900,569,138,707,Friday
2016,6,17,800,327,98,425,Friday
2016,6,17,700,184,66,250,Friday
2016,6,17,600,69,40,109,Friday
2016,6,17,500,60,37,97,Friday
2016,6,17,400,40,32,72,Friday
2016,6,17,300,35,42,77,Friday
2016,6,17,200,40,53,93,Friday
2016,6,17,100,52,80,132,Friday
2016,6,16,2400,91,97,188,Thursday
2016,6,16,2300,152,156,308,Thursday
2016,6,16,2200,196,224,420,Thursday
2016,6,16,2100,273,358,631,Thursday
2016,6,16,2000,396,485,881,Thursday
2016,6,16,1900,406,638,1044,Thursday
2016,6,16,1800,500,726,1226,Thursday
2016,6,16,1700,494,606,1100,Thursday
2016,6,16,1600,573,590,1163,Thursday
2016,6,16,1500,574,462,1036,Thursday
2016,6,16,1400,580,433,1013,Thursday
2016,6,16,1300,567,368,935,Thursday
2016,6,16,1200,721,287,1008,Thursday
2016,6,16,1100,727,217,944,Thursday
2016,6,16,1000,737,178,915,Thursday
2016,6,16,900,522,150,672,Thursday
2016,6,16,800,280,84,364,Thursday
2016,6,16,700,144,71,215,Thursday
2016,6,16,600,55,41,96,Thursday
2016,6,16,500,49,32,81,Thursday
2016,6,16,400,42,30,72,Thursday
2016,6,16,300,30,44,74,Thursday
2016,6,16,200,35,57,92,Thursday
2016,6,16,100,41,53,94,Thursday
2016,6,15,2400,81,95,176,Wednesday
2016,6,15,2300,107,157,264,Wednesday
2016,6,15,2200,143,233,376,Wednesday
2016,6,15,2100,205,341,546,Wednesday
2016,6,15,2000,250,443,693,Wednesday
2016,6,15,1900,269,568,837,Wednesday
2016,6,15,1800,295,683,978,Wednesday
2016,6,15,1700,325,643,968,Wednesday
2016,6,15,1600,393,605,998,Wednesday
2016,6,15,1500,463,465,928,Wednesday
2016,6,15,1400,518,384,902,Wednesday
2016,6,15,1300,578,405,983,Wednesday
2016,6,15,1200,701,323,1024,Wednesday
2016,6,15,1100,660,264,924,Wednesday
2016,6,15,1000,668,196,864,Wednesday
2016,6,15,900,457,174,631,Wednesday
2016,6,15,800,271,131,402,Wednesday
2016,6,15,700,146,55,201,Wednesday
2016,6,15,600,58,44,102,Wednesday
2016,6,15,500,25,36,61,Wednesday
2016,6,15,400,33,35,68,Wednesday
2016,6,15,300,24,39,63,Wednesday
2016,6,15,200,40,49,89,Wednesday
2016,6,15,100,54,89,143,Wednesday
2016,6,14,2400,71,83,154,Tuesday
2016,6,14,2300,91,157,248,Tuesday
2016,6,14,2200,103,191,294,Tuesday
2016,6,14,2100,159,305,464,Tuesday
2016,6,14,2000,181,372,553,Tuesday
2016,6,14,1900,207,484,691,Tuesday
2016,6,14,1800,265,584,849,Tuesday
2016,6,14,1700,305,590,895,Tuesday
2016,6,14,1600,350,522,872,Tuesday
2016,6,14,1500,427,464,891,Tuesday
2016,6,14,1400,407,558,965,Tuesday
2016,6,14,1300,501,387,888,Tuesday
2016,6,14,1200,603,304,907,Tuesday
2016,6,14,1100,626,234,860,Tuesday
2016,6,14,1000,554,189,743,Tuesday
2016,6,14,900,375,162,537,Tuesday
2016,6,14,800,210,113,323,Tuesday
2016,6,14,700,102,51,153,Tuesday
2016,6,14,600,60,52,112,Tuesday
2016,6,14,500,39,30,69,Tuesday
2016,6,14,400,33,29,62,Tuesday
2016,6,14,300,30,32,62,Tuesday
2016,6,14,200,36,49,85,Tuesday
2016,6,14,100,44,83,127,Tuesday
2016,6,13,2400,66,124,190,Monday
2016,6,13,2300,98,134,232,Monday
2016,6,13,2200,121,203,324,Monday
2016,6,13,2100,157,405,562,Monday
2016,6,13,2000,162,609,771,Monday
2016,6,13,1900,240,612,852,Monday
2016,6,13,1800,243,726,969,Monday
2016,6,13,1700,348,792,1140,Monday
2016,6,13,1600,400,699,1099,Monday
2016,6,13,1500,421,618,1039,Monday
2016,6,13,1400,466,480,946,Monday
2016,6,13,1300,547,372,919,Monday
2016,6,13,1200,719,342,1061,Monday
2016,6,13,1100,753,277,1030,Monday
2016,6,13,1000,610,178,788,Monday
2016,6,13,900,467,138,605,Monday
2016,6,13,800,230,94,324,Monday
2016,6,13,700,134,68,202,Monday
2016,6,13,600,50,32,82,Monday
2016,6,13,500,33,30,63,Monday
2016,6,13,400,20,14,34,Monday
2016,6,13,300,11,21,32,Monday
2016,6,13,200,25,54,79,Monday
2016,6,13,100,40,88,128,Monday
2016,6,12,2400,43,130,173,Sunday
2016,6,12,2300,76,207,283,Sunday
2016,6,12,2200,131,350,481,Sunday
2016,6,12,2100,153,599,752,Sunday
2016,6,12,2000,231,796,1027,Sunday
2016,6,12,1900,271,1118,1389,Sunday
2016,6,12,1800,311,1241,1552,Sunday
2016,6,12,1700,372,1354,1726,Sunday
2016,6,12,1600,440,1197,1637,Sunday
2016,6,12,1500,545,1007,1552,Sunday
2016,6,12,1400,621,797,1418,Sunday
2016,6,12,1300,582,681,1263,Sunday
2016,6,12,1200,794,520,1314,Sunday
2016,6,12,1100,840,286,1126,Sunday
2016,6,12,1000,683,189,872,Sunday
2016,6,12,900,455,116,571,Sunday
2016,6,12,800,243,55,298,Sunday
2016,6,12,700,100,27,127,Sunday
2016,6,12,600,37,16,53,Sunday
2016,6,12,500,23,22,45,Sunday
2016,6,12,400,19,14,33,Sunday
2016,6,12,300,15,25,40,Sunday
2016,6,12,200,32,29,61,Sunday
2016,6,12,100,28,52,80,Sunday
2016,6,11,2400,53,80,133,Saturday
2016,6,11,2300,86,131,217,Saturday
2016,6,11,2200,110,221,331,Saturday
2016,6,11,2100,132,318,450,Saturday
2016,6,11,2000,163,467,630,Saturday
2016,6,11,1900,207,562,769,Saturday
2016,6,11,1800,241,657,898,Saturday
2016,6,11,1700,334,774,1108,Saturday
2016,6,11,1600,362,726,1088,Saturday
2016,6,11,1500,488,504,992,Saturday
2016,6,11,1400,571,446,1017,Saturday
2016,6,11,1300,626,388,1014,Saturday
2016,6,11,1200,790,330,1120,Saturday
2016,6,11,1100,778,287,1065,Saturday
2016,6,11,1000,649,255,904,Saturday
2016,6,11,900,527,166,693,Saturday
2016,6,11,800,284,99,383,Saturday
2016,6,11,700,145,54,199,Saturday
2016,6,11,600,59,38,97,Saturday
2016,6,11,500,49,19,68,Saturday
2016,6,11,400,34,31,65,Saturday
2016,6,11,300,22,33,55,Saturday
2016,6,11,200,26,37,63,Saturday
2016,6,11,100,45,72,117,Saturday
2016,6,10,2400,74,85,159,Friday
2016,6,10,2300,135,131,266,Friday
2016,6,10,2200,219,189,408,Friday
2016,6,10,2100,364,269,633,Friday
2016,6,10,2000,521,342,863,Friday
2016,6,10,1900,617,460,1077,Friday
2016,6,10,1800,697,535,1232,Friday
2016,6,10,1700,866,581,1447,Friday
2016,6,10,1600,855,663,1518,Friday
2016,6,10,1500,562,667,1229,Friday
2016,6,10,1400,485,430,915,Friday
2016,6,10,1300,577,436,1013,Friday
2016,6,10,1200,613,353,966,Friday
2016,6,10,1100,727,276,1003,Friday
2016,6,10,1000,686,188,874,Friday
2016,6,10,900,497,130,627,Friday
2016,6,10,800,262,108,370,Friday
2016,6,10,700,171,69,240,Friday
2016,6,10,600,62,51,113,Friday
2016,6,10,500,25,40,65,Friday
2016,6,10,400,32,36,68,Friday
2016,6,10,300,42,45,87,Friday
2016,6,10,200,43,60,103,Friday
2016,6,10,100,60,71,131,Friday
2016,6,9,2400,83,127,210,Thursday
2016,6,9,2300,119,150,269,Thursday
2016,6,9,2200,172,242,414,Thursday
2016,6,9,2100,261,393,654,Thursday
2016,6,9,2000,325,422,747,Thursday
2016,6,9,1900,335,520,855,Thursday
2016,6,9,1800,420,628,1048,Thursday
2016,6,9,1700,434,590,1024,Thursday
2016,6,9,1600,472,610,1082,Thursday
2016,6,9,1500,493,436,929,Thursday
2016,6,9,1400,502,426,928,Thursday
2016,6,9,1300,619,348,967,Thursday
2016,6,9,1200,671,319,990,Thursday
2016,6,9,1100,745,220,965,Thursday
2016,6,9,1000,631,185,816,Thursday
2016,6,9,900,542,148,690,Thursday
2016,6,9,800,296,96,392,Thursday
2016,6,9,700,136,67,203,Thursday
2016,6,9,600,54,42,96,Thursday
2016,6,9,500,36,36,72,Thursday
2016,6,9,400,30,40,70,Thursday
2016,6,9,300,32,50,82,Thursday
2016,6,9,200,38,34,72,Thursday
2016,6,9,100,47,65,112,Thursday
2016,6,8,2400,66,81,147,Wednesday
2016,6,8,2300,86,150,236,Wednesday
2016,6,8,2200,142,214,356,Wednesday
2016,6,8,2100,196,318,514,Wednesday
2016,6,8,2000,231,407,638,Wednesday
2016,6,8,1900,234,523,757,Wednesday
2016,6,8,1800,287,592,879,Wednesday
2016,6,8,1700,297,571,868,Wednesday
2016,6,8,1600,362,568,930,Wednesday
2016,6,8,1500,387,463,850,Wednesday
2016,6,8,1400,439,366,805,Wednesday
2016,6,8,1300,469,349,818,Wednesday
2016,6,8,1200,677,323,1000,Wednesday
2016,6,8,1100,645,235,880,Wednesday
2016,6,8,1000,628,208,836,Wednesday
2016,6,8,900,422,164,586,Wednesday
2016,6,8,800,262,119,381,Wednesday
2016,6,8,700,128,55,183,Wednesday
2016,6,8,600,51,37,88,Wednesday
2016,6,8,500,30,35,65,Wednesday
2016,6,8,400,24,32,56,Wednesday
2016,6,8,300,29,41,70,Wednesday
2016,6,8,200,32,59,91,Wednesday
2016,6,8,100,47,72,119,Wednesday
2016,6,7,2400,84,90,174,Tuesday
2016,6,7,2300,103,162,265,Tuesday
2016,6,7,2200,134,269,403,Tuesday
2016,6,7,2100,183,294,477,Tuesday
2016,6,7,2000,163,397,560,Tuesday
2016,6,7,1900,189,530,719,Tuesday
2016,6,7,1800,245,601,846,Tuesday
2016,6,7,1700,301,651,952,Tuesday
2016,6,7,1600,342,542,884,Tuesday
2016,6,7,1500,364,425,789,Tuesday
2016,6,7,1400,473,424,897,Tuesday
2016,6,7,1300,508,379,887,Tuesday
2016,6,7,1200,620,269,889,Tuesday
2016,6,7,1100,620,255,875,Tuesday
2016,6,7,1000,573,183,756,Tuesday
2016,6,7,900,428,156,584,Tuesday
2016,6,7,800,249,116,365,Tuesday
2016,6,7,700,108,64,172,Tuesday
2016,6,7,600,46,39,85,Tuesday
2016,6,7,500,25,33,58,Tuesday
2016,6,7,400,28,34,62,Tuesday
2016,6,7,300,21,47,68,Tuesday
2016,6,7,200,28,51,79,Tuesday
2016,6,7,100,52,59,111,Tuesday
2016,6,6,2400,61,94,155,Monday
2016,6,6,2300,91,173,264,Monday
2016,6,6,2200,114,268,382,Monday
2016,6,6,2100,167,369,536,Monday
2016,6,6,2000,164,524,688,Monday
2016,6,6,1900,178,702,880,Monday
2016,6,6,1800,279,783,1062,Monday
2016,6,6,1700,326,773,1099,Monday
2016,6,6,1600,372,623,995,Monday
2016,6,6,1500,470,578,1048,Monday
2016,6,6,1400,508,469,977,Monday
2016,6,6,1300,619,413,1032,Monday
2016,6,6,1200,671,361,1032,Monday
2016,6,6,1100,711,282,993,Monday
2016,6,6,1000,582,209,791,Monday
2016,6,6,900,494,146,640,Monday
2016,6,6,800,237,101,338,Monday
2016,6,6,700,143,95,238,Monday
2016,6,6,600,52,51,103,Monday
2016,6,6,500,19,21,40,Monday
2016,6,6,400,21,25,46,Monday
2016,6,6,300,18,22,40,Monday
2016,6,6,200,24,48,72,Monday
2016,6,6,100,46,84,130,Monday
2016,6,5,2400,60,129,189,Sunday
2016,6,5,2300,100,281,381,Sunday
2016,6,5,2200,108,446,554,Sunday
2016,6,5,2100,165,738,903,Sunday
2016,6,5,2000,207,1010,1217,Sunday
2016,6,5,1900,228,1274,1502,Sunday
2016,6,5,1800,315,1313,1628,Sunday
2016,6,5,1700,378,1297,1675,Sunday
2016,6,5,1600,431,1156,1587,Sunday
2016,6,5,1500,514,940,1454,Sunday
2016,6,5,1400,662,953,1615,Sunday
2016,6,5,1300,651,726,1377,Sunday
2016,6,5,1200,819,578,1397,Sunday
2016,6,5,1100,862,379,1241,Sunday
2016,6,5,1000,742,236,978,Sunday
2016,6,5,900,441,126,567,Sunday
2016,6,5,800,228,66,294,Sunday
2016,6,5,700,94,39,133,Sunday
2016,6,5,600,36,19,55,Sunday
2016,6,5,500,21,14,35,Sunday
2016,6,5,400,26,16,42,Sunday
2016,6,5,300,27,22,49,Sunday
2016,6,5,200,23,53,76,Sunday
2016,6,5,100,29,68,97,Sunday
2016,6,4,2400,48,124,172,Saturday
2016,6,4,2300,93,190,283,Saturday
2016,6,4,2200,126,302,428,Saturday
2016,6,4,2100,168,502,670,Saturday
2016,6,4,2000,189,552,741,Saturday
2016,6,4,1900,225,750,975,Saturday
2016,6,4,1800,323,854,1177,Saturday
2016,6,4,1700,352,734,1086,Saturday
2016,6,4,1600,503,617,1120,Saturday
2016,6,4,1500,699,524,1223,Saturday
2016,6,4,1400,810,397,1207,Saturday
2016,6,4,1300,827,358,1185,Saturday
2016,6,4,1200,757,291,1048,Saturday
2016,6,4,1100,754,241,995,Saturday
2016,6,4,1000,751,216,967,Saturday
2016,6,4,900,548,134,682,Saturday
2016,6,4,800,341,100,441,Saturday
2016,6,4,700,175,63,238,Saturday
2016,6,4,600,53,47,100,Saturday
2016,6,4,500,31,26,57,Saturday
2016,6,4,400,25,31,56,Saturday
2016,6,4,300,26,37,63,Saturday
2016,6,4,200,30,52,82,Saturday
2016,6,4,100,70,61,131,Saturday
2016,6,3,2400,93,106,199,Friday
2016,6,3,2300,160,134,294,Friday
2016,6,3,2200,251,256,507,Friday
2016,6,3,2100,462,292,754,Friday
2016,6,3,2000,641,435,1076,Friday
2016,6,3,1900,702,568,1270,Friday
2016,6,3,1800,846,600,1446,Friday
2016,6,3,1700,909,608,1517,Friday
2016,6,3,1600,753,521,1274,Friday
2016,6,3,1500,742,469,1211,Friday
2016,6,3,1400,794,385,1179,Friday
2016,6,3,1300,760,387,1147,Friday
2016,6,3,1200,551,292,843,Friday
2016,6,3,1100,602,254,856,Friday
2016,6,3,1000,619,189,808,Friday
2016,6,3,900,504,140,644,Friday
2016,6,3,800,308,104,412,Friday
2016,6,3,700,194,71,265,Friday
2016,6,3,600,53,41,94,Friday
2016,6,3,500,35,22,57,Friday
2016,6,3,400,47,35,82,Friday
2016,6,3,300,39,34,73,Friday
2016,6,3,200,33,52,85,Friday
2016,6,3,100,57,74,131,Friday
2016,6,2,2400,93,91,184,Thursday
2016,6,2,2300,110,135,245,Thursday
2016,6,2,2200,204,210,414,Thursday
2016,6,2,2100,271,274,545,Thursday
2016,6,2,2000,349,391,740,Thursday
2016,6,2,1900,409,465,874,Thursday
2016,6,2,1800,390,575,965,Thursday
2016,6,2,1700,459,624,1083,Thursday
2016,6,2,1600,500,502,1002,Thursday
2016,6,2,1500,492,433,925,Thursday
2016,6,2,1400,513,414,927,Thursday
2016,6,2,1300,539,320,859,Thursday
2016,6,2,1200,609,289,898,Thursday
2016,6,2,1100,627,227,854,Thursday
2016,6,2,1000,565,195,760,Thursday
2016,6,2,900,462,146,608,Thursday
2016,6,2,800,238,87,325,Thursday
2016,6,2,700,128,64,192,Thursday
2016,6,2,600,53,45,98,Thursday
2016,6,2,500,36,29,65,Thursday
2016,6,2,400,28,29,57,Thursday
2016,6,2,300,34,40,74,Thursday
2016,6,2,200,38,45,83,Thursday
2016,6,2,100,46,71,117,Thursday
2016,6,1,2400,77,84,161,Wednesday
2016,6,1,2300,102,122,224,Wednesday
2016,6,1,2200,147,200,347,Wednesday
2016,6,1,2100,185,237,422,Wednesday
2016,6,1,2000,203,382,585,Wednesday
2016,6,1,1900,191,491,682,Wednesday
2016,6,1,1800,260,558,818,Wednesday
2016,6,1,1700,340,544,884,Wednesday
2016,6,1,1600,379,488,867,Wednesday
2016,6,1,1500,380,441,821,Wednesday
2016,6,1,1400,452,333,785,Wednesday
2016,6,1,1300,490,340,830,Wednesday
2016,6,1,1200,564,291,855,Wednesday
2016,6,1,1100,515,234,749,Wednesday
2016,6,1,1000,444,157,601,Wednesday
2016,6,1,900,358,142,500,Wednesday
2016,6,1,800,214,100,314,Wednesday
2016,6,1,700,132,65,197,Wednesday
2016,6,1,600,37,42,79,Wednesday
2016,6,1,500,27,43,70,Wednesday
2016,6,1,400,32,35,67,Wednesday
2016,6,1,300,30,28,58,Wednesday
2016,6,1,200,36,48,84,Wednesday
2016,6,1,100,52,71,123,Wednesday
2016,5,31,2400,61,88,149,Tuesday
2016,5,31,2300,101,154,255,Tuesday
2016,5,31,2200,111,222,333,Tuesday
2016,5,31,2100,171,289,460,Tuesday
2016,5,31,2000,181,394,575,Tuesday
2016,5,31,1900,198,510,708,Tuesday
2016,5,31,1800,226,594,820,Tuesday
2016,5,31,1700,287,553,840,Tuesday
2016,5,31,1600,315,489,804,Tuesday
2016,5,31,1500,382,418,800,Tuesday
2016,5,31,1400,422,370,792,Tuesday
2016,5,31,1300,448,291,739,Tuesday
2016,5,31,1200,494,237,731,Tuesday
2016,5,31,1100,565,218,783,Tuesday
2016,5,31,1000,530,163,693,Tuesday
2016,5,31,900,380,136,516,Tuesday
2016,5,31,800,224,105,329,Tuesday
2016,5,31,700,118,55,173,Tuesday
2016,5,31,600,57,43,100,Tuesday
2016,5,31,500,23,33,56,Tuesday
2016,5,31,400,23,35,58,Tuesday
2016,5,31,300,18,36,54,Tuesday
2016,5,31,200,28,55,83,Tuesday
2016,5,31,100,35,72,107,Tuesday
2016,5,30,2400,58,90,148,Monday
2016,5,30,2300,79,124,203,Monday
2016,5,30,2200,105,214,319,Monday
2016,5,30,2100,184,333,517,Monday
2016,5,30,2000,177,434,611,Monday
2016,5,30,1900,197,542,739,Monday
2016,5,30,1800,274,657,931,Monday
2016,5,30,1700,301,637,938,Monday
2016,5,30,1600,385,617,1002,Monday
2016,5,30,1500,422,499,921,Monday
2016,5,30,1400,512,396,908,Monday
2016,5,30,1300,513,399,912,Monday
2016,5,30,1200,596,320,916,Monday
2016,5,30,1100,659,223,882,Monday
2016,5,30,1000,569,175,744,Monday
2016,5,30,900,455,133,588,Monday
2016,5,30,800,240,83,323,Monday
2016,5,30,700,139,55,194,Monday
2016,5,30,600,59,26,85,Monday
2016,5,30,500,26,27,53,Monday
2016,5,30,400,26,15,41,Monday
2016,5,30,300,11,26,37,Monday
2016,5,30,200,21,70,91,Monday
2016,5,30,100,43,79,122,Monday
2016,5,29,2400,43,145,188,Sunday
2016,5,29,2300,79,283,362,Sunday
2016,5,29,2200,115,261,376,Sunday
2016,5,29,2100,142,383,525,Sunday
2016,5,29,2000,194,612,806,Sunday
2016,5,29,1900,229,830,1059,Sunday
2016,5,29,1800,313,999,1312,Sunday
2016,5,29,1700,355,1137,1492,Sunday
2016,5,29,1600,462,1027,1489,Sunday
2016,5,29,1500,522,944,1466,Sunday
2016,5,29,1400,527,941,1468,Sunday
2016,5,29,1300,581,764,1345,Sunday
2016,5,29,1200,593,585,1178,Sunday
2016,5,29,1100,607,390,997,Sunday
2016,5,29,1000,557,207,764,Sunday
2016,5,29,900,349,103,452,Sunday
2016,5,29,800,158,62,220,Sunday
2016,5,29,700,94,35,129,Sunday
2016,5,29,600,46,10,56,Sunday
2016,5,29,500,19,19,38,Sunday
2016,5,29,400,26,21,47,Sunday
2016,5,29,300,20,36,56,Sunday
2016,5,29,200,19,33,52,Sunday
2016,5,29,100,28,51,79,Sunday
2016,5,28,2400,45,81,126,Saturday
2016,5,28,2300,73,164,237,Saturday
2016,5,28,2200,111,258,369,Saturday
2016,5,28,2100,126,348,474,Saturday
2016,5,28,2000,153,498,651,Saturday
2016,5,28,1900,189,539,728,Saturday
2016,5,28,1800,275,657,932,Saturday
2016,5,28,1700,332,690,1022,Saturday
2016,5,28,1600,423,571,994,Saturday
2016,5,28,1500,476,505,981,Saturday
2016,5,28,1400,518,421,939,Saturday
2016,5,28,1300,574,380,954,Saturday
2016,5,28,1200,702,280,982,Saturday
2016,5,28,1100,707,213,920,Saturday
2016,5,28,1000,632,164,796,Saturday
2016,5,28,900,402,133,535,Saturday
2016,5,28,800,232,90,322,Saturday
2016,5,28,700,116,51,167,Saturday
2016,5,28,600,53,34,87,Saturday
2016,5,28,500,36,13,49,Saturday
2016,5,28,400,19,36,55,Saturday
2016,5,28,300,21,39,60,Saturday
2016,5,28,200,32,59,91,Saturday
2016,5,28,100,61,73,134,Saturday
2016,5,27,2400,82,97,179,Friday
2016,5,27,2300,152,130,282,Friday
2016,5,27,2200,196,192,388,Friday
2016,5,27,2100,341,220,561,Friday
2016,5,27,2000,408,372,780,Friday
2016,5,27,1900,594,473,1067,Friday
2016,5,27,1800,677,531,1208,Friday
2016,5,27,1700,647,593,1240,Friday
2016,5,27,1600,562,536,1098,Friday
2016,5,27,1500,612,549,1161,Friday
2016,5,27,1400,498,470,968,Friday
2016,5,27,1300,650,403,1053,Friday
2016,5,27,1200,728,384,1112,Friday
2016,5,27,1100,626,286,912,Friday
2016,5,27,1000,565,180,745,Friday
2016,5,27,900,342,149,491,Friday
2016,5,27,800,239,82,321,Friday
2016,5,27,700,134,58,192,Friday
2016,5,27,600,40,43,83,Friday
2016,5,27,500,36,37,73,Friday
2016,5,27,400,38,47,85,Friday
2016,5,27,300,32,47,79,Friday
2016,5,27,200,24,36,60,Friday
2016,5,27,100,64,53,117,Friday
2016,5,26,2400,84,215,299,Thursday
2016,5,26,2300,110,352,462,Thursday
2016,5,26,2200,144,86,230,Thursday
2016,5,26,2100,213,123,336,Thursday
2016,5,26,2000,252,251,503,Thursday
2016,5,26,1900,282,490,772,Thursday
2016,5,26,1800,331,524,855,Thursday
2016,5,26,1700,378,552,930,Thursday
2016,5,26,1600,407,515,922,Thursday
2016,5,26,1500,424,440,864,Thursday
2016,5,26,1400,450,386,836,Thursday
2016,5,26,1300,467,356,823,Thursday
2016,5,26,1200,562,282,844,Thursday
2016,5,26,1100,508,219,727,Thursday
2016,5,26,1000,518,160,678,Thursday
2016,5,26,900,352,139,491,Thursday
2016,5,26,800,286,92,378,Thursday
2016,5,26,700,130,62,192,Thursday
2016,5,26,600,54,48,102,Thursday
2016,5,26,500,33,33,66,Thursday
2016,5,26,400,30,29,59,Thursday
2016,5,26,300,26,50,76,Thursday
2016,5,26,200,32,40,72,Thursday
2016,5,26,100,47,58,105,Thursday
2016,5,25,2400,74,95,169,Wednesday
2016,5,25,2300,86,149,235,Wednesday
2016,5,25,2200,131,211,342,Wednesday
2016,5,25,2100,176,267,443,Wednesday
2016,5,25,2000,168,385,553,Wednesday
2016,5,25,1900,216,453,669,Wednesday
2016,5,25,1800,246,617,863,Wednesday
2016,5,25,1700,286,651,937,Wednesday
2016,5,25,1600,332,546,878,Wednesday
2016,5,25,1500,370,420,790,Wednesday
2016,5,25,1400,402,411,813,Wednesday
2016,5,25,1300,425,361,786,Wednesday
2016,5,25,1200,585,275,860,Wednesday
2016,5,25,1100,519,235,754,Wednesday
2016,5,25,1000,484,144,628,Wednesday
2016,5,25,900,336,132,468,Wednesday
2016,5,25,800,206,100,306,Wednesday
2016,5,25,700,128,66,194,Wednesday
2016,5,25,600,41,32,73,Wednesday
2016,5,25,500,27,31,58,Wednesday
2016,5,25,400,29,28,57,Wednesday
2016,5,25,300,23,36,59,Wednesday
2016,5,25,200,29,65,94,Wednesday
2016,5,25,100,44,91,135,Wednesday
2016,5,24,2400,65,118,183,Tuesday
2016,5,24,2300,76,202,278,Tuesday
2016,5,24,2200,109,285,394,Tuesday
2016,5,24,2100,129,420,549,Tuesday
2016,5,24,2000,155,608,763,Tuesday
2016,5,24,1900,200,913,1113,Tuesday
2016,5,24,1800,233,846,1079,Tuesday
2016,5,24,1700,296,793,1089,Tuesday
2016,5,24,1600,355,873,1228,Tuesday
2016,5,24,1500,419,582,1001,Tuesday
2016,5,24,1400,441,603,1044,Tuesday
2016,5,24,1300,505,546,1051,Tuesday
2016,5,24,1200,595,380,975,Tuesday
2016,5,24,1100,651,321,972,Tuesday
2016,5,24,1000,512,190,702,Tuesday
2016,5,24,900,416,181,597,Tuesday
2016,5,24,800,244,117,361,Tuesday
2016,5,24,700,126,69,195,Tuesday
2016,5,24,600,38,38,76,Tuesday
2016,5,24,500,35,32,67,Tuesday
2016,5,24,400,13,37,50,Tuesday
2016,5,24,300,15,40,55,Tuesday
2016,5,24,200,29,83,112,Tuesday
2016,5,24,100,25,108,133,Tuesday
2016,5,23,2400,25,184,209,Monday
2016,5,23,2300,54,372,426,Monday
2016,5,23,2200,88,591,679,Monday
2016,5,23,2100,110,969,1079,Monday
2016,5,23,2000,157,2049,2206,Monday
2016,5,23,1900,179,1285,1464,Monday
2016,5,23,1800,256,1705,1961,Monday
2016,5,23,1700,361,2149,2510,Monday
2016,5,23,1600,402,2276,2678,Monday
2016,5,23,1500,472,1954,2426,Monday
2016,5,23,1400,559,1800,2359,Monday
2016,5,23,1300,621,1450,2071,Monday
2016,5,23,1200,707,983,1690,Monday
2016,5,23,1100,670,571,1241,Monday
2016,5,23,1000,495,254,749,Monday
2016,5,23,900,338,150,488,Monday
2016,5,23,800,175,73,248,Monday
2016,5,23,700,85,29,114,Monday
2016,5,23,600,39,22,61,Monday
2016,5,23,500,25,19,44,Monday
2016,5,23,400,18,22,40,Monday
2016,5,23,300,16,44,60,Monday
2016,5,23,200,21,57,78,Monday
2016,5,23,100,31,88,119,Monday
2016,5,22,2400,33,104,137,Sunday
2016,5,22,2300,61,154,215,Sunday
2016,5,22,2200,88,272,360,Sunday
2016,5,22,2100,127,549,676,Sunday
2016,5,22,2000,155,532,687,Sunday
2016,5,22,1900,188,648,836,Sunday
2016,5,22,1800,265,835,1100,Sunday
2016,5,22,1700,359,821,1180,Sunday
2016,5,22,1600,380,878,1258,Sunday
2016,5,22,1500,461,792,1253,Sunday
2016,5,22,1400,513,690,1203,Sunday
2016,5,22,1300,538,648,1186,Sunday
2016,5,22,1200,536,469,1005,Sunday
2016,5,22,1100,517,281,798,Sunday
2016,5,22,1000,440,154,594,Sunday
2016,5,22,900,293,82,375,Sunday
2016,5,22,800,156,44,200,Sunday
2016,5,22,700,73,24,97,Sunday
2016,5,22,600,45,19,64,Sunday
2016,5,22,500,13,13,26,Sunday
2016,5,22,400,21,13,34,Sunday
2016,5,22,300,17,22,39,Sunday
2016,5,22,200,19,32,51,Sunday
2016,5,22,100,30,43,73,Sunday
2016,5,21,2400,41,84,125,Saturday
2016,5,21,2300,76,123,199,Saturday
2016,5,21,2200,113,202,315,Saturday
2016,5,21,2100,150,293,443,Saturday
2016,5,21,2000,190,484,674,Saturday
2016,5,21,1900,247,599,846,Saturday
2016,5,21,1800,347,639,986,Saturday
2016,5,21,1700,417,667,1084,Saturday
2016,5,21,1600,553,584,1137,Saturday
2016,5,21,1500,655,447,1102,Saturday
2016,5,21,1400,783,394,1177,Saturday
2016,5,21,1300,988,359,1347,Saturday
2016,5,21,1200,1118,308,1426,Saturday
2016,5,21,1100,990,235,1225,Saturday
2016,5,21,1000,830,168,998,Saturday
2016,5,21,900,590,113,703,Saturday
2016,5,21,800,455,79,534,Saturday
2016,5,21,700,225,46,271,Saturday
2016,5,21,600,87,39,126,Saturday
2016,5,21,500,36,43,79,Saturday
2016,5,21,400,39,31,70,Saturday
2016,5,21,300,34,27,61,Saturday
2016,5,21,200,48,55,103,Saturday
2016,5,21,100,54,65,119,Saturday
2016,5,20,2400,100,108,208,Friday
2016,5,20,2300,189,150,339,Friday
2016,5,20,2200,323,188,511,Friday
2016,5,20,2100,608,304,912,Friday
2016,5,20,2000,939,376,1315,Friday
2016,5,20,1900,1114,460,1574,Friday
2016,5,20,1800,1248,505,1753,Friday
2016,5,20,1700,1306,589,1895,Friday
2016,5,20,1600,1370,668,2038,Friday
2016,5,20,1500,1318,472,1790,Friday
2016,5,20,1400,1293,412,1705,Friday
2016,5,20,1300,1308,411,1719,Friday
2016,5,20,1200,1524,309,1833,Friday
2016,5,20,1100,1081,262,1343,Friday
2016,5,20,1000,1016,155,1171,Friday
2016,5,20,900,772,134,906,Friday
2016,5,20,800,487,90,577,Friday
2016,5,20,700,225,65,290,Friday
2016,5,20,600,96,38,134,Friday
2016,5,20,500,54,57,111,Friday
2016,5,20,400,73,37,110,Friday
2016,5,20,300,51,38,89,Friday
2016,5,20,200,57,55,112,Friday
2016,5,20,100,68,65,133,Friday
2016,5,19,2400,140,80,220,Thursday
2016,5,19,2300,162,124,286,Thursday
2016,5,19,2200,337,176,513,Thursday
2016,5,19,2100,544,233,777,Thursday
2016,5,19,2000,794,281,1075,Thursday
2016,5,19,1900,880,390,1270,Thursday
2016,5,19,1800,904,511,1415,Thursday
2016,5,19,1700,773,479,1252,Thursday
2016,5,19,1600,965,503,1468,Thursday
2016,5,19,1500,640,450,1090,Thursday
2016,5,19,1400,658,381,1039,Thursday
2016,5,19,1300,678,359,1037,Thursday
2016,5,19,1200,745,300,1045,Thursday
2016,5,19,1100,728,223,951,Thursday
2016,5,19,1000,608,154,762,Thursday
2016,5,19,900,430,123,553,Thursday
2016,5,19,800,279,83,362,Thursday
2016,5,19,700,173,47,220,Thursday
2016,5,19,600,70,34,104,Thursday
2016,5,19,500,34,39,73,Thursday
2016,5,19,400,31,30,61,Thursday
2016,5,19,300,21,42,63,Thursday
2016,5,19,200,30,42,72,Thursday
2016,5,19,100,57,68,125,Thursday
2016,5,18,2400,88,72,160,Wednesday
2016,5,18,2300,101,121,222,Wednesday
2016,5,18,2200,140,163,303,Wednesday
2016,5,18,2100,210,203,413,Wednesday
2016,5,18,2000,273,294,567,Wednesday
2016,5,18,1900,268,410,678,Wednesday
2016,5,18,1800,315,466,781,Wednesday
2016,5,18,1700,343,472,815,Wednesday
2016,5,18,1600,344,459,803,Wednesday
2016,5,18,1500,433,372,805,Wednesday
2016,5,18,1400,416,341,757,Wednesday
2016,5,18,1300,490,328,818,Wednesday
2016,5,18,1200,520,244,764,Wednesday
2016,5,18,1100,512,199,711,Wednesday
2016,5,18,1000,512,181,693,Wednesday
2016,5,18,900,372,144,516,Wednesday
2016,5,18,800,246,114,360,Wednesday
2016,5,18,700,115,56,171,Wednesday
2016,5,18,600,63,36,99,Wednesday
2016,5,18,500,25,37,62,Wednesday
2016,5,18,400,34,26,60,Wednesday
2016,5,18,300,17,38,55,Wednesday
2016,5,18,200,29,57,86,Wednesday
2016,5,18,100,43,76,119,Wednesday
2016,5,17,2400,72,73,145,Tuesday
2016,5,17,2300,89,113,202,Tuesday
2016,5,17,2200,109,147,256,Tuesday
2016,5,17,2100,153,250,403,Tuesday
2016,5,17,2000,165,289,454,Tuesday
2016,5,17,1900,190,389,579,Tuesday
2016,5,17,1800,250,450,700,Tuesday
2016,5,17,1700,262,508,770,Tuesday
2016,5,17,1600,289,443,732,Tuesday
2016,5,17,1500,338,423,761,Tuesday
2016,5,17,1400,359,327,686,Tuesday
2016,5,17,1300,388,270,658,Tuesday
2016,5,17,1200,485,231,716,Tuesday
2016,5,17,1100,478,205,683,Tuesday
2016,5,17,1000,401,143,544,Tuesday
2016,5,17,900,312,113,425,Tuesday
2016,5,17,800,184,90,274,Tuesday
2016,5,17,700,111,61,172,Tuesday
2016,5,17,600,43,44,87,Tuesday
2016,5,17,500,29,33,62,Tuesday
2016,5,17,400,16,39,55,Tuesday
2016,5,17,300,24,43,67,Tuesday
2016,5,17,200,26,49,75,Tuesday
2016,5,17,100,39,66,105,Tuesday
2016,5,16,2400,58,96,154,Monday
2016,5,16,2300,101,147,248,Monday
2016,5,16,2200,112,202,314,Monday
2016,5,16,2100,150,269,419,Monday
2016,5,16,2000,165,350,515,Monday
2016,5,16,1900,184,487,671,Monday
2016,5,16,1800,234,567,801,Monday
2016,5,16,1700,275,548,823,Monday
2016,5,16,1600,324,517,841,Monday
2016,5,16,1500,397,415,812,Monday
2016,5,16,1400,392,394,786,Monday
2016,5,16,1300,544,316,860,Monday
2016,5,16,1200,542,273,815,Monday
2016,5,16,1100,571,207,778,Monday
2016,5,16,1000,508,127,635,Monday
2016,5,16,900,356,117,473,Monday
2016,5,16,800,205,100,305,Monday
2016,5,16,700,114,40,154,Monday
2016,5,16,600,33,31,64,Monday
2016,5,16,500,18,25,43,Monday
2016,5,16,400,17,25,42,Monday
2016,5,16,300,16,34,50,Monday
2016,5,16,200,25,43,68,Monday
2016,5,16,100,39,82,121,Monday
2016,5,15,2400,45,133,178,Sunday
2016,5,15,2300,62,228,290,Sunday
2016,5,15,2200,89,482,571,Sunday
2016,5,15,2100,107,337,444,Sunday
2016,5,15,2000,143,676,819,Sunday
2016,5,15,1900,209,778,987,Sunday
2016,5,15,1800,255,897,1152,Sunday
2016,5,15,1700,320,907,1227,Sunday
2016,5,15,1600,396,862,1258,Sunday
2016,5,15,1500,403,715,1118,Sunday
2016,5,15,1400,496,595,1091,Sunday
2016,5,15,1300,633,525,1158,Sunday
2016,5,15,1200,637,325,962,Sunday
2016,5,15,1100,524,222,746,Sunday
2016,5,15,1000,474,157,631,Sunday
2016,5,15,900,284,72,356,Sunday
2016,5,15,800,193,46,239,Sunday
2016,5,15,700,90,24,114,Sunday
2016,5,15,600,39,11,50,Sunday
2016,5,15,500,17,15,32,Sunday
2016,5,15,400,18,13,31,Sunday
2016,5,15,300,15,14,29,Sunday
2016,5,15,200,24,29,53,Sunday
2016,5,15,100,33,34,67,Sunday
2016,5,14,2400,27,51,78,Saturday
2016,5,14,2300,55,101,156,Saturday
2016,5,14,2200,71,219,290,Saturday
2016,5,14,2100,123,245,368,Saturday
2016,5,14,2000,152,391,543,Saturday
2016,5,14,1900,208,582,790,Saturday
2016,5,14,1800,297,457,754,Saturday
2016,5,14,1700,256,444,700,Saturday
2016,5,14,1600,351,486,837,Saturday
2016,5,14,1500,400,427,827,Saturday
2016,5,14,1400,483,353,836,Saturday
2016,5,14,1300,558,295,853,Saturday
2016,5,14,1200,629,257,886,Saturday
2016,5,14,1100,596,205,801,Saturday
2016,5,14,1000,539,140,679,Saturday
2016,5,14,900,340,111,451,Saturday
2016,5,14,800,185,63,248,Saturday
2016,5,14,700,111,44,155,Saturday
2016,5,14,600,50,32,82,Saturday
2016,5,14,500,21,26,47,Saturday
2016,5,14,400,19,25,44,Saturday
2016,5,14,300,30,32,62,Saturday
2016,5,14,200,38,38,76,Saturday
2016,5,14,100,59,60,119,Saturday
2016,5,13,2400,73,82,155,Friday
2016,5,13,2300,95,124,219,Friday
2016,5,13,2200,175,158,333,Friday
2016,5,13,2100,271,205,476,Friday
2016,5,13,2000,409,261,670,Friday
2016,5,13,1900,555,397,952,Friday
2016,5,13,1800,505,451,956,Friday
2016,5,13,1700,544,462,1006,Friday
2016,5,13,1600,534,521,1055,Friday
2016,5,13,1500,564,369,933,Friday
2016,5,13,1400,545,378,923,Friday
2016,5,13,1300,525,365,890,Friday
2016,5,13,1200,612,324,936,Friday
2016,5,13,1100,616,224,840,Friday
2016,5,13,1000,495,152,647,Friday
2016,5,13,900,327,112,439,Friday
2016,5,13,800,225,70,295,Friday
2016,5,13,700,111,44,155,Friday
2016,5,13,600,38,30,68,Friday
2016,5,13,500,27,32,59,Friday
2016,5,13,400,34,41,75,Friday
2016,5,13,300,29,44,73,Friday
2016,5,13,200,41,61,102,Friday
2016,5,13,100,58,88,146,Friday
2016,5,12,2400,76,83,159,Thursday
2016,5,12,2300,89,92,181,Thursday
2016,5,12,2200,128,128,256,Thursday
2016,5,12,2100,182,190,372,Thursday
2016,5,12,2000,232,226,458,Thursday
2016,5,12,1900,270,324,594,Thursday
2016,5,12,1800,289,417,706,Thursday
2016,5,12,1700,338,461,799,Thursday
2016,5,12,1600,356,258,614,Thursday
2016,5,12,1500,367,325,692,Thursday
2016,5,12,1400,377,332,709,Thursday
2016,5,12,1300,361,285,646,Thursday
2016,5,12,1200,428,253,681,Thursday
2016,5,12,1100,366,182,548,Thursday
2016,5,12,1000,357,151,508,Thursday
2016,5,12,900,225,103,328,Thursday
2016,5,12,800,179,87,266,Thursday
2016,5,12,700,106,53,159,Thursday
2016,5,12,600,36,31,67,Thursday
2016,5,12,500,27,31,58,Thursday
2016,5,12,400,21,39,60,Thursday
2016,5,12,300,25,50,75,Thursday
2016,5,12,200,36,45,81,Thursday
2016,5,12,100,46,59,105,Thursday
2016,5,11,2400,70,81,151,Wednesday
2016,5,11,2300,73,107,180,Wednesday
2016,5,11,2200,111,117,228,Wednesday
2016,5,11,2100,149,186,335,Wednesday
2016,5,11,2000,164,203,367,Wednesday
2016,5,11,1900,208,318,526,Wednesday
2016,5,11,1800,242,392,634,Wednesday
2016,5,11,1700,230,390,620,Wednesday
2016,5,11,1600,288,398,686,Wednesday
2016,5,11,1500,329,361,690,Wednesday
2016,5,11,1400,345,314,659,Wednesday
2016,5,11,1300,374,289,663,Wednesday
2016,5,11,1200,423,233,656,Wednesday
2016,5,11,1100,387,171,558,Wednesday
2016,5,11,1000,373,171,544,Wednesday
2016,5,11,900,272,133,405,Wednesday
2016,5,11,800,172,74,246,Wednesday
2016,5,11,700,103,55,158,Wednesday
2016,5,11,600,45,39,84,Wednesday
2016,5,11,500,21,25,46,Wednesday
2016,5,11,400,32,42,74,Wednesday
2016,5,11,300,20,35,55,Wednesday
2016,5,11,200,40,43,83,Wednesday
2016,5,11,100,44,69,113,Wednesday
2016,5,10,2400,58,85,143,Tuesday
2016,5,10,2300,81,113,194,Tuesday
2016,5,10,2200,107,146,253,Tuesday
2016,5,10,2100,132,205,337,Tuesday
2016,5,10,2000,160,292,452,Tuesday
2016,5,10,1900,172,318,490,Tuesday
2016,5,10,1800,204,394,598,Tuesday
2016,5,10,1700,253,429,682,Tuesday
2016,5,10,1600,253,381,634,Tuesday
2016,5,10,1500,326,365,691,Tuesday
2016,5,10,1400,338,283,621,Tuesday
2016,5,10,1300,381,287,668,Tuesday
2016,5,10,1200,407,242,649,Tuesday
2016,5,10,1100,419,186,605,Tuesday
2016,5,10,1000,339,150,489,Tuesday
2016,5,10,900,251,128,379,Tuesday
2016,5,10,800,172,69,241,Tuesday
2016,5,10,700,110,56,166,Tuesday
2016,5,10,600,44,43,87,Tuesday
2016,5,10,500,25,25,50,Tuesday
2016,5,10,400,27,33,60,Tuesday
2016,5,10,300,25,37,62,Tuesday
2016,5,10,200,22,44,66,Tuesday
2016,5,10,100,37,59,96,Tuesday
2016,5,9,2400,67,82,149,Monday
2016,5,9,2300,67,93,160,Monday
2016,5,9,2200,84,139,223,Monday
2016,5,9,2100,127,270,397,Monday
2016,5,9,2000,143,244,387,Monday
2016,5,9,1900,175,400,575,Monday
2016,5,9,1800,213,421,634,Monday
2016,5,9,1700,287,479,766,Monday
2016,5,9,1600,348,428,776,Monday
2016,5,9,1500,345,435,780,Monday
2016,5,9,1400,438,340,778,Monday
2016,5,9,1300,440,293,733,Monday
2016,5,9,1200,500,255,755,Monday
2016,5,9,1100,445,190,635,Monday
2016,5,9,1000,405,144,549,Monday
2016,5,9,900,245,102,347,Monday
2016,5,9,800,163,77,240,Monday
2016,5,9,700,93,47,140,Monday
2016,5,9,600,40,31,71,Monday
2016,5,9,500,18,18,36,Monday
2016,5,9,400,26,23,49,Monday
2016,5,9,300,24,23,47,Monday
2016,5,9,200,16,39,55,Monday
2016,5,9,100,38,75,113,Monday
2016,5,8,2400,31,114,145,Sunday
2016,5,8,2300,69,166,235,Sunday
2016,5,8,2200,89,237,326,Sunday
2016,5,8,2100,137,375,512,Sunday
2016,5,8,2000,167,491,658,Sunday
2016,5,8,1900,207,692,899,Sunday
2016,5,8,1800,241,842,1083,Sunday
2016,5,8,1700,342,853,1195,Sunday
2016,5,8,1600,406,868,1274,Sunday
2016,5,8,1500,463,794,1257,Sunday
2016,5,8,1400,459,681,1140,Sunday
2016,5,8,1300,400,554,954,Sunday
2016,5,8,1200,458,399,857,Sunday
2016,5,8,1100,491,313,804,Sunday
2016,5,8,1000,353,161,514,Sunday
2016,5,8,900,229,90,319,Sunday
2016,5,8,800,130,36,166,Sunday
2016,5,8,700,56,23,79,Sunday
2016,5,8,600,35,10,45,Sunday
2016,5,8,500,9,14,23,Sunday
2016,5,8,400,16,16,32,Sunday
2016,5,8,300,12,13,25,Sunday
2016,5,8,200,28,27,55,Sunday
2016,5,8,100,25,40,65,Sunday
2016,5,7,2400,46,72,118,Saturday
2016,5,7,2300,55,111,166,Saturday
2016,5,7,2200,72,202,274,Saturday
2016,5,7,2100,122,316,438,Saturday
2016,5,7,2000,145,371,516,Saturday
2016,5,7,1900,201,507,708,Saturday
2016,5,7,1800,241,514,755,Saturday
2016,5,7,1700,304,524,828,Saturday
2016,5,7,1600,350,528,878,Saturday
2016,5,7,1500,443,432,875,Saturday
2016,5,7,1400,560,375,935,Saturday
2016,5,7,1300,715,303,1018,Saturday
2016,5,7,1200,496,241,737,Saturday
2016,5,7,1100,496,223,719,Saturday
2016,5,7,1000,460,151,611,Saturday
2016,5,7,900,288,108,396,Saturday
2016,5,7,800,161,68,229,Saturday
2016,5,7,700,89,48,137,Saturday
2016,5,7,600,47,28,75,Saturday
2016,5,7,500,23,23,46,Saturday
2016,5,7,400,17,31,48,Saturday
2016,5,7,300,13,24,37,Saturday
2016,5,7,200,38,32,70,Saturday
2016,5,7,100,51,44,95,Saturday
2016,5,6,2400,57,85,142,Friday
2016,5,6,2300,127,137,264,Friday
2016,5,6,2200,154,173,327,Friday
2016,5,6,2100,290,260,550,Friday
2016,5,6,2000,385,257,642,Friday
2016,5,6,1900,533,386,919,Friday
2016,5,6,1800,562,446,1008,Friday
2016,5,6,1700,488,483,971,Friday
2016,5,6,1600,527,467,994,Friday
2016,5,6,1500,551,414,965,Friday
2016,5,6,1400,506,357,863,Friday
2016,5,6,1300,602,377,979,Friday
2016,5,6,1200,501,284,785,Friday
2016,5,6,1100,517,210,727,Friday
2016,5,6,1000,404,169,573,Friday
2016,5,6,900,335,153,488,Friday
2016,5,6,800,176,64,240,Friday
2016,5,6,700,108,42,150,Friday
2016,5,6,600,53,48,101,Friday
2016,5,6,500,30,28,58,Friday
2016,5,6,400,37,39,76,Friday
2016,5,6,300,32,37,69,Friday
2016,5,6,200,31,57,88,Friday
2016,5,6,100,47,57,104,Friday
2016,5,5,2400,67,79,146,Thursday
2016,5,5,2300,91,100,191,Thursday
2016,5,5,2200,132,133,265,Thursday
2016,5,5,2100,185,190,375,Thursday
2016,5,5,2000,226,232,458,Thursday
2016,5,5,1900,310,323,633,Thursday
2016,5,5,1800,342,370,712,Thursday
2016,5,5,1700,368,408,776,Thursday
2016,5,5,1600,372,361,733,Thursday
2016,5,5,1500,397,351,748,Thursday
2016,5,5,1400,364,356,720,Thursday
2016,5,5,1300,431,327,758,Thursday
2016,5,5,1200,467,248,715,Thursday
2016,5,5,1100,476,191,667,Thursday
2016,5,5,1000,376,162,538,Thursday
2016,5,5,900,280,117,397,Thursday
2016,5,5,800,198,84,282,Thursday
2016,5,5,700,105,38,143,Thursday
2016,5,5,600,49,29,78,Thursday
2016,5,5,500,25,38,63,Thursday
2016,5,5,400,26,42,68,Thursday
2016,5,5,300,22,37,59,Thursday
2016,5,5,200,32,45,77,Thursday
2016,5,5,100,52,45,97,Thursday
2016,5,4,2400,81,72,153,Wednesday
2016,5,4,2300,83,115,198,Wednesday
2016,5,4,2200,115,144,259,Wednesday
2016,5,4,2100,140,165,305,Wednesday
2016,5,4,2000,165,283,448,Wednesday
2016,5,4,1900,180,394,574,Wednesday
2016,5,4,1800,238,422,660,Wednesday
2016,5,4,1700,249,415,664,Wednesday
2016,5,4,1600,342,420,762,Wednesday
2016,5,4,1500,316,328,644,Wednesday
2016,5,4,1400,334,294,628,Wednesday
2016,5,4,1300,384,249,633,Wednesday
2016,5,4,1200,421,206,627,Wednesday
2016,5,4,1100,431,189,620,Wednesday
2016,5,4,1000,343,157,500,Wednesday
2016,5,4,900,265,134,399,Wednesday
2016,5,4,800,171,80,251,Wednesday
2016,5,4,700,105,64,169,Wednesday
2016,5,4,600,35,40,75,Wednesday
2016,5,4,500,34,26,60,Wednesday
2016,5,4,400,31,35,66,Wednesday
2016,5,4,300,28,46,74,Wednesday
2016,5,4,200,23,46,69,Wednesday
2016,5,4,100,32,66,98,Wednesday
2016,5,3,2400,65,59,124,Tuesday
2016,5,3,2300,95,110,205,Tuesday
2016,5,3,2200,86,157,243,Tuesday
2016,5,3,2100,144,236,380,Tuesday
2016,5,3,2000,152,276,428,Tuesday
2016,5,3,1900,212,387,599,Tuesday
2016,5,3,1800,196,416,612,Tuesday
2016,5,3,1700,242,441,683,Tuesday
2016,5,3,1600,278,385,663,Tuesday
2016,5,3,1500,287,330,617,Tuesday
2016,5,3,1400,341,293,634,Tuesday
2016,5,3,1300,356,257,613,Tuesday
2016,5,3,1200,389,209,598,Tuesday
2016,5,3,1100,450,190,640,Tuesday
2016,5,3,1000,340,169,509,Tuesday
2016,5,3,900,243,101,344,Tuesday
2016,5,3,800,184,83,267,Tuesday
2016,5,3,700,75,55,130,Tuesday
2016,5,3,600,48,46,94,Tuesday
2016,5,3,500,33,34,67,Tuesday
2016,5,3,400,30,31,61,Tuesday
2016,5,3,300,21,36,57,Tuesday
2016,5,3,200,22,64,86,Tuesday
2016,5,3,100,43,55,98,Tuesday
2016,5,2,2400,47,67,114,Monday
2016,5,2,2300,68,124,192,Monday
2016,5,2,2200,85,172,257,Monday
2016,5,2,2100,124,256,380,Monday
2016,5,2,2000,179,330,509,Monday
2016,5,2,1900,169,385,554,Monday
2016,5,2,1800,228,523,751,Monday
2016,5,2,1700,261,521,782,Monday
2016,5,2,1600,305,491,796,Monday
2016,5,2,1500,381,439,820,Monday
2016,5,2,1400,421,308,729,Monday
2016,5,2,1300,62,47,109,Monday
2016,5,2,1200,0,0,0,Monday
2016,5,2,1100,347,146,493,Monday
2016,5,2,1000,402,155,557,Monday
2016,5,2,900,279,123,402,Monday
2016,5,2,800,181,65,246,Monday
2016,5,2,700,84,43,127,Monday
2016,5,2,600,41,29,70,Monday
2016,5,2,500,19,21,40,Monday
2016,5,2,400,24,24,48,Monday
2016,5,2,300,12,29,41,Monday
2016,5,2,200,25,49,74,Monday
2016,5,2,100,27,79,106,Monday
2016,5,1,2400,46,138,184,Sunday
2016,5,1,2300,66,192,258,Sunday
2016,5,1,2200,84,348,432,Sunday
2016,5,1,2100,148,447,595,Sunday
2016,5,1,2000,146,620,766,Sunday
2016,5,1,1900,229,770,999,Sunday
2016,5,1,1800,255,941,1196,Sunday
2016,5,1,1700,264,939,1203,Sunday
2016,5,1,1600,370,859,1229,Sunday
2016,5,1,1500,457,768,1225,Sunday
2016,5,1,1400,523,611,1134,Sunday
2016,5,1,1300,586,533,1119,Sunday
2016,5,1,1200,634,405,1039,Sunday
2016,5,1,1100,635,262,897,Sunday
2016,5,1,1000,512,164,676,Sunday
2016,5,1,900,316,82,398,Sunday
2016,5,1,800,161,33,194,Sunday
2016,5,1,700,87,21,108,Sunday
2016,5,1,600,42,16,58,Sunday
2016,5,1,500,21,13,34,Sunday
2016,5,1,400,21,20,41,Sunday
2016,5,1,300,15,42,57,Sunday
2016,5,1,200,21,25,46,Sunday
2016,5,1,100,29,50,79,Sunday
2016,4,30,2400,44,65,109,Saturday
2016,4,30,2300,62,117,179,Saturday
2016,4,30,2200,86,174,260,Saturday
2016,4,30,2100,113,238,351,Saturday
2016,4,30,2000,136,310,446,Saturday
2016,4,30,1900,183,404,587,Saturday
2016,4,30,1800,237,474,711,Saturday
2016,4,30,1700,262,540,802,Saturday
2016,4,30,1600,336,510,846,Saturday
2016,4,30,1500,444,385,829,Saturday
2016,4,30,1400,457,345,802,Saturday
2016,4,30,1300,519,307,826,Saturday
2016,4,30,1200,604,262,866,Saturday
2016,4,30,1100,596,193,789,Saturday
2016,4,30,1000,504,153,657,Saturday
2016,4,30,900,336,113,449,Saturday
2016,4,30,800,227,71,298,Saturday
2016,4,30,700,130,43,173,Saturday
2016,4,30,600,44,18,62,Saturday
2016,4,30,500,22,36,58,Saturday
2016,4,30,400,23,35,58,Saturday
2016,4,30,300,31,18,49,Saturday
2016,4,30,200,26,47,73,Saturday
2016,4,30,100,46,53,99,Saturday
2016,4,29,2400,69,61,130,Friday
2016,4,29,2300,107,110,217,Friday
2016,4,29,2200,178,138,316,Friday
2016,4,29,2100,274,171,445,Friday
2016,4,29,2000,408,276,684,Friday
2016,4,29,1900,437,312,749,Friday
2016,4,29,1800,524,422,946,Friday
2016,4,29,1700,507,502,1009,Friday
2016,4,29,1600,507,460,967,Friday
2016,4,29,1500,520,435,955,Friday
2016,4,29,1400,507,408,915,Friday
2016,4,29,1300,493,352,845,Friday
2016,4,29,1200,507,284,791,Friday
2016,4,29,1100,531,203,734,Friday
2016,4,29,1000,503,157,660,Friday
2016,4,29,900,332,115,447,Friday
2016,4,29,800,199,66,265,Friday
2016,4,29,700,123,48,171,Friday
2016,4,29,600,58,29,87,Friday
2016,4,29,500,32,38,70,Friday
2016,4,29,400,27,25,52,Friday
2016,4,29,300,25,42,67,Friday
2016,4,29,200,26,45,71,Friday
2016,4,29,100,38,63,101,Friday
2016,4,28,2400,72,108,180,Thursday
2016,4,28,2300,75,92,167,Thursday
2016,4,28,2200,128,138,266,Thursday
2016,4,28,2100,180,196,376,Thursday
2016,4,28,2000,232,244,476,Thursday
2016,4,28,1900,287,309,596,Thursday
2016,4,28,1800,297,395,692,Thursday
2016,4,28,1700,317,443,760,Thursday
2016,4,28,1600,348,457,805,Thursday
2016,4,28,1500,385,357,742,Thursday
2016,4,28,1400,392,315,707,Thursday
2016,4,28,1300,451,292,743,Thursday
2016,4,28,1200,462,246,708,Thursday
2016,4,28,1100,452,208,660,Thursday
2016,4,28,1000,421,139,560,Thursday
2016,4,28,900,286,121,407,Thursday
2016,4,28,800,212,78,290,Thursday
2016,4,28,700,104,43,147,Thursday
2016,4,28,600,48,26,74,Thursday
2016,4,28,500,34,33,67,Thursday
2016,4,28,400,27,35,62,Thursday
2016,4,28,300,28,26,54,Thursday
2016,4,28,200,27,37,64,Thursday
2016,4,28,100,53,67,120,Thursday
2016,4,27,2400,67,74,141,Wednesday
2016,4,27,2300,68,112,180,Wednesday
2016,4,27,2200,92,166,258,Wednesday
2016,4,27,2100,146,209,355,Wednesday
2016,4,27,2000,153,265,418,Wednesday
2016,4,27,1900,176,344,520,Wednesday
2016,4,27,1800,219,422,641,Wednesday
2016,4,27,1700,259,426,685,Wednesday
2016,4,27,1600,275,390,665,Wednesday
2016,4,27,1500,325,372,697,Wednesday
2016,4,27,1400,372,288,660,Wednesday
2016,4,27,1300,362,275,637,Wednesday
2016,4,27,1200,392,236,628,Wednesday
2016,4,27,1100,410,190,600,Wednesday
2016,4,27,1000,327,147,474,Wednesday
2016,4,27,900,289,108,397,Wednesday
2016,4,27,800,198,55,253,Wednesday
2016,4,27,700,91,55,146,Wednesday
2016,4,27,600,42,36,78,Wednesday
2016,4,27,500,21,30,51,Wednesday
2016,4,27,400,21,31,52,Wednesday
2016,4,27,300,25,27,52,Wednesday
2016,4,27,200,34,42,76,Wednesday
2016,4,27,100,43,52,95,Wednesday
2016,4,26,2400,56,69,125,Tuesday
2016,4,26,2300,79,101,180,Tuesday
2016,4,26,2200,92,159,251,Tuesday
2016,4,26,2100,130,190,320,Tuesday
2016,4,26,2000,124,270,394,Tuesday
2016,4,26,1900,152,322,474,Tuesday
2016,4,26,1800,202,375,577,Tuesday
2016,4,26,1700,219,475,694,Tuesday
2016,4,26,1600,273,382,655,Tuesday
2016,4,26,1500,306,386,692,Tuesday
2016,4,26,1400,286,290,576,Tuesday
2016,4,26,1300,337,316,653,Tuesday
2016,4,26,1200,401,250,651,Tuesday
2016,4,26,1100,384,186,570,Tuesday
2016,4,26,1000,342,153,495,Tuesday
2016,4,26,900,228,117,345,Tuesday
2016,4,26,800,152,83,235,Tuesday
2016,4,26,700,90,36,126,Tuesday
2016,4,26,600,36,40,76,Tuesday
2016,4,26,500,22,34,56,Tuesday
2016,4,26,400,20,39,59,Tuesday
2016,4,26,300,22,35,57,Tuesday
2016,4,26,200,22,46,68,Tuesday
2016,4,26,100,37,66,103,Tuesday
2016,4,25,2400,45,78,123,Monday
2016,4,25,2300,62,120,182,Monday
2016,4,25,2200,84,171,255,Monday
2016,4,25,2100,120,217,337,Monday
2016,4,25,2000,138,304,442,Monday
2016,4,25,1900,154,393,547,Monday
2016,4,25,1800,188,496,684,Monday
2016,4,25,1700,267,518,785,Monday
2016,4,25,1600,290,489,779,Monday
2016,4,25,1500,307,392,699,Monday
2016,4,25,1400,324,360,684,Monday
2016,4,25,1300,413,306,719,Monday
2016,4,25,1200,421,244,665,Monday
2016,4,25,1100,411,193,604,Monday
2016,4,25,1000,355,142,497,Monday
2016,4,25,900,236,113,349,Monday
2016,4,25,800,160,63,223,Monday
2016,4,25,700,91,38,129,Monday
2016,4,25,600,31,24,55,Monday
2016,4,25,500,13,13,26,Monday
2016,4,25,400,14,26,40,Monday
2016,4,25,300,10,27,37,Monday
2016,4,25,200,17,38,55,Monday
2016,4,25,100,25,76,101,Monday
2016,4,24,2400,38,109,147,Sunday
2016,4,24,2300,53,116,169,Sunday
2016,4,24,2200,73,267,340,Sunday
2016,4,24,2100,103,319,422,Sunday
2016,4,24,2000,139,416,555,Sunday
2016,4,24,1900,187,573,760,Sunday
2016,4,24,1800,207,759,966,Sunday
2016,4,24,1700,283,872,1155,Sunday
2016,4,24,1600,323,813,1136,Sunday
2016,4,24,1500,374,658,1032,Sunday
2016,4,24,1400,396,669,1065,Sunday
2016,4,24,1300,442,606,1048,Sunday
2016,4,24,1200,430,395,825,Sunday
2016,4,24,1100,439,246,685,Sunday
2016,4,24,1000,324,147,471,Sunday
2016,4,24,900,223,74,297,Sunday
2016,4,24,800,143,41,184,Sunday
2016,4,24,700,67,25,92,Sunday
2016,4,24,600,33,15,48,Sunday
2016,4,24,500,15,14,29,Sunday
2016,4,24,400,15,22,37,Sunday
2016,4,24,300,12,22,34,Sunday
2016,4,24,200,16,20,36,Sunday
2016,4,24,100,31,35,66,Sunday
2016,4,23,2400,42,70,112,Saturday
2016,4,23,2300,51,96,147,Saturday
2016,4,23,2200,87,165,252,Saturday
2016,4,23,2100,110,240,350,Saturday
2016,4,23,2000,142,280,422,Saturday
2016,4,23,1900,173,351,524,Saturday
2016,4,23,1800,186,505,691,Saturday
2016,4,23,1700,275,531,806,Saturday
2016,4,23,1600,306,466,772,Saturday
2016,4,23,1500,355,395,750,Saturday
2016,4,23,1400,379,343,722,Saturday
2016,4,23,1300,454,304,758,Saturday
2016,4,23,1200,542,234,776,Saturday
2016,4,23,1100,550,235,785,Saturday
2016,4,23,1000,452,141,593,Saturday
2016,4,23,900,415,101,516,Saturday
2016,4,23,800,228,61,289,Saturday
2016,4,23,700,103,42,145,Saturday
2016,4,23,600,56,23,79,Saturday
2016,4,23,500,19,31,50,Saturday
2016,4,23,400,16,23,39,Saturday
2016,4,23,300,23,24,47,Saturday
2016,4,23,200,27,37,64,Saturday
2016,4,23,100,46,74,120,Saturday
2016,4,22,2400,57,164,221,Friday
2016,4,22,2300,92,156,248,Friday
2016,4,22,2200,145,142,287,Friday
2016,4,22,2100,254,153,407,Friday
2016,4,22,2000,342,140,482,Friday
2016,4,22,1900,478,387,865,Friday
2016,4,22,1800,498,334,832,Friday
2016,4,22,1700,484,527,1011,Friday
2016,4,22,1600,463,430,893,Friday
2016,4,22,1500,525,396,921,Friday
2016,4,22,1400,471,349,820,Friday
2016,4,22,1300,487,326,813,Friday
2016,4,22,1200,577,265,842,Friday
2016,4,22,1100,569,218,787,Friday
2016,4,22,1000,473,135,608,Friday
2016,4,22,900,355,113,468,Friday
2016,4,22,800,220,81,301,Friday
2016,4,22,700,117,43,160,Friday
2016,4,22,600,72,33,105,Friday
2016,4,22,500,38,37,75,Friday
2016,4,22,400,40,33,73,Friday
2016,4,22,300,32,36,68,Friday
2016,4,22,200,43,54,97,Friday
2016,4,22,100,45,68,113,Friday
2016,4,21,2400,71,69,140,Thursday
2016,4,21,2300,94,103,197,Thursday
2016,4,21,2200,132,150,282,Thursday
2016,4,21,2100,176,190,366,Thursday
2016,4,21,2000,262,280,542,Thursday
2016,4,21,1900,275,279,554,Thursday
2016,4,21,1800,356,422,778,Thursday
2016,4,21,1700,349,401,750,Thursday
2016,4,21,1600,360,365,725,Thursday
2016,4,21,1500,344,363,707,Thursday
2016,4,21,1400,402,340,742,Thursday
2016,4,21,1300,380,258,638,Thursday
2016,4,21,1200,437,232,669,Thursday
2016,4,21,1100,427,205,632,Thursday
2016,4,21,1000,336,144,480,Thursday
2016,4,21,900,236,104,340,Thursday
2016,4,21,800,192,70,262,Thursday
2016,4,21,700,102,42,144,Thursday
2016,4,21,600,53,39,92,Thursday
2016,4,21,500,35,28,63,Thursday
2016,4,21,400,21,31,52,Thursday
2016,4,21,300,25,31,56,Thursday
2016,4,21,200,25,23,48,Thursday
2016,4,21,100,33,63,96,Thursday
2016,4,20,2400,66,69,135,Wednesday
2016,4,20,2300,66,70,136,Wednesday
2016,4,20,2200,117,132,249,Wednesday
2016,4,20,2100,130,174,304,Wednesday
2016,4,20,2000,151,226,377,Wednesday
2016,4,20,1900,158,263,421,Wednesday
2016,4,20,1800,215,365,580,Wednesday
2016,4,20,1700,248,413,661,Wednesday
2016,4,20,1600,250,371,621,Wednesday
2016,4,20,1500,260,306,566,Wednesday
2016,4,20,1400,302,290,592,Wednesday
2016,4,20,1300,346,267,613,Wednesday
2016,4,20,1200,355,227,582,Wednesday
2016,4,20,1100,399,182,581,Wednesday
2016,4,20,1000,289,140,429,Wednesday
2016,4,20,900,260,124,384,Wednesday
2016,4,20,800,177,73,250,Wednesday
2016,4,20,700,88,43,131,Wednesday
2016,4,20,600,28,39,67,Wednesday
2016,4,20,500,19,25,44,Wednesday
2016,4,20,400,24,29,53,Wednesday
2016,4,20,300,28,30,58,Wednesday
2016,4,20,200,34,50,84,Wednesday
2016,4,20,100,31,64,95,Wednesday
2016,4,19,2400,58,60,118,Tuesday
2016,4,19,2300,71,87,158,Tuesday
2016,4,19,2200,99,135,234,Tuesday
2016,4,19,2100,102,182,284,Tuesday
2016,4,19,2000,124,192,316,Tuesday
2016,4,19,1900,155,316,471,Tuesday
2016,4,19,1800,196,371,567,Tuesday
2016,4,19,1700,237,374,611,Tuesday
2016,4,19,1600,232,361,593,Tuesday
2016,4,19,1500,229,299,528,Tuesday
2016,4,19,1400,333,309,642,Tuesday
2016,4,19,1300,258,265,523,Tuesday
2016,4,19,1200,339,199,538,Tuesday
2016,4,19,1100,342,225,567,Tuesday
2016,4,19,1000,314,155,469,Tuesday
2016,4,19,900,214,133,347,Tuesday
2016,4,19,800,188,76,264,Tuesday
2016,4,19,700,79,41,120,Tuesday
2016,4,19,600,26,43,69,Tuesday
2016,4,19,500,24,35,59,Tuesday
2016,4,19,400,28,32,60,Tuesday
2016,4,19,300,20,30,50,Tuesday
2016,4,19,200,31,52,83,Tuesday
2016,4,19,100,43,68,111,Tuesday
2016,4,18,2400,48,57,105,Monday
2016,4,18,2300,74,91,165,Monday
2016,4,18,2200,89,143,232,Monday
2016,4,18,2100,144,239,383,Monday
2016,4,18,2000,122,264,386,Monday
2016,4,18,1900,151,355,506,Monday
2016,4,18,1800,220,438,658,Monday
2016,4,18,1700,222,448,670,Monday
2016,4,18,1600,298,389,687,Monday
2016,4,18,1500,300,413,713,Monday
2016,4,18,1400,366,313,679,Monday
2016,4,18,1300,392,310,702,Monday
2016,4,18,1200,428,255,683,Monday
2016,4,18,1100,433,182,615,Monday
2016,4,18,1000,377,149,526,Monday
2016,4,18,900,245,107,352,Monday
2016,4,18,800,146,67,213,Monday
2016,4,18,700,95,37,132,Monday
2016,4,18,600,45,17,62,Monday
2016,4,18,500,17,18,35,Monday
2016,4,18,400,15,24,39,Monday
2016,4,18,300,15,30,45,Monday
2016,4,18,200,21,47,68,Monday
2016,4,18,100,27,47,74,Monday
2016,4,17,2400,38,101,139,Sunday
2016,4,17,2300,44,134,178,Sunday
2016,4,17,2200,82,235,317,Sunday
2016,4,17,2100,109,348,457,Sunday
2016,4,17,2000,152,530,682,Sunday
2016,4,17,1900,185,695,880,Sunday
2016,4,17,1800,218,961,1179,Sunday
2016,4,17,1700,289,1067,1356,Sunday
2016,4,17,1600,313,832,1145,Sunday
2016,4,17,1500,391,723,1114,Sunday
2016,4,17,1400,442,607,1049,Sunday
2016,4,17,1300,517,539,1056,Sunday
2016,4,17,1200,594,332,926,Sunday
2016,4,17,1100,598,195,793,Sunday
2016,4,17,1000,482,151,633,Sunday
2016,4,17,900,352,74,426,Sunday
2016,4,17,800,159,36,195,Sunday
2016,4,17,700,65,19,84,Sunday
2016,4,17,600,16,19,35,Sunday
2016,4,17,500,13,12,25,Sunday
2016,4,17,400,18,20,38,Sunday
2016,4,17,300,14,15,29,Sunday
2016,4,17,200,19,27,46,Sunday
2016,4,17,100,31,54,85,Sunday
2016,4,16,2400,25,59,84,Saturday
2016,4,16,2300,50,70,120,Saturday
2016,4,16,2200,81,121,202,Saturday
2016,4,16,2100,98,197,295,Saturday
2016,4,16,2000,137,256,393,Saturday
2016,4,16,1900,136,388,524,Saturday
2016,4,16,1800,208,633,841,Saturday
2016,4,16,1700,269,695,964,Saturday
2016,4,16,1600,289,535,824,Saturday
2016,4,16,1500,379,406,785,Saturday
2016,4,16,1400,409,356,765,Saturday
2016,4,16,1300,498,290,788,Saturday
2016,4,16,1200,638,243,881,Saturday
2016,4,16,1100,595,162,757,Saturday
2016,4,16,1000,525,167,692,Saturday
2016,4,16,900,460,95,555,Saturday
2016,4,16,800,234,58,292,Saturday
2016,4,16,700,100,27,127,Saturday
2016,4,16,600,43,29,72,Saturday
2016,4,16,500,29,20,49,Saturday
2016,4,16,400,28,29,57,Saturday
2016,4,16,300,20,25,45,Saturday
2016,4,16,200,24,36,60,Saturday
2016,4,16,100,41,50,91,Saturday
2016,4,15,2400,56,61,117,Friday
2016,4,15,2300,102,73,175,Friday
2016,4,15,2200,145,130,275,Friday
2016,4,15,2100,261,153,414,Friday
2016,4,15,2000,353,200,553,Friday
2016,4,15,1900,450,311,761,Friday
2016,4,15,1800,435,458,893,Friday
2016,4,15,1700,521,498,1019,Friday
2016,4,15,1600,478,455,933,Friday
2016,4,15,1500,499,333,832,Friday
2016,4,15,1400,419,321,740,Friday
2016,4,15,1300,445,282,727,Friday
2016,4,15,1200,515,256,771,Friday
2016,4,15,1100,488,209,697,Friday
2016,4,15,1000,442,160,602,Friday
2016,4,15,900,335,105,440,Friday
2016,4,15,800,210,57,267,Friday
2016,4,15,700,93,42,135,Friday
2016,4,15,600,40,43,83,Friday
2016,4,15,500,22,32,54,Friday
2016,4,15,400,29,30,59,Friday
2016,4,15,300,25,41,66,Friday
2016,4,15,200,28,52,80,Friday
2016,4,15,100,49,62,111,Friday
2016,4,14,2400,62,70,132,Thursday
2016,4,14,2300,83,86,169,Thursday
2016,4,14,2200,121,144,265,Thursday
2016,4,14,2100,171,171,342,Thursday
2016,4,14,2000,205,199,404,Thursday
2016,4,14,1900,249,293,542,Thursday
2016,4,14,1800,261,343,604,Thursday
2016,4,14,1700,330,322,652,Thursday
2016,4,14,1600,340,343,683,Thursday
2016,4,14,1500,330,318,648,Thursday
2016,4,14,1400,351,290,641,Thursday
2016,4,14,1300,316,287,603,Thursday
2016,4,14,1200,399,227,626,Thursday
2016,4,14,1100,375,176,551,Thursday
2016,4,14,1000,300,121,421,Thursday
2016,4,14,900,254,114,368,Thursday
2016,4,14,800,190,63,253,Thursday
2016,4,14,700,94,53,147,Thursday
2016,4,14,600,29,44,73,Thursday
2016,4,14,500,33,22,55,Thursday
2016,4,14,400,23,32,55,Thursday
2016,4,14,300,24,30,54,Thursday
2016,4,14,200,20,43,63,Thursday
2016,4,14,100,36,49,85,Thursday
2016,4,13,2400,62,60,122,Wednesday
2016,4,13,2300,85,84,169,Wednesday
2016,4,13,2200,95,103,198,Wednesday
2016,4,13,2100,114,152,266,Wednesday
2016,4,13,2000,160,213,373,Wednesday
2016,4,13,1900,146,283,429,Wednesday
2016,4,13,1800,192,338,530,Wednesday
2016,4,13,1700,238,352,590,Wednesday
2016,4,13,1600,225,301,526,Wednesday
2016,4,13,1500,259,271,530,Wednesday
2016,4,13,1400,252,257,509,Wednesday
2016,4,13,1300,284,218,502,Wednesday
2016,4,13,1200,322,194,516,Wednesday
2016,4,13,1100,344,167,511,Wednesday
2016,4,13,1000,271,152,423,Wednesday
2016,4,13,900,216,128,344,Wednesday
2016,4,13,800,161,76,237,Wednesday
2016,4,13,700,75,43,118,Wednesday
2016,4,13,600,30,35,65,Wednesday
2016,4,13,500,16,35,51,Wednesday
2016,4,13,400,25,36,61,Wednesday
2016,4,13,300,22,29,51,Wednesday
2016,4,13,200,34,33,67,Wednesday
2016,4,13,100,43,55,98,Wednesday
2016,4,12,2400,58,50,108,Tuesday
2016,4,12,2300,71,73,144,Tuesday
2016,4,12,2200,87,115,202,Tuesday
2016,4,12,2100,116,155,271,Tuesday
2016,4,12,2000,137,235,372,Tuesday
2016,4,12,1900,138,259,397,Tuesday
2016,4,12,1800,160,312,472,Tuesday
2016,4,12,1700,238,375,613,Tuesday
2016,4,12,1600,202,356,558,Tuesday
2016,4,12,1500,229,320,549,Tuesday
2016,4,12,1400,269,288,557,Tuesday
2016,4,12,1300,308,261,569,Tuesday
2016,4,12,1200,339,220,559,Tuesday
2016,4,12,1100,315,190,505,Tuesday
2016,4,12,1000,303,132,435,Tuesday
2016,4,12,900,204,118,322,Tuesday
2016,4,12,800,171,81,252,Tuesday
2016,4,12,700,50,42,92,Tuesday
2016,4,12,600,26,40,66,Tuesday
2016,4,12,500,26,28,54,Tuesday
2016,4,12,400,22,26,48,Tuesday
2016,4,12,300,18,45,63,Tuesday
2016,4,12,200,28,34,62,Tuesday
2016,4,12,100,32,63,95,Tuesday
2016,4,11,2400,58,58,116,Monday
2016,4,11,2300,67,89,156,Monday
2016,4,11,2200,56,143,199,Monday
2016,4,11,2100,107,170,277,Monday
2016,4,11,2000,131,230,361,Monday
2016,4,11,1900,142,268,410,Monday
2016,4,11,1800,193,410,603,Monday
2016,4,11,1700,223,468,691,Monday
2016,4,11,1600,258,420,678,Monday
2016,4,11,1500,253,348,601,Monday
2016,4,11,1400,316,319,635,Monday
2016,4,11,1300,360,287,647,Monday
2016,4,11,1200,391,229,620,Monday
2016,4,11,1100,409,203,612,Monday
2016,4,11,1000,384,133,517,Monday
2016,4,11,900,239,121,360,Monday
2016,4,11,800,133,71,204,Monday
2016,4,11,700,83,43,126,Monday
2016,4,11,600,27,26,53,Monday
2016,4,11,500,13,22,35,Monday
2016,4,11,400,21,30,51,Monday
2016,4,11,300,16,26,42,Monday
2016,4,11,200,25,39,64,Monday
2016,4,11,100,27,68,95,Monday
2016,4,10,2400,37,71,108,Sunday
2016,4,10,2300,50,125,175,Sunday
2016,4,10,2200,77,221,298,Sunday
2016,4,10,2100,121,338,459,Sunday
2016,4,10,2000,150,626,776,Sunday
2016,4,10,1900,171,615,786,Sunday
2016,4,10,1800,188,865,1053,Sunday
2016,4,10,1700,206,970,1176,Sunday
2016,4,10,1600,290,808,1098,Sunday
2016,4,10,1500,334,715,1049,Sunday
2016,4,10,1400,331,540,871,Sunday
2016,4,10,1300,369,473,842,Sunday
2016,4,10,1200,504,383,887,Sunday
2016,4,10,1100,481,234,715,Sunday
2016,4,10,1000,412,134,546,Sunday
2016,4,10,900,379,69,448,Sunday
2016,4,10,800,183,40,223,Sunday
2016,4,10,700,99,18,117,Sunday
2016,4,10,600,37,11,48,Sunday
2016,4,10,500,27,6,33,Sunday
2016,4,10,400,13,19,32,Sunday
2016,4,10,300,14,19,33,Sunday
2016,4,10,200,23,25,48,Sunday
2016,4,10,100,25,43,68,Sunday
2016,4,9,2400,36,89,125,Saturday
2016,4,9,2300,57,97,154,Saturday
2016,4,9,2200,74,103,177,Saturday
2016,4,9,2100,78,181,259,Saturday
2016,4,9,2000,125,224,349,Saturday
2016,4,9,1900,173,376,549,Saturday
2016,4,9,1800,185,576,761,Saturday
2016,4,9,1700,234,732,966,Saturday
2016,4,9,1600,310,494,804,Saturday
2016,4,9,1500,343,446,789,Saturday
2016,4,9,1400,327,312,639,Saturday
2016,4,9,1300,447,288,735,Saturday
2016,4,9,1200,548,214,762,Saturday
2016,4,9,1100,601,153,754,Saturday
2016,4,9,1000,588,120,708,Saturday
2016,4,9,900,497,93,590,Saturday
2016,4,9,800,262,46,308,Saturday
2016,4,9,700,106,44,150,Saturday
2016,4,9,600,55,29,84,Saturday
2016,4,9,500,32,17,49,Saturday
2016,4,9,400,17,28,45,Saturday
2016,4,9,300,23,25,48,Saturday
2016,4,9,200,36,30,66,Saturday
2016,4,9,100,48,46,94,Saturday
2016,4,8,2400,65,72,137,Friday
2016,4,8,2300,104,96,200,Friday
2016,4,8,2200,191,117,308,Friday
2016,4,8,2100,232,176,408,Friday
2016,4,8,2000,388,215,603,Friday
2016,4,8,1900,487,291,778,Friday
2016,4,8,1800,463,419,882,Friday
2016,4,8,1700,515,502,1017,Friday
2016,4,8,1600,441,449,890,Friday
2016,4,8,1500,465,408,873,Friday
2016,4,8,1400,398,324,722,Friday
2016,4,8,1300,444,284,728,Friday
2016,4,8,1200,483,230,713,Friday
2016,4,8,1100,496,187,683,Friday
2016,4,8,1000,450,126,576,Friday
2016,4,8,900,343,98,441,Friday
2016,4,8,800,224,82,306,Friday
2016,4,8,700,105,36,141,Friday
2016,4,8,600,65,44,109,Friday
2016,4,8,500,31,25,56,Friday
2016,4,8,400,35,36,71,Friday
2016,4,8,300,26,41,67,Friday
2016,4,8,200,31,32,63,Friday
2016,4,8,100,64,39,103,Friday
2016,4,7,2400,62,74,136,Thursday
2016,4,7,2300,91,101,192,Thursday
2016,4,7,2200,117,109,226,Thursday
2016,4,7,2100,189,166,355,Thursday
2016,4,7,2000,232,227,459,Thursday
2016,4,7,1900,269,281,550,Thursday
2016,4,7,1800,282,362,644,Thursday
2016,4,7,1700,304,458,762,Thursday
2016,4,7,1600,309,398,707,Thursday
2016,4,7,1500,339,276,615,Thursday
2016,4,7,1400,272,288,560,Thursday
2016,4,7,1300,359,267,626,Thursday
2016,4,7,1200,364,197,561,Thursday
2016,4,7,1100,471,185,656,Thursday
2016,4,7,1000,361,140,501,Thursday
2016,4,7,900,289,118,407,Thursday
2016,4,7,800,191,52,243,Thursday
2016,4,7,700,79,40,119,Thursday
2016,4,7,600,47,33,80,Thursday
2016,4,7,500,18,25,43,Thursday
2016,4,7,400,35,26,61,Thursday
2016,4,7,300,19,16,35,Thursday
2016,4,7,200,29,48,77,Thursday
2016,4,7,100,49,61,110,Thursday
2016,4,6,2400,57,63,120,Wednesday
2016,4,6,2300,80,69,149,Wednesday
2016,4,6,2200,108,107,215,Wednesday
2016,4,6,2100,136,152,288,Wednesday
2016,4,6,2000,156,174,330,Wednesday
2016,4,6,1900,198,248,446,Wednesday
2016,4,6,1800,214,294,508,Wednesday
2016,4,6,1700,226,375,601,Wednesday
2016,4,6,1600,264,365,629,Wednesday
2016,4,6,1500,246,297,543,Wednesday
2016,4,6,1400,287,243,530,Wednesday
2016,4,6,1300,281,234,515,Wednesday
2016,4,6,1200,321,209,530,Wednesday
2016,4,6,1100,316,161,477,Wednesday
2016,4,6,1000,283,128,411,Wednesday
2016,4,6,900,233,114,347,Wednesday
2016,4,6,800,180,55,235,Wednesday
2016,4,6,700,70,42,112,Wednesday
2016,4,6,600,25,46,71,Wednesday
2016,4,6,500,23,24,47,Wednesday
2016,4,6,400,30,34,64,Wednesday
2016,4,6,300,30,32,62,Wednesday
2016,4,6,200,28,44,72,Wednesday
2016,4,6,100,47,50,97,Wednesday
2016,4,5,2400,52,55,107,Tuesday
2016,4,5,2300,65,85,150,Tuesday
2016,4,5,2200,81,105,186,Tuesday
2016,4,5,2100,96,133,229,Tuesday
2016,4,5,2000,112,169,281,Tuesday
2016,4,5,1900,134,231,365,Tuesday
2016,4,5,1800,163,318,481,Tuesday
2016,4,5,1700,208,354,562,Tuesday
2016,4,5,1600,241,343,584,Tuesday
2016,4,5,1500,230,302,532,Tuesday
2016,4,5,1400,234,305,539,Tuesday
2016,4,5,1300,253,238,491,Tuesday
2016,4,5,1200,315,164,479,Tuesday
2016,4,5,1100,314,193,507,Tuesday
2016,4,5,1000,300,139,439,Tuesday
2016,4,5,900,217,105,322,Tuesday
2016,4,5,800,161,54,215,Tuesday
2016,4,5,700,65,44,109,Tuesday
2016,4,5,600,42,30,72,Tuesday
2016,4,5,500,21,33,54,Tuesday
2016,4,5,400,26,30,56,Tuesday
2016,4,5,300,17,39,56,Tuesday
2016,4,5,200,31,44,75,Tuesday
2016,4,5,100,43,42,85,Tuesday
2016,4,4,2400,57,67,124,Monday
2016,4,4,2300,70,75,145,Monday
2016,4,4,2200,66,119,185,Monday
2016,4,4,2100,93,142,235,Monday
2016,4,4,2000,138,211,349,Monday
2016,4,4,1900,135,274,409,Monday
2016,4,4,1800,203,349,552,Monday
2016,4,4,1700,197,403,600,Monday
2016,4,4,1600,262,490,752,Monday
2016,4,4,1500,262,374,636,Monday
2016,4,4,1400,275,298,573,Monday
2016,4,4,1300,337,279,616,Monday
2016,4,4,1200,350,249,599,Monday
2016,4,4,1100,327,178,505,Monday
2016,4,4,1000,312,112,424,Monday
2016,4,4,900,219,107,326,Monday
2016,4,4,800,147,70,217,Monday
2016,4,4,700,78,38,116,Monday
2016,4,4,600,33,22,55,Monday
2016,4,4,500,8,10,18,Monday
2016,4,4,400,24,18,42,Monday
2016,4,4,300,15,21,36,Monday
2016,4,4,200,16,35,51,Monday
2016,4,4,100,21,53,74,Monday
2016,4,3,2400,27,96,123,Sunday
2016,4,3,2300,51,121,172,Sunday
2016,4,3,2200,71,209,280,Sunday
2016,4,3,2100,88,312,400,Sunday
2016,4,3,2000,116,497,613,Sunday
2016,4,3,1900,138,741,879,Sunday
2016,4,3,1800,174,1138,1312,Sunday
2016,4,3,1700,204,1057,1261,Sunday
2016,4,3,1600,266,885,1151,Sunday
2016,4,3,1500,318,800,1118,Sunday
2016,4,3,1400,334,646,980,Sunday
2016,4,3,1300,366,541,907,Sunday
2016,4,3,1200,458,397,855,Sunday
2016,4,3,1100,494,260,754,Sunday
2016,4,3,1000,475,131,606,Sunday
2016,4,3,900,370,76,446,Sunday
2016,4,3,800,179,45,224,Sunday
2016,4,3,700,104,23,127,Sunday
2016,4,3,600,37,16,53,Sunday
2016,4,3,500,16,21,37,Sunday
2016,4,3,400,14,14,28,Sunday
2016,4,3,300,15,24,39,Sunday
2016,4,3,200,16,35,51,Sunday
2016,4,3,100,23,31,54,Sunday
2016,4,2,2400,31,59,90,Saturday
2016,4,2,2300,45,88,133,Saturday
2016,4,2,2200,63,136,199,Saturday
2016,4,2,2100,82,222,304,Saturday
2016,4,2,2000,111,318,429,Saturday
2016,4,2,1900,155,590,745,Saturday
2016,4,2,1800,202,781,983,Saturday
2016,4,2,1700,260,1036,1296,Saturday
2016,4,2,1600,300,830,1130,Saturday
2016,4,2,1500,427,628,1055,Saturday
2016,4,2,1400,412,474,886,Saturday
2016,4,2,1300,526,445,971,Saturday
2016,4,2,1200,587,352,939,Saturday
2016,4,2,1100,641,260,901,Saturday
2016,4,2,1000,631,152,783,Saturday
2016,4,2,900,552,101,653,Saturday
2016,4,2,800,324,82,406,Saturday
2016,4,2,700,128,44,172,Saturday
2016,4,2,600,38,30,68,Saturday
2016,4,2,500,24,33,57,Saturday
2016,4,2,400,24,23,47,Saturday
2016,4,2,300,23,39,62,Saturday
2016,4,2,200,29,37,66,Saturday
2016,4,2,100,44,42,86,Saturday
2016,4,1,2400,58,66,124,Friday
2016,4,1,2300,98,119,217,Friday
2016,4,1,2200,147,149,296,Friday
2016,4,1,2100,248,227,475,Friday
2016,4,1,2000,353,396,749,Friday
2016,4,1,1900,472,402,874,Friday
2016,4,1,1800,447,575,1022,Friday
2016,4,1,1700,489,966,1455,Friday
2016,4,1,1600,476,426,902,Friday
2016,4,1,1500,420,523,943,Friday
2016,4,1,1400,458,436,894,Friday
2016,4,1,1300,419,418,837,Friday
2016,4,1,1200,577,366,943,Friday
2016,4,1,1100,579,279,858,Friday
2016,4,1,1000,533,187,720,Friday
2016,4,1,900,483,115,598,Friday
2016,4,1,800,286,74,360,Friday
2016,4,1,700,98,47,145,Friday
2016,4,1,600,48,37,85,Friday
2016,4,1,500,22,30,52,Friday
2016,4,1,400,31,37,68,Friday
2016,4,1,300,29,39,68,Friday
2016,4,1,200,32,49,81,Friday
2016,4,1,100,46,65,111,Friday
2016,3,31,2400,65,81,146,Thursday
2016,3,31,2300,84,104,188,Thursday
2016,3,31,2200,141,155,296,Thursday
2016,3,31,2100,182,239,421,Thursday
2016,3,31,2000,226,313,539,Thursday
2016,3,31,1900,254,338,592,Thursday
2016,3,31,1800,330,585,915,Thursday
2016,3,31,1700,359,677,1036,Thursday
2016,3,31,1600,380,552,932,Thursday
2016,3,31,1500,359,474,833,Thursday
2016,3,31,1400,369,387,756,Thursday
2016,3,31,1300,417,339,756,Thursday
2016,3,31,1200,576,300,876,Thursday
2016,3,31,1100,444,238,682,Thursday
2016,3,31,1000,499,157,656,Thursday
2016,3,31,900,417,105,522,Thursday
2016,3,31,800,209,75,284,Thursday
2016,3,31,700,100,34,134,Thursday
2016,3,31,600,39,33,72,Thursday
2016,3,31,500,28,29,57,Thursday
2016,3,31,400,25,33,58,Thursday
2016,3,31,300,30,25,55,Thursday
2016,3,31,200,43,48,91,Thursday
2016,3,31,100,18,47,65,Thursday
2016,3,30,2400,55,58,113,Wednesday
2016,3,30,2300,72,102,174,Wednesday
2016,3,30,2200,105,138,243,Wednesday
2016,3,30,2100,135,176,311,Wednesday
2016,3,30,2000,143,219,362,Wednesday
2016,3,30,1900,193,331,524,Wednesday
2016,3,30,1800,214,615,829,Wednesday
2016,3,30,1700,253,695,948,Wednesday
2016,3,30,1600,315,534,849,Wednesday
2016,3,30,1500,306,464,770,Wednesday
2016,3,30,1400,345,378,723,Wednesday
2016,3,30,1300,413,346,759,Wednesday
2016,3,30,1200,473,270,743,Wednesday
2016,3,30,1100,458,202,660,Wednesday
2016,3,30,1000,446,156,602,Wednesday
2016,3,30,900,459,112,571,Wednesday
2016,3,30,800,226,67,293,Wednesday
2016,3,30,700,87,48,135,Wednesday
2016,3,30,600,31,29,60,Wednesday
2016,3,30,500,15,29,44,Wednesday
2016,3,30,400,28,38,66,Wednesday
2016,3,30,300,20,47,67,Wednesday
2016,3,30,200,26,54,80,Wednesday
2016,3,30,100,38,49,87,Wednesday
2016,3,29,2400,64,75,139,Tuesday
2016,3,29,2300,84,86,170,Tuesday
2016,3,29,2200,117,141,258,Tuesday
2016,3,29,2100,102,222,324,Tuesday
2016,3,29,2000,147,291,438,Tuesday
2016,3,29,1900,173,426,599,Tuesday
2016,3,29,1800,213,783,996,Tuesday
2016,3,29,1700,250,846,1096,Tuesday
2016,3,29,1600,297,603,900,Tuesday
2016,3,29,1500,321,516,837,Tuesday
2016,3,29,1400,352,426,778,Tuesday
2016,3,29,1300,447,386,833,Tuesday
2016,3,29,1200,530,314,844,Tuesday
2016,3,29,1100,577,223,800,Tuesday
2016,3,29,1000,607,145,752,Tuesday
2016,3,29,900,475,111,586,Tuesday
2016,3,29,800,216,76,292,Tuesday
2016,3,29,700,66,49,115,Tuesday
2016,3,29,600,35,41,76,Tuesday
2016,3,29,500,20,27,47,Tuesday
2016,3,29,400,29,26,55,Tuesday
2016,3,29,300,14,37,51,Tuesday
2016,3,29,200,22,44,66,Tuesday
2016,3,29,100,42,65,107,Tuesday
2016,3,28,2400,47,99,146,Monday
2016,3,28,2300,57,133,190,Monday
2016,3,28,2200,82,201,283,Monday
2016,3,28,2100,107,330,437,Monday
2016,3,28,2000,157,504,661,Monday
2016,3,28,1900,185,754,939,Monday
2016,3,28,1800,248,1087,1335,Monday
2016,3,28,1700,325,1356,1681,Monday
2016,3,28,1600,371,1179,1550,Monday
2016,3,28,1500,547,1039,1586,Monday
2016,3,28,1400,558,899,1457,Monday
2016,3,28,1300,631,760,1391,Monday
2016,3,28,1200,725,552,1277,Monday
2016,3,28,1100,737,380,1117,Monday
2016,3,28,1000,665,185,850,Monday
2016,3,28,900,586,142,728,Monday
2016,3,28,800,242,85,327,Monday
2016,3,28,700,98,47,145,Monday
2016,3,28,600,28,26,54,Monday
2016,3,28,500,22,18,40,Monday
2016,3,28,400,15,15,30,Monday
2016,3,28,300,15,29,44,Monday
2016,3,28,200,12,58,70,Monday
2016,3,28,100,27,77,104,Monday
2016,3,27,2400,34,115,149,Sunday
2016,3,27,2300,55,169,224,Sunday
2016,3,27,2200,84,300,384,Sunday
2016,3,27,2100,106,436,542,Sunday
2016,3,27,2000,102,755,857,Sunday
2016,3,27,1900,159,893,1052,Sunday
2016,3,27,1800,252,1391,1643,Sunday
2016,3,27,1700,322,1478,1800,Sunday
2016,3,27,1600,461,1466,1927,Sunday
2016,3,27,1500,467,1263,1730,Sunday
2016,3,27,1400,525,1142,1667,Sunday
2016,3,27,1300,649,862,1511,Sunday
2016,3,27,1200,669,621,1290,Sunday
2016,3,27,1100,657,338,995,Sunday
2016,3,27,1000,615,177,792,Sunday
2016,3,27,900,484,99,583,Sunday
2016,3,27,800,221,49,270,Sunday
2016,3,27,700,93,19,112,Sunday
2016,3,27,600,30,16,46,Sunday
2016,3,27,500,21,15,36,Sunday
2016,3,27,400,15,18,33,Sunday
2016,3,27,300,16,36,52,Sunday
2016,3,27,200,27,22,49,Sunday
2016,3,27,100,40,44,84,Sunday
2016,3,26,2400,35,64,99,Saturday
2016,3,26,2300,71,119,190,Saturday
2016,3,26,2200,89,128,217,Saturday
2016,3,26,2100,112,265,377,Saturday
2016,3,26,2000,134,404,538,Saturday
2016,3,26,1900,184,623,807,Saturday
2016,3,26,1800,261,1146,1407,Saturday
2016,3,26,1700,360,1180,1540,Saturday
2016,3,26,1600,436,899,1335,Saturday
2016,3,26,1500,495,637,1132,Saturday
2016,3,26,1400,587,533,1120,Saturday
2016,3,26,1300,704,410,1114,Saturday
2016,3,26,1200,837,308,1145,Saturday
2016,3,26,1100,759,199,958,Saturday
2016,3,26,1000,739,117,856,Saturday
2016,3,26,900,770,90,860,Saturday
2016,3,26,800,381,47,428,Saturday
2016,3,26,700,121,21,142,Saturday
2016,3,26,600,46,16,62,Saturday
2016,3,26,500,26,13,39,Saturday
2016,3,26,400,20,19,39,Saturday
2016,3,26,300,21,13,34,Saturday
2016,3,26,200,24,15,39,Saturday
2016,3,26,100,30,38,68,Saturday
2016,3,25,2400,30,61,91,Friday
2016,3,25,2300,69,99,168,Friday
2016,3,25,2200,105,151,256,Friday
2016,3,25,2100,148,189,337,Friday
2016,3,25,2000,178,328,506,Friday
2016,3,25,1900,269,599,868,Friday
2016,3,25,1800,412,1153,1565,Friday
2016,3,25,1700,561,1308,1869,Friday
2016,3,25,1600,768,849,1617,Friday
2016,3,25,1500,972,727,1699,Friday
2016,3,25,1400,1124,532,1656,Friday
2016,3,25,1300,1329,496,1825,Friday
2016,3,25,1200,1431,352,1783,Friday
2016,3,25,1100,1395,247,1642,Friday
2016,3,25,1000,1503,176,1679,Friday
2016,3,25,900,1378,116,1494,Friday
2016,3,25,800,730,65,795,Friday
2016,3,25,700,299,51,350,Friday
2016,3,25,600,100,33,133,Friday
2016,3,25,500,59,40,99,Friday
2016,3,25,400,40,30,70,Friday
2016,3,25,300,48,35,83,Friday
2016,3,25,200,62,59,121,Friday
2016,3,25,100,83,48,131,Friday
2016,3,24,2400,147,89,236,Thursday
2016,3,24,2300,235,122,357,Thursday
2016,3,24,2200,329,170,499,Thursday
2016,3,24,2100,598,207,805,Thursday
2016,3,24,2000,875,319,1194,Thursday
2016,3,24,1900,881,397,1278,Thursday
2016,3,24,1800,933,598,1531,Thursday
2016,3,24,1700,903,677,1580,Thursday
2016,3,24,1600,882,601,1483,Thursday
2016,3,24,1500,819,441,1260,Thursday
2016,3,24,1400,691,393,1084,Thursday
2016,3,24,1300,616,332,948,Thursday
2016,3,24,1200,751,282,1033,Thursday
2016,3,24,1100,752,201,953,Thursday
2016,3,24,1000,722,183,905,Thursday
2016,3,24,900,643,110,753,Thursday
2016,3,24,800,323,61,384,Thursday
2016,3,24,700,142,36,178,Thursday
2016,3,24,600,63,30,93,Thursday
2016,3,24,500,39,28,67,Thursday
2016,3,24,400,44,18,62,Thursday
2016,3,24,300,33,38,71,Thursday
2016,3,24,200,37,45,82,Thursday
2016,3,24,100,54,61,115,Thursday
2016,3,23,2400,83,66,149,Wednesday
2016,3,23,2300,95,70,165,Wednesday
2016,3,23,2200,140,119,259,Wednesday
2016,3,23,2100,184,150,334,Wednesday
2016,3,23,2000,247,197,444,Wednesday
2016,3,23,1900,306,277,583,Wednesday
2016,3,23,1800,305,504,809,Wednesday
2016,3,23,1700,370,608,978,Wednesday
2016,3,23,1600,345,442,787,Wednesday
2016,3,23,1500,371,429,800,Wednesday
2016,3,23,1400,383,347,730,Wednesday
2016,3,23,1300,412,276,688,Wednesday
2016,3,23,1200,447,262,709,Wednesday
2016,3,23,1100,501,203,704,Wednesday
2016,3,23,1000,486,143,629,Wednesday
2016,3,23,900,416,79,495,Wednesday
2016,3,23,800,233,77,310,Wednesday
2016,3,23,700,102,36,138,Wednesday
2016,3,23,600,46,23,69,Wednesday
2016,3,23,500,22,25,47,Wednesday
2016,3,23,400,27,30,57,Wednesday
2016,3,23,300,29,27,56,Wednesday
2016,3,23,200,26,37,63,Wednesday
2016,3,23,100,44,57,101,Wednesday
2016,3,22,2400,58,64,122,Tuesday
2016,3,22,2300,76,79,155,Tuesday
2016,3,22,2200,114,101,215,Tuesday
2016,3,22,2100,106,135,241,Tuesday
2016,3,22,2000,124,215,339,Tuesday
2016,3,22,1900,188,298,486,Tuesday
2016,3,22,1800,219,487,706,Tuesday
2016,3,22,1700,223,527,750,Tuesday
2016,3,22,1600,304,449,753,Tuesday
2016,3,22,1500,269,319,588,Tuesday
2016,3,22,1400,291,307,598,Tuesday
2016,3,22,1300,355,263,618,Tuesday
2016,3,22,1200,408,238,646,Tuesday
2016,3,22,1100,425,199,624,Tuesday
2016,3,22,1000,419,147,566,Tuesday
2016,3,22,900,329,98,427,Tuesday
2016,3,22,800,204,76,280,Tuesday
2016,3,22,700,78,44,122,Tuesday
2016,3,22,600,37,34,71,Tuesday
2016,3,22,500,24,18,42,Tuesday
2016,3,22,400,22,36,58,Tuesday
2016,3,22,300,22,30,52,Tuesday
2016,3,22,200,37,39,76,Tuesday
2016,3,22,100,31,53,84,Tuesday
2016,3,21,2400,60,51,111,Monday
2016,3,21,2300,61,62,123,Monday
2016,3,21,2200,94,106,200,Monday
2016,3,21,2100,121,162,283,Monday
2016,3,21,2000,135,203,338,Monday
2016,3,21,1900,160,272,432,Monday
2016,3,21,1800,224,452,676,Monday
2016,3,21,1700,194,526,720,Monday
2016,3,21,1600,307,484,791,Monday
2016,3,21,1500,321,380,701,Monday
2016,3,21,1400,383,309,692,Monday
2016,3,21,1300,445,290,735,Monday
2016,3,21,1200,446,288,734,Monday
2016,3,21,1100,441,176,617,Monday
2016,3,21,1000,418,121,539,Monday
2016,3,21,900,354,111,465,Monday
2016,3,21,800,215,61,276,Monday
2016,3,21,700,89,38,127,Monday
2016,3,21,600,31,15,46,Monday
2016,3,21,500,21,23,44,Monday
2016,3,21,400,22,20,42,Monday
2016,3,21,300,12,25,37,Monday
2016,3,21,200,26,43,69,Monday
2016,3,21,100,37,53,90,Monday
2016,3,20,2400,39,66,105,Sunday
2016,3,20,2300,43,111,154,Sunday
2016,3,20,2200,70,139,209,Sunday
2016,3,20,2100,97,274,371,Sunday
2016,3,20,2000,131,397,528,Sunday
2016,3,20,1900,179,609,788,Sunday
2016,3,20,1800,245,1079,1324,Sunday
2016,3,20,1700,289,1227,1516,Sunday
2016,3,20,1600,359,943,1302,Sunday
2016,3,20,1500,422,776,1198,Sunday
2016,3,20,1400,467,610,1077,Sunday
2016,3,20,1300,508,526,1034,Sunday
2016,3,20,1200,558,408,966,Sunday
2016,3,20,1100,618,278,896,Sunday
2016,3,20,1000,599,144,743,Sunday
2016,3,20,900,589,79,668,Sunday
2016,3,20,800,252,41,293,Sunday
2016,3,20,700,98,19,117,Sunday
2016,3,20,600,44,16,60,Sunday
2016,3,20,500,23,13,36,Sunday
2016,3,20,400,17,18,35,Sunday
2016,3,20,300,18,13,31,Sunday
2016,3,20,200,20,23,43,Sunday
2016,3,20,100,37,32,69,Sunday
2016,3,19,2400,34,49,83,Saturday
2016,3,19,2300,56,78,134,Saturday
2016,3,19,2200,73,110,183,Saturday
2016,3,19,2100,87,176,263,Saturday
2016,3,19,2000,136,258,394,Saturday
2016,3,19,1900,164,444,608,Saturday
2016,3,19,1800,203,954,1157,Saturday
2016,3,19,1700,278,1023,1301,Saturday
2016,3,19,1600,343,602,945,Saturday
2016,3,19,1500,421,512,933,Saturday
2016,3,19,1400,494,395,889,Saturday
2016,3,19,1300,533,300,833,Saturday
2016,3,19,1200,703,274,977,Saturday
2016,3,19,1100,710,220,930,Saturday
2016,3,19,1000,766,137,903,Saturday
2016,3,19,900,847,91,938,Saturday
2016,3,19,800,422,66,488,Saturday
2016,3,19,700,165,55,220,Saturday
2016,3,19,600,65,29,94,Saturday
2016,3,19,500,24,14,38,Saturday
2016,3,19,400,21,24,45,Saturday
2016,3,19,300,17,25,42,Saturday
2016,3,19,200,25,49,74,Saturday
2016,3,19,100,52,71,123,Saturday
2016,3,18,2400,62,63,125,Friday
2016,3,18,2300,131,105,236,Friday
2016,3,18,2200,181,108,289,Friday
2016,3,18,2100,280,166,446,Friday
2016,3,18,2000,384,219,603,Friday
2016,3,18,1900,469,343,812,Friday
2016,3,18,1800,515,631,1146,Friday
2016,3,18,1700,524,676,1200,Friday
2016,3,18,1600,565,522,1087,Friday
2016,3,18,1500,542,371,913,Friday
2016,3,18,1400,525,346,871,Friday
2016,3,18,1300,469,332,801,Friday
2016,3,18,1200,533,250,783,Friday
2016,3,18,1100,587,252,839,Friday
2016,3,18,1000,613,143,756,Friday
2016,3,18,900,578,118,696,Friday
2016,3,18,800,286,69,355,Friday
2016,3,18,700,141,32,173,Friday
2016,3,18,600,52,41,93,Friday
2016,3,18,500,43,23,66,Friday
2016,3,18,400,37,36,73,Friday
2016,3,18,300,35,39,74,Friday
2016,3,18,200,30,54,84,Friday
2016,3,18,100,52,56,108,Friday
2016,3,17,2400,76,43,119,Thursday
2016,3,17,2300,84,85,169,Thursday
2016,3,17,2200,136,97,233,Thursday
2016,3,17,2100,182,136,318,Thursday
2016,3,17,2000,233,224,457,Thursday
2016,3,17,1900,228,251,479,Thursday
2016,3,17,1800,261,483,744,Thursday
2016,3,17,1700,317,511,828,Thursday
2016,3,17,1600,344,441,785,Thursday
2016,3,17,1500,333,281,614,Thursday
2016,3,17,1400,335,254,589,Thursday
2016,3,17,1300,315,257,572,Thursday
2016,3,17,1200,414,216,630,Thursday
2016,3,17,1100,409,176,585,Thursday
2016,3,17,1000,372,132,504,Thursday
2016,3,17,900,345,115,460,Thursday
2016,3,17,800,230,75,305,Thursday
2016,3,17,700,83,37,120,Thursday
2016,3,17,600,43,32,75,Thursday
2016,3,17,500,25,14,39,Thursday
2016,3,17,400,31,25,56,Thursday
2016,3,17,300,31,31,62,Thursday
2016,3,17,200,28,48,76,Thursday
2016,3,17,100,43,55,98,Thursday
2016,3,16,2400,47,80,127,Wednesday
2016,3,16,2300,63,95,158,Wednesday
2016,3,16,2200,112,114,226,Wednesday
2016,3,16,2100,143,113,256,Wednesday
2016,3,16,2000,183,182,365,Wednesday
2016,3,16,1900,182,263,445,Wednesday
2016,3,16,1800,186,469,655,Wednesday
2016,3,16,1700,273,526,799,Wednesday
2016,3,16,1600,257,360,617,Wednesday
2016,3,16,1500,272,337,609,Wednesday
2016,3,16,1400,261,288,549,Wednesday
2016,3,16,1300,310,239,549,Wednesday
2016,3,16,1200,343,244,587,Wednesday
2016,3,16,1100,375,170,545,Wednesday
2016,3,16,1000,385,142,527,Wednesday
2016,3,16,900,362,87,449,Wednesday
2016,3,16,800,202,78,280,Wednesday
2016,3,16,700,87,43,130,Wednesday
2016,3,16,600,32,27,59,Wednesday
2016,3,16,500,20,25,45,Wednesday
2016,3,16,400,30,39,69,Wednesday
2016,3,16,300,24,35,59,Wednesday
2016,3,16,200,25,33,58,Wednesday
2016,3,16,100,40,46,86,Wednesday
2016,3,15,2400,44,54,98,Tuesday
2016,3,15,2300,88,63,151,Tuesday
2016,3,15,2200,89,109,198,Tuesday
2016,3,15,2100,125,133,258,Tuesday
2016,3,15,2000,122,197,319,Tuesday
2016,3,15,1900,139,291,430,Tuesday
2016,3,15,1800,175,437,612,Tuesday
2016,3,15,1700,204,508,712,Tuesday
2016,3,15,1600,212,376,588,Tuesday
2016,3,15,1500,247,344,591,Tuesday
2016,3,15,1400,241,258,499,Tuesday
2016,3,15,1300,267,264,531,Tuesday
2016,3,15,1200,312,268,580,Tuesday
2016,3,15,1100,345,98,443,Tuesday
2016,3,15,1000,352,141,493,Tuesday
2016,3,15,900,360,106,466,Tuesday
2016,3,15,800,192,62,254,Tuesday
2016,3,15,700,95,33,128,Tuesday
2016,3,15,600,37,34,71,Tuesday
2016,3,15,500,17,22,39,Tuesday
2016,3,15,400,23,26,49,Tuesday
2016,3,15,300,16,33,49,Tuesday
2016,3,15,200,22,38,60,Tuesday
2016,3,15,100,36,41,77,Tuesday
2016,3,14,2400,56,62,118,Monday
2016,3,14,2300,73,85,158,Monday
2016,3,14,2200,85,100,185,Monday
2016,3,14,2100,115,118,233,Monday
2016,3,14,2000,145,253,398,Monday
2016,3,14,1900,123,322,445,Monday
2016,3,14,1800,166,494,660,Monday
2016,3,14,1700,225,554,779,Monday
2016,3,14,1600,244,459,703,Monday
2016,3,14,1500,287,356,643,Monday
2016,3,14,1400,281,292,573,Monday
2016,3,14,1300,299,298,597,Monday
2016,3,14,1200,353,243,596,Monday
2016,3,14,1100,350,135,485,Monday
2016,3,14,1000,381,123,504,Monday
2016,3,14,900,380,63,443,Monday
2016,3,14,800,173,44,217,Monday
2016,3,14,700,110,42,152,Monday
2016,3,14,600,36,19,55,Monday
2016,3,14,500,29,20,49,Monday
2016,3,14,400,20,25,45,Monday
2016,3,14,300,16,22,38,Monday
2016,3,14,200,16,32,48,Monday
2016,3,14,100,34,42,76,Monday
2016,3,13,2400,31,62,93,Sunday
2016,3,13,2300,61,104,165,Sunday
2016,3,13,2200,76,173,249,Sunday
2016,3,13,2100,94,256,350,Sunday
2016,3,13,2000,121,398,519,Sunday
2016,3,13,1900,154,670,824,Sunday
2016,3,13,1800,186,1204,1390,Sunday
2016,3,13,1700,239,1405,1644,Sunday
2016,3,13,1600,290,1091,1381,Sunday
2016,3,13,1500,379,728,1107,Sunday
2016,3,13,1400,376,649,1025,Sunday
2016,3,13,1300,482,578,1060,Sunday
2016,3,13,1200,553,393,946,Sunday
2016,3,13,1100,526,212,738,Sunday
2016,3,13,1000,638,123,761,Sunday
2016,3,13,900,740,72,812,Sunday
2016,3,13,800,263,32,295,Sunday
2016,3,13,700,82,22,104,Sunday
2016,3,13,600,31,23,54,Sunday
2016,3,13,500,20,24,44,Sunday
2016,3,13,400,12,34,46,Sunday
2016,3,13,300,0,0,0,Sunday
2016,3,13,200,16,40,56,Sunday
2016,3,13,100,27,28,55,Sunday
2016,3,12,2400,34,42,76,Saturday
2016,3,12,2300,65,65,130,Saturday
2016,3,12,2200,72,105,177,Saturday
2016,3,12,2100,81,158,239,Saturday
2016,3,12,2000,96,229,325,Saturday
2016,3,12,1900,133,354,487,Saturday
2016,3,12,1800,222,828,1050,Saturday
2016,3,12,1700,263,1094,1357,Saturday
2016,3,12,1600,339,762,1101,Saturday
2016,3,12,1500,342,511,853,Saturday
2016,3,12,1400,388,357,745,Saturday
2016,3,12,1300,456,331,787,Saturday
2016,3,12,1200,534,289,823,Saturday
2016,3,12,1100,530,187,717,Saturday
2016,3,12,1000,743,132,875,Saturday
2016,3,12,900,845,91,936,Saturday
2016,3,12,800,459,55,514,Saturday
2016,3,12,700,151,41,192,Saturday
2016,3,12,600,52,18,70,Saturday
2016,3,12,500,25,24,49,Saturday
2016,3,12,400,21,22,43,Saturday
2016,3,12,300,19,23,42,Saturday
2016,3,12,200,30,34,64,Saturday
2016,3,12,100,39,37,76,Saturday
2016,3,11,2400,69,49,118,Friday
2016,3,11,2300,109,70,179,Friday
2016,3,11,2200,164,82,246,Friday
2016,3,11,2100,248,153,401,Friday
2016,3,11,2000,332,216,548,Friday
2016,3,11,1900,469,312,781,Friday
2016,3,11,1800,490,461,951,Friday
2016,3,11,1700,490,667,1157,Friday
2016,3,11,1600,453,518,971,Friday
2016,3,11,1500,438,379,817,Friday
2016,3,11,1400,430,296,726,Friday
2016,3,11,1300,331,254,585,Friday
2016,3,11,1200,428,217,645,Friday
2016,3,11,1100,433,186,619,Friday
2016,3,11,1000,500,144,644,Friday
2016,3,11,900,556,109,665,Friday
2016,3,11,800,316,51,367,Friday
2016,3,11,700,137,31,168,Friday
2016,3,11,600,62,37,99,Friday
2016,3,11,500,24,25,49,Friday
2016,3,11,400,28,34,62,Friday
2016,3,11,300,30,29,59,Friday
2016,3,11,200,28,38,66,Friday
2016,3,11,100,38,64,102,Friday
2016,3,10,2400,53,44,97,Thursday
2016,3,10,2300,92,65,157,Thursday
2016,3,10,2200,124,92,216,Thursday
2016,3,10,2100,168,124,292,Thursday
2016,3,10,2000,215,176,391,Thursday
2016,3,10,1900,226,233,459,Thursday
2016,3,10,1800,268,407,675,Thursday
2016,3,10,1700,294,456,750,Thursday
2016,3,10,1600,285,379,664,Thursday
2016,3,10,1500,306,301,607,Thursday
2016,3,10,1400,281,263,544,Thursday
2016,3,10,1300,289,209,498,Thursday
2016,3,10,1200,296,188,484,Thursday
2016,3,10,1100,350,167,517,Thursday
2016,3,10,1000,371,123,494,Thursday
2016,3,10,900,364,94,458,Thursday
2016,3,10,800,225,62,287,Thursday
2016,3,10,700,118,33,151,Thursday
2016,3,10,600,36,23,59,Thursday
2016,3,10,500,24,20,44,Thursday
2016,3,10,400,35,21,56,Thursday
2016,3,10,300,26,22,48,Thursday
2016,3,10,200,23,43,66,Thursday
2016,3,10,100,41,58,99,Thursday
2016,3,9,2400,62,42,104,Wednesday
2016,3,9,2300,65,68,133,Wednesday
2016,3,9,2200,94,80,174,Wednesday
2016,3,9,2100,122,136,258,Wednesday
2016,3,9,2000,129,171,300,Wednesday
2016,3,9,1900,120,210,330,Wednesday
2016,3,9,1800,185,329,514,Wednesday
2016,3,9,1700,204,444,648,Wednesday
2016,3,9,1600,229,311,540,Wednesday
2016,3,9,1500,261,305,566,Wednesday
2016,3,9,1400,254,235,489,Wednesday
2016,3,9,1300,234,237,471,Wednesday
2016,3,9,1200,301,179,480,Wednesday
2016,3,9,1100,320,161,481,Wednesday
2016,3,9,1000,344,137,481,Wednesday
2016,3,9,900,299,103,402,Wednesday
2016,3,9,800,201,61,262,Wednesday
2016,3,9,700,106,32,138,Wednesday
2016,3,9,600,44,31,75,Wednesday
2016,3,9,500,22,23,45,Wednesday
2016,3,9,400,25,29,54,Wednesday
2016,3,9,300,17,33,50,Wednesday
2016,3,9,200,31,45,76,Wednesday
2016,3,9,100,36,34,70,Wednesday
2016,3,8,2400,50,63,113,Tuesday
2016,3,8,2300,57,75,132,Tuesday
2016,3,8,2200,93,85,178,Tuesday
2016,3,8,2100,91,100,191,Tuesday
2016,3,8,2000,116,150,266,Tuesday
2016,3,8,1900,129,222,351,Tuesday
2016,3,8,1800,131,331,462,Tuesday
2016,3,8,1700,205,422,627,Tuesday
2016,3,8,1600,208,337,545,Tuesday
2016,3,8,1500,223,282,505,Tuesday
2016,3,8,1400,252,230,482,Tuesday
2016,3,8,1300,242,206,448,Tuesday
2016,3,8,1200,265,181,446,Tuesday
2016,3,8,1100,266,172,438,Tuesday
2016,3,8,1000,350,132,482,Tuesday
2016,3,8,900,278,132,410,Tuesday
2016,3,8,800,215,53,268,Tuesday
2016,3,8,700,88,63,151,Tuesday
2016,3,8,600,41,47,88,Tuesday
2016,3,8,500,20,56,76,Tuesday
2016,3,8,400,29,42,71,Tuesday
2016,3,8,300,24,51,75,Tuesday
2016,3,8,200,36,43,79,Tuesday
2016,3,8,100,46,58,104,Tuesday
2016,3,7,2400,66,62,128,Monday
2016,3,7,2300,87,105,192,Monday
2016,3,7,2200,83,125,208,Monday
2016,3,7,2100,93,125,218,Monday
2016,3,7,2000,95,183,278,Monday
2016,3,7,1900,137,254,391,Monday
2016,3,7,1800,158,412,570,Monday
2016,3,7,1700,204,505,709,Monday
2016,3,7,1600,233,385,618,Monday
2016,3,7,1500,231,343,574,Monday
2016,3,7,1400,270,295,565,Monday
2016,3,7,1300,269,253,522,Monday
2016,3,7,1200,315,217,532,Monday
2016,3,7,1100,305,182,487,Monday
2016,3,7,1000,364,127,491,Monday
2016,3,7,900,374,127,501,Monday
2016,3,7,800,177,56,233,Monday
2016,3,7,700,87,35,122,Monday
2016,3,7,600,40,18,58,Monday
2016,3,7,500,15,13,28,Monday
2016,3,7,400,16,27,43,Monday
2016,3,7,300,20,25,45,Monday
2016,3,7,200,22,26,48,Monday
2016,3,7,100,20,65,85,Monday
2016,3,6,2400,34,72,106,Sunday
2016,3,6,2300,58,130,188,Sunday
2016,3,6,2200,80,208,288,Sunday
2016,3,6,2100,72,216,288,Sunday
2016,3,6,2000,72,206,278,Sunday
2016,3,6,1900,110,647,757,Sunday
2016,3,6,1800,141,865,1006,Sunday
2016,3,6,1700,226,1150,1376,Sunday
2016,3,6,1600,251,1212,1463,Sunday
2016,3,6,1500,274,800,1074,Sunday
2016,3,6,1400,324,711,1035,Sunday
2016,3,6,1300,356,618,974,Sunday
2016,3,6,1200,419,462,881,Sunday
2016,3,6,1100,472,316,788,Sunday
2016,3,6,1000,630,165,795,Sunday
2016,3,6,900,732,93,825,Sunday
2016,3,6,800,328,44,372,Sunday
2016,3,6,700,94,28,122,Sunday
2016,3,6,600,48,11,59,Sunday
2016,3,6,500,25,26,51,Sunday
2016,3,6,400,23,17,40,Sunday
2016,3,6,300,19,10,29,Sunday
2016,3,6,200,8,19,27,Sunday
2016,3,6,100,26,20,46,Sunday
2016,3,5,2400,28,42,70,Saturday
2016,3,5,2300,45,48,93,Saturday
2016,3,5,2200,59,78,137,Saturday
2016,3,5,2100,75,113,188,Saturday
2016,3,5,2000,92,201,293,Saturday
2016,3,5,1900,126,369,495,Saturday
2016,3,5,1800,182,860,1042,Saturday
2016,3,5,1700,214,915,1129,Saturday
2016,3,5,1600,241,661,902,Saturday
2016,3,5,1500,340,559,899,Saturday
2016,3,5,1400,359,516,875,Saturday
2016,3,5,1300,425,212,637,Saturday
2016,3,5,1200,491,250,741,Saturday
2016,3,5,1100,559,194,753,Saturday
2016,3,5,1000,687,144,831,Saturday
2016,3,5,900,894,98,992,Saturday
2016,3,5,800,463,53,516,Saturday
2016,3,5,700,141,33,174,Saturday
2016,3,5,600,51,36,87,Saturday
2016,3,5,500,25,20,45,Saturday
2016,3,5,400,18,18,36,Saturday
2016,3,5,300,40,22,62,Saturday
2016,3,5,200,20,29,49,Saturday
2016,3,5,100,38,30,68,Saturday
2016,3,4,2400,63,47,110,Friday
2016,3,4,2300,102,79,181,Friday
2016,3,4,2200,170,85,255,Friday
2016,3,4,2100,280,125,405,Friday
2016,3,4,2000,382,181,563,Friday
2016,3,4,1900,463,280,743,Friday
2016,3,4,1800,517,536,1053,Friday
2016,3,4,1700,558,587,1145,Friday
2016,3,4,1600,399,470,869,Friday
2016,3,4,1500,452,379,831,Friday
2016,3,4,1400,390,361,751,Friday
2016,3,4,1300,362,302,664,Friday
2016,3,4,1200,412,230,642,Friday
2016,3,4,1100,461,196,657,Friday
2016,3,4,1000,555,151,706,Friday
2016,3,4,900,503,112,615,Friday
2016,3,4,800,269,56,325,Friday
2016,3,4,700,138,36,174,Friday
2016,3,4,600,50,21,71,Friday
2016,3,4,500,17,21,38,Friday
2016,3,4,400,26,43,69,Friday
2016,3,4,300,25,40,65,Friday
2016,3,4,200,42,46,88,Friday
2016,3,4,100,37,52,89,Friday
2016,3,3,2400,71,75,146,Thursday
2016,3,3,2300,85,71,156,Thursday
2016,3,3,2200,153,84,237,Thursday
2016,3,3,2100,188,124,312,Thursday
2016,3,3,2000,236,146,382,Thursday
2016,3,3,1900,237,251,488,Thursday
2016,3,3,1800,255,431,686,Thursday
2016,3,3,1700,312,471,783,Thursday
2016,3,3,1600,274,371,645,Thursday
2016,3,3,1500,291,283,574,Thursday
2016,3,3,1400,264,247,511,Thursday
2016,3,3,1300,267,205,472,Thursday
2016,3,3,1200,325,177,502,Thursday
2016,3,3,1100,362,175,537,Thursday
2016,3,3,1000,385,134,519,Thursday
2016,3,3,900,364,93,457,Thursday
2016,3,3,800,253,71,324,Thursday
2016,3,3,700,103,30,133,Thursday
2016,3,3,600,42,35,77,Thursday
2016,3,3,500,21,20,41,Thursday
2016,3,3,400,34,35,69,Thursday
2016,3,3,300,24,31,55,Thursday
2016,3,3,200,16,50,66,Thursday
2016,3,3,100,53,43,96,Thursday
2016,3,2,2400,47,47,94,Wednesday
2016,3,2,2300,75,73,148,Wednesday
2016,3,2,2200,109,80,189,Wednesday
2016,3,2,2100,107,105,212,Wednesday
2016,3,2,2000,146,162,308,Wednesday
2016,3,2,1900,134,254,388,Wednesday
2016,3,2,1800,161,350,511,Wednesday
2016,3,2,1700,197,460,657,Wednesday
2016,3,2,1600,213,334,547,Wednesday
2016,3,2,1500,205,318,523,Wednesday
2016,3,2,1400,230,252,482,Wednesday
2016,3,2,1300,250,196,446,Wednesday
2016,3,2,1200,296,204,500,Wednesday
2016,3,2,1100,312,184,496,Wednesday
2016,3,2,1000,358,110,468,Wednesday
2016,3,2,900,340,80,420,Wednesday
2016,3,2,800,215,35,250,Wednesday
2016,3,2,700,76,40,116,Wednesday
2016,3,2,600,40,19,59,Wednesday
2016,3,2,500,17,17,34,Wednesday
2016,3,2,400,29,27,56,Wednesday
2016,3,2,300,22,26,48,Wednesday
2016,3,2,200,28,28,56,Wednesday
2016,3,2,100,28,45,73,Wednesday
2016,3,1,2400,61,48,109,Tuesday
2016,3,1,2300,59,82,141,Tuesday
2016,3,1,2200,85,87,172,Tuesday
2016,3,1,2100,118,111,229,Tuesday
2016,3,1,2000,117,145,262,Tuesday
2016,3,1,1900,136,205,341,Tuesday
2016,3,1,1800,163,352,515,Tuesday
2016,3,1,1700,198,452,650,Tuesday
2016,3,1,1600,237,323,560,Tuesday
2016,3,1,1500,205,280,485,Tuesday
2016,3,1,1400,247,239,486,Tuesday
2016,3,1,1300,249,217,466,Tuesday
2016,3,1,1200,291,194,485,Tuesday
2016,3,1,1100,292,174,466,Tuesday
2016,3,1,1000,319,126,445,Tuesday
2016,3,1,900,309,97,406,Tuesday
2016,3,1,800,200,74,274,Tuesday
2016,3,1,700,81,34,115,Tuesday
2016,3,1,600,33,37,70,Tuesday
2016,3,1,500,13,30,43,Tuesday
2016,3,1,400,22,23,45,Tuesday
2016,3,1,300,17,31,48,Tuesday
2016,3,1,200,24,32,56,Tuesday
2016,3,1,100,31,61,92,Tuesday
2016,2,29,2400,57,66,123,Monday
2016,2,29,2300,54,76,130,Monday
2016,2,29,2200,75,113,188,Monday
2016,2,29,2100,100,123,223,Monday
2016,2,29,2000,88,160,248,Monday
2016,2,29,1900,99,272,371,Monday
2016,2,29,1800,176,430,606,Monday
2016,2,29,1700,215,428,643,Monday
2016,2,29,1600,274,392,666,Monday
2016,2,29,1500,238,301,539,Monday
2016,2,29,1400,293,275,568,Monday
2016,2,29,1300,275,287,562,Monday
2016,2,29,1200,317,251,568,Monday
2016,2,29,1100,311,162,473,Monday
2016,2,29,1000,330,123,453,Monday
2016,2,29,900,364,88,452,Monday
2016,2,29,800,202,57,259,Monday
2016,2,29,700,88,20,108,Monday
2016,2,29,600,36,23,59,Monday
2016,2,29,500,14,22,36,Monday
2016,2,29,400,10,24,34,Monday
2016,2,29,300,19,24,43,Monday
2016,2,29,200,16,34,50,Monday
2016,2,29,100,21,59,80,Monday
2016,2,28,2400,27,65,92,Sunday
2016,2,28,2300,39,87,126,Sunday
2016,2,28,2200,53,103,156,Sunday
2016,2,28,2100,98,203,301,Sunday
2016,2,28,2000,109,290,399,Sunday
2016,2,28,1900,126,508,634,Sunday
2016,2,28,1800,167,880,1047,Sunday
2016,2,28,1700,209,1174,1383,Sunday
2016,2,28,1600,286,1023,1309,Sunday
2016,2,28,1500,299,942,1241,Sunday
2016,2,28,1400,351,691,1042,Sunday
2016,2,28,1300,437,625,1062,Sunday
2016,2,28,1200,492,533,1025,Sunday
2016,2,28,1100,490,293,783,Sunday
2016,2,28,1000,530,219,749,Sunday
2016,2,28,900,669,90,759,Sunday
2016,2,28,800,306,45,351,Sunday
2016,2,28,700,108,18,126,Sunday
2016,2,28,600,31,16,47,Sunday
2016,2,28,500,13,21,34,Sunday
2016,2,28,400,25,22,47,Sunday
2016,2,28,300,22,20,42,Sunday
2016,2,28,200,22,20,42,Sunday
2016,2,28,100,15,26,41,Sunday
2016,2,27,2400,38,44,82,Saturday
2016,2,27,2300,45,54,99,Saturday
2016,2,27,2200,84,78,162,Saturday
2016,2,27,2100,74,128,202,Saturday
2016,2,27,2000,84,219,303,Saturday
2016,2,27,1900,124,428,552,Saturday
2016,2,27,1800,187,916,1103,Saturday
2016,2,27,1700,259,1028,1287,Saturday
2016,2,27,1600,345,647,992,Saturday
2016,2,27,1500,324,522,846,Saturday
2016,2,27,1400,367,340,707,Saturday
2016,2,27,1300,482,301,783,Saturday
2016,2,27,1200,557,274,831,Saturday
2016,2,27,1100,555,202,757,Saturday
2016,2,27,1000,721,136,857,Saturday
2016,2,27,900,936,100,1036,Saturday
2016,2,27,800,411,71,482,Saturday
2016,2,27,700,147,33,180,Saturday
2016,2,27,600,47,22,69,Saturday
2016,2,27,500,22,23,45,Saturday
2016,2,27,400,29,19,48,Saturday
2016,2,27,300,28,27,55,Saturday
2016,2,27,200,18,35,53,Saturday
2016,2,27,100,39,39,78,Saturday
2016,2,26,2400,73,39,112,Friday
2016,2,26,2300,111,81,192,Friday
2016,2,26,2200,185,83,268,Friday
2016,2,26,2100,288,143,431,Friday
2016,2,26,2000,408,190,598,Friday
2016,2,26,1900,476,341,817,Friday
2016,2,26,1800,449,595,1044,Friday
2016,2,26,1700,534,672,1206,Friday
2016,2,26,1600,517,482,999,Friday
2016,2,26,1500,464,407,871,Friday
2016,2,26,1400,378,312,690,Friday
2016,2,26,1300,340,301,641,Friday
2016,2,26,1200,468,261,729,Friday
2016,2,26,1100,449,184,633,Friday
2016,2,26,1000,549,141,690,Friday
2016,2,26,900,541,107,648,Friday
2016,2,26,800,273,48,321,Friday
2016,2,26,700,93,47,140,Friday
2016,2,26,600,38,41,79,Friday
2016,2,26,500,26,29,55,Friday
2016,2,26,400,21,39,60,Friday
2016,2,26,300,23,32,55,Friday
2016,2,26,200,33,44,77,Friday
2016,2,26,100,38,55,93,Friday
2016,2,25,2400,70,60,130,Thursday
2016,2,25,2300,81,81,162,Thursday
2016,2,25,2200,122,95,217,Thursday
2016,2,25,2100,152,119,271,Thursday
2016,2,25,2000,223,163,386,Thursday
2016,2,25,1900,233,229,462,Thursday
2016,2,25,1800,231,404,635,Thursday
2016,2,25,1700,323,543,866,Thursday
2016,2,25,1600,338,405,743,Thursday
2016,2,25,1500,325,338,663,Thursday
2016,2,25,1400,278,233,511,Thursday
2016,2,25,1300,288,213,501,Thursday
2016,2,25,1200,332,186,518,Thursday
2016,2,25,1100,334,154,488,Thursday
2016,2,25,1000,407,130,537,Thursday
2016,2,25,900,407,95,502,Thursday
2016,2,25,800,186,55,241,Thursday
2016,2,25,700,84,30,114,Thursday
2016,2,25,600,38,47,85,Thursday
2016,2,25,500,27,21,48,Thursday
2016,2,25,400,28,20,48,Thursday
2016,2,25,300,43,42,85,Thursday
2016,2,25,200,9,54,63,Thursday
2016,2,25,100,43,41,84,Thursday
2016,2,24,2400,59,47,106,Wednesday
2016,2,24,2300,76,64,140,Wednesday
2016,2,24,2200,122,88,210,Wednesday
2016,2,24,2100,117,118,235,Wednesday
2016,2,24,2000,144,156,300,Wednesday
2016,2,24,1900,143,251,394,Wednesday
2016,2,24,1800,165,348,513,Wednesday
2016,2,24,1700,212,535,747,Wednesday
2016,2,24,1600,243,339,582,Wednesday
2016,2,24,1500,220,272,492,Wednesday
2016,2,24,1400,225,202,427,Wednesday
2016,2,24,1300,253,216,469,Wednesday
2016,2,24,1200,264,191,455,Wednesday
2016,2,24,1100,317,151,468,Wednesday
2016,2,24,1000,323,134,457,Wednesday
2016,2,24,900,303,91,394,Wednesday
2016,2,24,800,157,61,218,Wednesday
2016,2,24,700,94,31,125,Wednesday
2016,2,24,600,32,36,68,Wednesday
2016,2,24,500,23,24,47,Wednesday
2016,2,24,400,29,25,54,Wednesday
2016,2,24,300,21,37,58,Wednesday
2016,2,24,200,22,26,48,Wednesday
2016,2,24,100,43,23,66,Wednesday
2016,2,23,2400,56,55,111,Tuesday
2016,2,23,2300,68,66,134,Tuesday
2016,2,23,2200,88,85,173,Tuesday
2016,2,23,2100,110,101,211,Tuesday
2016,2,23,2000,109,164,273,Tuesday
2016,2,23,1900,110,230,340,Tuesday
2016,2,23,1800,155,421,576,Tuesday
2016,2,23,1700,168,435,603,Tuesday
2016,2,23,1600,206,361,567,Tuesday
2016,2,23,1500,214,268,482,Tuesday
2016,2,23,1400,230,188,418,Tuesday
2016,2,23,1300,271,240,511,Tuesday
2016,2,23,1200,295,201,496,Tuesday
2016,2,23,1100,272,155,427,Tuesday
2016,2,23,1000,352,120,472,Tuesday
2016,2,23,900,288,106,394,Tuesday
2016,2,23,800,187,60,247,Tuesday
2016,2,23,700,90,40,130,Tuesday
2016,2,23,600,29,35,64,Tuesday
2016,2,23,500,16,24,40,Tuesday
2016,2,23,400,19,29,48,Tuesday
2016,2,23,300,17,30,47,Tuesday
2016,2,23,200,21,35,56,Tuesday
2016,2,23,100,34,58,92,Tuesday
2016,2,22,2400,57,65,122,Monday
2016,2,22,2300,50,78,128,Monday
2016,2,22,2200,70,97,167,Monday
2016,2,22,2100,94,110,204,Monday
2016,2,22,2000,118,146,264,Monday
2016,2,22,1900,140,265,405,Monday
2016,2,22,1800,151,441,592,Monday
2016,2,22,1700,168,490,658,Monday
2016,2,22,1600,237,397,634,Monday
2016,2,22,1500,270,323,593,Monday
2016,2,22,1400,266,280,546,Monday
2016,2,22,1300,283,240,523,Monday
2016,2,22,1200,351,205,556,Monday
2016,2,22,1100,331,169,500,Monday
2016,2,22,1000,348,113,461,Monday
2016,2,22,900,320,85,405,Monday
2016,2,22,800,156,62,218,Monday
2016,2,22,700,65,24,89,Monday
2016,2,22,600,35,18,53,Monday
2016,2,22,500,19,19,38,Monday
2016,2,22,400,18,19,37,Monday
2016,2,22,300,13,11,24,Monday
2016,2,22,200,20,23,43,Monday
2016,2,22,100,19,36,55,Monday
2016,2,21,2400,41,52,93,Sunday
2016,2,21,2300,45,95,140,Sunday
2016,2,21,2200,58,139,197,Sunday
2016,2,21,2100,63,257,320,Sunday
2016,2,21,2000,109,349,458,Sunday
2016,2,21,1900,132,578,710,Sunday
2016,2,21,1800,174,1154,1328,Sunday
2016,2,21,1700,233,1439,1672,Sunday
2016,2,21,1600,270,1059,1329,Sunday
2016,2,21,1500,336,880,1216,Sunday
2016,2,21,1400,390,752,1142,Sunday
2016,2,21,1300,403,690,1093,Sunday
2016,2,21,1200,532,427,959,Sunday
2016,2,21,1100,562,281,843,Sunday
2016,2,21,1000,544,137,681,Sunday
2016,2,21,900,796,93,889,Sunday
2016,2,21,800,283,49,332,Sunday
2016,2,21,700,81,19,100,Sunday
2016,2,21,600,23,13,36,Sunday
2016,2,21,500,16,11,27,Sunday
2016,2,21,400,15,15,30,Sunday
2016,2,21,300,13,23,36,Sunday
2016,2,21,200,13,26,39,Sunday
2016,2,21,100,23,33,56,Sunday
2016,2,20,2400,21,59,80,Saturday
2016,2,20,2300,71,74,145,Saturday
2016,2,20,2200,68,117,185,Saturday
2016,2,20,2100,86,168,254,Saturday
2016,2,20,2000,99,190,289,Saturday
2016,2,20,1900,143,450,593,Saturday
2016,2,20,1800,185,1073,1258,Saturday
2016,2,20,1700,283,1136,1419,Saturday
2016,2,20,1600,295,728,1023,Saturday
2016,2,20,1500,311,546,857,Saturday
2016,2,20,1400,391,439,830,Saturday
2016,2,20,1300,463,362,825,Saturday
2016,2,20,1200,519,336,855,Saturday
2016,2,20,1100,586,243,829,Saturday
2016,2,20,1000,691,171,862,Saturday
2016,2,20,900,998,125,1123,Saturday
2016,2,20,800,465,69,534,Saturday
2016,2,20,700,115,39,154,Saturday
2016,2,20,600,35,20,55,Saturday
2016,2,20,500,22,24,46,Saturday
2016,2,20,400,18,26,44,Saturday
2016,2,20,300,24,21,45,Saturday
2016,2,20,200,34,27,61,Saturday
2016,2,20,100,31,24,55,Saturday
2016,2,19,2400,65,56,121,Friday
2016,2,19,2300,97,77,174,Friday
2016,2,19,2200,158,97,255,Friday
2016,2,19,2100,247,119,366,Friday
2016,2,19,2000,359,225,584,Friday
2016,2,19,1900,401,345,746,Friday
2016,2,19,1800,458,620,1078,Friday
2016,2,19,1700,472,809,1281,Friday
2016,2,19,1600,427,643,1070,Friday
2016,2,19,1500,458,509,967,Friday
2016,2,19,1400,393,429,822,Friday
2016,2,19,1300,424,375,799,Friday
2016,2,19,1200,449,305,754,Friday
2016,2,19,1100,542,225,767,Friday
2016,2,19,1000,576,159,735,Friday
2016,2,19,900,641,109,750,Friday
2016,2,19,800,283,69,352,Friday
2016,2,19,700,111,38,149,Friday
2016,2,19,600,45,29,74,Friday
2016,2,19,500,26,32,58,Friday
2016,2,19,400,30,28,58,Friday
2016,2,19,300,22,25,47,Friday
2016,2,19,200,35,31,66,Friday
2016,2,19,100,26,62,88,Friday
2016,2,18,2400,62,52,114,Thursday
2016,2,18,2300,85,97,182,Thursday
2016,2,18,2200,118,102,220,Thursday
2016,2,18,2100,153,124,277,Thursday
2016,2,18,2000,197,173,370,Thursday
2016,2,18,1900,229,373,602,Thursday
2016,2,18,1800,235,445,680,Thursday
2016,2,18,1700,298,738,1036,Thursday
2016,2,18,1600,323,600,923,Thursday
2016,2,18,1500,362,386,748,Thursday
2016,2,18,1400,332,329,661,Thursday
2016,2,18,1300,341,291,632,Thursday
2016,2,18,1200,344,213,557,Thursday
2016,2,18,1100,413,196,609,Thursday
2016,2,18,1000,507,148,655,Thursday
2016,2,18,900,488,97,585,Thursday
2016,2,18,800,257,61,318,Thursday
2016,2,18,700,77,30,107,Thursday
2016,2,18,600,37,27,64,Thursday
2016,2,18,500,27,25,52,Thursday
2016,2,18,400,22,34,56,Thursday
2016,2,18,300,20,28,48,Thursday
2016,2,18,200,37,36,73,Thursday
2016,2,18,100,52,42,94,Thursday
2016,2,17,2400,50,66,116,Wednesday
2016,2,17,2300,76,81,157,Wednesday
2016,2,17,2200,96,91,187,Wednesday
2016,2,17,2100,106,126,232,Wednesday
2016,2,17,2000,155,180,335,Wednesday
2016,2,17,1900,156,317,473,Wednesday
2016,2,17,1800,215,686,901,Wednesday
2016,2,17,1700,271,764,1035,Wednesday
2016,2,17,1600,306,555,861,Wednesday
2016,2,17,1500,284,445,729,Wednesday
2016,2,17,1400,340,323,663,Wednesday
2016,2,17,1300,345,258,603,Wednesday
2016,2,17,1200,407,253,660,Wednesday
2016,2,17,1100,402,184,586,Wednesday
2016,2,17,1000,504,153,657,Wednesday
2016,2,17,900,526,118,644,Wednesday
2016,2,17,800,226,71,297,Wednesday
2016,2,17,700,93,33,126,Wednesday
2016,2,17,600,39,24,63,Wednesday
2016,2,17,500,23,30,53,Wednesday
2016,2,17,400,28,24,52,Wednesday
2016,2,17,300,27,31,58,Wednesday
2016,2,17,200,35,41,76,Wednesday
2016,2,17,100,42,53,95,Wednesday
2016,2,16,2400,61,55,116,Tuesday
2016,2,16,2300,56,78,134,Tuesday
2016,2,16,2200,95,96,191,Tuesday
2016,2,16,2100,96,163,259,Tuesday
2016,2,16,2000,145,221,366,Tuesday
2016,2,16,1900,153,335,488,Tuesday
2016,2,16,1800,194,736,930,Tuesday
2016,2,16,1700,248,908,1156,Tuesday
2016,2,16,1600,298,715,1013,Tuesday
2016,2,16,1500,318,467,785,Tuesday
2016,2,16,1400,315,477,792,Tuesday
2016,2,16,1300,357,297,654,Tuesday
2016,2,16,1200,404,289,693,Tuesday
2016,2,16,1100,458,244,702,Tuesday
2016,2,16,1000,510,138,648,Tuesday
2016,2,16,900,621,117,738,Tuesday
2016,2,16,800,216,72,288,Tuesday
2016,2,16,700,80,46,126,Tuesday
2016,2,16,600,32,15,47,Tuesday
2016,2,16,500,15,29,44,Tuesday
2016,2,16,400,17,15,32,Tuesday
2016,2,16,300,15,37,52,Tuesday
2016,2,16,200,16,34,50,Tuesday
2016,2,16,100,28,55,83,Tuesday
2016,2,15,2400,16,78,94,Monday
2016,2,15,2300,48,127,175,Monday
2016,2,15,2200,76,150,226,Monday
2016,2,15,2100,75,278,353,Monday
2016,2,15,2000,95,468,563,Monday
2016,2,15,1900,112,904,1016,Monday
2016,2,15,1800,173,1532,1705,Monday
2016,2,15,1700,238,1830,2068,Monday
2016,2,15,1600,383,1633,2016,Monday
2016,2,15,1500,453,1505,1958,Monday
2016,2,15,1400,514,1392,1906,Monday
2016,2,15,1300,598,1181,1779,Monday
2016,2,15,1200,710,815,1525,Monday
2016,2,15,1100,697,455,1152,Monday
2016,2,15,1000,642,219,861,Monday
2016,2,15,900,790,105,895,Monday
2016,2,15,800,299,48,347,Monday
2016,2,15,700,74,25,99,Monday
2016,2,15,600,42,18,60,Monday
2016,2,15,500,19,24,43,Monday
2016,2,15,400,23,20,43,Monday
2016,2,15,300,19,13,32,Monday
2016,2,15,200,24,27,51,Monday
2016,2,15,100,27,42,69,Monday
2016,2,14,2400,40,50,90,Sunday
2016,2,14,2300,51,94,145,Sunday
2016,2,14,2200,88,111,199,Sunday
2016,2,14,2100,89,203,292,Sunday
2016,2,14,2000,124,333,457,Sunday
2016,2,14,1900,141,681,822,Sunday
2016,2,14,1800,239,1376,1615,Sunday
2016,2,14,1700,336,1487,1823,Sunday
2016,2,14,1600,500,1131,1631,Sunday
2016,2,14,1500,642,961,1603,Sunday
2016,2,14,1400,699,675,1374,Sunday
2016,2,14,1300,769,509,1278,Sunday
2016,2,14,1200,864,350,1214,Sunday
2016,2,14,1100,782,173,955,Sunday
2016,2,14,1000,918,126,1044,Sunday
2016,2,14,900,957,74,1031,Sunday
2016,2,14,800,341,35,376,Sunday
2016,2,14,700,93,17,110,Sunday
2016,2,14,600,36,11,47,Sunday
2016,2,14,500,17,15,32,Sunday
2016,2,14,400,14,16,30,Sunday
2016,2,14,300,8,14,22,Sunday
2016,2,14,200,18,15,33,Sunday
2016,2,14,100,35,30,65,Sunday
2016,2,13,2400,39,33,72,Saturday
2016,2,13,2300,45,48,93,Saturday
2016,2,13,2200,90,78,168,Saturday
2016,2,13,2100,100,134,234,Saturday
2016,2,13,2000,152,223,375,Saturday
2016,2,13,1900,207,397,604,Saturday
2016,2,13,1800,312,1032,1344,Saturday
2016,2,13,1700,421,1122,1543,Saturday
2016,2,13,1600,553,792,1345,Saturday
2016,2,13,1500,638,557,1195,Saturday
2016,2,13,1400,706,412,1118,Saturday
2016,2,13,1300,837,342,1179,Saturday
2016,2,13,1200,957,284,1241,Saturday
2016,2,13,1100,888,164,1052,Saturday
2016,2,13,1000,964,129,1093,Saturday
2016,2,13,900,1039,96,1135,Saturday
2016,2,13,800,472,43,515,Saturday
2016,2,13,700,144,30,174,Saturday
2016,2,13,600,55,34,89,Saturday
2016,2,13,500,21,25,46,Saturday
2016,2,13,400,32,23,55,Saturday
2016,2,13,300,30,34,64,Saturday
2016,2,13,200,28,43,71,Saturday
2016,2,13,100,63,44,107,Saturday
2016,2,12,2400,88,62,150,Friday
2016,2,12,2300,183,61,244,Friday
2016,2,12,2200,318,78,396,Friday
2016,2,12,2100,448,100,548,Friday
2016,2,12,2000,588,164,752,Friday
2016,2,12,1900,712,219,931,Friday
2016,2,12,1800,752,464,1216,Friday
2016,2,12,1700,813,675,1488,Friday
2016,2,12,1600,877,494,1371,Friday
2016,2,12,1500,828,369,1197,Friday
2016,2,12,1400,715,289,1004,Friday
2016,2,12,1300,552,259,811,Friday
2016,2,12,1200,672,227,899,Friday
2016,2,12,1100,594,160,754,Friday
2016,2,12,1000,636,119,755,Friday
2016,2,12,900,558,118,676,Friday
2016,2,12,800,287,59,346,Friday
2016,2,12,700,99,24,123,Friday
2016,2,12,600,34,29,63,Friday
2016,2,12,500,30,22,52,Friday
2016,2,12,400,21,21,42,Friday
2016,2,12,300,32,43,75,Friday
2016,2,12,200,28,41,69,Friday
2016,2,12,100,37,49,86,Friday
2016,2,11,2400,60,58,118,Thursday
2016,2,11,2300,120,62,182,Thursday
2016,2,11,2200,164,90,254,Thursday
2016,2,11,2100,223,88,311,Thursday
2016,2,11,2000,280,159,439,Thursday
2016,2,11,1900,315,242,557,Thursday
2016,2,11,1800,348,451,799,Thursday
2016,2,11,1700,370,501,871,Thursday
2016,2,11,1600,414,407,821,Thursday
2016,2,11,1500,411,323,734,Thursday
2016,2,11,1400,398,267,665,Thursday
2016,2,11,1300,456,207,663,Thursday
2016,2,11,1200,447,179,626,Thursday
2016,2,11,1100,451,160,611,Thursday
2016,2,11,1000,441,103,544,Thursday
2016,2,11,900,409,91,500,Thursday
2016,2,11,800,207,46,253,Thursday
2016,2,11,700,82,38,120,Thursday
2016,2,11,600,38,33,71,Thursday
2016,2,11,500,21,20,41,Thursday
2016,2,11,400,26,25,51,Thursday
2016,2,11,300,25,26,51,Thursday
2016,2,11,200,26,46,72,Thursday
2016,2,11,100,31,65,96,Thursday
2016,2,10,2400,44,31,75,Wednesday
2016,2,10,2300,78,72,150,Wednesday
2016,2,10,2200,104,80,184,Wednesday
2016,2,10,2100,138,100,238,Wednesday
2016,2,10,2000,162,99,261,Wednesday
2016,2,10,1900,200,208,408,Wednesday
2016,2,10,1800,231,337,568,Wednesday
2016,2,10,1700,232,432,664,Wednesday
2016,2,10,1600,256,344,600,Wednesday
2016,2,10,1500,285,282,567,Wednesday
2016,2,10,1400,266,232,498,Wednesday
2016,2,10,1300,270,197,467,Wednesday
2016,2,10,1200,300,152,452,Wednesday
2016,2,10,1100,327,173,500,Wednesday
2016,2,10,1000,286,129,415,Wednesday
2016,2,10,900,270,102,372,Wednesday
2016,2,10,800,165,57,222,Wednesday
2016,2,10,700,67,29,96,Wednesday
2016,2,10,600,17,31,48,Wednesday
2016,2,10,500,21,20,41,Wednesday
2016,2,10,400,18,34,52,Wednesday
2016,2,10,300,27,38,65,Wednesday
2016,2,10,200,18,34,52,Wednesday
2016,2,10,100,33,47,80,Wednesday
2016,2,9,2400,54,50,104,Tuesday
2016,2,9,2300,50,60,110,Tuesday
2016,2,9,2200,78,79,157,Tuesday
2016,2,9,2100,87,107,194,Tuesday
2016,2,9,2000,97,129,226,Tuesday
2016,2,9,1900,110,215,325,Tuesday
2016,2,9,1800,142,383,525,Tuesday
2016,2,9,1700,194,439,633,Tuesday
2016,2,9,1600,195,420,615,Tuesday
2016,2,9,1500,208,165,373,Tuesday
2016,2,9,1400,230,195,425,Tuesday
2016,2,9,1300,229,197,426,Tuesday
2016,2,9,1200,309,165,474,Tuesday
2016,2,9,1100,289,127,416,Tuesday
2016,2,9,1000,310,105,415,Tuesday
2016,2,9,900,295,64,359,Tuesday
2016,2,9,800,174,44,218,Tuesday
2016,2,9,700,79,26,105,Tuesday
2016,2,9,600,30,20,50,Tuesday
2016,2,9,500,20,11,31,Tuesday
2016,2,9,400,24,9,33,Tuesday
2016,2,9,300,24,22,46,Tuesday
2016,2,9,200,34,26,60,Tuesday
2016,2,9,100,41,38,79,Tuesday
2016,2,8,2400,47,37,84,Monday
2016,2,8,2300,65,54,119,Monday
2016,2,8,2200,73,69,142,Monday
2016,2,8,2100,114,83,197,Monday
2016,2,8,2000,103,101,204,Monday
2016,2,8,1900,133,204,337,Monday
2016,2,8,1800,146,404,550,Monday
2016,2,8,1700,239,406,645,Monday
2016,2,8,1600,254,364,618,Monday
2016,2,8,1500,256,322,578,Monday
2016,2,8,1400,287,233,520,Monday
2016,2,8,1300,311,266,577,Monday
2016,2,8,1200,382,216,598,Monday
2016,2,8,1100,369,155,524,Monday
2016,2,8,1000,376,125,501,Monday
2016,2,8,900,287,114,401,Monday
2016,2,8,800,152,57,209,Monday
2016,2,8,700,63,28,91,Monday
2016,2,8,600,22,23,45,Monday
2016,2,8,500,14,7,21,Monday
2016,2,8,400,12,15,27,Monday
2016,2,8,300,6,16,22,Monday
2016,2,8,200,18,32,50,Monday
2016,2,8,100,22,36,58,Monday
2016,2,7,2400,30,43,73,Sunday
2016,2,7,2300,41,101,142,Sunday
2016,2,7,2200,53,96,149,Sunday
2016,2,7,2100,70,154,224,Sunday
2016,2,7,2000,77,331,408,Sunday
2016,2,7,1900,91,450,541,Sunday
2016,2,7,1800,131,736,867,Sunday
2016,2,7,1700,192,1230,1422,Sunday
2016,2,7,1600,216,920,1136,Sunday
2016,2,7,1500,275,745,1020,Sunday
2016,2,7,1400,312,730,1042,Sunday
2016,2,7,1300,344,636,980,Sunday
2016,2,7,1200,464,479,943,Sunday
2016,2,7,1100,416,283,699,Sunday
2016,2,7,1000,465,150,615,Sunday
2016,2,7,900,695,72,767,Sunday
2016,2,7,800,232,49,281,Sunday
2016,2,7,700,69,23,92,Sunday
2016,2,7,600,22,15,37,Sunday
2016,2,7,500,14,12,26,Sunday
2016,2,7,400,17,12,29,Sunday
2016,2,7,300,9,15,24,Sunday
2016,2,7,200,14,27,41,Sunday
2016,2,7,100,24,35,59,Sunday
2016,2,6,2400,24,74,98,Saturday
2016,2,6,2300,33,147,180,Saturday
2016,2,6,2200,62,92,154,Saturday
2016,2,6,2100,85,83,168,Saturday
2016,2,6,2000,96,268,364,Saturday
2016,2,6,1900,103,265,368,Saturday
2016,2,6,1800,170,724,894,Saturday
2016,2,6,1700,222,963,1185,Saturday
2016,2,6,1600,268,650,918,Saturday
2016,2,6,1500,364,387,751,Saturday
2016,2,6,1400,398,408,806,Saturday
2016,2,6,1300,467,269,736,Saturday
2016,2,6,1200,477,182,659,Saturday
2016,2,6,1100,528,161,689,Saturday
2016,2,6,1000,729,136,865,Saturday
2016,2,6,900,699,85,784,Saturday
2016,2,6,800,336,53,389,Saturday
2016,2,6,700,113,42,155,Saturday
2016,2,6,600,35,22,57,Saturday
2016,2,6,500,17,20,37,Saturday
2016,2,6,400,26,21,47,Saturday
2016,2,6,300,27,37,64,Saturday
2016,2,6,200,31,24,55,Saturday
2016,2,6,100,40,44,84,Saturday
2016,2,5,2400,47,75,122,Friday
2016,2,5,2300,73,136,209,Friday
2016,2,5,2200,143,94,237,Friday
2016,2,5,2100,225,82,307,Friday
2016,2,5,2000,325,82,407,Friday
2016,2,5,1900,410,210,620,Friday
2016,2,5,1800,450,448,898,Friday
2016,2,5,1700,470,601,1071,Friday
2016,2,5,1600,468,480,948,Friday
2016,2,5,1500,395,372,767,Friday
2016,2,5,1400,351,317,668,Friday
2016,2,5,1300,358,260,618,Friday
2016,2,5,1200,409,226,635,Friday
2016,2,5,1100,444,131,575,Friday
2016,2,5,1000,465,89,554,Friday
2016,2,5,900,442,84,526,Friday
2016,2,5,800,225,40,265,Friday
2016,2,5,700,102,28,130,Friday
2016,2,5,600,34,29,63,Friday
2016,2,5,500,24,26,50,Friday
2016,2,5,400,21,19,40,Friday
2016,2,5,300,29,33,62,Friday
2016,2,5,200,31,30,61,Friday
2016,2,5,100,39,53,92,Friday
2016,2,4,2400,73,59,132,Thursday
2016,2,4,2300,90,46,136,Thursday
2016,2,4,2200,108,99,207,Thursday
2016,2,4,2100,166,92,258,Thursday
2016,2,4,2000,191,159,350,Thursday
2016,2,4,1900,203,243,446,Thursday
2016,2,4,1800,226,356,582,Thursday
2016,2,4,1700,271,433,704,Thursday
2016,2,4,1600,272,356,628,Thursday
2016,2,4,1500,258,260,518,Thursday
2016,2,4,1400,272,231,503,Thursday
2016,2,4,1300,250,261,511,Thursday
2016,2,4,1200,272,94,366,Thursday
2016,2,4,1100,295,107,402,Thursday
2016,2,4,1000,353,56,409,Thursday
2016,2,4,900,320,74,394,Thursday
2016,2,4,800,134,52,186,Thursday
2016,2,4,700,57,34,91,Thursday
2016,2,4,600,26,17,43,Thursday
2016,2,4,500,22,17,39,Thursday
2016,2,4,400,24,31,55,Thursday
2016,2,4,300,27,34,61,Thursday
2016,2,4,200,28,23,51,Thursday
2016,2,4,100,32,28,60,Thursday
2016,2,3,2400,37,40,77,Wednesday
2016,2,3,2300,75,64,139,Wednesday
2016,2,3,2200,71,72,143,Wednesday
2016,2,3,2100,109,80,189,Wednesday
2016,2,3,2000,120,93,213,Wednesday
2016,2,3,1900,122,191,313,Wednesday
2016,2,3,1800,158,289,447,Wednesday
2016,2,3,1700,201,438,639,Wednesday
2016,2,3,1600,198,432,630,Wednesday
2016,2,3,1500,206,196,402,Wednesday
2016,2,3,1400,212,162,374,Wednesday
2016,2,3,1300,221,185,406,Wednesday
2016,2,3,1200,241,132,373,Wednesday
2016,2,3,1100,264,123,387,Wednesday
2016,2,3,1000,286,141,427,Wednesday
2016,2,3,900,258,71,329,Wednesday
2016,2,3,800,153,38,191,Wednesday
2016,2,3,700,56,38,94,Wednesday
2016,2,3,600,37,40,77,Wednesday
2016,2,3,500,10,18,28,Wednesday
2016,2,3,400,23,21,44,Wednesday
2016,2,3,300,25,23,48,Wednesday
2016,2,3,200,26,55,81,Wednesday
2016,2,3,100,31,40,71,Wednesday
2016,2,2,2400,48,55,103,Tuesday
2016,2,2,2300,62,50,112,Tuesday
2016,2,2,2200,73,86,159,Tuesday
2016,2,2,2100,90,91,181,Tuesday
2016,2,2,2000,95,151,246,Tuesday
2016,2,2,1900,93,196,289,Tuesday
2016,2,2,1800,144,294,438,Tuesday
2016,2,2,1700,166,378,544,Tuesday
2016,2,2,1600,197,331,528,Tuesday
2016,2,2,1500,181,222,403,Tuesday
2016,2,2,1400,187,198,385,Tuesday
2016,2,2,1300,218,192,410,Tuesday
2016,2,2,1200,242,160,402,Tuesday
2016,2,2,1100,283,146,429,Tuesday
2016,2,2,1000,300,124,424,Tuesday
2016,2,2,900,252,82,334,Tuesday
2016,2,2,800,137,64,201,Tuesday
2016,2,2,700,61,46,107,Tuesday
2016,2,2,600,30,32,62,Tuesday
2016,2,2,500,18,27,45,Tuesday
2016,2,2,400,20,25,45,Tuesday
2016,2,2,300,23,28,51,Tuesday
2016,2,2,200,17,36,53,Tuesday
2016,2,2,100,33,45,78,Tuesday
2016,2,1,2400,40,30,70,Monday
2016,2,1,2300,61,60,121,Monday
2016,2,1,2200,62,71,133,Monday
2016,2,1,2100,74,65,139,Monday
2016,2,1,2000,88,121,209,Monday
2016,2,1,1900,137,196,333,Monday
2016,2,1,1800,147,364,511,Monday
2016,2,1,1700,180,493,673,Monday
2016,2,1,1600,226,403,629,Monday
2016,2,1,1500,209,355,564,Monday
2016,2,1,1400,239,275,514,Monday
2016,2,1,1300,246,236,482,Monday
2016,2,1,1200,275,232,507,Monday
2016,2,1,1100,333,148,481,Monday
2016,2,1,1000,305,133,438,Monday
2016,2,1,900,284,87,371,Monday
2016,2,1,800,153,44,197,Monday
2016,2,1,700,57,41,98,Monday
2016,2,1,600,25,12,37,Monday
2016,2,1,500,16,18,34,Monday
2016,2,1,400,20,18,38,Monday
2016,2,1,300,19,23,42,Monday
2016,2,1,200,23,18,41,Monday
2016,2,1,100,26,35,61,Monday
2016,1,31,2400,36,55,91,Sunday
2016,1,31,2300,42,76,118,Sunday
2016,1,31,2200,53,137,190,Sunday
2016,1,31,2100,78,224,302,Sunday
2016,1,31,2000,93,299,392,Sunday
2016,1,31,1900,89,469,558,Sunday
2016,1,31,1800,149,1095,1244,Sunday
2016,1,31,1700,175,1550,1725,Sunday
2016,1,31,1600,238,1219,1457,Sunday
2016,1,31,1500,310,897,1207,Sunday
2016,1,31,1400,382,774,1156,Sunday
2016,1,31,1300,471,573,1044,Sunday
2016,1,31,1200,589,409,998,Sunday
2016,1,31,1100,518,251,769,Sunday
2016,1,31,1000,633,120,753,Sunday
2016,1,31,900,829,62,891,Sunday
2016,1,31,800,299,42,341,Sunday
2016,1,31,700,81,11,92,Sunday
2016,1,31,600,26,13,39,Sunday
2016,1,31,500,15,6,21,Sunday
2016,1,31,400,15,14,29,Sunday
2016,1,31,300,9,19,28,Sunday
2016,1,31,200,14,17,31,Sunday
2016,1,31,100,20,33,53,Sunday
2016,1,30,2400,24,41,65,Saturday
2016,1,30,2300,55,62,117,Saturday
2016,1,30,2200,59,72,131,Saturday
2016,1,30,2100,71,91,162,Saturday
2016,1,30,2000,92,210,302,Saturday
2016,1,30,1900,130,494,624,Saturday
2016,1,30,1800,171,1220,1391,Saturday
2016,1,30,1700,196,1224,1420,Saturday
2016,1,30,1600,317,809,1126,Saturday
2016,1,30,1500,342,513,855,Saturday
2016,1,30,1400,400,393,793,Saturday
2016,1,30,1300,505,293,798,Saturday
2016,1,30,1200,587,225,812,Saturday
2016,1,30,1100,617,150,767,Saturday
2016,1,30,1000,922,122,1044,Saturday
2016,1,30,900,1213,65,1278,Saturday
2016,1,30,800,485,57,542,Saturday
2016,1,30,700,119,28,147,Saturday
2016,1,30,600,40,20,60,Saturday
2016,1,30,500,18,14,32,Saturday
2016,1,30,400,22,18,40,Saturday
2016,1,30,300,24,13,37,Saturday
2016,1,30,200,22,33,55,Saturday
2016,1,30,100,42,29,71,Saturday
2016,1,29,2400,66,48,114,Friday
2016,1,29,2300,86,65,151,Friday
2016,1,29,2200,138,69,207,Friday
2016,1,29,2100,269,86,355,Friday
2016,1,29,2000,378,133,511,Friday
2016,1,29,1900,572,250,822,Friday
2016,1,29,1800,389,503,892,Friday
2016,1,29,1700,448,717,1165,Friday
2016,1,29,1600,500,497,997,Friday
2016,1,29,1500,426,362,788,Friday
2016,1,29,1400,384,309,693,Friday
2016,1,29,1300,359,276,635,Friday
2016,1,29,1200,390,213,603,Friday
2016,1,29,1100,432,170,602,Friday
2016,1,29,1000,518,150,668,Friday
2016,1,29,900,640,109,749,Friday
2016,1,29,800,326,70,396,Friday
2016,1,29,700,92,102,194,Friday
2016,1,29,600,36,68,104,Friday
2016,1,29,500,28,10,38,Friday
2016,1,29,400,23,48,71,Friday
2016,1,29,300,26,27,53,Friday
2016,1,29,200,35,38,73,Friday
2016,1,29,100,58,72,130,Friday
2016,1,28,2400,61,43,104,Thursday
2016,1,28,2300,112,15,127,Thursday
2016,1,28,2200,124,21,145,Thursday
2016,1,28,2100,185,42,227,Thursday
2016,1,28,2000,262,50,312,Thursday
2016,1,28,1900,235,110,345,Thursday
2016,1,28,1800,236,364,600,Thursday
2016,1,28,1700,286,361,647,Thursday
2016,1,28,1600,256,316,572,Thursday
2016,1,28,1500,263,274,537,Thursday
2016,1,28,1400,271,247,518,Thursday
2016,1,28,1300,265,239,504,Thursday
2016,1,28,1200,262,134,396,Thursday
2016,1,28,1100,315,118,433,Thursday
2016,1,28,1000,361,93,454,Thursday
2016,1,28,900,345,84,429,Thursday
2016,1,28,800,176,57,233,Thursday
2016,1,28,700,83,31,114,Thursday
2016,1,28,600,38,24,62,Thursday
2016,1,28,500,18,19,37,Thursday
2016,1,28,400,18,36,54,Thursday
2016,1,28,300,15,27,42,Thursday
2016,1,28,200,21,34,55,Thursday
2016,1,28,100,40,40,80,Thursday
2016,1,27,2400,53,50,103,Wednesday
2016,1,27,2300,80,58,138,Wednesday
2016,1,27,2200,92,81,173,Wednesday
2016,1,27,2100,96,98,194,Wednesday
2016,1,27,2000,111,106,217,Wednesday
2016,1,27,1900,126,190,316,Wednesday
2016,1,27,1800,147,276,423,Wednesday
2016,1,27,1700,222,419,641,Wednesday
2016,1,27,1600,203,356,559,Wednesday
2016,1,27,1500,215,233,448,Wednesday
2016,1,27,1400,243,221,464,Wednesday
2016,1,27,1300,235,198,433,Wednesday
2016,1,27,1200,263,169,432,Wednesday
2016,1,27,1100,284,152,436,Wednesday
2016,1,27,1000,328,123,451,Wednesday
2016,1,27,900,241,66,307,Wednesday
2016,1,27,800,155,55,210,Wednesday
2016,1,27,700,62,35,97,Wednesday
2016,1,27,600,27,34,61,Wednesday
2016,1,27,500,26,20,46,Wednesday
2016,1,27,400,25,30,55,Wednesday
2016,1,27,300,15,32,47,Wednesday
2016,1,27,200,22,40,62,Wednesday
2016,1,27,100,31,43,74,Wednesday
2016,1,26,2400,49,41,90,Tuesday
2016,1,26,2300,66,59,125,Tuesday
2016,1,26,2200,59,72,131,Tuesday
2016,1,26,2100,87,94,181,Tuesday
2016,1,26,2000,101,118,219,Tuesday
2016,1,26,1900,98,153,251,Tuesday
2016,1,26,1800,119,272,391,Tuesday
2016,1,26,1700,173,407,580,Tuesday
2016,1,26,1600,170,334,504,Tuesday
2016,1,26,1500,189,253,442,Tuesday
2016,1,26,1400,214,236,450,Tuesday
2016,1,26,1300,231,185,416,Tuesday
2016,1,26,1200,286,139,425,Tuesday
2016,1,26,1100,268,138,406,Tuesday
2016,1,26,1000,279,112,391,Tuesday
2016,1,26,900,302,94,396,Tuesday
2016,1,26,800,138,64,202,Tuesday
2016,1,26,700,62,31,93,Tuesday
2016,1,26,600,16,24,40,Tuesday
2016,1,26,500,19,23,42,Tuesday
2016,1,26,400,15,27,42,Tuesday
2016,1,26,300,17,31,48,Tuesday
2016,1,26,200,21,49,70,Tuesday
2016,1,26,100,36,35,71,Tuesday
2016,1,25,2400,31,37,68,Monday
2016,1,25,2300,48,65,113,Monday
2016,1,25,2200,63,78,141,Monday
2016,1,25,2100,90,100,190,Monday
2016,1,25,2000,78,114,192,Monday
2016,1,25,1900,116,183,299,Monday
2016,1,25,1800,120,340,460,Monday
2016,1,25,1700,204,473,677,Monday
2016,1,25,1600,223,344,567,Monday
2016,1,25,1500,204,386,590,Monday
2016,1,25,1400,258,218,476,Monday
2016,1,25,1300,237,268,505,Monday
2016,1,25,1200,277,170,447,Monday
2016,1,25,1100,312,153,465,Monday
2016,1,25,1000,295,124,419,Monday
2016,1,25,900,275,80,355,Monday
2016,1,25,800,137,51,188,Monday
2016,1,25,700,64,23,87,Monday
2016,1,25,600,30,17,47,Monday
2016,1,25,500,22,16,38,Monday
2016,1,25,400,15,22,37,Monday
2016,1,25,300,11,21,32,Monday
2016,1,25,200,10,28,38,Monday
2016,1,25,100,20,43,63,Monday
2016,1,24,2400,19,42,61,Sunday
2016,1,24,2300,37,84,121,Sunday
2016,1,24,2200,52,137,189,Sunday
2016,1,24,2100,69,177,246,Sunday
2016,1,24,2000,85,312,397,Sunday
2016,1,24,1900,95,471,566,Sunday
2016,1,24,1800,147,1026,1173,Sunday
2016,1,24,1700,168,1529,1697,Sunday
2016,1,24,1600,234,1077,1311,Sunday
2016,1,24,1500,300,851,1151,Sunday
2016,1,24,1400,376,733,1109,Sunday
2016,1,24,1300,463,637,1100,Sunday
2016,1,24,1200,563,386,949,Sunday
2016,1,24,1100,552,223,775,Sunday
2016,1,24,1000,621,111,732,Sunday
2016,1,24,900,695,60,755,Sunday
2016,1,24,800,228,24,252,Sunday
2016,1,24,700,101,18,119,Sunday
2016,1,24,600,32,17,49,Sunday
2016,1,24,500,17,13,30,Sunday
2016,1,24,400,8,10,18,Sunday
2016,1,24,300,9,17,26,Sunday
2016,1,24,200,16,25,41,Sunday
2016,1,24,100,27,21,48,Sunday
2016,1,23,2400,35,29,64,Saturday
2016,1,23,2300,41,47,88,Saturday
2016,1,23,2200,65,88,153,Saturday
2016,1,23,2100,60,120,180,Saturday
2016,1,23,2000,97,245,342,Saturday
2016,1,23,1900,106,455,561,Saturday
2016,1,23,1800,168,1188,1356,Saturday
2016,1,23,1700,244,1347,1591,Saturday
2016,1,23,1600,309,864,1173,Saturday
2016,1,23,1500,399,721,1120,Saturday
2016,1,23,1400,538,378,916,Saturday
2016,1,23,1300,670,295,965,Saturday
2016,1,23,1200,764,203,967,Saturday
2016,1,23,1100,743,178,921,Saturday
2016,1,23,1000,889,91,980,Saturday
2016,1,23,900,1060,91,1151,Saturday
2016,1,23,800,409,49,458,Saturday
2016,1,23,700,108,39,147,Saturday
2016,1,23,600,43,12,55,Saturday
2016,1,23,500,18,15,33,Saturday
2016,1,23,400,19,18,37,Saturday
2016,1,23,300,16,29,45,Saturday
2016,1,23,200,25,29,54,Saturday
2016,1,23,100,33,40,73,Saturday
2016,1,22,2400,67,42,109,Friday
2016,1,22,2300,82,55,137,Friday
2016,1,22,2200,158,108,266,Friday
2016,1,22,2100,233,63,296,Friday
2016,1,22,2000,378,178,556,Friday
2016,1,22,1900,410,198,608,Friday
2016,1,22,1800,455,330,785,Friday
2016,1,22,1700,423,580,1003,Friday
2016,1,22,1600,449,536,985,Friday
2016,1,22,1500,461,315,776,Friday
2016,1,22,1400,423,250,673,Friday
2016,1,22,1300,417,202,619,Friday
2016,1,22,1200,514,191,705,Friday
2016,1,22,1100,461,139,600,Friday
2016,1,22,1000,453,115,568,Friday
2016,1,22,900,426,105,531,Friday
2016,1,22,800,185,48,233,Friday
2016,1,22,700,95,48,143,Friday
2016,1,22,600,30,26,56,Friday
2016,1,22,500,19,35,54,Friday
2016,1,22,400,26,31,57,Friday
2016,1,22,300,23,29,52,Friday
2016,1,22,200,22,39,61,Friday
2016,1,22,100,46,50,96,Friday
2016,1,21,2400,63,39,102,Thursday
2016,1,21,2300,75,65,140,Thursday
2016,1,21,2200,111,73,184,Thursday
2016,1,21,2100,131,121,252,Thursday
2016,1,21,2000,186,101,287,Thursday
2016,1,21,1900,218,157,375,Thursday
2016,1,21,1800,246,293,539,Thursday
2016,1,21,1700,283,427,710,Thursday
2016,1,21,1600,298,358,656,Thursday
2016,1,21,1500,315,254,569,Thursday
2016,1,21,1400,263,230,493,Thursday
2016,1,21,1300,256,209,465,Thursday
2016,1,21,1200,290,147,437,Thursday
2016,1,21,1100,287,138,425,Thursday
2016,1,21,1000,324,96,420,Thursday
2016,1,21,900,285,71,356,Thursday
2016,1,21,800,159,59,218,Thursday
2016,1,21,700,60,46,106,Thursday
2016,1,21,600,32,21,53,Thursday
2016,1,21,500,27,15,42,Thursday
2016,1,21,400,21,35,56,Thursday
2016,1,21,300,24,32,56,Thursday
2016,1,21,200,37,37,74,Thursday
2016,1,21,100,31,33,64,Thursday
2016,1,20,2400,56,47,103,Wednesday
2016,1,20,2300,54,60,114,Wednesday
2016,1,20,2200,76,77,153,Wednesday
2016,1,20,2100,103,81,184,Wednesday
2016,1,20,2000,134,107,241,Wednesday
2016,1,20,1900,157,170,327,Wednesday
2016,1,20,1800,138,308,446,Wednesday
2016,1,20,1700,171,368,539,Wednesday
2016,1,20,1600,194,291,485,Wednesday
2016,1,20,1500,195,226,421,Wednesday
2016,1,20,1400,215,201,416,Wednesday
2016,1,20,1300,223,160,383,Wednesday
2016,1,20,1200,257,166,423,Wednesday
2016,1,20,1100,265,111,376,Wednesday
2016,1,20,1000,254,95,349,Wednesday
2016,1,20,900,247,90,337,Wednesday
2016,1,20,800,146,58,204,Wednesday
2016,1,20,700,56,43,99,Wednesday
2016,1,20,600,21,31,52,Wednesday
2016,1,20,500,16,29,45,Wednesday
2016,1,20,400,23,29,52,Wednesday
2016,1,20,300,19,30,49,Wednesday
2016,1,20,200,26,22,48,Wednesday
2016,1,20,100,22,42,64,Wednesday
2016,1,19,2400,47,49,96,Tuesday
2016,1,19,2300,50,53,103,Tuesday
2016,1,19,2200,85,67,152,Tuesday
2016,1,19,2100,87,84,171,Tuesday
2016,1,19,2000,95,120,215,Tuesday
2016,1,19,1900,101,168,269,Tuesday
2016,1,19,1800,162,304,466,Tuesday
2016,1,19,1700,167,402,569,Tuesday
2016,1,19,1600,207,322,529,Tuesday
2016,1,19,1500,214,253,467,Tuesday
2016,1,19,1400,197,222,419,Tuesday
2016,1,19,1300,236,184,420,Tuesday
2016,1,19,1200,269,171,440,Tuesday
2016,1,19,1100,242,127,369,Tuesday
2016,1,19,1000,270,105,375,Tuesday
2016,1,19,900,218,88,306,Tuesday
2016,1,19,800,128,55,183,Tuesday
2016,1,19,700,65,35,100,Tuesday
2016,1,19,600,24,30,54,Tuesday
2016,1,19,500,19,28,47,Tuesday
2016,1,19,400,16,40,56,Tuesday
2016,1,19,300,19,29,48,Tuesday
2016,1,19,200,26,41,67,Tuesday
2016,1,19,100,26,46,72,Tuesday
2016,1,18,2400,48,46,94,Monday
2016,1,18,2300,59,67,126,Monday
2016,1,18,2200,73,77,150,Monday
2016,1,18,2100,89,96,185,Monday
2016,1,18,2000,97,102,199,Monday
2016,1,18,1900,115,221,336,Monday
2016,1,18,1800,134,305,439,Monday
2016,1,18,1700,157,417,574,Monday
2016,1,18,1600,210,349,559,Monday
2016,1,18,1500,216,294,510,Monday
2016,1,18,1400,222,255,477,Monday
2016,1,18,1300,270,211,481,Monday
2016,1,18,1200,299,196,495,Monday
2016,1,18,1100,276,135,411,Monday
2016,1,18,1000,296,136,432,Monday
2016,1,18,900,228,98,326,Monday
2016,1,18,800,138,63,201,Monday
2016,1,18,700,67,24,91,Monday
2016,1,18,600,34,24,58,Monday
2016,1,18,500,19,19,38,Monday
2016,1,18,400,18,16,34,Monday
2016,1,18,300,12,23,35,Monday
2016,1,18,200,16,28,44,Monday
2016,1,18,100,15,39,54,Monday
2016,1,17,2400,24,58,82,Sunday
2016,1,17,2300,39,94,133,Sunday
2016,1,17,2200,54,106,160,Sunday
2016,1,17,2100,85,197,282,Sunday
2016,1,17,2000,95,247,342,Sunday
2016,1,17,1900,91,493,584,Sunday
2016,1,17,1800,123,1022,1145,Sunday
2016,1,17,1700,187,1355,1542,Sunday
2016,1,17,1600,217,979,1196,Sunday
2016,1,17,1500,249,741,990,Sunday
2016,1,17,1400,339,627,966,Sunday
2016,1,17,1300,397,491,888,Sunday
2016,1,17,1200,509,300,809,Sunday
2016,1,17,1100,459,192,651,Sunday
2016,1,17,1000,615,93,708,Sunday
2016,1,17,900,697,58,755,Sunday
2016,1,17,800,240,31,271,Sunday
2016,1,17,700,60,12,72,Sunday
2016,1,17,600,22,12,34,Sunday
2016,1,17,500,18,8,26,Sunday
2016,1,17,400,15,16,31,Sunday
2016,1,17,300,11,12,23,Sunday
2016,1,17,200,11,22,33,Sunday
2016,1,17,100,20,33,53,Sunday
2016,1,16,2400,17,38,55,Saturday
2016,1,16,2300,32,47,79,Saturday
2016,1,16,2200,33,57,90,Saturday
2016,1,16,2100,65,107,172,Saturday
2016,1,16,2000,64,672,736,Saturday
2016,1,16,1900,88,111,199,Saturday
2016,1,16,1800,143,394,537,Saturday
2016,1,16,1700,184,944,1128,Saturday
2016,1,16,1600,247,637,884,Saturday
2016,1,16,1500,280,443,723,Saturday
2016,1,16,1400,366,313,679,Saturday
2016,1,16,1300,379,210,589,Saturday
2016,1,16,1200,516,178,694,Saturday
2016,1,16,1100,508,140,648,Saturday
2016,1,16,1000,666,130,796,Saturday
2016,1,16,900,902,82,984,Saturday
2016,1,16,800,353,45,398,Saturday
2016,1,16,700,82,32,114,Saturday
2016,1,16,600,37,22,59,Saturday
2016,1,16,500,10,21,31,Saturday
2016,1,16,400,15,16,31,Saturday
2016,1,16,300,25,27,52,Saturday
2016,1,16,200,20,33,53,Saturday
2016,1,16,100,39,32,71,Saturday
2016,1,15,2400,62,37,99,Friday
2016,1,15,2300,84,54,138,Friday
2016,1,15,2200,131,66,197,Friday
2016,1,15,2100,211,102,313,Friday
2016,1,15,2000,306,114,420,Friday
2016,1,15,1900,382,232,614,Friday
2016,1,15,1800,397,368,765,Friday
2016,1,15,1700,433,516,949,Friday
2016,1,15,1600,441,377,818,Friday
2016,1,15,1500,401,255,656,Friday
2016,1,15,1400,321,240,561,Friday
2016,1,15,1300,318,191,509,Friday
2016,1,15,1200,320,157,477,Friday
2016,1,15,1100,329,140,469,Friday
2016,1,15,1000,374,115,489,Friday
2016,1,15,900,368,70,438,Friday
2016,1,15,800,173,48,221,Friday
2016,1,15,700,68,29,97,Friday
2016,1,15,600,32,28,60,Friday
2016,1,15,500,20,22,42,Friday
2016,1,15,400,18,26,44,Friday
2016,1,15,300,28,26,54,Friday
2016,1,15,200,37,39,76,Friday
2016,1,15,100,37,46,83,Friday
2016,1,14,2400,50,59,109,Thursday
2016,1,14,2300,92,53,145,Thursday
2016,1,14,2200,99,83,182,Thursday
2016,1,14,2100,132,97,229,Thursday
2016,1,14,2000,151,117,268,Thursday
2016,1,14,1900,182,150,332,Thursday
2016,1,14,1800,210,293,503,Thursday
2016,1,14,1700,242,370,612,Thursday
2016,1,14,1600,249,338,587,Thursday
2016,1,14,1500,246,244,490,Thursday
2016,1,14,1400,231,153,384,Thursday
2016,1,14,1300,215,152,367,Thursday
2016,1,14,1200,230,152,382,Thursday
2016,1,14,1100,243,122,365,Thursday
2016,1,14,1000,303,91,394,Thursday
2016,1,14,900,285,77,362,Thursday
2016,1,14,800,167,55,222,Thursday
2016,1,14,700,61,47,108,Thursday
2016,1,14,600,28,28,56,Thursday
2016,1,14,500,20,19,39,Thursday
2016,1,14,400,15,29,44,Thursday
2016,1,14,300,26,33,59,Thursday
2016,1,14,200,26,36,62,Thursday
2016,1,14,100,36,55,91,Thursday
2016,1,13,2400,54,46,100,Wednesday
2016,1,13,2300,66,51,117,Wednesday
2016,1,13,2200,81,61,142,Wednesday
2016,1,13,2100,100,63,163,Wednesday
2016,1,13,2000,93,111,204,Wednesday
2016,1,13,1900,112,141,253,Wednesday
2016,1,13,1800,119,248,367,Wednesday
2016,1,13,1700,175,341,516,Wednesday
2016,1,13,1600,152,272,424,Wednesday
2016,1,13,1500,225,225,450,Wednesday
2016,1,13,1400,232,190,422,Wednesday
2016,1,13,1300,202,161,363,Wednesday
2016,1,13,1200,252,149,401,Wednesday
2016,1,13,1100,245,116,361,Wednesday
2016,1,13,1000,271,111,382,Wednesday
2016,1,13,900,206,71,277,Wednesday
2016,1,13,800,135,50,185,Wednesday
2016,1,13,700,72,35,107,Wednesday
2016,1,13,600,24,35,59,Wednesday
2016,1,13,500,24,22,46,Wednesday
2016,1,13,400,22,29,51,Wednesday
2016,1,13,300,24,37,61,Wednesday
2016,1,13,200,25,48,73,Wednesday
2016,1,13,100,36,59,95,Wednesday
2016,1,12,2400,47,57,104,Tuesday
2016,1,12,2300,59,56,115,Tuesday
2016,1,12,2200,87,79,166,Tuesday
2016,1,12,2100,84,80,164,Tuesday
2016,1,12,2000,105,109,214,Tuesday
2016,1,12,1900,101,174,275,Tuesday
2016,1,12,1800,125,271,396,Tuesday
2016,1,12,1700,150,332,482,Tuesday
2016,1,12,1600,174,247,421,Tuesday
2016,1,12,1500,131,220,351,Tuesday
2016,1,12,1400,195,213,408,Tuesday
2016,1,12,1300,180,175,355,Tuesday
2016,1,12,1200,215,175,390,Tuesday
2016,1,12,1100,221,140,361,Tuesday
2016,1,12,1000,254,114,368,Tuesday
2016,1,12,900,223,63,286,Tuesday
2016,1,12,800,116,51,167,Tuesday
2016,1,12,700,52,42,94,Tuesday
2016,1,12,600,23,21,44,Tuesday
2016,1,12,500,19,29,48,Tuesday
2016,1,12,400,15,22,37,Tuesday
2016,1,12,300,24,30,54,Tuesday
2016,1,12,200,21,36,57,Tuesday
2016,1,12,100,28,44,72,Tuesday
2016,1,11,2400,34,28,62,Monday
2016,1,11,2300,54,46,100,Monday
2016,1,11,2200,62,71,133,Monday
2016,1,11,2100,77,77,154,Monday
2016,1,11,2000,103,110,213,Monday
2016,1,11,1900,91,144,235,Monday
2016,1,11,1800,140,237,377,Monday
2016,1,11,1700,178,365,543,Monday
2016,1,11,1600,183,263,446,Monday
2016,1,11,1500,225,240,465,Monday
2016,1,11,1400,215,191,406,Monday
2016,1,11,1300,176,194,370,Monday
2016,1,11,1200,199,170,369,Monday
2016,1,11,1100,209,122,331,Monday
2016,1,11,1000,224,102,326,Monday
2016,1,11,900,189,84,273,Monday
2016,1,11,800,123,42,165,Monday
2016,1,11,700,57,22,79,Monday
2016,1,11,600,24,24,48,Monday
2016,1,11,500,18,17,35,Monday
2016,1,11,400,22,10,32,Monday
2016,1,11,300,18,10,28,Monday
2016,1,11,200,9,28,37,Monday
2016,1,11,100,15,43,58,Monday
2016,1,10,2400,17,52,69,Sunday
2016,1,10,2300,39,59,98,Sunday
2016,1,10,2200,37,111,148,Sunday
2016,1,10,2100,66,141,207,Sunday
2016,1,10,2000,84,263,347,Sunday
2016,1,10,1900,79,346,425,Sunday
2016,1,10,1800,147,678,825,Sunday
2016,1,10,1700,171,1007,1178,Sunday
2016,1,10,1600,221,699,920,Sunday
2016,1,10,1500,217,532,749,Sunday
2016,1,10,1400,241,432,673,Sunday
2016,1,10,1300,289,430,719,Sunday
2016,1,10,1200,314,332,646,Sunday
2016,1,10,1100,352,199,551,Sunday
2016,1,10,1000,397,94,491,Sunday
2016,1,10,900,545,57,602,Sunday
2016,1,10,800,263,36,299,Sunday
2016,1,10,700,43,18,61,Sunday
2016,1,10,600,19,16,35,Sunday
2016,1,10,500,4,11,15,Sunday
2016,1,10,400,9,11,20,Sunday
2016,1,10,300,9,15,24,Sunday
2016,1,10,200,14,23,37,Sunday
2016,1,10,100,14,19,33,Sunday
2016,1,9,2400,31,37,68,Saturday
2016,1,9,2300,32,54,86,Saturday
2016,1,9,2200,53,51,104,Saturday
2016,1,9,2100,62,85,147,Saturday
2016,1,9,2000,76,147,223,Saturday
2016,1,9,1900,100,203,303,Saturday
2016,1,9,1800,111,567,678,Saturday
2016,1,9,1700,166,794,960,Saturday
2016,1,9,1600,220,454,674,Saturday
2016,1,9,1500,253,297,550,Saturday
2016,1,9,1400,282,219,501,Saturday
2016,1,9,1300,295,208,503,Saturday
2016,1,9,1200,342,166,508,Saturday
2016,1,9,1100,328,139,467,Saturday
2016,1,9,1000,470,96,566,Saturday
2016,1,9,900,626,75,701,Saturday
2016,1,9,800,279,48,327,Saturday
2016,1,9,700,83,22,105,Saturday
2016,1,9,600,28,22,50,Saturday
2016,1,9,500,17,14,31,Saturday
2016,1,9,400,16,19,35,Saturday
2016,1,9,300,11,31,42,Saturday
2016,1,9,200,24,36,60,Saturday
2016,1,9,100,32,33,65,Saturday
2016,1,8,2400,48,29,77,Friday
2016,1,8,2300,81,64,145,Friday
2016,1,8,2200,114,56,170,Friday
2016,1,8,2100,202,84,286,Friday
2016,1,8,2000,310,121,431,Friday
2016,1,8,1900,308,201,509,Friday
2016,1,8,1800,360,340,700,Friday
2016,1,8,1700,436,469,905,Friday
2016,1,8,1600,337,405,742,Friday
2016,1,8,1500,318,266,584,Friday
2016,1,8,1400,273,250,523,Friday
2016,1,8,1300,259,190,449,Friday
2016,1,8,1200,308,169,477,Friday
2016,1,8,1100,275,170,445,Friday
2016,1,8,1000,335,124,459,Friday
2016,1,8,900,296,89,385,Friday
2016,1,8,800,126,60,186,Friday
2016,1,8,700,69,24,93,Friday
2016,1,8,600,21,17,38,Friday
2016,1,8,500,24,21,45,Friday
2016,1,8,400,22,32,54,Friday
2016,1,8,300,21,19,40,Friday
2016,1,8,200,27,36,63,Friday
2016,1,8,100,27,39,66,Friday
2016,1,7,2400,56,50,106,Thursday
2016,1,7,2300,69,63,132,Thursday
2016,1,7,2200,81,65,146,Thursday
2016,1,7,2100,108,82,190,Thursday
2016,1,7,2000,106,109,215,Thursday
2016,1,7,1900,136,190,326,Thursday
2016,1,7,1800,154,269,423,Thursday
2016,1,7,1700,196,306,502,Thursday
2016,1,7,1600,210,292,502,Thursday
2016,1,7,1500,176,254,430,Thursday
2016,1,7,1400,186,194,380,Thursday
2016,1,7,1300,184,176,360,Thursday
2016,1,7,1200,182,154,336,Thursday
2016,1,7,1100,229,127,356,Thursday
2016,1,7,1000,230,116,346,Thursday
2016,1,7,900,235,71,306,Thursday
2016,1,7,800,103,47,150,Thursday
2016,1,7,700,56,30,86,Thursday
2016,1,7,600,23,22,45,Thursday
2016,1,7,500,26,28,54,Thursday
2016,1,7,400,17,40,57,Thursday
2016,1,7,300,26,32,58,Thursday
2016,1,7,200,30,41,71,Thursday
2016,1,7,100,42,39,81,Thursday
2016,1,6,2400,50,48,98,Wednesday
2016,1,6,2300,66,74,140,Wednesday
2016,1,6,2200,82,82,164,Wednesday
2016,1,6,2100,81,104,185,Wednesday
2016,1,6,2000,102,104,206,Wednesday
2016,1,6,1900,123,188,311,Wednesday
2016,1,6,1800,160,327,487,Wednesday
2016,1,6,1700,149,412,561,Wednesday
2016,1,6,1600,196,349,545,Wednesday
2016,1,6,1500,209,254,463,Wednesday
2016,1,6,1400,222,255,477,Wednesday
2016,1,6,1300,233,188,421,Wednesday
2016,1,6,1200,259,178,437,Wednesday
2016,1,6,1100,258,118,376,Wednesday
2016,1,6,1000,278,125,403,Wednesday
2016,1,6,900,266,79,345,Wednesday
2016,1,6,800,133,52,185,Wednesday
2016,1,6,700,54,47,101,Wednesday
2016,1,6,600,23,30,53,Wednesday
2016,1,6,500,20,34,54,Wednesday
2016,1,6,400,21,46,67,Wednesday
2016,1,6,300,27,28,55,Wednesday
2016,1,6,200,24,36,60,Wednesday
2016,1,6,100,16,48,64,Wednesday
2016,1,5,2400,47,67,114,Tuesday
2016,1,5,2300,66,69,135,Tuesday
2016,1,5,2200,65,88,153,Tuesday
2016,1,5,2100,84,101,185,Tuesday
2016,1,5,2000,88,116,204,Tuesday
2016,1,5,1900,102,194,296,Tuesday
2016,1,5,1800,129,358,487,Tuesday
2016,1,5,1700,168,458,626,Tuesday
2016,1,5,1600,187,335,522,Tuesday
2016,1,5,1500,177,276,453,Tuesday
2016,1,5,1400,238,238,476,Tuesday
2016,1,5,1300,218,199,417,Tuesday
2016,1,5,1200,221,203,424,Tuesday
2016,1,5,1100,255,148,403,Tuesday
2016,1,5,1000,281,140,421,Tuesday
2016,1,5,900,259,71,330,Tuesday
2016,1,5,800,125,50,175,Tuesday
2016,1,5,700,65,35,100,Tuesday
2016,1,5,600,24,25,49,Tuesday
2016,1,5,500,18,23,41,Tuesday
2016,1,5,400,17,29,46,Tuesday
2016,1,5,300,15,47,62,Tuesday
2016,1,5,200,15,34,49,Tuesday
2016,1,5,100,33,31,64,Tuesday
2016,1,4,2400,40,52,92,Monday
2016,1,4,2300,70,60,130,Monday
2016,1,4,2200,54,87,141,Monday
2016,1,4,2100,83,94,177,Monday
2016,1,4,2000,115,102,217,Monday
2016,1,4,1900,104,223,327,Monday
2016,1,4,1800,132,402,534,Monday
2016,1,4,1700,170,538,708,Monday
2016,1,4,1600,205,489,694,Monday
2016,1,4,1500,210,413,623,Monday
2016,1,4,1400,236,320,556,Monday
2016,1,4,1300,246,285,531,Monday
2016,1,4,1200,280,227,507,Monday
2016,1,4,1100,324,178,502,Monday
2016,1,4,1000,300,130,430,Monday
2016,1,4,900,312,87,399,Monday
2016,1,4,800,143,34,177,Monday
2016,1,4,700,76,33,109,Monday
2016,1,4,600,30,17,47,Monday
2016,1,4,500,14,18,32,Monday
2016,1,4,400,15,23,38,Monday
2016,1,4,300,8,15,23,Monday
2016,1,4,200,9,34,43,Monday
2016,1,4,100,14,48,62,Monday
2016,1,3,2400,16,53,69,Sunday
2016,1,3,2300,23,81,104,Sunday
2016,1,3,2200,46,111,157,Sunday
2016,1,3,2100,76,230,306,Sunday
2016,1,3,2000,86,269,355,Sunday
2016,1,3,1900,91,597,688,Sunday
2016,1,3,1800,151,962,1113,Sunday
2016,1,3,1700,200,1500,1700,Sunday
2016,1,3,1600,290,1305,1595,Sunday
2016,1,3,1500,320,1237,1557,Sunday
2016,1,3,1400,371,1046,1417,Sunday
2016,1,3,1300,422,892,1314,Sunday
2016,1,3,1200,505,639,1144,Sunday
2016,1,3,1100,436,375,811,Sunday
2016,1,3,1000,493,201,694,Sunday
2016,1,3,900,598,119,717,Sunday
2016,1,3,800,258,53,311,Sunday
2016,1,3,700,70,20,90,Sunday
2016,1,3,600,22,14,36,Sunday
2016,1,3,500,15,16,31,Sunday
2016,1,3,400,10,21,31,Sunday
2016,1,3,300,7,23,30,Sunday
2016,1,3,200,16,23,39,Sunday
2016,1,3,100,19,29,48,Sunday
2016,1,2,2400,22,74,96,Saturday
2016,1,2,2300,38,112,150,Saturday
2016,1,2,2200,60,156,216,Saturday
2016,1,2,2100,80,502,582,Saturday
2016,1,2,2000,78,540,618,Saturday
2016,1,2,1900,113,991,1104,Saturday
2016,1,2,1800,166,1646,1812,Saturday
2016,1,2,1700,223,1870,2093,Saturday
2016,1,2,1600,316,1561,1877,Saturday
2016,1,2,1500,408,1365,1773,Saturday
2016,1,2,1400,522,877,1399,Saturday
2016,1,2,1300,600,623,1223,Saturday
2016,1,2,1200,644,472,1116,Saturday
2016,1,2,1100,708,297,1005,Saturday
2016,1,2,1000,804,221,1025,Saturday
2016,1,2,900,924,95,1019,Saturday
2016,1,2,800,375,64,439,Saturday
2016,1,2,700,86,20,106,Saturday
2016,1,2,600,25,20,45,Saturday
2016,1,2,500,17,14,31,Saturday
2016,1,2,400,12,27,39,Saturday
2016,1,2,300,6,18,24,Saturday
2016,1,2,200,9,28,37,Saturday
2016,1,2,100,23,24,47,Saturday
2016,1,1,2400,27,41,68,Friday
2016,1,1,2300,44,68,112,Friday
2016,1,1,2200,63,99,162,Friday
2016,1,1,2100,67,164,231,Friday
2016,1,1,2000,97,247,344,Friday
2016,1,1,1900,133,499,632,Friday
2016,1,1,1800,201,1043,1244,Friday
2016,1,1,1700,273,1298,1571,Friday
2016,1,1,1600,338,1049,1387,Friday
2016,1,1,1500,503,817,1320,Friday
2016,1,1,1400,605,647,1252,Friday
2016,1,1,1300,641,544,1185,Friday
2016,1,1,1200,582,338,920,Friday
2016,1,1,1100,546,170,716,Friday
2016,1,1,1000,536,102,638,Friday
2016,1,1,900,534,55,589,Friday
2016,1,1,800,188,31,219,Friday
2016,1,1,700,63,23,86,Friday
2016,1,1,600,27,14,41,Friday
2016,1,1,500,19,7,26,Friday
2016,1,1,400,16,15,31,Friday
2016,1,1,300,16,19,35,Friday
2016,1,1,200,20,21,41,Friday
2016,1,1,100,35,22,57,Friday
2015,12,31,2400,25,35,60,Thursday
2015,12,31,2300,47,49,96,Thursday
2015,12,31,2200,56,71,127,Thursday
2015,12,31,2100,96,111,207,Thursday
2015,12,31,2000,124,148,272,Thursday
2015,12,31,1900,197,239,436,Thursday
2015,12,31,1800,261,702,963,Thursday
2015,12,31,1700,415,965,1380,Thursday
2015,12,31,1600,560,808,1368,Thursday
2015,12,31,1500,620,644,1264,Thursday
2015,12,31,1400,616,563,1179,Thursday
2015,12,31,1300,625,495,1120,Thursday
2015,12,31,1200,611,407,1018,Thursday
2015,12,31,1100,588,271,859,Thursday
2015,12,31,1000,635,134,769,Thursday
2015,12,31,900,739,106,845,Thursday
2015,12,31,800,300,61,361,Thursday
2015,12,31,700,96,17,113,Thursday
2015,12,31,600,27,24,51,Thursday
2015,12,31,500,28,22,50,Thursday
2015,12,31,400,21,27,48,Thursday
2015,12,31,300,20,41,61,Thursday
2015,12,31,200,33,40,73,Thursday
2015,12,31,100,40,43,83,Thursday
2015,12,30,2400,68,63,131,Wednesday
2015,12,30,2300,92,85,177,Wednesday
2015,12,30,2200,105,143,248,Wednesday
2015,12,30,2100,180,193,373,Wednesday
2015,12,30,2000,194,267,461,Wednesday
2015,12,30,1900,236,499,735,Wednesday
2015,12,30,1800,323,1435,1758,Wednesday
2015,12,30,1700,468,1426,1894,Wednesday
2015,12,30,1600,610,1057,1667,Wednesday
2015,12,30,1500,720,874,1594,Wednesday
2015,12,30,1400,743,694,1437,Wednesday
2015,12,30,1300,833,643,1476,Wednesday
2015,12,30,1200,839,449,1288,Wednesday
2015,12,30,1100,820,275,1095,Wednesday
2015,12,30,1000,894,206,1100,Wednesday
2015,12,30,900,1077,105,1182,Wednesday
2015,12,30,800,435,70,505,Wednesday
2015,12,30,700,105,40,145,Wednesday
2015,12,30,600,36,33,69,Wednesday
2015,12,30,500,32,17,49,Wednesday
2015,12,30,400,19,40,59,Wednesday
2015,12,30,300,31,28,59,Wednesday
2015,12,30,200,30,41,71,Wednesday
2015,12,30,100,46,51,97,Wednesday
2015,12,29,2400,67,55,122,Tuesday
2015,12,29,2300,78,107,185,Tuesday
2015,12,29,2200,98,135,233,Tuesday
2015,12,29,2100,143,177,320,Tuesday
2015,12,29,2000,155,220,375,Tuesday
2015,12,29,1900,185,543,728,Tuesday
2015,12,29,1800,256,1329,1585,Tuesday
2015,12,29,1700,385,1281,1666,Tuesday
2015,12,29,1600,576,980,1556,Tuesday
2015,12,29,1500,635,790,1425,Tuesday
2015,12,29,1400,718,643,1361,Tuesday
2015,12,29,1300,718,514,1232,Tuesday
2015,12,29,1200,876,409,1285,Tuesday
2015,12,29,1100,839,291,1130,Tuesday
2015,12,29,1000,1226,149,1375,Tuesday
2015,12,29,900,910,84,994,Tuesday
2015,12,29,800,345,64,409,Tuesday
2015,12,29,700,87,26,113,Tuesday
2015,12,29,600,45,34,79,Tuesday
2015,12,29,500,23,29,52,Tuesday
2015,12,29,400,15,29,44,Tuesday
2015,12,29,300,14,31,45,Tuesday
2015,12,29,200,16,34,50,Tuesday
2015,12,29,100,40,55,95,Tuesday
2015,12,28,2400,43,70,113,Monday
2015,12,28,2300,57,92,149,Monday
2015,12,28,2200,74,155,229,Monday
2015,12,28,2100,113,212,325,Monday
2015,12,28,2000,137,907,1044,Monday
2015,12,28,1900,221,1006,1227,Monday
2015,12,28,1800,266,1173,1439,Monday
2015,12,28,1700,369,843,1212,Monday
2015,12,28,1600,610,603,1213,Monday
2015,12,28,1500,721,479,1200,Monday
2015,12,28,1400,662,497,1159,Monday
2015,12,28,1300,608,481,1089,Monday
2015,12,28,1200,707,353,1060,Monday
2015,12,28,1100,992,214,1206,Monday
2015,12,28,1000,955,124,1079,Monday
2015,12,28,900,990,55,1045,Monday
2015,12,28,800,376,42,418,Monday
2015,12,28,700,103,17,120,Monday
2015,12,28,600,49,12,61,Monday
2015,12,28,500,22,8,30,Monday
2015,12,28,400,16,20,36,Monday
2015,12,28,300,18,17,35,Monday
2015,12,28,200,17,45,62,Monday
2015,12,28,100,32,50,82,Monday
2015,12,27,2400,28,44,72,Sunday
2015,12,27,2300,56,74,130,Sunday
2015,12,27,2200,88,136,224,Sunday
2015,12,27,2100,122,152,274,Sunday
2015,12,27,2000,138,271,409,Sunday
2015,12,27,1900,197,496,693,Sunday
2015,12,27,1800,354,1146,1500,Sunday
2015,12,27,1700,521,1307,1828,Sunday
2015,12,27,1600,723,1031,1754,Sunday
2015,12,27,1500,888,757,1645,Sunday
2015,12,27,1400,1037,629,1666,Sunday
2015,12,27,1300,1022,521,1543,Sunday
2015,12,27,1200,1062,351,1413,Sunday
2015,12,27,1100,937,220,1157,Sunday
2015,12,27,1000,946,112,1058,Sunday
2015,12,27,900,872,65,937,Sunday
2015,12,27,800,380,26,406,Sunday
2015,12,27,700,95,10,105,Sunday
2015,12,27,600,43,15,58,Sunday
2015,12,27,500,19,16,35,Sunday
2015,12,27,400,11,9,20,Sunday
2015,12,27,300,18,14,32,Sunday
2015,12,27,200,15,19,34,Sunday
2015,12,27,100,26,33,59,Sunday
2015,12,26,2400,35,45,80,Saturday
2015,12,26,2300,41,66,107,Saturday
2015,12,26,2200,76,53,129,Saturday
2015,12,26,2100,112,115,227,Saturday
2015,12,26,2000,146,140,286,Saturday
2015,12,26,1900,183,281,464,Saturday
2015,12,26,1800,286,538,824,Saturday
2015,12,26,1700,443,774,1217,Saturday
2015,12,26,1600,657,625,1282,Saturday
2015,12,26,1500,787,481,1268,Saturday
2015,12,26,1400,737,415,1152,Saturday
2015,12,26,1300,740,348,1088,Saturday
2015,12,26,1200,763,259,1022,Saturday
2015,12,26,1100,604,169,773,Saturday
2015,12,26,1000,517,106,623,Saturday
2015,12,26,900,497,49,546,Saturday
2015,12,26,800,223,26,249,Saturday
2015,12,26,700,96,17,113,Saturday
2015,12,26,600,37,13,50,Saturday
2015,12,26,500,12,6,18,Saturday
2015,12,26,400,5,8,13,Saturday
2015,12,26,300,8,8,16,Saturday
2015,12,26,200,7,7,14,Saturday
2015,12,26,100,19,18,37,Saturday
2015,12,25,2400,19,18,37,Friday
2015,12,25,2300,41,24,65,Friday
2015,12,25,2200,52,43,95,Friday
2015,12,25,2100,61,68,129,Friday
2015,12,25,2000,49,79,128,Friday
2015,12,25,1900,77,154,231,Friday
2015,12,25,1800,76,403,479,Friday
2015,12,25,1700,169,550,719,Friday
2015,12,25,1600,294,428,722,Friday
2015,12,25,1500,377,272,649,Friday
2015,12,25,1400,445,204,649,Friday
2015,12,25,1300,450,148,598,Friday
2015,12,25,1200,378,117,495,Friday
2015,12,25,1100,372,81,453,Friday
2015,12,25,1000,289,46,335,Friday
2015,12,25,900,290,45,335,Friday
2015,12,25,800,100,21,121,Friday
2015,12,25,700,38,21,59,Friday
2015,12,25,600,16,17,33,Friday
2015,12,25,500,13,8,21,Friday
2015,12,25,400,17,12,29,Friday
2015,12,25,300,12,11,23,Friday
2015,12,25,200,16,16,32,Friday
2015,12,25,100,11,27,38,Friday
2015,12,24,2400,24,39,63,Thursday
2015,12,24,2300,31,41,72,Thursday
2015,12,24,2200,66,57,123,Thursday
2015,12,24,2100,57,76,133,Thursday
2015,12,24,2000,103,100,203,Thursday
2015,12,24,1900,129,170,299,Thursday
2015,12,24,1800,182,339,521,Thursday
2015,12,24,1700,288,472,760,Thursday
2015,12,24,1600,474,414,888,Thursday
2015,12,24,1500,527,386,913,Thursday
2015,12,24,1400,508,346,854,Thursday
2015,12,24,1300,491,279,770,Thursday
2015,12,24,1200,475,219,694,Thursday
2015,12,24,1100,453,166,619,Thursday
2015,12,24,1000,450,218,668,Thursday
2015,12,24,900,385,76,461,Thursday
2015,12,24,800,179,28,207,Thursday
2015,12,24,700,89,21,110,Thursday
2015,12,24,600,35,6,41,Thursday
2015,12,24,500,29,4,33,Thursday
2015,12,24,400,20,9,29,Thursday
2015,12,24,300,23,35,58,Thursday
2015,12,24,200,33,38,71,Thursday
2015,12,24,100,60,32,92,Thursday
2015,12,23,2400,49,58,107,Wednesday
2015,12,23,2300,82,60,142,Wednesday
2015,12,23,2200,114,96,210,Wednesday
2015,12,23,2100,145,118,263,Wednesday
2015,12,23,2000,210,156,366,Wednesday
2015,12,23,1900,232,264,496,Wednesday
2015,12,23,1800,276,537,813,Wednesday
2015,12,23,1700,394,855,1249,Wednesday
2015,12,23,1600,510,703,1213,Wednesday
2015,12,23,1500,610,587,1197,Wednesday
2015,12,23,1400,576,485,1061,Wednesday
2015,12,23,1300,590,402,992,Wednesday
2015,12,23,1200,688,370,1058,Wednesday
2015,12,23,1100,625,242,867,Wednesday
2015,12,23,1000,622,173,795,Wednesday
2015,12,23,900,629,105,734,Wednesday
2015,12,23,800,311,62,373,Wednesday
2015,12,23,700,148,37,185,Wednesday
2015,12,23,600,49,39,88,Wednesday
2015,12,23,500,33,18,51,Wednesday
2015,12,23,400,35,36,71,Wednesday
2015,12,23,300,35,31,66,Wednesday
2015,12,23,200,42,43,85,Wednesday
2015,12,23,100,60,52,112,Wednesday
2015,12,22,2400,63,56,119,Tuesday
2015,12,22,2300,80,104,184,Tuesday
2015,12,22,2200,97,107,204,Tuesday
2015,12,22,2100,140,153,293,Tuesday
2015,12,22,2000,178,153,331,Tuesday
2015,12,22,1900,152,256,408,Tuesday
2015,12,22,1800,236,616,852,Tuesday
2015,12,22,1700,287,846,1133,Tuesday
2015,12,22,1600,372,663,1035,Tuesday
2015,12,22,1500,382,520,902,Tuesday
2015,12,22,1400,405,460,865,Tuesday
2015,12,22,1300,477,341,818,Tuesday
2015,12,22,1200,510,313,823,Tuesday
2015,12,22,1100,572,233,805,Tuesday
2015,12,22,1000,577,193,770,Tuesday
2015,12,22,900,657,109,766,Tuesday
2015,12,22,800,245,71,316,Tuesday
2015,12,22,700,109,51,160,Tuesday
2015,12,22,600,55,27,82,Tuesday
2015,12,22,500,24,16,40,Tuesday
2015,12,22,400,33,29,62,Tuesday
2015,12,22,300,17,34,51,Tuesday
2015,12,22,200,29,39,68,Tuesday
2015,12,22,100,43,49,92,Tuesday
2015,12,21,2400,46,42,88,Monday
2015,12,21,2300,81,74,155,Monday
2015,12,21,2200,78,112,190,Monday
2015,12,21,2100,139,136,275,Monday
2015,12,21,2000,146,442,588,Monday
2015,12,21,1900,181,128,309,Monday
2015,12,21,1800,214,745,959,Monday
2015,12,21,1700,309,697,1006,Monday
2015,12,21,1600,378,655,1033,Monday
2015,12,21,1500,383,327,710,Monday
2015,12,21,1400,422,371,793,Monday
2015,12,21,1300,472,328,800,Monday
2015,12,21,1200,502,236,738,Monday
2015,12,21,1100,507,156,663,Monday
2015,12,21,1000,609,139,748,Monday
2015,12,21,900,626,108,734,Monday
2015,12,21,800,278,50,328,Monday
2015,12,21,700,111,33,144,Monday
2015,12,21,600,44,18,62,Monday
2015,12,21,500,29,17,46,Monday
2015,12,21,400,17,13,30,Monday
2015,12,21,300,22,28,50,Monday
2015,12,21,200,24,34,58,Monday
2015,12,21,100,22,40,62,Monday
2015,12,20,2400,38,64,102,Sunday
2015,12,20,2300,57,115,172,Sunday
2015,12,20,2200,82,116,198,Sunday
2015,12,20,2100,132,177,309,Sunday
2015,12,20,2000,156,186,342,Sunday
2015,12,20,1900,148,327,475,Sunday
2015,12,20,1800,207,631,838,Sunday
2015,12,20,1700,289,1031,1320,Sunday
2015,12,20,1600,391,719,1110,Sunday
2015,12,20,1500,443,595,1038,Sunday
2015,12,20,1400,424,456,880,Sunday
2015,12,20,1300,488,423,911,Sunday
2015,12,20,1200,522,302,824,Sunday
2015,12,20,1100,543,175,718,Sunday
2015,12,20,1000,570,124,694,Sunday
2015,12,20,900,649,58,707,Sunday
2015,12,20,800,290,36,326,Sunday
2015,12,20,700,84,22,106,Sunday
2015,12,20,600,36,12,48,Sunday
2015,12,20,500,20,12,32,Sunday
2015,12,20,400,24,11,35,Sunday
2015,12,20,300,20,11,31,Sunday
2015,12,20,200,18,24,42,Sunday
2015,12,20,100,22,33,55,Sunday
2015,12,19,2400,33,41,74,Saturday
2015,12,19,2300,50,80,130,Saturday
2015,12,19,2200,84,115,199,Saturday
2015,12,19,2100,103,131,234,Saturday
2015,12,19,2000,117,127,244,Saturday
2015,12,19,1900,133,205,338,Saturday
2015,12,19,1800,237,520,757,Saturday
2015,12,19,1700,277,828,1105,Saturday
2015,12,19,1600,388,626,1014,Saturday
2015,12,19,1500,459,426,885,Saturday
2015,12,19,1400,502,382,884,Saturday
2015,12,19,1300,538,210,748,Saturday
2015,12,19,1200,491,194,685,Saturday
2015,12,19,1100,549,169,718,Saturday
2015,12,19,1000,691,103,794,Saturday
2015,12,19,900,705,81,786,Saturday
2015,12,19,800,337,55,392,Saturday
2015,12,19,700,126,29,155,Saturday
2015,12,19,600,56,18,74,Saturday
2015,12,19,500,20,34,54,Saturday
2015,12,19,400,26,20,46,Saturday
2015,12,19,300,25,34,59,Saturday
2015,12,19,200,32,30,62,Saturday
2015,12,19,100,43,36,79,Saturday
2015,12,18,2400,66,64,130,Friday
2015,12,18,2300,103,64,167,Friday
2015,12,18,2200,151,77,228,Friday
2015,12,18,2100,213,92,305,Friday
2015,12,18,2000,257,115,372,Friday
2015,12,18,1900,271,187,458,Friday
2015,12,18,1800,307,386,693,Friday
2015,12,18,1700,415,501,916,Friday
2015,12,18,1600,421,364,785,Friday
2015,12,18,1500,385,283,668,Friday
2015,12,18,1400,338,196,534,Friday
2015,12,18,1300,349,185,534,Friday
2015,12,18,1200,347,177,524,Friday
2015,12,18,1100,367,158,525,Friday
2015,12,18,1000,382,121,503,Friday
2015,12,18,900,356,80,436,Friday
2015,12,18,800,188,34,222,Friday
2015,12,18,700,73,33,106,Friday
2015,12,18,600,40,23,63,Friday
2015,12,18,500,33,17,50,Friday
2015,12,18,400,25,26,51,Friday
2015,12,18,300,36,35,71,Friday
2015,12,18,200,38,31,69,Friday
2015,12,18,100,37,43,80,Friday
2015,12,17,2400,62,48,110,Thursday
2015,12,17,2300,77,55,132,Thursday
2015,12,17,2200,117,95,212,Thursday
2015,12,17,2100,133,110,243,Thursday
2015,12,17,2000,152,182,334,Thursday
2015,12,17,1900,153,167,320,Thursday
2015,12,17,1800,203,301,504,Thursday
2015,12,17,1700,212,395,607,Thursday
2015,12,17,1600,236,320,556,Thursday
2015,12,17,1500,223,291,514,Thursday
2015,12,17,1400,249,273,522,Thursday
2015,12,17,1300,247,214,461,Thursday
2015,12,17,1200,290,159,449,Thursday
2015,12,17,1100,274,149,423,Thursday
2015,12,17,1000,304,112,416,Thursday
2015,12,17,900,267,78,345,Thursday
2015,12,17,800,160,51,211,Thursday
2015,12,17,700,63,41,104,Thursday
2015,12,17,600,30,37,67,Thursday
2015,12,17,500,24,20,44,Thursday
2015,12,17,400,24,31,55,Thursday
2015,12,17,300,21,27,48,Thursday
2015,12,17,200,30,38,68,Thursday
2015,12,17,100,38,46,84,Thursday
2015,12,16,2400,58,59,117,Wednesday
2015,12,16,2300,73,57,130,Wednesday
2015,12,16,2200,102,87,189,Wednesday
2015,12,16,2100,111,99,210,Wednesday
2015,12,16,2000,118,110,228,Wednesday
2015,12,16,1900,104,166,270,Wednesday
2015,12,16,1800,144,252,396,Wednesday
2015,12,16,1700,188,366,554,Wednesday
2015,12,16,1600,181,307,488,Wednesday
2015,12,16,1500,217,269,486,Wednesday
2015,12,16,1400,209,218,427,Wednesday
2015,12,16,1300,224,188,412,Wednesday
2015,12,16,1200,232,175,407,Wednesday
2015,12,16,1100,238,113,351,Wednesday
2015,12,16,1000,264,114,378,Wednesday
2015,12,16,900,228,95,323,Wednesday
2015,12,16,800,125,54,179,Wednesday
2015,12,16,700,59,20,79,Wednesday
2015,12,16,600,19,27,46,Wednesday
2015,12,16,500,26,16,42,Wednesday
2015,12,16,400,23,28,51,Wednesday
2015,12,16,300,14,23,37,Wednesday
2015,12,16,200,26,39,65,Wednesday
2015,12,16,100,26,35,61,Wednesday
2015,12,15,2400,58,45,103,Tuesday
2015,12,15,2300,57,68,125,Tuesday
2015,12,15,2200,73,64,137,Tuesday
2015,12,15,2100,82,80,162,Tuesday
2015,12,15,2000,105,122,227,Tuesday
2015,12,15,1900,99,148,247,Tuesday
2015,12,15,1800,133,281,414,Tuesday
2015,12,15,1700,188,351,539,Tuesday
2015,12,15,1600,168,276,444,Tuesday
2015,12,15,1500,194,254,448,Tuesday
2015,12,15,1400,185,196,381,Tuesday
2015,12,15,1300,199,152,351,Tuesday
2015,12,15,1200,201,156,357,Tuesday
2015,12,15,1100,232,159,391,Tuesday
2015,12,15,1000,261,109,370,Tuesday
2015,12,15,900,235,82,317,Tuesday
2015,12,15,800,139,61,200,Tuesday
2015,12,15,700,63,35,98,Tuesday
2015,12,15,600,27,31,58,Tuesday
2015,12,15,500,19,22,41,Tuesday
2015,12,15,400,14,26,40,Tuesday
2015,12,15,300,16,32,48,Tuesday
2015,12,15,200,25,27,52,Tuesday
2015,12,15,100,30,53,83,Tuesday
2015,12,14,2400,41,31,72,Monday
2015,12,14,2300,71,59,130,Monday
2015,12,14,2200,62,88,150,Monday
2015,12,14,2100,88,97,185,Monday
2015,12,14,2000,122,104,226,Monday
2015,12,14,1900,117,149,266,Monday
2015,12,14,1800,153,288,441,Monday
2015,12,14,1700,196,393,589,Monday
2015,12,14,1600,225,330,555,Monday
2015,12,14,1500,207,245,452,Monday
2015,12,14,1400,226,188,414,Monday
2015,12,14,1300,191,177,368,Monday
2015,12,14,1200,267,171,438,Monday
2015,12,14,1100,247,116,363,Monday
2015,12,14,1000,273,119,392,Monday
2015,12,14,900,240,91,331,Monday
2015,12,14,800,101,56,157,Monday
2015,12,14,700,69,25,94,Monday
2015,12,14,600,31,23,54,Monday
2015,12,14,500,16,20,36,Monday
2015,12,14,400,23,26,49,Monday
2015,12,14,300,16,15,31,Monday
2015,12,14,200,20,33,53,Monday
2015,12,14,100,17,37,54,Monday
2015,12,13,2400,28,55,83,Sunday
2015,12,13,2300,41,73,114,Sunday
2015,12,13,2200,68,137,205,Sunday
2015,12,13,2100,64,179,243,Sunday
2015,12,13,2000,84,205,289,Sunday
2015,12,13,1900,123,360,483,Sunday
2015,12,13,1800,138,714,852,Sunday
2015,12,13,1700,192,1014,1206,Sunday
2015,12,13,1600,227,777,1004,Sunday
2015,12,13,1500,206,620,826,Sunday
2015,12,13,1400,252,477,729,Sunday
2015,12,13,1300,294,433,727,Sunday
2015,12,13,1200,345,332,677,Sunday
2015,12,13,1100,320,174,494,Sunday
2015,12,13,1000,485,110,595,Sunday
2015,12,13,900,639,64,703,Sunday
2015,12,13,800,265,35,300,Sunday
2015,12,13,700,70,27,97,Sunday
2015,12,13,600,28,15,43,Sunday
2015,12,13,500,9,13,22,Sunday
2015,12,13,400,11,8,19,Sunday
2015,12,13,300,20,17,37,Sunday
2015,12,13,200,17,24,41,Sunday
2015,12,13,100,25,25,50,Sunday
2015,12,12,2400,35,47,82,Saturday
2015,12,12,2300,43,38,81,Saturday
2015,12,12,2200,69,54,123,Saturday
2015,12,12,2100,74,86,160,Saturday
2015,12,12,2000,76,106,182,Saturday
2015,12,12,1900,102,186,288,Saturday
2015,12,12,1800,130,559,689,Saturday
2015,12,12,1700,203,793,996,Saturday
2015,12,12,1600,236,555,791,Saturday
2015,12,12,1500,228,348,576,Saturday
2015,12,12,1400,267,267,534,Saturday
2015,12,12,1300,260,251,511,Saturday
2015,12,12,1200,349,180,529,Saturday
2015,12,12,1100,377,138,515,Saturday
2015,12,12,1000,566,119,685,Saturday
2015,12,12,900,739,81,820,Saturday
2015,12,12,800,334,60,394,Saturday
2015,12,12,700,90,25,115,Saturday
2015,12,12,600,35,32,67,Saturday
2015,12,12,500,20,27,47,Saturday
2015,12,12,400,20,15,35,Saturday
2015,12,12,300,15,23,38,Saturday
2015,12,12,200,18,19,37,Saturday
2015,12,12,100,35,26,61,Saturday
2015,12,11,2400,90,39,129,Friday
2015,12,11,2300,81,63,144,Friday
2015,12,11,2200,113,80,193,Friday
2015,12,11,2100,182,104,286,Friday
2015,12,11,2000,305,109,414,Friday
2015,12,11,1900,242,181,423,Friday
2015,12,11,1800,349,361,710,Friday
2015,12,11,1700,439,482,921,Friday
2015,12,11,1600,438,387,825,Friday
2015,12,11,1500,345,277,622,Friday
2015,12,11,1400,306,224,530,Friday
2015,12,11,1300,289,217,506,Friday
2015,12,11,1200,281,235,516,Friday
2015,12,11,1100,291,136,427,Friday
2015,12,11,1000,372,100,472,Friday
2015,12,11,900,411,75,486,Friday
2015,12,11,800,203,60,263,Friday
2015,12,11,700,92,38,130,Friday
2015,12,11,600,39,18,57,Friday
2015,12,11,500,31,28,59,Friday
2015,12,11,400,24,29,53,Friday
2015,12,11,300,27,25,52,Friday
2015,12,11,200,20,14,34,Friday
2015,12,11,100,32,26,58,Friday
2015,12,10,2400,66,60,126,Thursday
2015,12,10,2300,78,69,147,Thursday
2015,12,10,2200,128,67,195,Thursday
2015,12,10,2100,140,106,246,Thursday
2015,12,10,2000,164,197,361,Thursday
2015,12,10,1900,178,70,248,Thursday
2015,12,10,1800,195,220,415,Thursday
2015,12,10,1700,235,379,614,Thursday
2015,12,10,1600,209,340,549,Thursday
2015,12,10,1500,214,315,529,Thursday
2015,12,10,1400,213,177,390,Thursday
2015,12,10,1300,206,190,396,Thursday
2015,12,10,1200,242,155,397,Thursday
2015,12,10,1100,243,145,388,Thursday
2015,12,10,1000,323,115,438,Thursday
2015,12,10,900,382,68,450,Thursday
2015,12,10,800,138,53,191,Thursday
2015,12,10,700,67,31,98,Thursday
2015,12,10,600,34,33,67,Thursday
2015,12,10,500,17,15,32,Thursday
2015,12,10,400,22,25,47,Thursday
2015,12,10,300,24,31,55,Thursday
2015,12,10,200,26,36,62,Thursday
2015,12,10,100,24,46,70,Thursday
2015,12,9,2400,45,34,79,Wednesday
2015,12,9,2300,46,70,116,Wednesday
2015,12,9,2200,66,66,132,Wednesday
2015,12,9,2100,101,79,180,Wednesday
2015,12,9,2000,90,88,178,Wednesday
2015,12,9,1900,115,161,276,Wednesday
2015,12,9,1800,111,274,385,Wednesday
2015,12,9,1700,176,348,524,Wednesday
2015,12,9,1600,160,278,438,Wednesday
2015,12,9,1500,159,241,400,Wednesday
2015,12,9,1400,186,239,425,Wednesday
2015,12,9,1300,146,134,280,Wednesday
2015,12,9,1200,196,115,311,Wednesday
2015,12,9,1100,207,129,336,Wednesday
2015,12,9,1000,265,98,363,Wednesday
2015,12,9,900,369,89,458,Wednesday
2015,12,9,800,134,55,189,Wednesday
2015,12,9,700,59,35,94,Wednesday
2015,12,9,600,25,41,66,Wednesday
2015,12,9,500,15,31,46,Wednesday
2015,12,9,400,21,41,62,Wednesday
2015,12,9,300,18,46,64,Wednesday
2015,12,9,200,33,49,82,Wednesday
2015,12,9,100,37,10,47,Wednesday
2015,12,8,2400,45,31,76,Tuesday
2015,12,8,2300,66,68,134,Tuesday
2015,12,8,2200,67,154,221,Tuesday
2015,12,8,2100,90,108,198,Tuesday
2015,12,8,2000,90,38,128,Tuesday
2015,12,8,1900,105,93,198,Tuesday
2015,12,8,1800,117,223,340,Tuesday
2015,12,8,1700,151,285,436,Tuesday
2015,12,8,1600,174,252,426,Tuesday
2015,12,8,1500,168,209,377,Tuesday
2015,12,8,1400,164,200,364,Tuesday
2015,12,8,1300,181,166,347,Tuesday
2015,12,8,1200,181,156,337,Tuesday
2015,12,8,1100,235,131,366,Tuesday
2015,12,8,1000,195,127,322,Tuesday
2015,12,8,900,263,74,337,Tuesday
2015,12,8,800,132,46,178,Tuesday
2015,12,8,700,62,41,103,Tuesday
2015,12,8,600,28,38,66,Tuesday
2015,12,8,500,11,27,38,Tuesday
2015,12,8,400,20,29,49,Tuesday
2015,12,8,300,23,27,50,Tuesday
2015,12,8,200,22,37,59,Tuesday
2015,12,8,100,30,48,78,Tuesday
2015,12,7,2400,46,56,102,Monday
2015,12,7,2300,55,71,126,Monday
2015,12,7,2200,63,101,164,Monday
2015,12,7,2100,94,92,186,Monday
2015,12,7,2000,98,146,244,Monday
2015,12,7,1900,106,168,274,Monday
2015,12,7,1800,144,285,429,Monday
2015,12,7,1700,176,356,532,Monday
2015,12,7,1600,210,290,500,Monday
2015,12,7,1500,235,258,493,Monday
2015,12,7,1400,217,229,446,Monday
2015,12,7,1300,219,168,387,Monday
2015,12,7,1200,235,166,401,Monday
2015,12,7,1100,238,127,365,Monday
2015,12,7,1000,258,110,368,Monday
2015,12,7,900,227,85,312,Monday
2015,12,7,800,120,43,163,Monday
2015,12,7,700,69,30,99,Monday
2015,12,7,600,40,20,60,Monday
2015,12,7,500,16,12,28,Monday
2015,12,7,400,11,30,41,Monday
2015,12,7,300,16,26,42,Monday
2015,12,7,200,14,28,42,Monday
2015,12,7,100,19,48,67,Monday
2015,12,6,2400,29,47,76,Sunday
2015,12,6,2300,35,78,113,Sunday
2015,12,6,2200,55,129,184,Sunday
2015,12,6,2100,78,132,210,Sunday
2015,12,6,2000,90,222,312,Sunday
2015,12,6,1900,108,375,483,Sunday
2015,12,6,1800,141,600,741,Sunday
2015,12,6,1700,186,980,1166,Sunday
2015,12,6,1600,228,796,1024,Sunday
2015,12,6,1500,220,672,892,Sunday
2015,12,6,1400,247,525,772,Sunday
2015,12,6,1300,279,357,636,Sunday
2015,12,6,1200,351,245,596,Sunday
2015,12,6,1100,373,177,550,Sunday
2015,12,6,1000,443,95,538,Sunday
2015,12,6,900,504,69,573,Sunday
2015,12,6,800,223,39,262,Sunday
2015,12,6,700,71,21,92,Sunday
2015,12,6,600,36,17,53,Sunday
2015,12,6,500,14,13,27,Sunday
2015,12,6,400,14,8,22,Sunday
2015,12,6,300,12,9,21,Sunday
2015,12,6,200,14,17,31,Sunday
2015,12,6,100,20,18,38,Sunday
2015,12,5,2400,30,36,66,Saturday
2015,12,5,2300,34,42,76,Saturday
2015,12,5,2200,64,52,116,Saturday
2015,12,5,2100,82,87,169,Saturday
2015,12,5,2000,90,106,196,Saturday
2015,12,5,1900,98,210,308,Saturday
2015,12,5,1800,129,524,653,Saturday
2015,12,5,1700,179,837,1016,Saturday
2015,12,5,1600,249,605,854,Saturday
2015,12,5,1500,242,422,664,Saturday
2015,12,5,1400,278,272,550,Saturday
2015,12,5,1300,326,198,524,Saturday
2015,12,5,1200,371,165,536,Saturday
2015,12,5,1100,405,130,535,Saturday
2015,12,5,1000,522,123,645,Saturday
2015,12,5,900,729,64,793,Saturday
2015,12,5,800,362,59,421,Saturday
2015,12,5,700,83,44,127,Saturday
2015,12,5,600,36,27,63,Saturday
2015,12,5,500,13,10,23,Saturday
2015,12,5,400,20,22,42,Saturday
2015,12,5,300,22,17,39,Saturday
2015,12,5,200,21,35,56,Saturday
2015,12,5,100,39,34,73,Saturday
2015,12,4,2400,66,52,118,Friday
2015,12,4,2300,81,46,127,Friday
2015,12,4,2200,112,70,182,Friday
2015,12,4,2100,207,77,284,Friday
2015,12,4,2000,271,140,411,Friday
2015,12,4,1900,302,143,445,Friday
2015,12,4,1800,327,319,646,Friday
2015,12,4,1700,380,439,819,Friday
2015,12,4,1600,346,355,701,Friday
2015,12,4,1500,353,304,657,Friday
2015,12,4,1400,295,204,499,Friday
2015,12,4,1300,318,205,523,Friday
2015,12,4,1200,334,179,513,Friday
2015,12,4,1100,295,126,421,Friday
2015,12,4,1000,337,112,449,Friday
2015,12,4,900,296,70,366,Friday
2015,12,4,800,168,53,221,Friday
2015,12,4,700,68,39,107,Friday
2015,12,4,600,43,21,64,Friday
2015,12,4,500,19,18,37,Friday
2015,12,4,400,20,25,45,Friday
2015,12,4,300,21,41,62,Friday
2015,12,4,200,35,33,68,Friday
2015,12,4,100,41,25,66,Friday
2015,12,3,2400,70,67,137,Thursday
2015,12,3,2300,64,72,136,Thursday
2015,12,3,2200,100,87,187,Thursday
2015,12,3,2100,127,121,248,Thursday
2015,12,3,2000,156,115,271,Thursday
2015,12,3,1900,157,165,322,Thursday
2015,12,3,1800,180,247,427,Thursday
2015,12,3,1700,217,324,541,Thursday
2015,12,3,1600,182,277,459,Thursday
2015,12,3,1500,221,171,392,Thursday
2015,12,3,1400,227,165,392,Thursday
2015,12,3,1300,204,147,351,Thursday
2015,12,3,1200,218,124,342,Thursday
2015,12,3,1100,223,119,342,Thursday
2015,12,3,1000,234,119,353,Thursday
2015,12,3,900,218,94,312,Thursday
2015,12,3,800,93,55,148,Thursday
2015,12,3,700,74,46,120,Thursday
2015,12,3,600,34,29,63,Thursday
2015,12,3,500,29,23,52,Thursday
2015,12,3,400,21,24,45,Thursday
2015,12,3,300,26,42,68,Thursday
2015,12,3,200,22,28,50,Thursday
2015,12,3,100,38,47,85,Thursday
2015,12,2,2400,59,45,104,Wednesday
2015,12,2,2300,72,81,153,Wednesday
2015,12,2,2200,78,80,158,Wednesday
2015,12,2,2100,92,89,181,Wednesday
2015,12,2,2000,112,106,218,Wednesday
2015,12,2,1900,130,158,288,Wednesday
2015,12,2,1800,165,193,358,Wednesday
2015,12,2,1700,180,307,487,Wednesday
2015,12,2,1600,194,265,459,Wednesday
2015,12,2,1500,181,203,384,Wednesday
2015,12,2,1400,225,159,384,Wednesday
2015,12,2,1300,194,159,353,Wednesday
2015,12,2,1200,205,167,372,Wednesday
2015,12,2,1100,194,144,338,Wednesday
2015,12,2,1000,232,79,311,Wednesday
2015,12,2,900,183,79,262,Wednesday
2015,12,2,800,123,42,165,Wednesday
2015,12,2,700,74,22,96,Wednesday
2015,12,2,600,32,12,44,Wednesday
2015,12,2,500,21,15,36,Wednesday
2015,12,2,400,28,29,57,Wednesday
2015,12,2,300,22,20,42,Wednesday
2015,12,2,200,27,33,60,Wednesday
2015,12,2,100,34,44,78,Wednesday
2015,12,1,2400,47,40,87,Tuesday
2015,12,1,2300,64,62,126,Tuesday
2015,12,1,2200,76,76,152,Tuesday
2015,12,1,2100,82,69,151,Tuesday
2015,12,1,2000,100,125,225,Tuesday
2015,12,1,1900,84,155,239,Tuesday
2015,12,1,1800,121,216,337,Tuesday
2015,12,1,1700,139,307,446,Tuesday
2015,12,1,1600,194,233,427,Tuesday
2015,12,1,1500,182,215,397,Tuesday
2015,12,1,1400,199,160,359,Tuesday
2015,12,1,1300,195,179,374,Tuesday
2015,12,1,1200,214,187,401,Tuesday
2015,12,1,1100,214,169,383,Tuesday
2015,12,1,1000,196,171,367,Tuesday
2015,12,1,900,186,123,309,Tuesday
2015,12,1,800,124,32,156,Tuesday
2015,12,1,700,53,28,81,Tuesday
2015,12,1,600,45,9,54,Tuesday
2015,12,1,500,21,4,25,Tuesday
2015,12,1,400,20,3,23,Tuesday
2015,12,1,300,15,6,21,Tuesday
2015,12,1,200,24,11,35,Tuesday
2015,12,1,100,32,35,67,Tuesday
2015,11,30,2400,47,42,89,Monday
2015,11,30,2300,59,69,128,Monday
2015,11,30,2200,72,71,143,Monday
2015,11,30,2100,79,95,174,Monday
2015,11,30,2000,91,139,230,Monday
2015,11,30,1900,129,147,276,Monday
2015,11,30,1800,149,276,425,Monday
2015,11,30,1700,205,370,575,Monday
2015,11,30,1600,198,315,513,Monday
2015,11,30,1500,191,258,449,Monday
2015,11,30,1400,232,208,440,Monday
2015,11,30,1300,224,205,429,Monday
2015,11,30,1200,250,169,419,Monday
2015,11,30,1100,248,149,397,Monday
2015,11,30,1000,280,100,380,Monday
2015,11,30,900,220,77,297,Monday
2015,11,30,800,105,47,152,Monday
2015,11,30,700,59,37,96,Monday
2015,11,30,600,36,24,60,Monday
2015,11,30,500,12,13,25,Monday
2015,11,30,400,14,18,32,Monday
2015,11,30,300,10,26,36,Monday
2015,11,30,200,13,28,41,Monday
2015,11,30,100,27,50,77,Monday
2015,11,29,2400,29,58,87,Sunday
2015,11,29,2300,51,64,115,Sunday
2015,11,29,2200,40,120,160,Sunday
2015,11,29,2100,83,161,244,Sunday
2015,11,29,2000,85,295,380,Sunday
2015,11,29,1900,102,443,545,Sunday
2015,11,29,1800,143,701,844,Sunday
2015,11,29,1700,199,1059,1258,Sunday
2015,11,29,1600,223,966,1189,Sunday
2015,11,29,1500,240,719,959,Sunday
2015,11,29,1400,253,524,777,Sunday
2015,11,29,1300,286,404,690,Sunday
2015,11,29,1200,383,289,672,Sunday
2015,11,29,1100,432,191,623,Sunday
2015,11,29,1000,463,105,568,Sunday
2015,11,29,900,583,66,649,Sunday
2015,11,29,800,300,33,333,Sunday
2015,11,29,700,76,17,93,Sunday
2015,11,29,600,42,10,52,Sunday
2015,11,29,500,15,7,22,Sunday
2015,11,29,400,17,19,36,Sunday
2015,11,29,300,10,17,27,Sunday
2015,11,29,200,15,25,40,Sunday
2015,11,29,100,32,24,56,Sunday
2015,11,28,2400,18,45,63,Saturday
2015,11,28,2300,40,40,80,Saturday
2015,11,28,2200,53,76,129,Saturday
2015,11,28,2100,64,143,207,Saturday
2015,11,28,2000,72,156,228,Saturday
2015,11,28,1900,117,285,402,Saturday
2015,11,28,1800,144,736,880,Saturday
2015,11,28,1700,180,922,1102,Saturday
2015,11,28,1600,219,691,910,Saturday
2015,11,28,1500,229,440,669,Saturday
2015,11,28,1400,238,275,513,Saturday
2015,11,28,1300,315,231,546,Saturday
2015,11,28,1200,426,161,587,Saturday
2015,11,28,1100,522,120,642,Saturday
2015,11,28,1000,643,107,750,Saturday
2015,11,28,900,802,74,876,Saturday
2015,11,28,800,435,47,482,Saturday
2015,11,28,700,174,30,204,Saturday
2015,11,28,600,46,29,75,Saturday
2015,11,28,500,15,31,46,Saturday
2015,11,28,400,23,25,48,Saturday
2015,11,28,300,16,25,41,Saturday
2015,11,28,200,34,26,60,Saturday
2015,11,28,100,45,29,74,Saturday
2015,11,27,2400,70,43,113,Friday
2015,11,27,2300,109,39,148,Friday
2015,11,27,2200,161,81,242,Friday
2015,11,27,2100,252,98,350,Friday
2015,11,27,2000,371,142,513,Friday
2015,11,27,1900,362,187,549,Friday
2015,11,27,1800,424,345,769,Friday
2015,11,27,1700,433,535,968,Friday
2015,11,27,1600,380,377,757,Friday
2015,11,27,1500,342,304,646,Friday
2015,11,27,1400,346,249,595,Friday
2015,11,27,1300,342,218,560,Friday
2015,11,27,1200,341,185,526,Friday
2015,11,27,1100,365,144,509,Friday
2015,11,27,1000,409,138,547,Friday
2015,11,27,900,411,95,506,Friday
2015,11,27,800,145,58,203,Friday
2015,11,27,700,85,45,130,Friday
2015,11,27,600,34,45,79,Friday
2015,11,27,500,16,17,33,Friday
2015,11,27,400,31,31,62,Friday
2015,11,27,300,20,31,51,Friday
2015,11,27,200,33,38,71,Friday
2015,11,27,100,39,38,77,Friday
2015,11,26,2400,59,48,107,Thursday
2015,11,26,2300,78,76,154,Thursday
2015,11,26,2200,115,82,197,Thursday
2015,11,26,2100,153,106,259,Thursday
2015,11,26,2000,155,125,280,Thursday
2015,11,26,1900,181,177,358,Thursday
2015,11,26,1800,206,297,503,Thursday
2015,11,26,1700,264,372,636,Thursday
2015,11,26,1600,262,294,556,Thursday
2015,11,26,1500,230,251,481,Thursday
2015,11,26,1400,213,218,431,Thursday
2015,11,26,1300,244,186,430,Thursday
2015,11,26,1200,233,136,369,Thursday
2015,11,26,1100,267,115,382,Thursday
2015,11,26,1000,276,115,391,Thursday
2015,11,26,900,269,74,343,Thursday
2015,11,26,800,153,63,216,Thursday
2015,11,26,700,70,51,121,Thursday
2015,11,26,600,42,30,72,Thursday
2015,11,26,500,27,26,53,Thursday
2015,11,26,400,24,21,45,Thursday
2015,11,26,300,16,28,44,Thursday
2015,11,26,200,20,41,61,Thursday
2015,11,26,100,40,47,87,Thursday
2015,11,25,2400,56,30,86,Wednesday
2015,11,25,2300,55,73,128,Wednesday
2015,11,25,2200,84,93,177,Wednesday
2015,11,25,2100,96,95,191,Wednesday
2015,11,25,2000,109,105,214,Wednesday
2015,11,25,1900,131,151,282,Wednesday
2015,11,25,1800,149,272,421,Wednesday
2015,11,25,1700,174,367,541,Wednesday
2015,11,25,1600,220,321,541,Wednesday
2015,11,25,1500,189,249,438,Wednesday
2015,11,25,1400,183,182,365,Wednesday
2015,11,25,1300,220,166,386,Wednesday
2015,11,25,1200,242,134,376,Wednesday
2015,11,25,1100,226,110,336,Wednesday
2015,11,25,1000,269,122,391,Wednesday
2015,11,25,900,245,85,330,Wednesday
2015,11,25,800,156,62,218,Wednesday
2015,11,25,700,58,42,100,Wednesday
2015,11,25,600,33,24,57,Wednesday
2015,11,25,500,17,18,35,Wednesday
2015,11,25,400,28,27,55,Wednesday
2015,11,25,300,25,25,50,Wednesday
2015,11,25,200,26,38,64,Wednesday
2015,11,25,100,29,26,55,Wednesday
2015,11,24,2400,60,43,103,Tuesday
2015,11,24,2300,59,46,105,Tuesday
2015,11,24,2200,73,73,146,Tuesday
2015,11,24,2100,87,100,187,Tuesday
2015,11,24,2000,98,102,200,Tuesday
2015,11,24,1900,104,139,243,Tuesday
2015,11,24,1800,116,236,352,Tuesday
2015,11,24,1700,158,287,445,Tuesday
2015,11,24,1600,146,265,411,Tuesday
2015,11,24,1500,157,235,392,Tuesday
2015,11,24,1400,181,189,370,Tuesday
2015,11,24,1300,155,167,322,Tuesday
2015,11,24,1200,180,138,318,Tuesday
2015,11,24,1100,158,100,258,Tuesday
2015,11,24,1000,222,111,333,Tuesday
2015,11,24,900,233,67,300,Tuesday
2015,11,24,800,106,47,153,Tuesday
2015,11,24,700,41,24,65,Tuesday
2015,11,24,600,32,19,51,Tuesday
2015,11,24,500,15,10,25,Tuesday
2015,11,24,400,19,21,40,Tuesday
2015,11,24,300,19,41,60,Tuesday
2015,11,24,200,15,29,44,Tuesday
2015,11,24,100,28,36,64,Tuesday
2015,11,23,2400,49,51,100,Monday
2015,11,23,2300,55,52,107,Monday
2015,11,23,2200,62,91,153,Monday
2015,11,23,2100,75,76,151,Monday
2015,11,23,2000,90,93,183,Monday
2015,11,23,1900,90,155,245,Monday
2015,11,23,1800,152,263,415,Monday
2015,11,23,1700,181,320,501,Monday
2015,11,23,1600,187,244,431,Monday
2015,11,23,1500,195,210,405,Monday
2015,11,23,1400,239,171,410,Monday
2015,11,23,1300,196,169,365,Monday
2015,11,23,1200,227,161,388,Monday
2015,11,23,1100,261,125,386,Monday
2015,11,23,1000,271,79,350,Monday
2015,11,23,900,264,72,336,Monday
2015,11,23,800,138,50,188,Monday
2015,11,23,700,58,41,99,Monday
2015,11,23,600,34,19,53,Monday
2015,11,23,500,20,12,32,Monday
2015,11,23,400,12,24,36,Monday
2015,11,23,300,19,26,45,Monday
2015,11,23,200,17,39,56,Monday
2015,11,23,100,29,41,70,Monday
2015,11,22,2400,30,58,88,Sunday
2015,11,22,2300,33,85,118,Sunday
2015,11,22,2200,64,121,185,Sunday
2015,11,22,2100,74,152,226,Sunday
2015,11,22,2000,85,213,298,Sunday
2015,11,22,1900,107,329,436,Sunday
2015,11,22,1800,165,756,921,Sunday
2015,11,22,1700,179,1009,1188,Sunday
2015,11,22,1600,241,743,984,Sunday
2015,11,22,1500,263,590,853,Sunday
2015,11,22,1400,257,460,717,Sunday
2015,11,22,1300,319,397,716,Sunday
2015,11,22,1200,360,303,663,Sunday
2015,11,22,1100,414,148,562,Sunday
2015,11,22,1000,571,100,671,Sunday
2015,11,22,900,673,59,732,Sunday
2015,11,22,800,249,30,279,Sunday
2015,11,22,700,77,14,91,Sunday
2015,11,22,600,29,12,41,Sunday
2015,11,22,500,14,16,30,Sunday
2015,11,22,400,6,21,27,Sunday
2015,11,22,300,11,29,40,Sunday
2015,11,22,200,17,10,27,Sunday
2015,11,22,100,23,26,49,Sunday
2015,11,21,2400,29,21,50,Saturday
2015,11,21,2300,43,54,97,Saturday
2015,11,21,2200,41,71,112,Saturday
2015,11,21,2100,87,80,167,Saturday
2015,11,21,2000,83,124,207,Saturday
2015,11,21,1900,88,185,273,Saturday
2015,11,21,1800,144,596,740,Saturday
2015,11,21,1700,202,890,1092,Saturday
2015,11,21,1600,209,689,898,Saturday
2015,11,21,1500,242,455,697,Saturday
2015,11,21,1400,295,299,594,Saturday
2015,11,21,1300,326,221,547,Saturday
2015,11,21,1200,380,171,551,Saturday
2015,11,21,1100,509,136,645,Saturday
2015,11,21,1000,559,115,674,Saturday
2015,11,21,900,951,72,1023,Saturday
2015,11,21,800,348,62,410,Saturday
2015,11,21,700,92,33,125,Saturday
2015,11,21,600,39,29,68,Saturday
2015,11,21,500,20,16,36,Saturday
2015,11,21,400,16,22,38,Saturday
2015,11,21,300,18,27,45,Saturday
2015,11,21,200,28,23,51,Saturday
2015,11,21,100,43,37,80,Saturday
2015,11,20,2400,55,57,112,Friday
2015,11,20,2300,81,48,129,Friday
2015,11,20,2200,101,77,178,Friday
2015,11,20,2100,178,99,277,Friday
2015,11,20,2000,236,128,364,Friday
2015,11,20,1900,212,184,396,Friday
2015,11,20,1800,222,363,585,Friday
2015,11,20,1700,297,488,785,Friday
2015,11,20,1600,290,445,735,Friday
2015,11,20,1500,311,296,607,Friday
2015,11,20,1400,316,248,564,Friday
2015,11,20,1300,346,184,530,Friday
2015,11,20,1200,299,165,464,Friday
2015,11,20,1100,351,164,515,Friday
2015,11,20,1000,447,111,558,Friday
2015,11,20,900,362,91,453,Friday
2015,11,20,800,163,46,209,Friday
2015,11,20,700,73,69,142,Friday
2015,11,20,600,42,11,53,Friday
2015,11,20,500,25,6,31,Friday
2015,11,20,400,21,27,48,Friday
2015,11,20,300,25,40,65,Friday
2015,11,20,200,32,44,76,Friday
2015,11,20,100,50,41,91,Friday
2015,11,19,2400,63,50,113,Thursday
2015,11,19,2300,60,63,123,Thursday
2015,11,19,2200,91,80,171,Thursday
2015,11,19,2100,120,90,210,Thursday
2015,11,19,2000,126,110,236,Thursday
2015,11,19,1900,159,161,320,Thursday
2015,11,19,1800,179,254,433,Thursday
2015,11,19,1700,184,375,559,Thursday
2015,11,19,1600,200,344,544,Thursday
2015,11,19,1500,236,312,548,Thursday
2015,11,19,1400,214,391,605,Thursday
2015,11,19,1300,220,185,405,Thursday
2015,11,19,1200,241,84,325,Thursday
2015,11,19,1100,263,64,327,Thursday
2015,11,19,1000,278,60,338,Thursday
2015,11,19,900,378,80,458,Thursday
2015,11,19,800,178,46,224,Thursday
2015,11,19,700,65,37,102,Thursday
2015,11,19,600,37,41,78,Thursday
2015,11,19,500,16,23,39,Thursday
2015,11,19,400,20,19,39,Thursday
2015,11,19,300,22,22,44,Thursday
2015,11,19,200,25,33,58,Thursday
2015,11,19,100,39,51,90,Thursday
2015,11,18,2400,55,45,100,Wednesday
2015,11,18,2300,55,66,121,Wednesday
2015,11,18,2200,84,71,155,Wednesday
2015,11,18,2100,100,67,167,Wednesday
2015,11,18,2000,128,103,231,Wednesday
2015,11,18,1900,116,157,273,Wednesday
2015,11,18,1800,131,273,404,Wednesday
2015,11,18,1700,149,435,584,Wednesday
2015,11,18,1600,174,475,649,Wednesday
2015,11,18,1500,166,404,570,Wednesday
2015,11,18,1400,161,278,439,Wednesday
2015,11,18,1300,200,285,485,Wednesday
2015,11,18,1200,209,104,313,Wednesday
2015,11,18,1100,207,174,381,Wednesday
2015,11,18,1000,326,123,449,Wednesday
2015,11,18,900,414,91,505,Wednesday
2015,11,18,800,201,66,267,Wednesday
2015,11,18,700,49,31,80,Wednesday
2015,11,18,600,25,60,85,Wednesday
2015,11,18,500,11,121,132,Wednesday
2015,11,18,400,14,123,137,Wednesday
2015,11,18,300,9,58,67,Wednesday
2015,11,18,200,15,32,47,Wednesday
2015,11,18,100,36,17,53,Wednesday
2015,11,17,2400,32,16,48,Tuesday
2015,11,17,2300,31,8,39,Tuesday
2015,11,17,2200,28,10,38,Tuesday
2015,11,17,2100,21,22,43,Tuesday
2015,11,17,2000,51,21,72,Tuesday
2015,11,17,1900,60,49,109,Tuesday
2015,11,17,1800,92,114,206,Tuesday
2015,11,17,1700,109,129,238,Tuesday
2015,11,17,1600,135,126,261,Tuesday
2015,11,17,1500,132,118,250,Tuesday
2015,11,17,1400,142,111,253,Tuesday
2015,11,17,1300,158,119,277,Tuesday
2015,11,17,1200,177,95,272,Tuesday
2015,11,17,1100,208,127,335,Tuesday
2015,11,17,1000,190,110,300,Tuesday
2015,11,17,900,201,64,265,Tuesday
2015,11,17,800,139,102,241,Tuesday
2015,11,17,700,52,70,122,Tuesday
2015,11,17,600,30,9,39,Tuesday
2015,11,17,500,17,13,30,Tuesday
2015,11,17,400,19,15,34,Tuesday
2015,11,17,300,16,4,20,Tuesday
2015,11,17,200,21,5,26,Tuesday
2015,11,17,100,31,9,40,Tuesday
2015,11,16,2400,43,24,67,Monday
2015,11,16,2300,51,35,86,Monday
2015,11,16,2200,74,82,156,Monday
2015,11,16,2100,109,80,189,Monday
2015,11,16,2000,86,76,162,Monday
2015,11,16,1900,111,171,282,Monday
2015,11,16,1800,148,316,464,Monday
2015,11,16,1700,181,321,502,Monday
2015,11,16,1600,221,355,576,Monday
2015,11,16,1500,220,281,501,Monday
2015,11,16,1400,232,232,464,Monday
2015,11,16,1300,251,212,463,Monday
2015,11,16,1200,314,142,456,Monday
2015,11,16,1100,294,138,432,Monday
2015,11,16,1000,236,97,333,Monday
2015,11,16,900,232,75,307,Monday
2015,11,16,800,130,51,181,Monday
2015,11,16,700,73,28,101,Monday
2015,11,16,600,30,22,52,Monday
2015,11,16,500,14,22,36,Monday
2015,11,16,400,12,19,31,Monday
2015,11,16,300,14,18,32,Monday
2015,11,16,200,17,36,53,Monday
2015,11,16,100,25,104,129,Monday
2015,11,15,2400,35,139,174,Sunday
2015,11,15,2300,36,83,119,Sunday
2015,11,15,2200,61,138,199,Sunday
2015,11,15,2100,69,48,117,Sunday
2015,11,15,2000,90,269,359,Sunday
2015,11,15,1900,110,365,475,Sunday
2015,11,15,1800,145,674,819,Sunday
2015,11,15,1700,188,793,981,Sunday
2015,11,15,1600,250,784,1034,Sunday
2015,11,15,1500,273,784,1057,Sunday
2015,11,15,1400,319,630,949,Sunday
2015,11,15,1300,379,470,849,Sunday
2015,11,15,1200,413,313,726,Sunday
2015,11,15,1100,453,189,642,Sunday
2015,11,15,1000,495,90,585,Sunday
2015,11,15,900,507,54,561,Sunday
2015,11,15,800,220,17,237,Sunday
2015,11,15,700,63,20,83,Sunday
2015,11,15,600,37,10,47,Sunday
2015,11,15,500,21,17,38,Sunday
2015,11,15,400,17,19,36,Sunday
2015,11,15,300,10,26,36,Sunday
2015,11,15,200,20,19,39,Sunday
2015,11,15,100,28,28,56,Sunday
2015,11,14,2400,33,27,60,Saturday
2015,11,14,2300,35,60,95,Saturday
2015,11,14,2200,56,62,118,Saturday
2015,11,14,2100,59,89,148,Saturday
2015,11,14,2000,79,138,217,Saturday
2015,11,14,1900,78,184,262,Saturday
2015,11,14,1800,112,436,548,Saturday
2015,11,14,1700,133,692,825,Saturday
2015,11,14,1600,217,577,794,Saturday
2015,11,14,1500,254,427,681,Saturday
2015,11,14,1400,293,376,669,Saturday
2015,11,14,1300,297,284,581,Saturday
2015,11,14,1200,396,293,689,Saturday
2015,11,14,1100,417,155,572,Saturday
2015,11,14,1000,440,80,520,Saturday
2015,11,14,900,644,48,692,Saturday
2015,11,14,800,277,47,324,Saturday
2015,11,14,700,75,23,98,Saturday
2015,11,14,600,17,14,31,Saturday
2015,11,14,500,16,14,30,Saturday
2015,11,14,400,20,12,32,Saturday
2015,11,14,300,22,12,34,Saturday
2015,11,14,200,22,30,52,Saturday
2015,11,14,100,34,38,72,Saturday
2015,11,13,2400,51,44,95,Friday
2015,11,13,2300,63,58,121,Friday
2015,11,13,2200,87,57,144,Friday
2015,11,13,2100,132,88,220,Friday
2015,11,13,2000,198,143,341,Friday
2015,11,13,1900,224,219,443,Friday
2015,11,13,1800,251,350,601,Friday
2015,11,13,1700,286,445,731,Friday
2015,11,13,1600,284,513,797,Friday
2015,11,13,1500,311,369,680,Friday
2015,11,13,1400,282,212,494,Friday
2015,11,13,1300,285,191,476,Friday
2015,11,13,1200,289,201,490,Friday
2015,11,13,1100,285,124,409,Friday
2015,11,13,1000,321,70,391,Friday
2015,11,13,900,319,60,379,Friday
2015,11,13,800,143,56,199,Friday
2015,11,13,700,68,43,111,Friday
2015,11,13,600,26,59,85,Friday
2015,11,13,500,18,9,27,Friday
2015,11,13,400,27,21,48,Friday
2015,11,13,300,18,34,52,Friday
2015,11,13,200,25,39,64,Friday
2015,11,13,100,41,25,66,Friday
2015,11,12,2400,65,72,137,Thursday
2015,11,12,2300,73,74,147,Thursday
2015,11,12,2200,98,79,177,Thursday
2015,11,12,2100,121,60,181,Thursday
2015,11,12,2000,145,104,249,Thursday
2015,11,12,1900,138,158,296,Thursday
2015,11,12,1800,177,260,437,Thursday
2015,11,12,1700,240,394,634,Thursday
2015,11,12,1600,272,400,672,Thursday
2015,11,12,1500,265,326,591,Thursday
2015,11,12,1400,263,306,569,Thursday
2015,11,12,1300,305,234,539,Thursday
2015,11,12,1200,362,219,581,Thursday
2015,11,12,1100,361,163,524,Thursday
2015,11,12,1000,321,128,449,Thursday
2015,11,12,900,251,73,324,Thursday
2015,11,12,800,128,35,163,Thursday
2015,11,12,700,66,25,91,Thursday
2015,11,12,600,29,29,58,Thursday
2015,11,12,500,16,19,35,Thursday
2015,11,12,400,15,19,34,Thursday
2015,11,12,300,14,71,85,Thursday
2015,11,12,200,18,140,158,Thursday
2015,11,12,100,27,42,69,Thursday
2015,11,11,2400,32,49,81,Wednesday
2015,11,11,2300,39,41,80,Wednesday
2015,11,11,2200,49,35,84,Wednesday
2015,11,11,2100,69,40,109,Wednesday
2015,11,11,2000,91,160,251,Wednesday
2015,11,11,1900,98,535,633,Wednesday
2015,11,11,1800,145,562,707,Wednesday
2015,11,11,1700,185,485,670,Wednesday
2015,11,11,1600,244,466,710,Wednesday
2015,11,11,1500,307,361,668,Wednesday
2015,11,11,1400,391,268,659,Wednesday
2015,11,11,1300,416,258,674,Wednesday
2015,11,11,1200,469,197,666,Wednesday
2015,11,11,1100,491,147,638,Wednesday
2015,11,11,1000,526,102,628,Wednesday
2015,11,11,900,440,77,517,Wednesday
2015,11,11,800,161,39,200,Wednesday
2015,11,11,700,77,23,100,Wednesday
2015,11,11,600,35,33,68,Wednesday
2015,11,11,500,22,22,44,Wednesday
2015,11,11,400,21,27,48,Wednesday
2015,11,11,300,32,19,51,Wednesday
2015,11,11,200,38,36,74,Wednesday
2015,11,11,100,38,61,99,Wednesday
2015,11,10,2400,47,47,94,Tuesday
2015,11,10,2300,65,58,123,Tuesday
2015,11,10,2200,81,92,173,Tuesday
2015,11,10,2100,129,118,247,Tuesday
2015,11,10,2000,151,146,297,Tuesday
2015,11,10,1900,169,240,409,Tuesday
2015,11,10,1800,188,312,500,Tuesday
2015,11,10,1700,220,337,557,Tuesday
2015,11,10,1600,224,393,617,Tuesday
2015,11,10,1500,215,294,509,Tuesday
2015,11,10,1400,294,247,541,Tuesday
2015,11,10,1300,255,244,499,Tuesday
2015,11,10,1200,339,203,542,Tuesday
2015,11,10,1100,295,159,454,Tuesday
2015,11,10,1000,260,152,412,Tuesday
2015,11,10,900,202,77,279,Tuesday
2015,11,10,800,96,54,150,Tuesday
2015,11,10,700,68,40,108,Tuesday
2015,11,10,600,26,37,63,Tuesday
2015,11,10,500,16,41,57,Tuesday
2015,11,10,400,18,40,58,Tuesday
2015,11,10,300,30,33,63,Tuesday
2015,11,10,200,26,40,66,Tuesday
2015,11,10,100,33,47,80,Tuesday
2015,11,9,2400,37,45,82,Monday
2015,11,9,2300,51,58,109,Monday
2015,11,9,2200,71,91,162,Monday
2015,11,9,2100,80,127,207,Monday
2015,11,9,2000,100,135,235,Monday
2015,11,9,1900,122,248,370,Monday
2015,11,9,1800,140,305,445,Monday
2015,11,9,1700,196,259,455,Monday
2015,11,9,1600,226,299,525,Monday
2015,11,9,1500,220,307,527,Monday
2015,11,9,1400,274,233,507,Monday
2015,11,9,1300,308,203,511,Monday
2015,11,9,1200,336,153,489,Monday
2015,11,9,1100,363,121,484,Monday
2015,11,9,1000,305,107,412,Monday
2015,11,9,900,189,63,252,Monday
2015,11,9,800,121,39,160,Monday
2015,11,9,700,76,36,112,Monday
2015,11,9,600,30,24,54,Monday
2015,11,9,500,18,9,27,Monday
2015,11,9,400,17,28,45,Monday
2015,11,9,300,15,17,32,Monday
2015,11,9,200,21,28,49,Monday
2015,11,9,100,28,52,80,Monday
2015,11,8,2400,34,60,94,Sunday
2015,11,8,2300,38,68,106,Sunday
2015,11,8,2200,54,75,129,Sunday
2015,11,8,2100,79,150,229,Sunday
2015,11,8,2000,88,190,278,Sunday
2015,11,8,1900,123,322,445,Sunday
2015,11,8,1800,148,461,609,Sunday
2015,11,8,1700,205,569,774,Sunday
2015,11,8,1600,280,602,882,Sunday
2015,11,8,1500,312,643,955,Sunday
2015,11,8,1400,299,637,936,Sunday
2015,11,8,1300,379,437,816,Sunday
2015,11,8,1200,394,306,700,Sunday
2015,11,8,1100,388,177,565,Sunday
2015,11,8,1000,318,95,413,Sunday
2015,11,8,900,286,56,342,Sunday
2015,11,8,800,137,31,168,Sunday
2015,11,8,700,64,11,75,Sunday
2015,11,8,600,24,3,27,Sunday
2015,11,8,500,14,8,22,Sunday
2015,11,8,400,9,19,28,Sunday
2015,11,8,300,10,21,31,Sunday
2015,11,8,200,19,27,46,Sunday
2015,11,8,100,27,29,56,Sunday
2015,11,7,2400,27,35,62,Saturday
2015,11,7,2300,31,59,90,Saturday
2015,11,7,2200,60,77,137,Saturday
2015,11,7,2100,67,59,126,Saturday
2015,11,7,2000,99,106,205,Saturday
2015,11,7,1900,96,354,450,Saturday
2015,11,7,1800,142,488,630,Saturday
2015,11,7,1700,187,360,547,Saturday
2015,11,7,1600,240,383,623,Saturday
2015,11,7,1500,272,369,641,Saturday
2015,11,7,1400,340,334,674,Saturday
2015,11,7,1300,437,268,705,Saturday
2015,11,7,1200,510,200,710,Saturday
2015,11,7,1100,437,160,597,Saturday
2015,11,7,1000,435,104,539,Saturday
2015,11,7,900,327,63,390,Saturday
2015,11,7,800,152,46,198,Saturday
2015,11,7,700,78,35,113,Saturday
2015,11,7,600,46,24,70,Saturday
2015,11,7,500,17,17,34,Saturday
2015,11,7,400,20,33,53,Saturday
2015,11,7,300,21,33,54,Saturday
2015,11,7,200,23,24,47,Saturday
2015,11,7,100,38,38,76,Saturday
2015,11,6,2400,61,59,120,Friday
2015,11,6,2300,62,64,126,Friday
2015,11,6,2200,102,81,183,Friday
2015,11,6,2100,179,105,284,Friday
2015,11,6,2000,275,160,435,Friday
2015,11,6,1900,312,249,561,Friday
2015,11,6,1800,331,310,641,Friday
2015,11,6,1700,360,406,766,Friday
2015,11,6,1600,362,463,825,Friday
2015,11,6,1500,385,375,760,Friday
2015,11,6,1400,383,303,686,Friday
2015,11,6,1300,374,225,599,Friday
2015,11,6,1200,366,218,584,Friday
2015,11,6,1100,353,144,497,Friday
2015,11,6,1000,360,112,472,Friday
2015,11,6,900,329,98,427,Friday
2015,11,6,800,143,71,214,Friday
2015,11,6,700,79,44,123,Friday
2015,11,6,600,44,33,77,Friday
2015,11,6,500,16,28,44,Friday
2015,11,6,400,24,34,58,Friday
2015,11,6,300,24,32,56,Friday
2015,11,6,200,32,21,53,Friday
2015,11,6,100,26,60,86,Friday
2015,11,5,2400,63,68,131,Thursday
2015,11,5,2300,65,61,126,Thursday
2015,11,5,2200,186,77,263,Thursday
2015,11,5,2100,58,83,141,Thursday
2015,11,5,2000,120,143,263,Thursday
2015,11,5,1900,117,209,326,Thursday
2015,11,5,1800,172,246,418,Thursday
2015,11,5,1700,199,259,458,Thursday
2015,11,5,1600,250,270,520,Thursday
2015,11,5,1500,239,361,600,Thursday
2015,11,5,1400,263,248,511,Thursday
2015,11,5,1300,235,222,457,Thursday
2015,11,5,1200,272,166,438,Thursday
2015,11,5,1100,230,144,374,Thursday
2015,11,5,1000,216,106,322,Thursday
2015,11,5,900,154,84,238,Thursday
2015,11,5,800,124,60,184,Thursday
2015,11,5,700,72,51,123,Thursday
2015,11,5,600,32,23,55,Thursday
2015,11,5,500,16,22,38,Thursday
2015,11,5,400,28,24,52,Thursday
2015,11,5,300,28,38,66,Thursday
2015,11,5,200,23,36,59,Thursday
2015,11,5,100,35,46,81,Thursday
2015,11,4,2400,63,55,118,Wednesday
2015,11,4,2300,62,65,127,Wednesday
2015,11,4,2200,84,90,174,Wednesday
2015,11,4,2100,100,89,189,Wednesday
2015,11,4,2000,112,119,231,Wednesday
2015,11,4,1900,110,225,335,Wednesday
2015,11,4,1800,148,213,361,Wednesday
2015,11,4,1700,194,256,450,Wednesday
2015,11,4,1600,198,238,436,Wednesday
2015,11,4,1500,186,235,421,Wednesday
2015,11,4,1400,205,187,392,Wednesday
2015,11,4,1300,223,163,386,Wednesday
2015,11,4,1200,232,168,400,Wednesday
2015,11,4,1100,216,101,317,Wednesday
2015,11,4,1000,186,121,307,Wednesday
2015,11,4,900,150,86,236,Wednesday
2015,11,4,800,115,72,187,Wednesday
2015,11,4,700,64,34,98,Wednesday
2015,11,4,600,27,34,61,Wednesday
2015,11,4,500,24,16,40,Wednesday
2015,11,4,400,31,34,65,Wednesday
2015,11,4,300,19,36,55,Wednesday
2015,11,4,200,21,35,56,Wednesday
2015,11,4,100,39,42,81,Wednesday
2015,11,3,2400,60,41,101,Tuesday
2015,11,3,2300,57,65,122,Tuesday
2015,11,3,2200,73,79,152,Tuesday
2015,11,3,2100,90,117,207,Tuesday
2015,11,3,2000,96,122,218,Tuesday
2015,11,3,1900,99,190,289,Tuesday
2015,11,3,1800,131,274,405,Tuesday
2015,11,3,1700,159,300,459,Tuesday
2015,11,3,1600,193,220,413,Tuesday
2015,11,3,1500,201,236,437,Tuesday
2015,11,3,1400,224,203,427,Tuesday
2015,11,3,1300,237,188,425,Tuesday
2015,11,3,1200,236,150,386,Tuesday
2015,11,3,1100,233,139,372,Tuesday
2015,11,3,1000,193,111,304,Tuesday
2015,11,3,900,163,94,257,Tuesday
2015,11,3,800,117,59,176,Tuesday
2015,11,3,700,76,48,124,Tuesday
2015,11,3,600,29,26,55,Tuesday
2015,11,3,500,21,26,47,Tuesday
2015,11,3,400,25,20,45,Tuesday
2015,11,3,300,20,30,50,Tuesday
2015,11,3,200,26,43,69,Tuesday
2015,11,3,100,41,40,81,Tuesday
2015,11,2,2400,43,48,91,Monday
2015,11,2,2300,47,75,122,Monday
2015,11,2,2200,62,89,151,Monday
2015,11,2,2100,75,110,185,Monday
2015,11,2,2000,98,122,220,Monday
2015,11,2,1900,97,238,335,Monday
2015,11,2,1800,146,260,406,Monday
2015,11,2,1700,194,288,482,Monday
2015,11,2,1600,259,259,518,Monday
2015,11,2,1500,265,272,537,Monday
2015,11,2,1400,263,202,465,Monday
2015,11,2,1300,299,227,526,Monday
2015,11,2,1200,312,133,445,Monday
2015,11,2,1100,237,141,378,Monday
2015,11,2,1000,191,107,298,Monday
2015,11,2,900,150,70,220,Monday
2015,11,2,800,107,57,164,Monday
2015,11,2,700,71,16,87,Monday
2015,11,2,600,25,21,46,Monday
2015,11,2,500,13,16,29,Monday
2015,11,2,400,10,19,29,Monday
2015,11,2,300,20,17,37,Monday
2015,11,2,200,5,27,32,Monday
2015,11,2,100,20,37,57,Monday
2015,11,1,2400,22,69,91,Sunday
2015,11,1,2300,37,79,116,Sunday
2015,11,1,2200,60,110,170,Sunday
2015,11,1,2100,77,146,223,Sunday
2015,11,1,2000,92,234,326,Sunday
2015,11,1,1900,145,257,402,Sunday
2015,11,1,1800,130,403,533,Sunday
2015,11,1,1700,188,444,632,Sunday
2015,11,1,1600,255,440,695,Sunday
2015,11,1,1500,293,382,675,Sunday
2015,11,1,1400,313,343,656,Sunday
2015,11,1,1300,336,443,779,Sunday
2015,11,1,1200,314,149,463,Sunday
2015,11,1,1100,283,155,438,Sunday
2015,11,1,1000,227,104,331,Sunday
2015,11,1,900,159,68,227,Sunday
2015,11,1,800,110,36,146,Sunday
2015,11,1,700,58,14,72,Sunday
2015,11,1,600,24,9,33,Sunday
2015,11,1,500,7,10,17,Sunday
2015,11,1,400,19,12,31,Sunday
2015,11,1,300,12,20,32,Sunday
2015,11,1,200,13,15,28,Sunday
2015,11,1,100,20,37,57,Sunday
2015,10,31,2400,34,38,72,Saturday
2015,10,31,2300,44,58,102,Saturday
2015,10,31,2200,43,70,113,Saturday
2015,10,31,2100,62,103,165,Saturday
2015,10,31,2000,83,150,233,Saturday
2015,10,31,1900,100,157,257,Saturday
2015,10,31,1800,132,275,407,Saturday
2015,10,31,1700,172,356,528,Saturday
2015,10,31,1600,197,318,515,Saturday
2015,10,31,1500,239,370,609,Saturday
2015,10,31,1400,291,311,602,Saturday
2015,10,31,1300,310,241,551,Saturday
2015,10,31,1200,335,172,507,Saturday
2015,10,31,1100,305,144,449,Saturday
2015,10,31,1000,218,112,330,Saturday
2015,10,31,900,172,66,238,Saturday
2015,10,31,800,147,53,200,Saturday
2015,10,31,700,59,33,92,Saturday
2015,10,31,600,32,26,58,Saturday
2015,10,31,500,17,30,47,Saturday
2015,10,31,400,21,29,50,Saturday
2015,10,31,300,31,34,65,Saturday
2015,10,31,200,26,54,80,Saturday
2015,10,31,100,36,93,129,Saturday
2015,10,30,2400,59,51,110,Friday
2015,10,30,2300,53,63,116,Friday
2015,10,30,2200,117,55,172,Friday
2015,10,30,2100,157,90,247,Friday
2015,10,30,2000,204,192,396,Friday
2015,10,30,1900,262,298,560,Friday
2015,10,30,1800,314,348,662,Friday
2015,10,30,1700,339,292,631,Friday
2015,10,30,1600,316,304,620,Friday
2015,10,30,1500,302,323,625,Friday
2015,10,30,1400,287,263,550,Friday
2015,10,30,1300,284,243,527,Friday
2015,10,30,1200,312,199,511,Friday
2015,10,30,1100,317,181,498,Friday
2015,10,30,1000,227,97,324,Friday
2015,10,30,900,189,99,288,Friday
2015,10,30,800,149,72,221,Friday
2015,10,30,700,92,38,130,Friday
2015,10,30,600,45,40,85,Friday
2015,10,30,500,23,30,53,Friday
2015,10,30,400,31,31,62,Friday
2015,10,30,300,21,36,57,Friday
2015,10,30,200,31,52,83,Friday
2015,10,30,100,37,55,92,Friday
2015,10,29,2400,69,66,135,Thursday
2015,10,29,2300,85,74,159,Thursday
2015,10,29,2200,104,107,211,Thursday
2015,10,29,2100,179,126,305,Thursday
2015,10,29,2000,180,196,376,Thursday
2015,10,29,1900,228,249,477,Thursday
2015,10,29,1800,234,284,518,Thursday
2015,10,29,1700,246,251,497,Thursday
2015,10,29,1600,276,366,642,Thursday
2015,10,29,1500,254,228,482,Thursday
2015,10,29,1400,269,259,528,Thursday
2015,10,29,1300,250,204,454,Thursday
2015,10,29,1200,270,144,414,Thursday
2015,10,29,1100,257,150,407,Thursday
2015,10,29,1000,210,97,307,Thursday
2015,10,29,900,180,94,274,Thursday
2015,10,29,800,113,66,179,Thursday
2015,10,29,700,77,51,128,Thursday
2015,10,29,600,37,34,71,Thursday
2015,10,29,500,27,30,57,Thursday
2015,10,29,400,33,41,74,Thursday
2015,10,29,300,35,31,66,Thursday
2015,10,29,200,21,42,63,Thursday
2015,10,29,100,49,43,92,Thursday
2015,10,28,2400,49,63,112,Wednesday
2015,10,28,2300,60,69,129,Wednesday
2015,10,28,2200,87,89,176,Wednesday
2015,10,28,2100,130,114,244,Wednesday
2015,10,28,2000,137,168,305,Wednesday
2015,10,28,1900,159,217,376,Wednesday
2015,10,28,1800,160,319,479,Wednesday
2015,10,28,1700,210,312,522,Wednesday
2015,10,28,1600,243,273,516,Wednesday
2015,10,28,1500,235,291,526,Wednesday
2015,10,28,1400,274,219,493,Wednesday
2015,10,28,1300,229,198,427,Wednesday
2015,10,28,1200,277,178,455,Wednesday
2015,10,28,1100,261,146,407,Wednesday
2015,10,28,1000,184,133,317,Wednesday
2015,10,28,900,122,80,202,Wednesday
2015,10,28,800,98,86,184,Wednesday
2015,10,28,700,57,45,102,Wednesday
2015,10,28,600,28,34,62,Wednesday
2015,10,28,500,12,26,38,Wednesday
2015,10,28,400,31,39,70,Wednesday
2015,10,28,300,21,34,55,Wednesday
2015,10,28,200,23,50,73,Wednesday
2015,10,28,100,39,58,97,Wednesday
2015,10,27,2400,55,58,113,Tuesday
2015,10,27,2300,64,72,136,Tuesday
2015,10,27,2200,73,86,159,Tuesday
2015,10,27,2100,105,106,211,Tuesday
2015,10,27,2000,118,154,272,Tuesday
2015,10,27,1900,119,240,359,Tuesday
2015,10,27,1800,136,275,411,Tuesday
2015,10,27,1700,202,307,509,Tuesday
2015,10,27,1600,224,278,502,Tuesday
2015,10,27,1500,223,253,476,Tuesday
2015,10,27,1400,243,215,458,Tuesday
2015,10,27,1300,235,193,428,Tuesday
2015,10,27,1200,260,176,436,Tuesday
2015,10,27,1100,272,143,415,Tuesday
2015,10,27,1000,196,124,320,Tuesday
2015,10,27,900,148,96,244,Tuesday
2015,10,27,800,113,95,208,Tuesday
2015,10,27,700,72,40,112,Tuesday
2015,10,27,600,45,43,88,Tuesday
2015,10,27,500,16,22,38,Tuesday
2015,10,27,400,24,38,62,Tuesday
2015,10,27,300,20,30,50,Tuesday
2015,10,27,200,16,62,78,Tuesday
2015,10,27,100,44,39,83,Tuesday
2015,10,26,2400,44,66,110,Monday
2015,10,26,2300,60,74,134,Monday
2015,10,26,2200,83,109,192,Monday
2015,10,26,2100,105,124,229,Monday
2015,10,26,2000,115,214,329,Monday
2015,10,26,1900,136,218,354,Monday
2015,10,26,1800,156,315,471,Monday
2015,10,26,1700,197,357,554,Monday
2015,10,26,1600,249,341,590,Monday
2015,10,26,1500,301,304,605,Monday
2015,10,26,1400,283,294,577,Monday
2015,10,26,1300,323,227,550,Monday
2015,10,26,1200,330,208,538,Monday
2015,10,26,1100,319,150,469,Monday
2015,10,26,1000,232,84,316,Monday
2015,10,26,900,180,76,256,Monday
2015,10,26,800,96,62,158,Monday
2015,10,26,700,71,41,112,Monday
2015,10,26,600,33,31,64,Monday
2015,10,26,500,25,22,47,Monday
2015,10,26,400,15,16,31,Monday
2015,10,26,300,18,32,50,Monday
2015,10,26,200,14,22,36,Monday
2015,10,26,100,18,76,94,Monday
2015,10,25,2400,22,71,93,Sunday
2015,10,25,2300,51,100,151,Sunday
2015,10,25,2200,72,130,202,Sunday
2015,10,25,2100,98,244,342,Sunday
2015,10,25,2000,118,376,494,Sunday
2015,10,25,1900,160,627,787,Sunday
2015,10,25,1800,183,647,830,Sunday
2015,10,25,1700,254,733,987,Sunday
2015,10,25,1600,303,667,970,Sunday
2015,10,25,1500,346,645,991,Sunday
2015,10,25,1400,362,562,924,Sunday
2015,10,25,1300,444,461,905,Sunday
2015,10,25,1200,455,329,784,Sunday
2015,10,25,1100,363,241,604,Sunday
2015,10,25,1000,275,144,419,Sunday
2015,10,25,900,163,78,241,Sunday
2015,10,25,800,94,28,122,Sunday
2015,10,25,700,54,14,68,Sunday
2015,10,25,600,29,17,46,Sunday
2015,10,25,500,19,14,33,Sunday
2015,10,25,400,18,23,41,Sunday
2015,10,25,300,25,20,45,Sunday
2015,10,25,200,26,32,58,Sunday
2015,10,25,100,30,34,64,Sunday
2015,10,24,2400,32,50,82,Saturday
2015,10,24,2300,54,80,134,Saturday
2015,10,24,2200,62,83,145,Saturday
2015,10,24,2100,73,137,210,Saturday
2015,10,24,2000,110,244,354,Saturday
2015,10,24,1900,159,353,512,Saturday
2015,10,24,1800,181,507,688,Saturday
2015,10,24,1700,241,407,648,Saturday
2015,10,24,1600,289,444,733,Saturday
2015,10,24,1500,353,402,755,Saturday
2015,10,24,1400,420,323,743,Saturday
2015,10,24,1300,503,294,797,Saturday
2015,10,24,1200,477,220,697,Saturday
2015,10,24,1100,465,171,636,Saturday
2015,10,24,1000,326,118,444,Saturday
2015,10,24,900,227,86,313,Saturday
2015,10,24,800,128,60,188,Saturday
2015,10,24,700,70,41,111,Saturday
2015,10,24,600,35,17,52,Saturday
2015,10,24,500,19,29,48,Saturday
2015,10,24,400,25,28,53,Saturday
2015,10,24,300,21,28,49,Saturday
2015,10,24,200,38,31,69,Saturday
2015,10,24,100,38,35,73,Saturday
2015,10,23,2400,67,84,151,Friday
2015,10,23,2300,82,86,168,Friday
2015,10,23,2200,121,104,225,Friday
2015,10,23,2100,207,130,337,Friday
2015,10,23,2000,287,190,477,Friday
2015,10,23,1900,345,304,649,Friday
2015,10,23,1800,381,321,702,Friday
2015,10,23,1700,397,456,853,Friday
2015,10,23,1600,460,457,917,Friday
2015,10,23,1500,413,327,740,Friday
2015,10,23,1400,448,295,743,Friday
2015,10,23,1300,441,270,711,Friday
2015,10,23,1200,411,210,621,Friday
2015,10,23,1100,424,195,619,Friday
2015,10,23,1000,307,136,443,Friday
2015,10,23,900,198,100,298,Friday
2015,10,23,800,139,74,213,Friday
2015,10,23,700,101,44,145,Friday
2015,10,23,600,48,48,96,Friday
2015,10,23,500,30,31,61,Friday
2015,10,23,400,30,30,60,Friday
2015,10,23,300,29,30,59,Friday
2015,10,23,200,41,46,87,Friday
2015,10,23,100,44,76,120,Friday
2015,10,22,2400,71,75,146,Thursday
2015,10,22,2300,78,73,151,Thursday
2015,10,22,2200,113,127,240,Thursday
2015,10,22,2100,165,168,333,Thursday
2015,10,22,2000,208,198,406,Thursday
2015,10,22,1900,190,288,478,Thursday
2015,10,22,1800,242,314,556,Thursday
2015,10,22,1700,288,380,668,Thursday
2015,10,22,1600,316,305,621,Thursday
2015,10,22,1500,324,256,580,Thursday
2015,10,22,1400,284,241,525,Thursday
2015,10,22,1300,303,240,543,Thursday
2015,10,22,1200,382,226,608,Thursday
2015,10,22,1100,332,122,454,Thursday
2015,10,22,1000,253,108,361,Thursday
2015,10,22,900,199,89,288,Thursday
2015,10,22,800,125,72,197,Thursday
2015,10,22,700,88,40,128,Thursday
2015,10,22,600,46,33,79,Thursday
2015,10,22,500,28,36,64,Thursday
2015,10,22,400,26,40,66,Thursday
2015,10,22,300,18,51,69,Thursday
2015,10,22,200,27,32,59,Thursday
2015,10,22,100,47,61,108,Thursday
2015,10,21,2400,67,55,122,Wednesday
2015,10,21,2300,89,86,175,Wednesday
2015,10,21,2200,108,113,221,Wednesday
2015,10,21,2100,123,111,234,Wednesday
2015,10,21,2000,161,233,394,Wednesday
2015,10,21,1900,175,245,420,Wednesday
2015,10,21,1800,175,313,488,Wednesday
2015,10,21,1700,219,363,582,Wednesday
2015,10,21,1600,267,314,581,Wednesday
2015,10,21,1500,269,269,538,Wednesday
2015,10,21,1400,256,268,524,Wednesday
2015,10,21,1300,302,230,532,Wednesday
2015,10,21,1200,307,186,493,Wednesday
2015,10,21,1100,344,124,468,Wednesday
2015,10,21,1000,253,144,397,Wednesday
2015,10,21,900,171,91,262,Wednesday
2015,10,21,800,112,77,189,Wednesday
2015,10,21,700,81,40,121,Wednesday
2015,10,21,600,26,36,62,Wednesday
2015,10,21,500,23,33,56,Wednesday
2015,10,21,400,22,33,55,Wednesday
2015,10,21,300,22,35,57,Wednesday
2015,10,21,200,28,36,64,Wednesday
2015,10,21,100,39,48,87,Wednesday
2015,10,20,2400,49,54,103,Tuesday
2015,10,20,2300,63,73,136,Tuesday
2015,10,20,2200,68,101,169,Tuesday
2015,10,20,2100,109,126,235,Tuesday
2015,10,20,2000,148,164,312,Tuesday
2015,10,20,1900,129,283,412,Tuesday
2015,10,20,1800,162,309,471,Tuesday
2015,10,20,1700,208,316,524,Tuesday
2015,10,20,1600,237,307,544,Tuesday
2015,10,20,1500,247,255,502,Tuesday
2015,10,20,1400,295,272,567,Tuesday
2015,10,20,1300,271,191,462,Tuesday
2015,10,20,1200,300,183,483,Tuesday
2015,10,20,1100,317,166,483,Tuesday
2015,10,20,1000,248,104,352,Tuesday
2015,10,20,900,169,79,248,Tuesday
2015,10,20,800,115,75,190,Tuesday
2015,10,20,700,71,42,113,Tuesday
2015,10,20,600,36,44,80,Tuesday
2015,10,20,500,16,26,42,Tuesday
2015,10,20,400,23,28,51,Tuesday
2015,10,20,300,28,38,66,Tuesday
2015,10,20,200,19,35,54,Tuesday
2015,10,20,100,48,53,101,Tuesday
2015,10,19,2400,47,49,96,Monday
2015,10,19,2300,61,86,147,Monday
2015,10,19,2200,81,116,197,Monday
2015,10,19,2100,84,123,207,Monday
2015,10,19,2000,115,173,288,Monday
2015,10,19,1900,151,311,462,Monday
2015,10,19,1800,161,380,541,Monday
2015,10,19,1700,209,362,571,Monday
2015,10,19,1600,254,359,613,Monday
2015,10,19,1500,292,333,625,Monday
2015,10,19,1400,286,274,560,Monday
2015,10,19,1300,354,262,616,Monday
2015,10,19,1200,378,237,615,Monday
2015,10,19,1100,356,140,496,Monday
2015,10,19,1000,298,123,421,Monday
2015,10,19,900,194,83,277,Monday
2015,10,19,800,132,48,180,Monday
2015,10,19,700,89,39,128,Monday
2015,10,19,600,31,23,54,Monday
2015,10,19,500,27,26,53,Monday
2015,10,19,400,17,18,35,Monday
2015,10,19,300,19,22,41,Monday
2015,10,19,200,16,36,52,Monday
2015,10,19,100,15,59,74,Monday
2015,10,18,2400,39,76,115,Sunday
2015,10,18,2300,48,112,160,Sunday
2015,10,18,2200,85,164,249,Sunday
2015,10,18,2100,101,221,322,Sunday
2015,10,18,2000,140,416,556,Sunday
2015,10,18,1900,152,594,746,Sunday
2015,10,18,1800,223,704,927,Sunday
2015,10,18,1700,246,772,1018,Sunday
2015,10,18,1600,331,775,1106,Sunday
2015,10,18,1500,373,685,1058,Sunday
2015,10,18,1400,436,570,1006,Sunday
2015,10,18,1300,473,434,907,Sunday
2015,10,18,1200,473,360,833,Sunday
2015,10,18,1100,440,184,624,Sunday
2015,10,18,1000,266,98,364,Sunday
2015,10,18,900,221,81,302,Sunday
2015,10,18,800,113,39,152,Sunday
2015,10,18,700,63,20,83,Sunday
2015,10,18,600,24,17,41,Sunday
2015,10,18,500,16,16,32,Sunday
2015,10,18,400,15,10,25,Sunday
2015,10,18,300,16,18,34,Sunday
2015,10,18,200,13,27,40,Sunday
2015,10,18,100,24,50,74,Sunday
2015,10,17,2400,24,53,77,Saturday
2015,10,17,2300,42,88,130,Saturday
2015,10,17,2200,78,113,191,Saturday
2015,10,17,2100,91,156,247,Saturday
2015,10,17,2000,122,375,497,Saturday
2015,10,17,1900,162,600,762,Saturday
2015,10,17,1800,182,533,715,Saturday
2015,10,17,1700,280,593,873,Saturday
2015,10,17,1600,306,567,873,Saturday
2015,10,17,1500,406,404,810,Saturday
2015,10,17,1400,488,367,855,Saturday
2015,10,17,1300,572,324,896,Saturday
2015,10,17,1200,660,159,819,Saturday
2015,10,17,1100,619,165,784,Saturday
2015,10,17,1000,478,127,605,Saturday
2015,10,17,900,298,87,385,Saturday
2015,10,17,800,160,61,221,Saturday
2015,10,17,700,84,39,123,Saturday
2015,10,17,600,41,31,72,Saturday
2015,10,17,500,28,29,57,Saturday
2015,10,17,400,27,27,54,Saturday
2015,10,17,300,18,35,53,Saturday
2015,10,17,200,30,44,74,Saturday
2015,10,17,100,52,56,108,Saturday
2015,10,16,2400,69,73,142,Friday
2015,10,16,2300,69,84,153,Friday
2015,10,16,2200,143,115,258,Friday
2015,10,16,2100,205,170,375,Friday
2015,10,16,2000,294,245,539,Friday
2015,10,16,1900,377,431,808,Friday
2015,10,16,1800,388,444,832,Friday
2015,10,16,1700,456,568,1024,Friday
2015,10,16,1600,425,522,947,Friday
2015,10,16,1500,520,348,868,Friday
2015,10,16,1400,389,308,697,Friday
2015,10,16,1300,454,268,722,Friday
2015,10,16,1200,450,251,701,Friday
2015,10,16,1100,466,200,666,Friday
2015,10,16,1000,338,138,476,Friday
2015,10,16,900,224,99,323,Friday
2015,10,16,800,154,75,229,Friday
2015,10,16,700,96,41,137,Friday
2015,10,16,600,43,31,74,Friday
2015,10,16,500,30,32,62,Friday
2015,10,16,400,29,32,61,Friday
2015,10,16,300,32,38,70,Friday
2015,10,16,200,24,55,79,Friday
2015,10,16,100,33,62,95,Friday
2015,10,15,2400,69,79,148,Thursday
2015,10,15,2300,96,102,198,Thursday
2015,10,15,2200,99,129,228,Thursday
2015,10,15,2100,157,173,330,Thursday
2015,10,15,2000,172,318,490,Thursday
2015,10,15,1900,193,363,556,Thursday
2015,10,15,1800,261,398,659,Thursday
2015,10,15,1700,271,468,739,Thursday
2015,10,15,1600,316,419,735,Thursday
2015,10,15,1500,318,303,621,Thursday
2015,10,15,1400,366,281,647,Thursday
2015,10,15,1300,360,234,594,Thursday
2015,10,15,1200,422,262,684,Thursday
2015,10,15,1100,425,96,521,Thursday
2015,10,15,1000,319,138,457,Thursday
2015,10,15,900,242,94,336,Thursday
2015,10,15,800,137,72,209,Thursday
2015,10,15,700,103,47,150,Thursday
2015,10,15,600,44,43,87,Thursday
2015,10,15,500,19,36,55,Thursday
2015,10,15,400,27,41,68,Thursday
2015,10,15,300,28,40,68,Thursday
2015,10,15,200,33,43,76,Thursday
2015,10,15,100,35,57,92,Thursday
2015,10,14,2400,65,67,132,Wednesday
2015,10,14,2300,73,114,187,Wednesday
2015,10,14,2200,102,129,231,Wednesday
2015,10,14,2100,122,167,289,Wednesday
2015,10,14,2000,142,338,480,Wednesday
2015,10,14,1900,165,399,564,Wednesday
2015,10,14,1800,193,342,535,Wednesday
2015,10,14,1700,219,382,601,Wednesday
2015,10,14,1600,233,388,621,Wednesday
2015,10,14,1500,293,348,641,Wednesday
2015,10,14,1400,325,320,645,Wednesday
2015,10,14,1300,377,268,645,Wednesday
2015,10,14,1200,457,229,686,Wednesday
2015,10,14,1100,430,131,561,Wednesday
2015,10,14,1000,308,175,483,Wednesday
2015,10,14,900,207,110,317,Wednesday
2015,10,14,800,142,70,212,Wednesday
2015,10,14,700,96,43,139,Wednesday
2015,10,14,600,35,34,69,Wednesday
2015,10,14,500,18,28,46,Wednesday
2015,10,14,400,26,36,62,Wednesday
2015,10,14,300,26,49,75,Wednesday
2015,10,14,200,30,51,81,Wednesday
2015,10,14,100,47,72,119,Wednesday
2015,10,13,2400,55,101,156,Tuesday
2015,10,13,2300,80,122,202,Tuesday
2015,10,13,2200,96,157,253,Tuesday
2015,10,13,2100,112,218,330,Tuesday
2015,10,13,2000,117,366,483,Tuesday
2015,10,13,1900,164,555,719,Tuesday
2015,10,13,1800,200,607,807,Tuesday
2015,10,13,1700,271,596,867,Tuesday
2015,10,13,1600,304,721,1025,Tuesday
2015,10,13,1500,334,450,784,Tuesday
2015,10,13,1400,365,398,763,Tuesday
2015,10,13,1300,451,324,775,Tuesday
2015,10,13,1200,520,317,837,Tuesday
2015,10,13,1100,519,189,708,Tuesday
2015,10,13,1000,414,133,547,Tuesday
2015,10,13,900,308,89,397,Tuesday
2015,10,13,800,176,63,239,Tuesday
2015,10,13,700,102,50,152,Tuesday
2015,10,13,600,43,43,86,Tuesday
2015,10,13,500,17,24,41,Tuesday
2015,10,13,400,21,34,55,Tuesday
2015,10,13,300,19,34,53,Tuesday
2015,10,13,200,26,53,79,Tuesday
2015,10,13,100,10,88,98,Tuesday
2015,10,12,2400,31,139,170,Monday
2015,10,12,2300,46,227,273,Monday
2015,10,12,2200,69,343,412,Monday
2015,10,12,2100,92,563,655,Monday
2015,10,12,2000,119,848,967,Monday
2015,10,12,1900,155,1313,1468,Monday
2015,10,12,1800,231,1628,1859,Monday
2015,10,12,1700,297,1739,2036,Monday
2015,10,12,1600,439,1663,2102,Monday
2015,10,12,1500,540,1714,2254,Monday
2015,10,12,1400,653,1548,2201,Monday
2015,10,12,1300,814,1147,1961,Monday
2015,10,12,1200,956,741,1697,Monday
2015,10,12,1100,808,396,1204,Monday
2015,10,12,1000,607,198,805,Monday
2015,10,12,900,364,112,476,Monday
2015,10,12,800,179,49,228,Monday
2015,10,12,700,85,25,110,Monday
2015,10,12,600,35,13,48,Monday
2015,10,12,500,18,15,33,Monday
2015,10,12,400,18,17,35,Monday
2015,10,12,300,17,17,34,Monday
2015,10,12,200,23,33,56,Monday
2015,10,12,100,18,54,72,Monday
2015,10,11,2400,35,81,116,Sunday
2015,10,11,2300,54,85,139,Sunday
2015,10,11,2200,84,164,248,Sunday
2015,10,11,2100,86,282,368,Sunday
2015,10,11,2000,100,495,595,Sunday
2015,10,11,1900,163,711,874,Sunday
2015,10,11,1800,226,881,1107,Sunday
2015,10,11,1700,293,830,1123,Sunday
2015,10,11,1600,397,767,1164,Sunday
2015,10,11,1500,502,721,1223,Sunday
2015,10,11,1400,591,545,1136,Sunday
2015,10,11,1300,714,414,1128,Sunday
2015,10,11,1200,776,358,1134,Sunday
2015,10,11,1100,706,212,918,Sunday
2015,10,11,1000,477,119,596,Sunday
2015,10,11,900,268,61,329,Sunday
2015,10,11,800,127,39,166,Sunday
2015,10,11,700,61,24,85,Sunday
2015,10,11,600,24,10,34,Sunday
2015,10,11,500,24,26,50,Sunday
2015,10,11,400,18,23,41,Sunday
2015,10,11,300,14,18,32,Sunday
2015,10,11,200,20,23,43,Sunday
2015,10,11,100,20,50,70,Sunday
2015,10,10,2400,36,50,86,Saturday
2015,10,10,2300,51,62,113,Saturday
2015,10,10,2200,100,96,196,Saturday
2015,10,10,2100,151,186,337,Saturday
2015,10,10,2000,165,309,474,Saturday
2015,10,10,1900,225,514,739,Saturday
2015,10,10,1800,277,626,903,Saturday
2015,10,10,1700,356,792,1148,Saturday
2015,10,10,1600,525,736,1261,Saturday
2015,10,10,1500,672,662,1334,Saturday
2015,10,10,1400,789,553,1342,Saturday
2015,10,10,1300,937,399,1336,Saturday
2015,10,10,1200,1004,353,1357,Saturday
2015,10,10,1100,962,244,1206,Saturday
2015,10,10,1000,728,169,897,Saturday
2015,10,10,900,549,111,660,Saturday
2015,10,10,800,276,66,342,Saturday
2015,10,10,700,143,46,189,Saturday
2015,10,10,600,55,37,92,Saturday
2015,10,10,500,36,36,72,Saturday
2015,10,10,400,31,30,61,Saturday
2015,10,10,300,42,43,85,Saturday
2015,10,10,200,47,56,103,Saturday
2015,10,10,100,59,60,119,Saturday
2015,10,9,2400,93,107,200,Friday
2015,10,9,2300,161,151,312,Friday
2015,10,9,2200,286,182,468,Friday
2015,10,9,2100,426,253,679,Friday
2015,10,9,2000,723,373,1096,Friday
2015,10,9,1900,945,529,1474,Friday
2015,10,9,1800,1062,744,1806,Friday
2015,10,9,1700,1068,724,1792,Friday
2015,10,9,1600,988,901,1889,Friday
2015,10,9,1500,1042,515,1557,Friday
2015,10,9,1400,876,458,1334,Friday
2015,10,9,1300,902,400,1302,Friday
2015,10,9,1200,906,320,1226,Friday
2015,10,9,1100,940,241,1181,Friday
2015,10,9,1000,748,161,909,Friday
2015,10,9,900,546,112,658,Friday
2015,10,9,800,293,78,371,Friday
2015,10,9,700,156,52,208,Friday
2015,10,9,600,70,31,101,Friday
2015,10,9,500,41,43,84,Friday
2015,10,9,400,39,42,81,Friday
2015,10,9,300,39,55,94,Friday
2015,10,9,200,40,71,111,Friday
2015,10,9,100,54,63,117,Friday
2015,10,8,2400,69,84,153,Thursday
2015,10,8,2300,132,152,284,Thursday
2015,10,8,2200,204,155,359,Thursday
2015,10,8,2100,297,212,509,Thursday
2015,10,8,2000,396,332,728,Thursday
2015,10,8,1900,436,396,832,Thursday
2015,10,8,1800,470,448,918,Thursday
2015,10,8,1700,494,526,1020,Thursday
2015,10,8,1600,462,471,933,Thursday
2015,10,8,1500,498,441,939,Thursday
2015,10,8,1400,450,421,871,Thursday
2015,10,8,1300,511,310,821,Thursday
2015,10,8,1200,506,236,742,Thursday
2015,10,8,1100,552,133,685,Thursday
2015,10,8,1000,470,144,614,Thursday
2015,10,8,900,325,110,435,Thursday
2015,10,8,800,203,80,283,Thursday
2015,10,8,700,112,47,159,Thursday
2015,10,8,600,42,37,79,Thursday
2015,10,8,500,37,30,67,Thursday
2015,10,8,400,31,26,57,Thursday
2015,10,8,300,27,58,85,Thursday
2015,10,8,200,37,60,97,Thursday
2015,10,8,100,40,61,101,Thursday
2015,10,7,2400,67,74,141,Wednesday
2015,10,7,2300,82,105,187,Wednesday
2015,10,7,2200,123,154,277,Wednesday
2015,10,7,2100,163,166,329,Wednesday
2015,10,7,2000,175,252,427,Wednesday
2015,10,7,1900,202,369,571,Wednesday
2015,10,7,1800,240,458,698,Wednesday
2015,10,7,1700,259,441,700,Wednesday
2015,10,7,1600,309,407,716,Wednesday
2015,10,7,1500,303,386,689,Wednesday
2015,10,7,1400,320,306,626,Wednesday
2015,10,7,1300,386,278,664,Wednesday
2015,10,7,1200,435,232,667,Wednesday
2015,10,7,1100,397,184,581,Wednesday
2015,10,7,1000,335,142,477,Wednesday
2015,10,7,900,283,117,400,Wednesday
2015,10,7,800,162,83,245,Wednesday
2015,10,7,700,88,52,140,Wednesday
2015,10,7,600,36,43,79,Wednesday
2015,10,7,500,22,45,67,Wednesday
2015,10,7,400,23,32,55,Wednesday
2015,10,7,300,31,35,66,Wednesday
2015,10,7,200,26,55,81,Wednesday
2015,10,7,100,36,61,97,Wednesday
2015,10,6,2400,67,60,127,Tuesday
2015,10,6,2300,62,94,156,Tuesday
2015,10,6,2200,83,114,197,Tuesday
2015,10,6,2100,100,194,294,Tuesday
2015,10,6,2000,109,293,402,Tuesday
2015,10,6,1900,152,378,530,Tuesday
2015,10,6,1800,199,449,648,Tuesday
2015,10,6,1700,255,522,777,Tuesday
2015,10,6,1600,268,394,662,Tuesday
2015,10,6,1500,289,331,620,Tuesday
2015,10,6,1400,314,338,652,Tuesday
2015,10,6,1300,340,245,585,Tuesday
2015,10,6,1200,419,237,656,Tuesday
2015,10,6,1100,471,174,645,Tuesday
2015,10,6,1000,347,152,499,Tuesday
2015,10,6,900,273,117,390,Tuesday
2015,10,6,800,132,72,204,Tuesday
2015,10,6,700,67,44,111,Tuesday
2015,10,6,600,41,35,76,Tuesday
2015,10,6,500,31,40,71,Tuesday
2015,10,6,400,28,32,60,Tuesday
2015,10,6,300,22,30,52,Tuesday
2015,10,6,200,30,46,76,Tuesday
2015,10,6,100,46,59,105,Tuesday
2015,10,5,2400,63,84,147,Monday
2015,10,5,2300,54,93,147,Monday
2015,10,5,2200,90,136,226,Monday
2015,10,5,2100,105,221,326,Monday
2015,10,5,2000,151,346,497,Monday
2015,10,5,1900,165,539,704,Monday
2015,10,5,1800,209,601,810,Monday
2015,10,5,1700,268,558,826,Monday
2015,10,5,1600,334,491,825,Monday
2015,10,5,1500,336,404,740,Monday
2015,10,5,1400,386,319,705,Monday
2015,10,5,1300,472,253,725,Monday
2015,10,5,1200,542,248,790,Monday
2015,10,5,1100,526,185,711,Monday
2015,10,5,1000,416,136,552,Monday
2015,10,5,900,284,90,374,Monday
2015,10,5,800,155,68,223,Monday
2015,10,5,700,92,49,141,Monday
2015,10,5,600,31,21,52,Monday
2015,10,5,500,19,22,41,Monday
2015,10,5,400,23,30,53,Monday
2015,10,5,300,25,27,52,Monday
2015,10,5,200,16,33,49,Monday
2015,10,5,100,35,62,97,Monday
2015,10,4,2400,36,105,141,Sunday
2015,10,4,2300,50,158,208,Sunday
2015,10,4,2200,96,239,335,Sunday
2015,10,4,2100,117,391,508,Sunday
2015,10,4,2000,122,623,745,Sunday
2015,10,4,1900,192,844,1036,Sunday
2015,10,4,1800,252,1049,1301,Sunday
2015,10,4,1700,295,1012,1307,Sunday
2015,10,4,1600,343,920,1263,Sunday
2015,10,4,1500,411,758,1169,Sunday
2015,10,4,1400,478,613,1091,Sunday
2015,10,4,1300,566,576,1142,Sunday
2015,10,4,1200,654,344,998,Sunday
2015,10,4,1100,599,222,821,Sunday
2015,10,4,1000,526,149,675,Sunday
2015,10,4,900,320,74,394,Sunday
2015,10,4,800,164,38,202,Sunday
2015,10,4,700,58,20,78,Sunday
2015,10,4,600,34,18,52,Sunday
2015,10,4,500,19,18,37,Sunday
2015,10,4,400,17,18,35,Sunday
2015,10,4,300,21,24,45,Sunday
2015,10,4,200,23,31,54,Sunday
2015,10,4,100,31,47,78,Sunday
2015,10,3,2400,29,55,84,Saturday
2015,10,3,2300,53,75,128,Saturday
2015,10,3,2200,76,111,187,Saturday
2015,10,3,2100,106,217,323,Saturday
2015,10,3,2000,116,329,445,Saturday
2015,10,3,1900,146,429,575,Saturday
2015,10,3,1800,213,496,709,Saturday
2015,10,3,1700,248,501,749,Saturday
2015,10,3,1600,321,473,794,Saturday
2015,10,3,1500,390,399,789,Saturday
2015,10,3,1400,421,346,767,Saturday
2015,10,3,1300,477,301,778,Saturday
2015,10,3,1200,547,241,788,Saturday
2015,10,3,1100,567,186,753,Saturday
2015,10,3,1000,466,130,596,Saturday
2015,10,3,900,359,93,452,Saturday
2015,10,3,800,187,71,258,Saturday
2015,10,3,700,85,34,119,Saturday
2015,10,3,600,38,41,79,Saturday
2015,10,3,500,17,28,45,Saturday
2015,10,3,400,19,20,39,Saturday
2015,10,3,300,19,41,60,Saturday
2015,10,3,200,28,44,72,Saturday
2015,10,3,100,50,48,98,Saturday
2015,10,2,2400,65,79,144,Friday
2015,10,2,2300,118,74,192,Friday
2015,10,2,2200,170,151,321,Friday
2015,10,2,2100,248,199,447,Friday
2015,10,2,2000,395,346,741,Friday
2015,10,2,1900,503,584,1087,Friday
2015,10,2,1800,530,544,1074,Friday
2015,10,2,1700,573,752,1325,Friday
2015,10,2,1600,542,501,1043,Friday
2015,10,2,1500,549,448,997,Friday
2015,10,2,1400,511,344,855,Friday
2015,10,2,1300,589,331,920,Friday
2015,10,2,1200,660,339,999,Friday
2015,10,2,1100,615,181,796,Friday
2015,10,2,1000,583,129,712,Friday
2015,10,2,900,395,118,513,Friday
2015,10,2,800,203,73,276,Friday
2015,10,2,700,118,52,170,Friday
2015,10,2,600,43,39,82,Friday
2015,10,2,500,28,43,71,Friday
2015,10,2,400,37,39,76,Friday
2015,10,2,300,23,41,64,Friday
2015,10,2,200,37,52,89,Friday
2015,10,2,100,36,72,108,Friday
2015,10,1,2400,61,97,158,Thursday
2015,10,1,2300,76,111,187,Thursday
2015,10,1,2200,129,110,239,Thursday
2015,10,1,2100,174,224,398,Thursday
2015,10,1,2000,243,358,601,Thursday
2015,10,1,1900,274,492,766,Thursday
2015,10,1,1800,293,571,864,Thursday
2015,10,1,1700,333,603,936,Thursday
2015,10,1,1600,418,494,912,Thursday
2015,10,1,1500,376,442,818,Thursday
2015,10,1,1400,417,318,735,Thursday
2015,10,1,1300,461,296,757,Thursday
2015,10,1,1200,524,263,787,Thursday
2015,10,1,1100,611,186,797,Thursday
2015,10,1,1000,540,143,683,Thursday
2015,10,1,900,385,99,484,Thursday
2015,10,1,800,210,60,270,Thursday
2015,10,1,700,107,41,148,Thursday
2015,10,1,600,44,26,70,Thursday
2015,10,1,500,34,35,69,Thursday
2015,10,1,400,28,39,67,Thursday
2015,10,1,300,20,37,57,Thursday
2015,10,1,200,52,45,97,Thursday
2015,10,1,100,50,65,115,Thursday
2015,9,30,2400,74,69,143,Wednesday
2015,9,30,2300,80,94,174,Wednesday
2015,9,30,2200,104,146,250,Wednesday
2015,9,30,2100,148,293,441,Wednesday
2015,9,30,2000,155,345,500,Wednesday
2015,9,30,1900,186,523,709,Wednesday
2015,9,30,1800,247,545,792,Wednesday
2015,9,30,1700,271,539,810,Wednesday
2015,9,30,1600,291,442,733,Wednesday
2015,9,30,1500,340,458,798,Wednesday
2015,9,30,1400,387,232,619,Wednesday
2015,9,30,1300,445,276,721,Wednesday
2015,9,30,1200,545,225,770,Wednesday
2015,9,30,1100,532,204,736,Wednesday
2015,9,30,1000,461,129,590,Wednesday
2015,9,30,900,349,133,482,Wednesday
2015,9,30,800,188,79,267,Wednesday
2015,9,30,700,102,61,163,Wednesday
2015,9,30,600,40,36,76,Wednesday
2015,9,30,500,24,45,69,Wednesday
2015,9,30,400,25,41,66,Wednesday
2015,9,30,300,33,39,72,Wednesday
2015,9,30,200,24,42,66,Wednesday
2015,9,30,100,29,51,80,Wednesday
2015,9,29,2400,63,69,132,Tuesday
2015,9,29,2300,76,105,181,Tuesday
2015,9,29,2200,85,147,232,Tuesday
2015,9,29,2100,109,237,346,Tuesday
2015,9,29,2000,136,349,485,Tuesday
2015,9,29,1900,151,527,678,Tuesday
2015,9,29,1800,199,577,776,Tuesday
2015,9,29,1700,226,509,735,Tuesday
2015,9,29,1600,266,516,782,Tuesday
2015,9,29,1500,333,431,764,Tuesday
2015,9,29,1400,339,298,637,Tuesday
2015,9,29,1300,423,279,702,Tuesday
2015,9,29,1200,511,256,767,Tuesday
2015,9,29,1100,555,201,756,Tuesday
2015,9,29,1000,477,125,602,Tuesday
2015,9,29,900,377,112,489,Tuesday
2015,9,29,800,183,62,245,Tuesday
2015,9,29,700,101,57,158,Tuesday
2015,9,29,600,50,46,96,Tuesday
2015,9,29,500,34,42,76,Tuesday
2015,9,29,400,30,16,46,Tuesday
2015,9,29,300,24,41,65,Tuesday
2015,9,29,200,23,60,83,Tuesday
2015,9,29,100,41,56,97,Tuesday
2015,9,28,2400,61,69,130,Monday
2015,9,28,2300,78,100,178,Monday
2015,9,28,2200,88,168,256,Monday
2015,9,28,2100,122,282,404,Monday
2015,9,28,2000,136,527,663,Monday
2015,9,28,1900,193,601,794,Monday
2015,9,28,1800,206,645,851,Monday
2015,9,28,1700,291,654,945,Monday
2015,9,28,1600,346,607,953,Monday
2015,9,28,1500,379,426,805,Monday
2015,9,28,1400,430,380,810,Monday
2015,9,28,1300,503,317,820,Monday
2015,9,28,1200,593,283,876,Monday
2015,9,28,1100,604,204,808,Monday
2015,9,28,1000,583,135,718,Monday
2015,9,28,900,339,92,431,Monday
2015,9,28,800,203,75,278,Monday
2015,9,28,700,101,66,167,Monday
2015,9,28,600,32,27,59,Monday
2015,9,28,500,27,25,52,Monday
2015,9,28,400,22,22,44,Monday
2015,9,28,300,18,33,51,Monday
2015,9,28,200,15,44,59,Monday
2015,9,28,100,29,60,89,Monday
2015,9,27,2400,45,99,144,Sunday
2015,9,27,2300,44,164,208,Sunday
2015,9,27,2200,100,288,388,Sunday
2015,9,27,2100,130,461,591,Sunday
2015,9,27,2000,148,718,866,Sunday
2015,9,27,1900,197,1082,1279,Sunday
2015,9,27,1800,227,1590,1817,Sunday
2015,9,27,1700,337,1439,1776,Sunday
2015,9,27,1600,444,1214,1658,Sunday
2015,9,27,1500,494,965,1459,Sunday
2015,9,27,1400,592,794,1386,Sunday
2015,9,27,1300,693,717,1410,Sunday
2015,9,27,1200,800,483,1283,Sunday
2015,9,27,1100,830,301,1131,Sunday
2015,9,27,1000,739,161,900,Sunday
2015,9,27,900,543,73,616,Sunday
2015,9,27,800,234,48,282,Sunday
2015,9,27,700,82,19,101,Sunday
2015,9,27,600,19,26,45,Sunday
2015,9,27,500,19,14,33,Sunday
2015,9,27,400,18,22,40,Sunday
2015,9,27,300,16,16,32,Sunday
2015,9,27,200,26,28,54,Sunday
2015,9,27,100,28,67,95,Sunday
2015,9,26,2400,55,78,133,Saturday
2015,9,26,2300,64,88,152,Saturday
2015,9,26,2200,88,138,226,Saturday
2015,9,26,2100,120,266,386,Saturday
2015,9,26,2000,138,406,544,Saturday
2015,9,26,1900,197,662,859,Saturday
2015,9,26,1800,231,813,1044,Saturday
2015,9,26,1700,331,857,1188,Saturday
2015,9,26,1600,427,766,1193,Saturday
2015,9,26,1500,498,514,1012,Saturday
2015,9,26,1400,541,428,969,Saturday
2015,9,26,1300,699,355,1054,Saturday
2015,9,26,1200,822,318,1140,Saturday
2015,9,26,1100,795,244,1039,Saturday
2015,9,26,1000,698,156,854,Saturday
2015,9,26,900,496,111,607,Saturday
2015,9,26,800,234,67,301,Saturday
2015,9,26,700,98,47,145,Saturday
2015,9,26,600,48,34,82,Saturday
2015,9,26,500,23,33,56,Saturday
2015,9,26,400,21,38,59,Saturday
2015,9,26,300,26,39,65,Saturday
2015,9,26,200,35,53,88,Saturday
2015,9,26,100,41,70,111,Saturday
2015,9,25,2400,77,80,157,Friday
2015,9,25,2300,98,91,189,Friday
2015,9,25,2200,214,133,347,Friday
2015,9,25,2100,288,206,494,Friday
2015,9,25,2000,456,311,767,Friday
2015,9,25,1900,526,467,993,Friday
2015,9,25,1800,567,699,1266,Friday
2015,9,25,1700,611,647,1258,Friday
2015,9,25,1600,638,725,1363,Friday
2015,9,25,1500,646,639,1285,Friday
2015,9,25,1400,564,561,1125,Friday
2015,9,25,1300,653,465,1118,Friday
2015,9,25,1200,712,340,1052,Friday
2015,9,25,1100,794,242,1036,Friday
2015,9,25,1000,647,218,865,Friday
2015,9,25,900,478,114,592,Friday
2015,9,25,800,248,73,321,Friday
2015,9,25,700,115,53,168,Friday
2015,9,25,600,59,33,92,Friday
2015,9,25,500,33,43,76,Friday
2015,9,25,400,34,44,78,Friday
2015,9,25,300,29,30,59,Friday
2015,9,25,200,27,53,80,Friday
2015,9,25,100,48,65,113,Friday
2015,9,24,2400,73,90,163,Thursday
2015,9,24,2300,113,97,210,Thursday
2015,9,24,2200,153,167,320,Thursday
2015,9,24,2100,214,252,466,Thursday
2015,9,24,2000,309,414,723,Thursday
2015,9,24,1900,290,531,821,Thursday
2015,9,24,1800,322,680,1002,Thursday
2015,9,24,1700,384,668,1052,Thursday
2015,9,24,1600,421,572,993,Thursday
2015,9,24,1500,457,485,942,Thursday
2015,9,24,1400,441,409,850,Thursday
2015,9,24,1300,491,323,814,Thursday
2015,9,24,1200,635,269,904,Thursday
2015,9,24,1100,641,256,897,Thursday
2015,9,24,1000,632,139,771,Thursday
2015,9,24,900,416,81,497,Thursday
2015,9,24,800,265,65,330,Thursday
2015,9,24,700,118,52,170,Thursday
2015,9,24,600,52,48,100,Thursday
2015,9,24,500,21,30,51,Thursday
2015,9,24,400,31,25,56,Thursday
2015,9,24,300,19,37,56,Thursday
2015,9,24,200,35,43,78,Thursday
2015,9,24,100,39,57,96,Thursday
2015,9,23,2400,74,85,159,Wednesday
2015,9,23,2300,93,103,196,Wednesday
2015,9,23,2200,123,178,301,Wednesday
2015,9,23,2100,142,278,420,Wednesday
2015,9,23,2000,181,408,589,Wednesday
2015,9,23,1900,190,545,735,Wednesday
2015,9,23,1800,233,669,902,Wednesday
2015,9,23,1700,283,593,876,Wednesday
2015,9,23,1600,321,521,842,Wednesday
2015,9,23,1500,344,423,767,Wednesday
2015,9,23,1400,364,388,752,Wednesday
2015,9,23,1300,439,317,756,Wednesday
2015,9,23,1200,579,258,837,Wednesday
2015,9,23,1100,663,207,870,Wednesday
2015,9,23,1000,552,179,731,Wednesday
2015,9,23,900,416,124,540,Wednesday
2015,9,23,800,219,93,312,Wednesday
2015,9,23,700,116,62,178,Wednesday
2015,9,23,600,40,49,89,Wednesday
2015,9,23,500,24,35,59,Wednesday
2015,9,23,400,25,26,51,Wednesday
2015,9,23,300,34,36,70,Wednesday
2015,9,23,200,48,43,91,Wednesday
2015,9,23,100,32,52,84,Wednesday
2015,9,22,2400,70,72,142,Tuesday
2015,9,22,2300,68,114,182,Tuesday
2015,9,22,2200,110,146,256,Tuesday
2015,9,22,2100,107,309,416,Tuesday
2015,9,22,2000,148,416,564,Tuesday
2015,9,22,1900,173,596,769,Tuesday
2015,9,22,1800,241,633,874,Tuesday
2015,9,22,1700,297,663,960,Tuesday
2015,9,22,1600,297,564,861,Tuesday
2015,9,22,1500,314,401,715,Tuesday
2015,9,22,1400,358,339,697,Tuesday
2015,9,22,1300,487,309,796,Tuesday
2015,9,22,1200,547,250,797,Tuesday
2015,9,22,1100,625,190,815,Tuesday
2015,9,22,1000,577,162,739,Tuesday
2015,9,22,900,413,123,536,Tuesday
2015,9,22,800,211,75,286,Tuesday
2015,9,22,700,119,57,176,Tuesday
2015,9,22,600,46,37,83,Tuesday
2015,9,22,500,28,41,69,Tuesday
2015,9,22,400,22,30,52,Tuesday
2015,9,22,300,17,42,59,Tuesday
2015,9,22,200,31,63,94,Tuesday
2015,9,22,100,37,59,96,Tuesday
2015,9,21,2400,61,62,123,Monday
2015,9,21,2300,96,114,210,Monday
2015,9,21,2200,92,162,254,Monday
2015,9,21,2100,120,322,442,Monday
2015,9,21,2000,144,492,636,Monday
2015,9,21,1900,198,584,782,Monday
2015,9,21,1800,235,701,936,Monday
2015,9,21,1700,311,781,1092,Monday
2015,9,21,1600,363,683,1046,Monday
2015,9,21,1500,415,535,950,Monday
2015,9,21,1400,442,473,915,Monday
2015,9,21,1300,554,430,984,Monday
2015,9,21,1200,652,312,964,Monday
2015,9,21,1100,759,231,990,Monday
2015,9,21,1000,601,164,765,Monday
2015,9,21,900,436,129,565,Monday
2015,9,21,800,218,85,303,Monday
2015,9,21,700,117,38,155,Monday
2015,9,21,600,34,34,68,Monday
2015,9,21,500,17,19,36,Monday
2015,9,21,400,22,25,47,Monday
2015,9,21,300,21,35,56,Monday
2015,9,21,200,23,35,58,Monday
2015,9,21,100,31,87,118,Monday
2015,9,20,2400,33,114,147,Sunday
2015,9,20,2300,52,157,209,Sunday
2015,9,20,2200,110,221,331,Sunday
2015,9,20,2100,113,340,453,Sunday
2015,9,20,2000,155,558,713,Sunday
2015,9,20,1900,208,811,1019,Sunday
2015,9,20,1800,270,1040,1310,Sunday
2015,9,20,1700,351,1170,1521,Sunday
2015,9,20,1600,434,1254,1688,Sunday
2015,9,20,1500,487,1261,1748,Sunday
2015,9,20,1400,550,1152,1702,Sunday
2015,9,20,1300,657,1141,1798,Sunday
2015,9,20,1200,753,825,1578,Sunday
2015,9,20,1100,715,612,1327,Sunday
2015,9,20,1000,643,341,984,Sunday
2015,9,20,900,446,120,566,Sunday
2015,9,20,800,220,52,272,Sunday
2015,9,20,700,91,27,118,Sunday
2015,9,20,600,31,25,56,Sunday
2015,9,20,500,14,19,33,Sunday
2015,9,20,400,16,17,33,Sunday
2015,9,20,300,19,28,47,Sunday
2015,9,20,200,18,30,48,Sunday
2015,9,20,100,37,52,89,Sunday
2015,9,19,2400,47,75,122,Saturday
2015,9,19,2300,72,113,185,Saturday
2015,9,19,2200,98,188,286,Saturday
2015,9,19,2100,118,337,455,Saturday
2015,9,19,2000,139,557,696,Saturday
2015,9,19,1900,180,905,1085,Saturday
2015,9,19,1800,246,983,1229,Saturday
2015,9,19,1700,335,1004,1339,Saturday
2015,9,19,1600,390,935,1325,Saturday
2015,9,19,1500,483,677,1160,Saturday
2015,9,19,1400,596,604,1200,Saturday
2015,9,19,1300,807,468,1275,Saturday
2015,9,19,1200,923,357,1280,Saturday
2015,9,19,1100,1057,238,1295,Saturday
2015,9,19,1000,930,190,1120,Saturday
2015,9,19,900,776,105,881,Saturday
2015,9,19,800,349,59,408,Saturday
2015,9,19,700,142,34,176,Saturday
2015,9,19,600,46,45,91,Saturday
2015,9,19,500,19,30,49,Saturday
2015,9,19,400,19,26,45,Saturday
2015,9,19,300,23,32,55,Saturday
2015,9,19,200,38,43,81,Saturday
2015,9,19,100,50,57,107,Saturday
2015,9,18,2400,85,82,167,Friday
2015,9,18,2300,120,122,242,Friday
2015,9,18,2200,177,187,364,Friday
2015,9,18,2100,331,266,597,Friday
2015,9,18,2000,461,394,855,Friday
2015,9,18,1900,552,591,1143,Friday
2015,9,18,1800,699,685,1384,Friday
2015,9,18,1700,732,752,1484,Friday
2015,9,18,1600,729,724,1453,Friday
2015,9,18,1500,761,603,1364,Friday
2015,9,18,1400,717,462,1179,Friday
2015,9,18,1300,744,414,1158,Friday
2015,9,18,1200,852,330,1182,Friday
2015,9,18,1100,859,264,1123,Friday
2015,9,18,1000,751,174,925,Friday
2015,9,18,900,486,126,612,Friday
2015,9,18,800,270,66,336,Friday
2015,9,18,700,120,60,180,Friday
2015,9,18,600,59,39,98,Friday
2015,9,18,500,20,44,64,Friday
2015,9,18,400,46,30,76,Friday
2015,9,18,300,36,32,68,Friday
2015,9,18,200,35,52,87,Friday
2015,9,18,100,56,58,114,Friday
2015,9,17,2400,69,80,149,Thursday
2015,9,17,2300,112,96,208,Thursday
2015,9,17,2200,162,144,306,Thursday
2015,9,17,2100,218,252,470,Thursday
2015,9,17,2000,284,405,689,Thursday
2015,9,17,1900,306,586,892,Thursday
2015,9,17,1800,353,685,1038,Thursday
2015,9,17,1700,447,691,1138,Thursday
2015,9,17,1600,502,680,1182,Thursday
2015,9,17,1500,470,514,984,Thursday
2015,9,17,1400,503,434,937,Thursday
2015,9,17,1300,592,388,980,Thursday
2015,9,17,1200,700,285,985,Thursday
2015,9,17,1100,794,346,1140,Thursday
2015,9,17,1000,682,184,866,Thursday
2015,9,17,900,455,151,606,Thursday
2015,9,17,800,214,70,284,Thursday
2015,9,17,700,138,51,189,Thursday
2015,9,17,600,41,31,72,Thursday
2015,9,17,500,21,37,58,Thursday
2015,9,17,400,36,33,69,Thursday
2015,9,17,300,18,33,51,Thursday
2015,9,17,200,30,51,81,Thursday
2015,9,17,100,46,52,98,Thursday
2015,9,16,2400,71,67,138,Wednesday
2015,9,16,2300,79,105,184,Wednesday
2015,9,16,2200,118,167,285,Wednesday
2015,9,16,2100,136,334,470,Wednesday
2015,9,16,2000,188,306,494,Wednesday
2015,9,16,1900,215,525,740,Wednesday
2015,9,16,1800,249,685,934,Wednesday
2015,9,16,1700,283,595,878,Wednesday
2015,9,16,1600,318,571,889,Wednesday
2015,9,16,1500,387,505,892,Wednesday
2015,9,16,1400,375,343,718,Wednesday
2015,9,16,1300,453,279,732,Wednesday
2015,9,16,1200,547,309,856,Wednesday
2015,9,16,1100,680,244,924,Wednesday
2015,9,16,1000,537,178,715,Wednesday
2015,9,16,900,396,138,534,Wednesday
2015,9,16,800,177,71,248,Wednesday
2015,9,16,700,90,54,144,Wednesday
2015,9,16,600,47,48,95,Wednesday
2015,9,16,500,16,35,51,Wednesday
2015,9,16,400,22,31,53,Wednesday
2015,9,16,300,25,53,78,Wednesday
2015,9,16,200,30,45,75,Wednesday
2015,9,16,100,38,40,78,Wednesday
2015,9,15,2400,60,64,124,Tuesday
2015,9,15,2300,87,99,186,Tuesday
2015,9,15,2200,93,187,280,Tuesday
2015,9,15,2100,138,265,403,Tuesday
2015,9,15,2000,162,396,558,Tuesday
2015,9,15,1900,165,551,716,Tuesday
2015,9,15,1800,268,640,908,Tuesday
2015,9,15,1700,342,679,1021,Tuesday
2015,9,15,1600,357,548,905,Tuesday
2015,9,15,1500,372,435,807,Tuesday
2015,9,15,1400,423,394,817,Tuesday
2015,9,15,1300,448,352,800,Tuesday
2015,9,15,1200,587,290,877,Tuesday
2015,9,15,1100,659,205,864,Tuesday
2015,9,15,1000,495,190,685,Tuesday
2015,9,15,900,344,124,468,Tuesday
2015,9,15,800,195,89,284,Tuesday
2015,9,15,700,107,54,161,Tuesday
2015,9,15,600,35,40,75,Tuesday
2015,9,15,500,29,41,70,Tuesday
2015,9,15,400,31,38,69,Tuesday
2015,9,15,300,23,32,55,Tuesday
2015,9,15,200,24,42,66,Tuesday
2015,9,15,100,30,59,89,Tuesday
2015,9,14,2400,55,78,133,Monday
2015,9,14,2300,57,128,185,Monday
2015,9,14,2200,99,191,290,Monday
2015,9,14,2100,115,252,367,Monday
2015,9,14,2000,134,360,494,Monday
2015,9,14,1900,195,607,802,Monday
2015,9,14,1800,218,621,839,Monday
2015,9,14,1700,309,794,1103,Monday
2015,9,14,1600,357,672,1029,Monday
2015,9,14,1500,386,517,903,Monday
2015,9,14,1400,418,498,916,Monday
2015,9,14,1300,499,404,903,Monday
2015,9,14,1200,598,389,987,Monday
2015,9,14,1100,636,261,897,Monday
2015,9,14,1000,523,163,686,Monday
2015,9,14,900,373,134,507,Monday
2015,9,14,800,204,80,284,Monday
2015,9,14,700,111,47,158,Monday
2015,9,14,600,64,23,87,Monday
2015,9,14,500,36,20,56,Monday
2015,9,14,400,25,33,58,Monday
2015,9,14,300,20,34,54,Monday
2015,9,14,200,15,52,67,Monday
2015,9,14,100,27,91,118,Monday
2015,9,13,2400,34,112,146,Sunday
2015,9,13,2300,50,211,261,Sunday
2015,9,13,2200,102,311,413,Sunday
2015,9,13,2100,116,468,584,Sunday
2015,9,13,2000,185,727,912,Sunday
2015,9,13,1900,189,1063,1252,Sunday
2015,9,13,1800,248,1175,1423,Sunday
2015,9,13,1700,292,1184,1476,Sunday
2015,9,13,1600,428,1208,1636,Sunday
2015,9,13,1500,504,1003,1507,Sunday
2015,9,13,1400,570,817,1387,Sunday
2015,9,13,1300,596,764,1360,Sunday
2015,9,13,1200,648,588,1236,Sunday
2015,9,13,1100,662,428,1090,Sunday
2015,9,13,1000,531,219,750,Sunday
2015,9,13,900,361,125,486,Sunday
2015,9,13,800,189,40,229,Sunday
2015,9,13,700,85,17,102,Sunday
2015,9,13,600,28,9,37,Sunday
2015,9,13,500,27,17,44,Sunday
2015,9,13,400,16,14,30,Sunday
2015,9,13,300,21,27,48,Sunday
2015,9,13,200,16,26,42,Sunday
2015,9,13,100,28,50,78,Sunday
2015,9,12,2400,47,93,140,Saturday
2015,9,12,2300,62,136,198,Saturday
2015,9,12,2200,96,269,365,Saturday
2015,9,12,2100,129,545,674,Saturday
2015,9,12,2000,164,872,1036,Saturday
2015,9,12,1900,216,1099,1315,Saturday
2015,9,12,1800,277,1117,1394,Saturday
2015,9,12,1700,346,1050,1396,Saturday
2015,9,12,1600,465,859,1324,Saturday
2015,9,12,1500,577,663,1240,Saturday
2015,9,12,1400,714,502,1216,Saturday
2015,9,12,1300,835,484,1319,Saturday
2015,9,12,1200,1099,399,1498,Saturday
2015,9,12,1100,1141,289,1430,Saturday
2015,9,12,1000,1061,225,1286,Saturday
2015,9,12,900,775,148,923,Saturday
2015,9,12,800,366,62,428,Saturday
2015,9,12,700,147,40,187,Saturday
2015,9,12,600,63,42,105,Saturday
2015,9,12,500,26,36,62,Saturday
2015,9,12,400,23,24,47,Saturday
2015,9,12,300,34,41,75,Saturday
2015,9,12,200,32,47,79,Saturday
2015,9,12,100,72,64,136,Saturday
2015,9,11,2400,75,81,156,Friday
2015,9,11,2300,131,146,277,Friday
2015,9,11,2200,236,218,454,Friday
2015,9,11,2100,328,373,701,Friday
2015,9,11,2000,500,578,1078,Friday
2015,9,11,1900,599,807,1406,Friday
2015,9,11,1800,631,874,1505,Friday
2015,9,11,1700,656,819,1475,Friday
2015,9,11,1600,704,716,1420,Friday
2015,9,11,1500,694,514,1208,Friday
2015,9,11,1400,690,487,1177,Friday
2015,9,11,1300,736,400,1136,Friday
2015,9,11,1200,861,376,1237,Friday
2015,9,11,1100,981,279,1260,Friday
2015,9,11,1000,832,193,1025,Friday
2015,9,11,900,622,114,736,Friday
2015,9,11,800,299,72,371,Friday
2015,9,11,700,146,59,205,Friday
2015,9,11,600,62,40,102,Friday
2015,9,11,500,39,44,83,Friday
2015,9,11,400,37,36,73,Friday
2015,9,11,300,32,48,80,Friday
2015,9,11,200,36,61,97,Friday
2015,9,11,100,45,88,133,Friday
2015,9,10,2400,90,82,172,Thursday
2015,9,10,2300,98,88,186,Thursday
2015,9,10,2200,152,219,371,Thursday
2015,9,10,2100,231,315,546,Thursday
2015,9,10,2000,308,493,801,Thursday
2015,9,10,1900,302,676,978,Thursday
2015,9,10,1800,349,772,1121,Thursday
2015,9,10,1700,400,710,1110,Thursday
2015,9,10,1600,462,650,1112,Thursday
2015,9,10,1500,508,508,1016,Thursday
2015,9,10,1400,516,408,924,Thursday
2015,9,10,1300,559,382,941,Thursday
2015,9,10,1200,713,276,989,Thursday
2015,9,10,1100,797,238,1035,Thursday
2015,9,10,1000,718,192,910,Thursday
2015,9,10,900,540,123,663,Thursday
2015,9,10,800,275,94,369,Thursday
2015,9,10,700,128,53,181,Thursday
2015,9,10,600,50,42,92,Thursday
2015,9,10,500,31,41,72,Thursday
2015,9,10,400,25,42,67,Thursday
2015,9,10,300,24,37,61,Thursday
2015,9,10,200,30,47,77,Thursday
2015,9,10,100,46,66,112,Thursday
2015,9,9,2400,63,94,157,Wednesday
2015,9,9,2300,92,131,223,Wednesday
2015,9,9,2200,124,194,318,Wednesday
2015,9,9,2100,149,292,441,Wednesday
2015,9,9,2000,211,422,633,Wednesday
2015,9,9,1900,208,580,788,Wednesday
2015,9,9,1800,236,707,943,Wednesday
2015,9,9,1700,333,747,1080,Wednesday
2015,9,9,1600,326,630,956,Wednesday
2015,9,9,1500,374,530,904,Wednesday
2015,9,9,1400,434,374,808,Wednesday
2015,9,9,1300,513,347,860,Wednesday
2015,9,9,1200,620,312,932,Wednesday
2015,9,9,1100,736,240,976,Wednesday
2015,9,9,1000,604,168,772,Wednesday
2015,9,9,900,401,146,547,Wednesday
2015,9,9,800,205,83,288,Wednesday
2015,9,9,700,95,43,138,Wednesday
2015,9,9,600,52,36,88,Wednesday
2015,9,9,500,18,25,43,Wednesday
2015,9,9,400,28,39,67,Wednesday
2015,9,9,300,27,50,77,Wednesday
2015,9,9,200,35,52,87,Wednesday
2015,9,9,100,53,61,114,Wednesday
2015,9,8,2400,73,93,166,Tuesday
2015,9,8,2300,88,164,252,Tuesday
2015,9,8,2200,88,325,413,Tuesday
2015,9,8,2100,146,441,587,Tuesday
2015,9,8,2000,187,553,740,Tuesday
2015,9,8,1900,185,713,898,Tuesday
2015,9,8,1800,216,873,1089,Tuesday
2015,9,8,1700,324,884,1208,Tuesday
2015,9,8,1600,385,880,1265,Tuesday
2015,9,8,1500,443,699,1142,Tuesday
2015,9,8,1400,524,555,1079,Tuesday
2015,9,8,1300,565,528,1093,Tuesday
2015,9,8,1200,734,457,1191,Tuesday
2015,9,8,1100,740,286,1026,Tuesday
2015,9,8,1000,624,199,823,Tuesday
2015,9,8,900,420,161,581,Tuesday
2015,9,8,800,213,106,319,Tuesday
2015,9,8,700,118,62,180,Tuesday
2015,9,8,600,50,51,101,Tuesday
2015,9,8,500,28,30,58,Tuesday
2015,9,8,400,27,33,60,Tuesday
2015,9,8,300,20,52,72,Tuesday
2015,9,8,200,21,66,87,Tuesday
2015,9,8,100,29,107,136,Tuesday
2015,9,7,2400,42,200,242,Monday
2015,9,7,2300,57,326,383,Monday
2015,9,7,2200,107,941,1048,Monday
2015,9,7,2100,121,927,1048,Monday
2015,9,7,2000,180,1412,1592,Monday
2015,9,7,1900,212,1922,2134,Monday
2015,9,7,1800,261,2101,2362,Monday
2015,9,7,1700,335,1993,2328,Monday
2015,9,7,1600,473,1842,2315,Monday
2015,9,7,1500,580,1980,2560,Monday
2015,9,7,1400,642,1755,2397,Monday
2015,9,7,1300,818,1585,2403,Monday
2015,9,7,1200,971,1113,2084,Monday
2015,9,7,1100,980,709,1689,Monday
2015,9,7,1000,831,323,1154,Monday
2015,9,7,900,601,150,751,Monday
2015,9,7,800,252,70,322,Monday
2015,9,7,700,107,35,142,Monday
2015,9,7,600,52,19,71,Monday
2015,9,7,500,19,33,52,Monday
2015,9,7,400,15,39,54,Monday
2015,9,7,300,20,40,60,Monday
2015,9,7,200,22,80,102,Monday
2015,9,7,100,28,100,128,Monday
2015,9,6,2400,39,199,238,Sunday
2015,9,6,2300,63,252,315,Sunday
2015,9,6,2200,99,393,492,Sunday
2015,9,6,2100,171,556,727,Sunday
2015,9,6,2000,186,799,985,Sunday
2015,9,6,1900,243,1099,1342,Sunday
2015,9,6,1800,316,1244,1560,Sunday
2015,9,6,1700,435,1283,1718,Sunday
2015,9,6,1600,591,1088,1679,Sunday
2015,9,6,1500,658,870,1528,Sunday
2015,9,6,1400,710,801,1511,Sunday
2015,9,6,1300,880,635,1515,Sunday
2015,9,6,1200,927,469,1396,Sunday
2015,9,6,1100,882,343,1225,Sunday
2015,9,6,1000,636,179,815,Sunday
2015,9,6,900,435,96,531,Sunday
2015,9,6,800,225,58,283,Sunday
2015,9,6,700,106,26,132,Sunday
2015,9,6,600,42,27,69,Sunday
2015,9,6,500,17,25,42,Sunday
2015,9,6,400,20,28,48,Sunday
2015,9,6,300,15,44,59,Sunday
2015,9,6,200,33,47,80,Sunday
2015,9,6,100,36,49,85,Sunday
2015,9,5,2400,40,87,127,Saturday
2015,9,5,2300,67,142,209,Saturday
2015,9,5,2200,120,186,306,Saturday
2015,9,5,2100,184,345,529,Saturday
2015,9,5,2000,210,535,745,Saturday
2015,9,5,1900,257,635,892,Saturday
2015,9,5,1800,414,739,1153,Saturday
2015,9,5,1700,530,725,1255,Saturday
2015,9,5,1600,642,682,1324,Saturday
2015,9,5,1500,807,624,1431,Saturday
2015,9,5,1400,934,553,1487,Saturday
2015,9,5,1300,1114,441,1555,Saturday
2015,9,5,1200,1222,394,1616,Saturday
2015,9,5,1100,1201,263,1464,Saturday
2015,9,5,1000,962,177,1139,Saturday
2015,9,5,900,761,133,894,Saturday
2015,9,5,800,419,95,514,Saturday
2015,9,5,700,203,55,258,Saturday
2015,9,5,600,109,33,142,Saturday
2015,9,5,500,50,37,87,Saturday
2015,9,5,400,55,35,90,Saturday
2015,9,5,300,33,39,72,Saturday
2015,9,5,200,54,55,109,Saturday
2015,9,5,100,73,67,140,Saturday
2015,9,4,2400,142,106,248,Friday
2015,9,4,2300,243,149,392,Friday
2015,9,4,2200,416,229,645,Friday
2015,9,4,2100,706,354,1060,Friday
2015,9,4,2000,1237,470,1707,Friday
2015,9,4,1900,1759,689,2448,Friday
2015,9,4,1800,1533,777,2310,Friday
2015,9,4,1700,1048,752,1800,Friday
2015,9,4,1600,1096,688,1784,Friday
2015,9,4,1500,1106,601,1707,Friday
2015,9,4,1400,1055,452,1507,Friday
2015,9,4,1300,1026,439,1465,Friday
2015,9,4,1200,1229,343,1572,Friday
2015,9,4,1100,1224,272,1496,Friday
2015,9,4,1000,1022,192,1214,Friday
2015,9,4,900,800,125,925,Friday
2015,9,4,800,449,65,514,Friday
2015,9,4,700,234,67,301,Friday
2015,9,4,600,112,38,150,Friday
2015,9,4,500,52,45,97,Friday
2015,9,4,400,57,32,89,Friday
2015,9,4,300,35,58,93,Friday
2015,9,4,200,42,55,97,Friday
2015,9,4,100,79,114,193,Friday
2015,9,3,2400,128,104,232,Thursday
2015,9,3,2300,158,134,292,Thursday
2015,9,3,2200,292,245,537,Thursday
2015,9,3,2100,470,515,985,Thursday
2015,9,3,2000,580,341,921,Thursday
2015,9,3,1900,600,460,1060,Thursday
2015,9,3,1800,647,610,1257,Thursday
2015,9,3,1700,594,713,1307,Thursday
2015,9,3,1600,643,645,1288,Thursday
2015,9,3,1500,717,517,1234,Thursday
2015,9,3,1400,659,469,1128,Thursday
2015,9,3,1300,714,340,1054,Thursday
2015,9,3,1200,875,315,1190,Thursday
2015,9,3,1100,936,255,1191,Thursday
2015,9,3,1000,785,151,936,Thursday
2015,9,3,900,542,147,689,Thursday
2015,9,3,800,312,81,393,Thursday
2015,9,3,700,157,64,221,Thursday
2015,9,3,600,80,35,115,Thursday
2015,9,3,500,27,43,70,Thursday
2015,9,3,400,38,39,77,Thursday
2015,9,3,300,34,43,77,Thursday
2015,9,3,200,29,46,75,Thursday
2015,9,3,100,50,68,118,Thursday
2015,9,2,2400,81,81,162,Wednesday
2015,9,2,2300,122,126,248,Wednesday
2015,9,2,2200,160,213,373,Wednesday
2015,9,2,2100,223,332,555,Wednesday
2015,9,2,2000,253,456,709,Wednesday
2015,9,2,1900,289,608,897,Wednesday
2015,9,2,1800,301,690,991,Wednesday
2015,9,2,1700,408,605,1013,Wednesday
2015,9,2,1600,470,555,1025,Wednesday
2015,9,2,1500,481,446,927,Wednesday
2015,9,2,1400,546,459,1005,Wednesday
2015,9,2,1300,596,417,1013,Wednesday
2015,9,2,1200,767,382,1149,Wednesday
2015,9,2,1100,784,291,1075,Wednesday
2015,9,2,1000,618,190,808,Wednesday
2015,9,2,900,475,137,612,Wednesday
2015,9,2,800,231,86,317,Wednesday
2015,9,2,700,128,56,184,Wednesday
2015,9,2,600,71,30,101,Wednesday
2015,9,2,500,27,36,63,Wednesday
2015,9,2,400,34,39,73,Wednesday
2015,9,2,300,32,46,78,Wednesday
2015,9,2,200,45,58,103,Wednesday
2015,9,2,100,39,74,113,Wednesday
2015,9,1,2400,74,86,160,Tuesday
2015,9,1,2300,107,138,245,Tuesday
2015,9,1,2200,131,263,394,Tuesday
2015,9,1,2100,137,310,447,Tuesday
2015,9,1,2000,203,603,806,Tuesday
2015,9,1,1900,216,610,826,Tuesday
2015,9,1,1800,287,715,1002,Tuesday
2015,9,1,1700,326,688,1014,Tuesday
2015,9,1,1600,427,650,1077,Tuesday
2015,9,1,1500,443,564,1007,Tuesday
2015,9,1,1400,532,437,969,Tuesday
2015,9,1,1300,623,435,1058,Tuesday
2015,9,1,1200,763,344,1107,Tuesday
2015,9,1,1100,784,284,1068,Tuesday
2015,9,1,1000,688,186,874,Tuesday
2015,9,1,900,464,160,624,Tuesday
2015,9,1,800,263,87,350,Tuesday
2015,9,1,700,119,51,170,Tuesday
2015,9,1,600,59,49,108,Tuesday
2015,9,1,500,38,28,66,Tuesday
2015,9,1,400,24,32,56,Tuesday
2015,9,1,300,22,55,77,Tuesday
2015,9,1,200,39,55,94,Tuesday
2015,9,1,100,46,81,127,Tuesday
2015,8,31,2400,81,125,206,Monday
2015,8,31,2300,95,167,262,Monday
2015,8,31,2200,130,255,385,Monday
2015,8,31,2100,155,451,606,Monday
2015,8,31,2000,217,665,882,Monday
2015,8,31,1900,257,879,1136,Monday
2015,8,31,1800,313,1092,1405,Monday
2015,8,31,1700,447,951,1398,Monday
2015,8,31,1600,472,922,1394,Monday
2015,8,31,1500,541,742,1283,Monday
2015,8,31,1400,611,582,1193,Monday
2015,8,31,1300,671,513,1184,Monday
2015,8,31,1200,835,434,1269,Monday
2015,8,31,1100,822,278,1100,Monday
2015,8,31,1000,687,218,905,Monday
2015,8,31,900,534,187,721,Monday
2015,8,31,800,271,103,374,Monday
2015,8,31,700,154,51,205,Monday
2015,8,31,600,61,33,94,Monday
2015,8,31,500,20,30,50,Monday
2015,8,31,400,35,33,68,Monday
2015,8,31,300,28,33,61,Monday
2015,8,31,200,26,60,86,Monday
2015,8,31,100,41,144,185,Monday
2015,8,30,2400,55,157,212,Sunday
2015,8,30,2300,81,252,333,Sunday
2015,8,30,2200,103,431,534,Sunday
2015,8,30,2100,159,755,914,Sunday
2015,8,30,2000,197,930,1127,Sunday
2015,8,30,1900,265,1146,1411,Sunday
2015,8,30,1800,331,1391,1722,Sunday
2015,8,30,1700,396,1844,2240,Sunday
2015,8,30,1600,532,1693,2225,Sunday
2015,8,30,1500,641,1420,2061,Sunday
2015,8,30,1400,689,1290,1979,Sunday
2015,8,30,1300,841,1101,1942,Sunday
2015,8,30,1200,907,849,1756,Sunday
2015,8,30,1100,936,499,1435,Sunday
2015,8,30,1000,801,251,1052,Sunday
2015,8,30,900,516,124,640,Sunday
2015,8,30,800,291,60,351,Sunday
2015,8,30,700,117,31,148,Sunday
2015,8,30,600,67,30,97,Sunday
2015,8,30,500,40,20,60,Sunday
2015,8,30,400,27,20,47,Sunday
2015,8,30,300,25,33,58,Sunday
2015,8,30,200,29,71,100,Sunday
2015,8,30,100,28,64,92,Sunday
2015,8,29,2400,47,114,161,Saturday
2015,8,29,2300,77,186,263,Saturday
2015,8,29,2200,111,352,463,Saturday
2015,8,29,2100,153,779,932,Saturday
2015,8,29,2000,210,948,1158,Saturday
2015,8,29,1900,252,1242,1494,Saturday
2015,8,29,1800,302,1357,1659,Saturday
2015,8,29,1700,442,1202,1644,Saturday
2015,8,29,1600,591,1085,1676,Saturday
2015,8,29,1500,667,834,1501,Saturday
2015,8,29,1400,771,676,1447,Saturday
2015,8,29,1300,898,623,1521,Saturday
2015,8,29,1200,1065,511,1576,Saturday
2015,8,29,1100,1086,332,1418,Saturday
2015,8,29,1000,979,217,1196,Saturday
2015,8,29,900,667,149,816,Saturday
2015,8,29,800,327,90,417,Saturday
2015,8,29,700,155,48,203,Saturday
2015,8,29,600,66,40,106,Saturday
2015,8,29,500,27,37,64,Saturday
2015,8,29,400,29,35,64,Saturday
2015,8,29,300,36,46,82,Saturday
2015,8,29,200,39,60,99,Saturday
2015,8,29,100,55,78,133,Saturday
2015,8,28,2400,105,136,241,Friday
2015,8,28,2300,149,234,383,Friday
2015,8,28,2200,262,295,557,Friday
2015,8,28,2100,391,545,936,Friday
2015,8,28,2000,576,689,1265,Friday
2015,8,28,1900,687,948,1635,Friday
2015,8,28,1800,724,1125,1849,Friday
2015,8,28,1700,799,1182,1981,Friday
2015,8,28,1600,800,874,1674,Friday
2015,8,28,1500,749,794,1543,Friday
2015,8,28,1400,797,645,1442,Friday
2015,8,28,1300,892,605,1497,Friday
2015,8,28,1200,1007,469,1476,Friday
2015,8,28,1100,1020,322,1342,Friday
2015,8,28,1000,929,207,1136,Friday
2015,8,28,900,627,145,772,Friday
2015,8,28,800,340,90,430,Friday
2015,8,28,700,156,54,210,Friday
2015,8,28,600,85,37,122,Friday
2015,8,28,500,31,42,73,Friday
2015,8,28,400,36,45,81,Friday
2015,8,28,300,28,58,86,Friday
2015,8,28,200,50,51,101,Friday
2015,8,28,100,61,94,155,Friday
2015,8,27,2400,83,135,218,Thursday
2015,8,27,2300,115,182,297,Thursday
2015,8,27,2200,198,323,521,Thursday
2015,8,27,2100,266,491,757,Thursday
2015,8,27,2000,406,696,1102,Thursday
2015,8,27,1900,434,941,1375,Thursday
2015,8,27,1800,436,966,1402,Thursday
2015,8,27,1700,524,897,1421,Thursday
2015,8,27,1600,565,762,1327,Thursday
2015,8,27,1500,657,714,1371,Thursday
2015,8,27,1400,669,574,1243,Thursday
2015,8,27,1300,822,485,1307,Thursday
2015,8,27,1200,871,400,1271,Thursday
2015,8,27,1100,913,330,1243,Thursday
2015,8,27,1000,777,212,989,Thursday
2015,8,27,900,592,142,734,Thursday
2015,8,27,800,292,87,379,Thursday
2015,8,27,700,149,58,207,Thursday
2015,8,27,600,62,59,121,Thursday
2015,8,27,500,40,29,69,Thursday
2015,8,27,400,37,33,70,Thursday
2015,8,27,300,27,48,75,Thursday
2015,8,27,200,41,52,93,Thursday
2015,8,27,100,49,79,128,Thursday
2015,8,26,2400,84,115,199,Wednesday
2015,8,26,2300,106,169,275,Wednesday
2015,8,26,2200,152,311,463,Wednesday
2015,8,26,2100,200,466,666,Wednesday
2015,8,26,2000,280,684,964,Wednesday
2015,8,26,1900,306,785,1091,Wednesday
2015,8,26,1800,343,1002,1345,Wednesday
2015,8,26,1700,415,1006,1421,Wednesday
2015,8,26,1600,491,683,1174,Wednesday
2015,8,26,1500,552,648,1200,Wednesday
2015,8,26,1400,599,617,1216,Wednesday
2015,8,26,1300,654,513,1167,Wednesday
2015,8,26,1200,821,411,1232,Wednesday
2015,8,26,1100,902,287,1189,Wednesday
2015,8,26,1000,720,201,921,Wednesday
2015,8,26,900,504,136,640,Wednesday
2015,8,26,800,315,82,397,Wednesday
2015,8,26,700,124,61,185,Wednesday
2015,8,26,600,79,62,141,Wednesday
2015,8,26,500,35,45,80,Wednesday
2015,8,26,400,30,38,68,Wednesday
2015,8,26,300,19,56,75,Wednesday
2015,8,26,200,33,59,92,Wednesday
2015,8,26,100,56,81,137,Wednesday
2015,8,25,2400,69,125,194,Tuesday
2015,8,25,2300,93,193,286,Tuesday
2015,8,25,2200,140,329,469,Tuesday
2015,8,25,2100,169,548,717,Tuesday
2015,8,25,2000,249,769,1018,Tuesday
2015,8,25,1900,253,878,1131,Tuesday
2015,8,25,1800,324,923,1247,Tuesday
2015,8,25,1700,405,923,1328,Tuesday
2015,8,25,1600,439,795,1234,Tuesday
2015,8,25,1500,525,741,1266,Tuesday
2015,8,25,1400,525,578,1103,Tuesday
2015,8,25,1300,702,531,1233,Tuesday
2015,8,25,1200,862,401,1263,Tuesday
2015,8,25,1100,843,337,1180,Tuesday
2015,8,25,1000,724,207,931,Tuesday
2015,8,25,900,512,177,689,Tuesday
2015,8,25,800,271,106,377,Tuesday
2015,8,25,700,141,65,206,Tuesday
2015,8,25,600,63,35,98,Tuesday
2015,8,25,500,36,51,87,Tuesday
2015,8,25,400,34,52,86,Tuesday
2015,8,25,300,27,62,89,Tuesday
2015,8,25,200,34,75,109,Tuesday
2015,8,25,100,66,88,154,Tuesday
2015,8,24,2400,61,137,198,Monday
2015,8,24,2300,81,243,324,Monday
2015,8,24,2200,123,464,587,Monday
2015,8,24,2100,195,804,999,Monday
2015,8,24,2000,237,972,1209,Monday
2015,8,24,1900,347,1219,1566,Monday
2015,8,24,1800,504,1249,1753,Monday
2015,8,24,1700,405,1188,1593,Monday
2015,8,24,1600,419,1016,1435,Monday
2015,8,24,1500,654,843,1497,Monday
2015,8,24,1400,799,715,1514,Monday
2015,8,24,1300,985,674,1659,Monday
2015,8,24,1200,1066,535,1601,Monday
2015,8,24,1100,1003,368,1371,Monday
2015,8,24,1000,906,242,1148,Monday
2015,8,24,900,642,185,827,Monday
2015,8,24,800,366,106,472,Monday
2015,8,24,700,154,87,241,Monday
2015,8,24,600,67,35,102,Monday
2015,8,24,500,35,23,58,Monday
2015,8,24,400,25,32,57,Monday
2015,8,24,300,19,57,76,Monday
2015,8,24,200,26,59,85,Monday
2015,8,24,100,35,136,171,Monday
2015,8,23,2400,58,192,250,Sunday
2015,8,23,2300,99,405,504,Sunday
2015,8,23,2200,162,721,883,Sunday
2015,8,23,2100,204,1266,1470,Sunday
2015,8,23,2000,225,1937,2162,Sunday
2015,8,23,1900,343,1968,2311,Sunday
2015,8,23,1800,361,2142,2503,Sunday
2015,8,23,1700,585,2150,2735,Sunday
2015,8,23,1600,689,1556,2245,Sunday
2015,8,23,1500,850,1616,2466,Sunday
2015,8,23,1400,1007,1145,2152,Sunday
2015,8,23,1300,1190,1055,2245,Sunday
2015,8,23,1200,1254,731,1985,Sunday
2015,8,23,1100,1196,455,1651,Sunday
2015,8,23,1000,1032,281,1313,Sunday
2015,8,23,900,680,115,795,Sunday
2015,8,23,800,358,77,435,Sunday
2015,8,23,700,111,39,150,Sunday
2015,8,23,600,67,21,88,Sunday
2015,8,23,500,32,32,64,Sunday
2015,8,23,400,16,28,44,Sunday
2015,8,23,300,25,40,65,Sunday
2015,8,23,200,26,60,86,Sunday
2015,8,23,100,48,109,157,Sunday
2015,8,22,2400,48,180,228,Saturday
2015,8,22,2300,106,347,453,Saturday
2015,8,22,2200,157,531,688,Saturday
2015,8,22,2100,183,1044,1227,Saturday
2015,8,22,2000,238,1280,1518,Saturday
2015,8,22,1900,288,1306,1594,Saturday
2015,8,22,1800,394,1353,1747,Saturday
2015,8,22,1700,551,1307,1858,Saturday
2015,8,22,1600,731,1076,1807,Saturday
2015,8,22,1500,891,886,1777,Saturday
2015,8,22,1400,1209,756,1965,Saturday
2015,8,22,1300,1351,690,2041,Saturday
2015,8,22,1200,1627,532,2159,Saturday
2015,8,22,1100,1506,370,1876,Saturday
2015,8,22,1000,1414,238,1652,Saturday
2015,8,22,900,912,149,1061,Saturday
2015,8,22,800,462,83,545,Saturday
2015,8,22,700,241,47,288,Saturday
2015,8,22,600,86,37,123,Saturday
2015,8,22,500,38,42,80,Saturday
2015,8,22,400,45,36,81,Saturday
2015,8,22,300,41,44,85,Saturday
2015,8,22,200,39,63,102,Saturday
2015,8,22,100,50,93,143,Saturday
2015,8,21,2400,104,133,237,Friday
2015,8,21,2300,149,200,349,Friday
2015,8,21,2200,299,352,651,Friday
2015,8,21,2100,471,459,930,Friday
2015,8,21,2000,763,627,1390,Friday
2015,8,21,1900,895,867,1762,Friday
2015,8,21,1800,913,829,1742,Friday
2015,8,21,1700,876,955,1831,Friday
2015,8,21,1600,976,934,1910,Friday
2015,8,21,1500,919,837,1756,Friday
2015,8,21,1400,885,891,1776,Friday
2015,8,21,1300,960,780,1740,Friday
2015,8,21,1200,1103,631,1734,Friday
2015,8,21,1100,1029,383,1412,Friday
2015,8,21,1000,843,229,1072,Friday
2015,8,21,900,620,170,790,Friday
2015,8,21,800,354,100,454,Friday
2015,8,21,700,193,54,247,Friday
2015,8,21,600,80,48,128,Friday
2015,8,21,500,55,36,91,Friday
2015,8,21,400,42,40,82,Friday
2015,8,21,300,31,52,83,Friday
2015,8,21,200,39,53,92,Friday
2015,8,21,100,72,101,173,Friday
2015,8,20,2400,85,112,197,Thursday
2015,8,20,2300,130,215,345,Thursday
2015,8,20,2200,233,341,574,Thursday
2015,8,20,2100,347,576,923,Thursday
2015,8,20,2000,492,873,1365,Thursday
2015,8,20,1900,526,888,1414,Thursday
2015,8,20,1800,564,1064,1628,Thursday
2015,8,20,1700,615,1097,1712,Thursday
2015,8,20,1600,751,988,1739,Thursday
2015,8,20,1500,780,829,1609,Thursday
2015,8,20,1400,849,656,1505,Thursday
2015,8,20,1300,874,549,1423,Thursday
2015,8,20,1200,1134,480,1614,Thursday
2015,8,20,1100,1089,343,1432,Thursday
2015,8,20,1000,965,254,1219,Thursday
2015,8,20,900,704,179,883,Thursday
2015,8,20,800,419,104,523,Thursday
2015,8,20,700,203,63,266,Thursday
2015,8,20,600,87,77,164,Thursday
2015,8,20,500,49,32,81,Thursday
2015,8,20,400,39,28,67,Thursday
2015,8,20,300,39,20,59,Thursday
2015,8,20,200,37,31,68,Thursday
2015,8,20,100,81,86,167,Thursday
2015,8,19,2400,100,114,214,Wednesday
2015,8,19,2300,117,219,336,Wednesday
2015,8,19,2200,206,425,631,Wednesday
2015,8,19,2100,276,610,886,Wednesday
2015,8,19,2000,289,859,1148,Wednesday
2015,8,19,1900,334,1031,1365,Wednesday
2015,8,19,1800,372,1027,1399,Wednesday
2015,8,19,1700,459,1043,1502,Wednesday
2015,8,19,1600,546,899,1445,Wednesday
2015,8,19,1500,671,705,1376,Wednesday
2015,8,19,1400,717,590,1307,Wednesday
2015,8,19,1300,823,510,1333,Wednesday
2015,8,19,1200,1085,439,1524,Wednesday
2015,8,19,1100,1102,306,1408,Wednesday
2015,8,19,1000,923,229,1152,Wednesday
2015,8,19,900,722,148,870,Wednesday
2015,8,19,800,384,91,475,Wednesday
2015,8,19,700,163,52,215,Wednesday
2015,8,19,600,72,38,110,Wednesday
2015,8,19,500,28,27,55,Wednesday
2015,8,19,400,32,49,81,Wednesday
2015,8,19,300,35,49,84,Wednesday
2015,8,19,200,41,72,113,Wednesday
2015,8,19,100,71,96,167,Wednesday
2015,8,18,2400,79,122,201,Tuesday
2015,8,18,2300,106,234,340,Tuesday
2015,8,18,2200,173,433,606,Tuesday
2015,8,18,2100,164,648,812,Tuesday
2015,8,18,2000,246,948,1194,Tuesday
2015,8,18,1900,272,983,1255,Tuesday
2015,8,18,1800,338,942,1280,Tuesday
2015,8,18,1700,410,938,1348,Tuesday
2015,8,18,1600,529,887,1416,Tuesday
2015,8,18,1500,586,672,1258,Tuesday
2015,8,18,1400,659,625,1284,Tuesday
2015,8,18,1300,778,504,1282,Tuesday
2015,8,18,1200,1013,408,1421,Tuesday
2015,8,18,1100,1006,334,1340,Tuesday
2015,8,18,1000,896,214,1110,Tuesday
2015,8,18,900,585,145,730,Tuesday
2015,8,18,800,295,97,392,Tuesday
2015,8,18,700,164,55,219,Tuesday
2015,8,18,600,74,50,124,Tuesday
2015,8,18,500,38,49,87,Tuesday
2015,8,18,400,27,41,68,Tuesday
2015,8,18,300,21,41,62,Tuesday
2015,8,18,200,30,60,90,Tuesday
2015,8,18,100,44,107,151,Tuesday
2015,8,17,2400,70,150,220,Monday
2015,8,17,2300,107,299,406,Monday
2015,8,17,2200,133,406,539,Monday
2015,8,17,2100,205,687,892,Monday
2015,8,17,2000,217,942,1159,Monday
2015,8,17,1900,354,1309,1663,Monday
2015,8,17,1800,391,1321,1712,Monday
2015,8,17,1700,582,1160,1742,Monday
2015,8,17,1600,685,1022,1707,Monday
2015,8,17,1500,748,907,1655,Monday
2015,8,17,1400,820,755,1575,Monday
2015,8,17,1300,891,592,1483,Monday
2015,8,17,1200,1084,438,1522,Monday
2015,8,17,1100,1103,341,1444,Monday
2015,8,17,1000,963,223,1186,Monday
2015,8,17,900,696,171,867,Monday
2015,8,17,800,405,123,528,Monday
2015,8,17,700,175,69,244,Monday
2015,8,17,600,54,48,102,Monday
2015,8,17,500,41,35,76,Monday
2015,8,17,400,20,38,58,Monday
2015,8,17,300,29,48,77,Monday
2015,8,17,200,31,71,102,Monday
2015,8,17,100,34,129,163,Monday
2015,8,16,2400,63,217,280,Sunday
2015,8,16,2300,93,440,533,Sunday
2015,8,16,2200,131,689,820,Sunday
2015,8,16,2100,191,1039,1230,Sunday
2015,8,16,2000,267,1326,1593,Sunday
2015,8,16,1900,333,1796,2129,Sunday
2015,8,16,1800,411,1840,2251,Sunday
2015,8,16,1700,544,1674,2218,Sunday
2015,8,16,1600,708,1587,2295,Sunday
2015,8,16,1500,803,1361,2164,Sunday
2015,8,16,1400,960,1214,2174,Sunday
2015,8,16,1300,1083,1021,2104,Sunday
2015,8,16,1200,1234,769,2003,Sunday
2015,8,16,1100,1168,530,1698,Sunday
2015,8,16,1000,920,249,1169,Sunday
2015,8,16,900,625,139,764,Sunday
2015,8,16,800,322,85,407,Sunday
2015,8,16,700,137,24,161,Sunday
2015,8,16,600,55,33,88,Sunday
2015,8,16,500,29,23,52,Sunday
2015,8,16,400,24,34,58,Sunday
2015,8,16,300,35,45,80,Sunday
2015,8,16,200,35,77,112,Sunday
2015,8,16,100,40,113,153,Sunday
2015,8,15,2400,64,198,262,Saturday
2015,8,15,2300,89,259,348,Saturday
2015,8,15,2200,110,438,548,Saturday
2015,8,15,2100,182,621,803,Saturday
2015,8,15,2000,243,888,1131,Saturday
2015,8,15,1900,299,1261,1560,Saturday
2015,8,15,1800,460,1307,1767,Saturday
2015,8,15,1700,553,1110,1663,Saturday
2015,8,15,1600,695,1074,1769,Saturday
2015,8,15,1500,819,898,1717,Saturday
2015,8,15,1400,970,833,1803,Saturday
2015,8,15,1300,1143,728,1871,Saturday
2015,8,15,1200,1324,636,1960,Saturday
2015,8,15,1100,1196,424,1620,Saturday
2015,8,15,1000,966,240,1206,Saturday
2015,8,15,900,723,160,883,Saturday
2015,8,15,800,399,91,490,Saturday
2015,8,15,700,213,52,265,Saturday
2015,8,15,600,100,39,139,Saturday
2015,8,15,500,50,32,82,Saturday
2015,8,15,400,39,32,71,Saturday
2015,8,15,300,36,58,94,Saturday
2015,8,15,200,49,95,144,Saturday
2015,8,15,100,71,90,161,Saturday
2015,8,14,2400,117,148,265,Friday
2015,8,14,2300,196,277,473,Friday
2015,8,14,2200,280,386,666,Friday
2015,8,14,2100,471,587,1058,Friday
2015,8,14,2000,734,841,1575,Friday
2015,8,14,1900,833,1049,1882,Friday
2015,8,14,1800,910,1194,2104,Friday
2015,8,14,1700,1044,1099,2143,Friday
2015,8,14,1600,1056,1135,2191,Friday
2015,8,14,1500,1058,964,2022,Friday
2015,8,14,1400,1007,897,1904,Friday
2015,8,14,1300,1163,837,2000,Friday
2015,8,14,1200,1312,567,1879,Friday
2015,8,14,1100,1266,393,1659,Friday
2015,8,14,1000,1094,270,1364,Friday
2015,8,14,900,774,168,942,Friday
2015,8,14,800,493,92,585,Friday
2015,8,14,700,234,50,284,Friday
2015,8,14,600,113,47,160,Friday
2015,8,14,500,46,42,88,Friday
2015,8,14,400,43,44,87,Friday
2015,8,14,300,53,54,107,Friday
2015,8,14,200,53,103,156,Friday
2015,8,14,100,72,103,175,Friday
2015,8,13,2400,132,162,294,Thursday
2015,8,13,2300,176,263,439,Thursday
2015,8,13,2200,245,493,738,Thursday
2015,8,13,2100,379,637,1016,Thursday
2015,8,13,2000,487,886,1373,Thursday
2015,8,13,1900,499,1016,1515,Thursday
2015,8,13,1800,568,1163,1731,Thursday
2015,8,13,1700,640,1087,1727,Thursday
2015,8,13,1600,732,856,1588,Thursday
2015,8,13,1500,739,779,1518,Thursday
2015,8,13,1400,869,682,1551,Thursday
2015,8,13,1300,934,579,1513,Thursday
2015,8,13,1200,1143,485,1628,Thursday
2015,8,13,1100,1212,332,1544,Thursday
2015,8,13,1000,1029,271,1300,Thursday
2015,8,13,900,789,164,953,Thursday
2015,8,13,800,488,111,599,Thursday
2015,8,13,700,221,58,279,Thursday
2015,8,13,600,116,41,157,Thursday
2015,8,13,500,50,36,86,Thursday
2015,8,13,400,44,48,92,Thursday
2015,8,13,300,38,47,85,Thursday
2015,8,13,200,38,75,113,Thursday
2015,8,13,100,56,82,138,Thursday
2015,8,12,2400,91,166,257,Wednesday
2015,8,12,2300,143,268,411,Wednesday
2015,8,12,2200,202,422,624,Wednesday
2015,8,12,2100,275,601,876,Wednesday
2015,8,12,2000,303,793,1096,Wednesday
2015,8,12,1900,330,992,1322,Wednesday
2015,8,12,1800,440,1104,1544,Wednesday
2015,8,12,1700,479,1090,1569,Wednesday
2015,8,12,1600,580,955,1535,Wednesday
2015,8,12,1500,672,726,1398,Wednesday
2015,8,12,1400,730,581,1311,Wednesday
2015,8,12,1300,872,523,1395,Wednesday
2015,8,12,1200,950,498,1448,Wednesday
2015,8,12,1100,1041,330,1371,Wednesday
2015,8,12,1000,978,224,1202,Wednesday
2015,8,12,900,762,163,925,Wednesday
2015,8,12,800,409,107,516,Wednesday
2015,8,12,700,200,62,262,Wednesday
2015,8,12,600,79,39,118,Wednesday
2015,8,12,500,37,45,82,Wednesday
2015,8,12,400,26,49,75,Wednesday
2015,8,12,300,40,48,88,Wednesday
2015,8,12,200,38,68,106,Wednesday
2015,8,12,100,49,99,148,Wednesday
2015,8,11,2400,91,139,230,Tuesday
2015,8,11,2300,105,323,428,Tuesday
2015,8,11,2200,152,738,890,Tuesday
2015,8,11,2100,218,771,989,Tuesday
2015,8,11,2000,271,1163,1434,Tuesday
2015,8,11,1900,310,1090,1400,Tuesday
2015,8,11,1800,371,882,1253,Tuesday
2015,8,11,1700,442,737,1179,Tuesday
2015,8,11,1600,580,639,1219,Tuesday
2015,8,11,1500,619,553,1172,Tuesday
2015,8,11,1400,703,640,1343,Tuesday
2015,8,11,1300,836,582,1418,Tuesday
2015,8,11,1200,,,,Tuesday
2015,8,11,1100,,,,Tuesday
2015,8,11,1000,,,,Tuesday
2015,8,11,900,,,,Tuesday
2015,8,11,800,,,,Tuesday
2015,8,11,700,,,,Tuesday
2015,8,11,600,,,,Tuesday
2015,8,11,500,,,,Tuesday
2015,8,11,400,,,,Tuesday
2015,8,11,300,,,,Tuesday
2015,8,11,200,,,,Tuesday
2015,8,11,100,,,,Tuesday
2015,8,10,2400,,,,Monday
2015,8,10,2300,,,,Monday
2015,8,10,2200,,,,Monday
2015,8,10,2100,,,,Monday
2015,8,10,2000,,,,Monday
2015,8,10,1900,,,,Monday
2015,8,10,1800,,,,Monday
2015,8,10,1700,,,,Monday
2015,8,10,1600,,,,Monday
2015,8,10,1500,,,,Monday
2015,8,10,1400,,,,Monday
2015,8,10,1300,,,,Monday
2015,8,10,1200,,,,Monday
2015,8,10,1100,,,,Monday
2015,8,10,1000,,,,Monday
2015,8,10,900,,,,Monday
2015,8,10,800,,,,Monday
2015,8,10,700,,,,Monday
2015,8,10,600,,,,Monday
2015,8,10,500,,,,Monday
2015,8,10,400,,,,Monday
2015,8,10,300,,,,Monday
2015,8,10,200,,,,Monday
2015,8,10,100,,,,Monday
2015,8,9,2400,,,,Sunday
2015,8,9,2300,,,,Sunday
2015,8,9,2200,,,,Sunday
2015,8,9,2100,,,,Sunday
2015,8,9,2000,,,,Sunday
2015,8,9,1900,,,,Sunday
2015,8,9,1800,,,,Sunday
2015,8,9,1700,,,,Sunday
2015,8,9,1600,,,,Sunday
2015,8,9,1500,,,,Sunday
2015,8,9,1400,,,,Sunday
2015,8,9,1300,,,,Sunday
2015,8,9,1200,,,,Sunday
2015,8,9,1100,,,,Sunday
2015,8,9,1000,,,,Sunday
2015,8,9,900,,,,Sunday
2015,8,9,800,,,,Sunday
2015,8,9,700,,,,Sunday
2015,8,9,600,,,,Sunday
2015,8,9,500,,,,Sunday
2015,8,9,400,,,,Sunday
2015,8,9,300,,,,Sunday
2015,8,9,200,,,,Sunday
2015,8,9,100,,,,Sunday
2015,8,8,2400,,,,Saturday
2015,8,8,2300,,,,Saturday
2015,8,8,2200,,,,Saturday
2015,8,8,2100,,,,Saturday
2015,8,8,2000,,,,Saturday
2015,8,8,1900,,,,Saturday
2015,8,8,1800,,,,Saturday
2015,8,8,1700,,,,Saturday
2015,8,8,1600,,,,Saturday
2015,8,8,1500,,,,Saturday
2015,8,8,1400,,,,Saturday
2015,8,8,1300,,,,Saturday
2015,8,8,1200,,,,Saturday
2015,8,8,1100,,,,Saturday
2015,8,8,1000,,,,Saturday
2015,8,8,900,,,,Saturday
2015,8,8,800,,,,Saturday
2015,8,8,700,,,,Saturday
2015,8,8,600,,,,Saturday
2015,8,8,500,,,,Saturday
2015,8,8,400,,,,Saturday
2015,8,8,300,,,,Saturday
2015,8,8,200,,,,Saturday
2015,8,8,100,,,,Saturday
2015,8,7,2400,,,,Friday
2015,8,7,2300,,,,Friday
2015,8,7,2200,,,,Friday
2015,8,7,2100,,,,Friday
2015,8,7,2000,,,,Friday
2015,8,7,1900,,,,Friday
2015,8,7,1800,,,,Friday
2015,8,7,1700,,,,Friday
2015,8,7,1600,,,,Friday
2015,8,7,1500,,,,Friday
2015,8,7,1400,,,,Friday
2015,8,7,1300,,,,Friday
2015,8,7,1200,,,,Friday
2015,8,7,1100,,,,Friday
2015,8,7,1000,,,,Friday
2015,8,7,900,,,,Friday
2015,8,7,800,,,,Friday
2015,8,7,700,,,,Friday
2015,8,7,600,,,,Friday
2015,8,7,500,,,,Friday
2015,8,7,400,,,,Friday
2015,8,7,300,,,,Friday
2015,8,7,200,,,,Friday
2015,8,7,100,,,,Friday
2015,8,6,2400,,,,Thursday
2015,8,6,2300,,,,Thursday
2015,8,6,2200,,,,Thursday
2015,8,6,2100,,,,Thursday
2015,8,6,2000,,,,Thursday
2015,8,6,1900,,,,Thursday
2015,8,6,1800,,,,Thursday
2015,8,6,1700,,,,Thursday
2015,8,6,1600,,,,Thursday
2015,8,6,1500,,,,Thursday
2015,8,6,1400,,,,Thursday
2015,8,6,1300,,,,Thursday
2015,8,6,1200,,,,Thursday
2015,8,6,1100,,,,Thursday
2015,8,6,1000,,,,Thursday
2015,8,6,900,,,,Thursday
2015,8,6,800,,,,Thursday
2015,8,6,700,,,,Thursday
2015,8,6,600,,,,Thursday
2015,8,6,500,,,,Thursday
2015,8,6,400,,,,Thursday
2015,8,6,300,,,,Thursday
2015,8,6,200,,,,Thursday
2015,8,6,100,,,,Thursday
2015,8,5,2400,,,,Wednesday
2015,8,5,2300,,,,Wednesday
2015,8,5,2200,,,,Wednesday
2015,8,5,2100,,,,Wednesday
2015,8,5,2000,,,,Wednesday
2015,8,5,1900,,,,Wednesday
2015,8,5,1800,,,,Wednesday
2015,8,5,1700,,,,Wednesday
2015,8,5,1600,,,,Wednesday
2015,8,5,1500,,,,Wednesday
2015,8,5,1400,,,,Wednesday
2015,8,5,1300,,,,Wednesday
2015,8,5,1200,,,,Wednesday
2015,8,5,1100,,,,Wednesday
2015,8,5,1000,,,,Wednesday
2015,8,5,900,,,,Wednesday
2015,8,5,800,,,,Wednesday
2015,8,5,700,,,,Wednesday
2015,8,5,600,,,,Wednesday
2015,8,5,500,,,,Wednesday
2015,8,5,400,,,,Wednesday
2015,8,5,300,,,,Wednesday
2015,8,5,200,,,,Wednesday
2015,8,5,100,,,,Wednesday
2015,8,4,2400,,,,Tuesday
2015,8,4,2300,,,,Tuesday
2015,8,4,2200,,,,Tuesday
2015,8,4,2100,,,,Tuesday
2015,8,4,2000,,,,Tuesday
2015,8,4,1900,,,,Tuesday
2015,8,4,1800,,,,Tuesday
2015,8,4,1700,,,,Tuesday
2015,8,4,1600,,,,Tuesday
2015,8,4,1500,,,,Tuesday
2015,8,4,1400,,,,Tuesday
2015,8,4,1300,,,,Tuesday
2015,8,4,1200,,,,Tuesday
2015,8,4,1100,,,,Tuesday
2015,8,4,1000,,,,Tuesday
2015,8,4,900,,,,Tuesday
2015,8,4,800,,,,Tuesday
2015,8,4,700,,,,Tuesday
2015,8,4,600,,,,Tuesday
2015,8,4,500,,,,Tuesday
2015,8,4,400,,,,Tuesday
2015,8,4,300,,,,Tuesday
2015,8,4,200,,,,Tuesday
2015,8,4,100,,,,Tuesday
2015,8,3,2400,,,,Monday
2015,8,3,2300,,,,Monday
2015,8,3,2200,,,,Monday
2015,8,3,2100,,,,Monday
2015,8,3,2000,,,,Monday
2015,8,3,1900,,,,Monday
2015,8,3,1800,,,,Monday
2015,8,3,1700,,,,Monday
2015,8,3,1600,,,,Monday
2015,8,3,1500,,,,Monday
2015,8,3,1400,,,,Monday
2015,8,3,1300,,,,Monday
2015,8,3,1200,,,,Monday
2015,8,3,1100,,,,Monday
2015,8,3,1000,,,,Monday
2015,8,3,900,,,,Monday
2015,8,3,800,,,,Monday
2015,8,3,700,,,,Monday
2015,8,3,600,,,,Monday
2015,8,3,500,,,,Monday
2015,8,3,400,,,,Monday
2015,8,3,300,,,,Monday
2015,8,3,200,,,,Monday
2015,8,3,100,,,,Monday
2015,8,2,2400,,,,Sunday
2015,8,2,2300,,,,Sunday
2015,8,2,2200,,,,Sunday
2015,8,2,2100,,,,Sunday
2015,8,2,2000,,,,Sunday
2015,8,2,1900,,,,Sunday
2015,8,2,1800,,,,Sunday
2015,8,2,1700,,,,Sunday
2015,8,2,1600,,,,Sunday
2015,8,2,1500,,,,Sunday
2015,8,2,1400,,,,Sunday
2015,8,2,1300,,,,Sunday
2015,8,2,1200,,,,Sunday
2015,8,2,1100,,,,Sunday
2015,8,2,1000,,,,Sunday
2015,8,2,900,,,,Sunday
2015,8,2,800,,,,Sunday
2015,8,2,700,,,,Sunday
2015,8,2,600,,,,Sunday
2015,8,2,500,,,,Sunday
2015,8,2,400,,,,Sunday
2015,8,2,300,,,,Sunday
2015,8,2,200,,,,Sunday
2015,8,2,100,,,,Sunday
2015,8,1,2400,,,,Saturday
2015,8,1,2300,,,,Saturday
2015,8,1,2200,,,,Saturday
2015,8,1,2100,,,,Saturday
2015,8,1,2000,,,,Saturday
2015,8,1,1900,,,,Saturday
2015,8,1,1800,,,,Saturday
2015,8,1,1700,,,,Saturday
2015,8,1,1600,,,,Saturday
2015,8,1,1500,,,,Saturday
2015,8,1,1400,,,,Saturday
2015,8,1,1300,,,,Saturday
2015,8,1,1200,,,,Saturday
2015,8,1,1100,,,,Saturday
2015,8,1,1000,,,,Saturday
2015,8,1,900,,,,Saturday
2015,8,1,800,,,,Saturday
2015,8,1,700,,,,Saturday
2015,8,1,600,,,,Saturday
2015,8,1,500,,,,Saturday
2015,8,1,400,,,,Saturday
2015,8,1,300,,,,Saturday
2015,8,1,200,,,,Saturday
2015,8,1,100,,,,Saturday
2015,7,31,2400,,,,Friday
2015,7,31,2300,,,,Friday
2015,7,31,2200,,,,Friday
2015,7,31,2100,,,,Friday
2015,7,31,2000,,,,Friday
2015,7,31,1900,,,,Friday
2015,7,31,1800,,,,Friday
2015,7,31,1700,,,,Friday
2015,7,31,1600,,,,Friday
2015,7,31,1500,,,,Friday
2015,7,31,1400,,,,Friday
2015,7,31,1300,,,,Friday
2015,7,31,1200,,,,Friday
2015,7,31,1100,,,,Friday
2015,7,31,1000,,,,Friday
2015,7,31,900,,,,Friday
2015,7,31,800,,,,Friday
2015,7,31,700,,,,Friday
2015,7,31,600,,,,Friday
2015,7,31,500,,,,Friday
2015,7,31,400,,,,Friday
2015,7,31,300,,,,Friday
2015,7,31,200,,,,Friday
2015,7,31,100,,,,Friday
2015,7,30,2400,,,,Thursday
2015,7,30,2300,,,,Thursday
2015,7,30,2200,,,,Thursday
2015,7,30,2100,,,,Thursday
2015,7,30,2000,,,,Thursday
2015,7,30,1900,,,,Thursday
2015,7,30,1800,,,,Thursday
2015,7,30,1700,,,,Thursday
2015,7,30,1600,,,,Thursday
2015,7,30,1500,,,,Thursday
2015,7,30,1400,,,,Thursday
2015,7,30,1300,,,,Thursday
2015,7,30,1200,,,,Thursday
2015,7,30,1100,,,,Thursday
2015,7,30,1000,,,,Thursday
2015,7,30,900,,,,Thursday
2015,7,30,800,,,,Thursday
2015,7,30,700,,,,Thursday
2015,7,30,600,,,,Thursday
2015,7,30,500,,,,Thursday
2015,7,30,400,,,,Thursday
2015,7,30,300,,,,Thursday
2015,7,30,200,,,,Thursday
2015,7,30,100,,,,Thursday
2015,7,29,2400,,,,Wednesday
2015,7,29,2300,,,,Wednesday
2015,7,29,2200,,,,Wednesday
2015,7,29,2100,,,,Wednesday
2015,7,29,2000,,,,Wednesday
2015,7,29,1900,,,,Wednesday
2015,7,29,1800,,,,Wednesday
2015,7,29,1700,,,,Wednesday
2015,7,29,1600,,,,Wednesday
2015,7,29,1500,,,,Wednesday
2015,7,29,1400,,,,Wednesday
2015,7,29,1300,,,,Wednesday
2015,7,29,1200,,,,Wednesday
2015,7,29,1100,,,,Wednesday
2015,7,29,1000,,,,Wednesday
2015,7,29,900,,,,Wednesday
2015,7,29,800,,,,Wednesday
2015,7,29,700,,,,Wednesday
2015,7,29,600,,,,Wednesday
2015,7,29,500,,,,Wednesday
2015,7,29,400,,,,Wednesday
2015,7,29,300,,,,Wednesday
2015,7,29,200,,,,Wednesday
2015,7,29,100,,,,Wednesday
2015,7,28,2400,,,,Tuesday
2015,7,28,2300,,,,Tuesday
2015,7,28,2200,,,,Tuesday
2015,7,28,2100,,,,Tuesday
2015,7,28,2000,,,,Tuesday
2015,7,28,1900,,,,Tuesday
2015,7,28,1800,,,,Tuesday
2015,7,28,1700,,,,Tuesday
2015,7,28,1600,,,,Tuesday
2015,7,28,1500,,,,Tuesday
2015,7,28,1400,,,,Tuesday
2015,7,28,1300,,,,Tuesday
2015,7,28,1200,,,,Tuesday
2015,7,28,1100,,,,Tuesday
2015,7,28,1000,,,,Tuesday
2015,7,28,900,,,,Tuesday
2015,7,28,800,,,,Tuesday
2015,7,28,700,,,,Tuesday
2015,7,28,600,,,,Tuesday
2015,7,28,500,,,,Tuesday
2015,7,28,400,,,,Tuesday
2015,7,28,300,,,,Tuesday
2015,7,28,200,,,,Tuesday
2015,7,28,100,,,,Tuesday
2015,7,27,2400,,,,Monday
2015,7,27,2300,,,,Monday
2015,7,27,2200,,,,Monday
2015,7,27,2100,,,,Monday
2015,7,27,2000,,,,Monday
2015,7,27,1900,,,,Monday
2015,7,27,1800,,,,Monday
2015,7,27,1700,,,,Monday
2015,7,27,1600,,,,Monday
2015,7,27,1500,,,,Monday
2015,7,27,1400,,,,Monday
2015,7,27,1300,,,,Monday
2015,7,27,1200,,,,Monday
2015,7,27,1100,,,,Monday
2015,7,27,1000,,,,Monday
2015,7,27,900,,,,Monday
2015,7,27,800,,,,Monday
2015,7,27,700,,,,Monday
2015,7,27,600,,,,Monday
2015,7,27,500,,,,Monday
2015,7,27,400,,,,Monday
2015,7,27,300,,,,Monday
2015,7,27,200,,,,Monday
2015,7,27,100,,,,Monday
2015,7,26,2400,,,,Sunday
2015,7,26,2300,,,,Sunday
2015,7,26,2200,,,,Sunday
2015,7,26,2100,,,,Sunday
2015,7,26,2000,,,,Sunday
2015,7,26,1900,,,,Sunday
2015,7,26,1800,,,,Sunday
2015,7,26,1700,,,,Sunday
2015,7,26,1600,,,,Sunday
2015,7,26,1500,,,,Sunday
2015,7,26,1400,,,,Sunday
2015,7,26,1300,,,,Sunday
2015,7,26,1200,,,,Sunday
2015,7,26,1100,,,,Sunday
2015,7,26,1000,,,,Sunday
2015,7,26,900,,,,Sunday
2015,7,26,800,,,,Sunday
2015,7,26,700,,,,Sunday
2015,7,26,600,,,,Sunday
2015,7,26,500,,,,Sunday
2015,7,26,400,,,,Sunday
2015,7,26,300,,,,Sunday
2015,7,26,200,,,,Sunday
2015,7,26,100,,,,Sunday
2015,7,25,2400,,,,Saturday
2015,7,25,2300,,,,Saturday
2015,7,25,2200,,,,Saturday
2015,7,25,2100,,,,Saturday
2015,7,25,2000,,,,Saturday
2015,7,25,1900,,,,Saturday
2015,7,25,1800,,,,Saturday
2015,7,25,1700,,,,Saturday
2015,7,25,1600,,,,Saturday
2015,7,25,1500,,,,Saturday
2015,7,25,1400,,,,Saturday
2015,7,25,1300,,,,Saturday
2015,7,25,1200,,,,Saturday
2015,7,25,1100,,,,Saturday
2015,7,25,1000,,,,Saturday
2015,7,25,900,,,,Saturday
2015,7,25,800,,,,Saturday
2015,7,25,700,,,,Saturday
2015,7,25,600,,,,Saturday
2015,7,25,500,,,,Saturday
2015,7,25,400,,,,Saturday
2015,7,25,300,,,,Saturday
2015,7,25,200,,,,Saturday
2015,7,25,100,,,,Saturday
2015,7,24,2400,,,,Friday
2015,7,24,2300,,,,Friday
2015,7,24,2200,,,,Friday
2015,7,24,2100,,,,Friday
2015,7,24,2000,,,,Friday
2015,7,24,1900,,,,Friday
2015,7,24,1800,,,,Friday
2015,7,24,1700,,,,Friday
2015,7,24,1600,,,,Friday
2015,7,24,1500,,,,Friday
2015,7,24,1400,,,,Friday
2015,7,24,1300,,,,Friday
2015,7,24,1200,,,,Friday
2015,7,24,1100,,,,Friday
2015,7,24,1000,,,,Friday
2015,7,24,900,,,,Friday
2015,7,24,800,,,,Friday
2015,7,24,700,,,,Friday
2015,7,24,600,,,,Friday
2015,7,24,500,,,,Friday
2015,7,24,400,,,,Friday
2015,7,24,300,,,,Friday
2015,7,24,200,,,,Friday
2015,7,24,100,,,,Friday
2015,7,23,2400,,,,Thursday
2015,7,23,2300,,,,Thursday
2015,7,23,2200,,,,Thursday
2015,7,23,2100,,,,Thursday
2015,7,23,2000,,,,Thursday
2015,7,23,1900,,,,Thursday
2015,7,23,1800,,,,Thursday
2015,7,23,1700,,,,Thursday
2015,7,23,1600,,,,Thursday
2015,7,23,1500,,,,Thursday
2015,7,23,1400,,,,Thursday
2015,7,23,1300,,,,Thursday
2015,7,23,1200,,,,Thursday
2015,7,23,1100,,,,Thursday
2015,7,23,1000,,,,Thursday
2015,7,23,900,,,,Thursday
2015,7,23,800,,,,Thursday
2015,7,23,700,,,,Thursday
2015,7,23,600,,,,Thursday
2015,7,23,500,,,,Thursday
2015,7,23,400,,,,Thursday
2015,7,23,300,,,,Thursday
2015,7,23,200,,,,Thursday
2015,7,23,100,,,,Thursday
2015,7,22,2400,,,,Wednesday
2015,7,22,2300,,,,Wednesday
2015,7,22,2200,,,,Wednesday
2015,7,22,2100,,,,Wednesday
2015,7,22,2000,,,,Wednesday
2015,7,22,1900,,,,Wednesday
2015,7,22,1800,,,,Wednesday
2015,7,22,1700,,,,Wednesday
2015,7,22,1600,,,,Wednesday
2015,7,22,1500,,,,Wednesday
2015,7,22,1400,,,,Wednesday
2015,7,22,1300,,,,Wednesday
2015,7,22,1200,,,,Wednesday
2015,7,22,1100,,,,Wednesday
2015,7,22,1000,,,,Wednesday
2015,7,22,900,,,,Wednesday
2015,7,22,800,,,,Wednesday
2015,7,22,700,,,,Wednesday
2015,7,22,600,,,,Wednesday
2015,7,22,500,,,,Wednesday
2015,7,22,400,,,,Wednesday
2015,7,22,300,,,,Wednesday
2015,7,22,200,,,,Wednesday
2015,7,22,100,,,,Wednesday
2015,7,21,2400,,,,Tuesday
2015,7,21,2300,,,,Tuesday
2015,7,21,2200,,,,Tuesday
2015,7,21,2100,,,,Tuesday
2015,7,21,2000,,,,Tuesday
2015,7,21,1900,,,,Tuesday
2015,7,21,1800,,,,Tuesday
2015,7,21,1700,,,,Tuesday
2015,7,21,1600,,,,Tuesday
2015,7,21,1500,,,,Tuesday
2015,7,21,1400,,,,Tuesday
2015,7,21,1300,,,,Tuesday
2015,7,21,1200,,,,Tuesday
2015,7,21,1100,,,,Tuesday
2015,7,21,1000,,,,Tuesday
2015,7,21,900,,,,Tuesday
2015,7,21,800,,,,Tuesday
2015,7,21,700,,,,Tuesday
2015,7,21,600,,,,Tuesday
2015,7,21,500,,,,Tuesday
2015,7,21,400,,,,Tuesday
2015,7,21,300,,,,Tuesday
2015,7,21,200,,,,Tuesday
2015,7,21,100,,,,Tuesday
2015,7,20,2400,,,,Monday
2015,7,20,2300,,,,Monday
2015,7,20,2200,,,,Monday
2015,7,20,2100,,,,Monday
2015,7,20,2000,,,,Monday
2015,7,20,1900,,,,Monday
2015,7,20,1800,,,,Monday
2015,7,20,1700,,,,Monday
2015,7,20,1600,,,,Monday
2015,7,20,1500,,,,Monday
2015,7,20,1400,,,,Monday
2015,7,20,1300,,,,Monday
2015,7,20,1200,,,,Monday
2015,7,20,1100,,,,Monday
2015,7,20,1000,,,,Monday
2015,7,20,900,,,,Monday
2015,7,20,800,83,,,Monday
2015,7,20,700,198,93,291,Monday
2015,7,20,600,65,53,118,Monday
2015,7,20,500,39,29,68,Monday
2015,7,20,400,27,37,64,Monday
2015,7,20,300,36,49,85,Monday
2015,7,20,200,29,78,107,Monday
2015,7,20,100,37,144,181,Monday
2015,7,19,2400,63,263,326,Sunday
2015,7,19,2300,88,417,505,Sunday
2015,7,19,2200,139,803,942,Sunday
2015,7,19,2100,188,1169,1357,Sunday
2015,7,19,2000,241,1418,1659,Sunday
2015,7,19,1900,341,1862,2203,Sunday
2015,7,19,1800,416,2206,2622,Sunday
2015,7,19,1700,552,2067,2619,Sunday
2015,7,19,1600,721,1704,2425,Sunday
2015,7,19,1500,867,1425,2292,Sunday
2015,7,19,1400,1066,1230,2296,Sunday
2015,7,19,1300,1094,1008,2102,Sunday
2015,7,19,1200,1168,763,1931,Sunday
2015,7,19,1100,1224,493,1717,Sunday
2015,7,19,1000,1058,236,1294,Sunday
2015,7,19,900,752,143,895,Sunday
2015,7,19,800,370,74,444,Sunday
2015,7,19,700,162,39,201,Sunday
2015,7,19,600,55,23,78,Sunday
2015,7,19,500,35,29,64,Sunday
2015,7,19,400,22,31,53,Sunday
2015,7,19,300,27,39,66,Sunday
2015,7,19,200,32,59,91,Sunday
2015,7,19,100,41,95,136,Sunday
2015,7,18,2400,74,175,249,Saturday
2015,7,18,2300,128,299,427,Saturday
2015,7,18,2200,141,632,773,Saturday
2015,7,18,2100,192,911,1103,Saturday
2015,7,18,2000,264,1093,1357,Saturday
2015,7,18,1900,341,1202,1543,Saturday
2015,7,18,1800,489,1306,1795,Saturday
2015,7,18,1700,583,1215,1798,Saturday
2015,7,18,1600,876,984,1860,Saturday
2015,7,18,1500,1074,787,1861,Saturday
2015,7,18,1400,1049,627,1676,Saturday
2015,7,18,1300,1263,512,1775,Saturday
2015,7,18,1200,1396,451,1847,Saturday
2015,7,18,1100,1493,327,1820,Saturday
2015,7,18,1000,1395,230,1625,Saturday
2015,7,18,900,1031,121,1152,Saturday
2015,7,18,800,517,112,629,Saturday
2015,7,18,700,229,70,299,Saturday
2015,7,18,600,124,43,167,Saturday
2015,7,18,500,59,34,93,Saturday
2015,7,18,400,51,39,90,Saturday
2015,7,18,300,33,41,74,Saturday
2015,7,18,200,55,59,114,Saturday
2015,7,18,100,79,97,176,Saturday
2015,7,17,2400,121,130,251,Friday
2015,7,17,2300,215,210,425,Friday
2015,7,17,2200,341,298,639,Friday
2015,7,17,2100,587,473,1060,Friday
2015,7,17,2000,862,638,1500,Friday
2015,7,17,1900,1023,824,1847,Friday
2015,7,17,1800,1085,881,1966,Friday
2015,7,17,1700,1082,864,1946,Friday
2015,7,17,1600,1106,800,1906,Friday
2015,7,17,1500,1111,715,1826,Friday
2015,7,17,1400,1020,621,1641,Friday
2015,7,17,1300,1163,584,1747,Friday
2015,7,17,1200,1237,458,1695,Friday
2015,7,17,1100,1154,324,1478,Friday
2015,7,17,1000,996,242,1238,Friday
2015,7,17,900,718,156,874,Friday
2015,7,17,800,427,103,530,Friday
2015,7,17,700,209,62,271,Friday
2015,7,17,600,78,54,132,Friday
2015,7,17,500,52,40,92,Friday
2015,7,17,400,38,39,77,Friday
2015,7,17,300,57,40,97,Friday
2015,7,17,200,47,68,115,Friday
2015,7,17,100,70,69,139,Friday
2015,7,16,2400,102,126,228,Thursday
2015,7,16,2300,144,189,333,Thursday
2015,7,16,2200,224,263,487,Thursday
2015,7,16,2100,372,424,796,Thursday
2015,7,16,2000,512,617,1129,Thursday
2015,7,16,1900,602,694,1296,Thursday
2015,7,16,1800,583,848,1431,Thursday
2015,7,16,1700,630,892,1522,Thursday
2015,7,16,1600,730,725,1455,Thursday
2015,7,16,1500,797,692,1489,Thursday
2015,7,16,1400,762,482,1244,Thursday
2015,7,16,1300,962,494,1456,Thursday
2015,7,16,1200,998,441,1439,Thursday
2015,7,16,1100,1047,341,1388,Thursday
2015,7,16,1000,861,195,1056,Thursday
2015,7,16,900,638,150,788,Thursday
2015,7,16,800,363,106,469,Thursday
2015,7,16,700,192,72,264,Thursday
2015,7,16,600,86,45,131,Thursday
2015,7,16,500,49,31,80,Thursday
2015,7,16,400,49,28,77,Thursday
2015,7,16,300,52,53,105,Thursday
2015,7,16,200,50,58,108,Thursday
2015,7,16,100,85,79,164,Thursday
2015,7,15,2400,119,115,234,Wednesday
2015,7,15,2300,143,187,330,Wednesday
2015,7,15,2200,180,303,483,Wednesday
2015,7,15,2100,261,440,701,Wednesday
2015,7,15,2000,326,652,978,Wednesday
2015,7,15,1900,336,837,1173,Wednesday
2015,7,15,1800,438,915,1353,Wednesday
2015,7,15,1700,481,876,1357,Wednesday
2015,7,15,1600,565,782,1347,Wednesday
2015,7,15,1500,616,692,1308,Wednesday
2015,7,15,1400,633,562,1195,Wednesday
2015,7,15,1300,819,466,1285,Wednesday
2015,7,15,1200,962,378,1340,Wednesday
2015,7,15,1100,1048,273,1321,Wednesday
2015,7,15,1000,958,203,1161,Wednesday
2015,7,15,900,753,157,910,Wednesday
2015,7,15,800,421,120,541,Wednesday
2015,7,15,700,186,51,237,Wednesday
2015,7,15,600,102,42,144,Wednesday
2015,7,15,500,52,37,89,Wednesday
2015,7,15,400,50,51,101,Wednesday
2015,7,15,300,58,37,95,Wednesday
2015,7,15,200,42,52,94,Wednesday
2015,7,15,100,40,97,137,Wednesday
2015,7,14,2400,108,126,234,Tuesday
2015,7,14,2300,136,201,337,Tuesday
2015,7,14,2200,198,342,540,Tuesday
2015,7,14,2100,217,498,715,Tuesday
2015,7,14,2000,273,635,908,Tuesday
2015,7,14,1900,281,809,1090,Tuesday
2015,7,14,1800,355,1020,1375,Tuesday
2015,7,14,1700,463,883,1346,Tuesday
2015,7,14,1600,522,716,1238,Tuesday
2015,7,14,1500,575,642,1217,Tuesday
2015,7,14,1400,630,551,1181,Tuesday
2015,7,14,1300,818,474,1292,Tuesday
2015,7,14,1200,969,384,1353,Tuesday
2015,7,14,1100,1043,262,1305,Tuesday
2015,7,14,1000,895,235,1130,Tuesday
2015,7,14,900,604,138,742,Tuesday
2015,7,14,800,356,99,455,Tuesday
2015,7,14,700,148,59,207,Tuesday
2015,7,14,600,66,39,105,Tuesday
2015,7,14,500,36,39,75,Tuesday
2015,7,14,400,24,42,66,Tuesday
2015,7,14,300,35,57,92,Tuesday
2015,7,14,200,38,56,94,Tuesday
2015,7,14,100,49,86,135,Tuesday
2015,7,13,2400,86,139,225,Monday
2015,7,13,2300,99,242,341,Monday
2015,7,13,2200,147,296,443,Monday
2015,7,13,2100,168,570,738,Monday
2015,7,13,2000,233,683,916,Monday
2015,7,13,1900,328,853,1181,Monday
2015,7,13,1800,353,1034,1387,Monday
2015,7,13,1700,499,1123,1622,Monday
2015,7,13,1600,666,939,1605,Monday
2015,7,13,1500,778,817,1595,Monday
2015,7,13,1400,861,699,1560,Monday
2015,7,13,1300,1016,602,1618,Monday
2015,7,13,1200,1188,454,1642,Monday
2015,7,13,1100,1169,314,1483,Monday
2015,7,13,1000,960,234,1194,Monday
2015,7,13,900,700,166,866,Monday
2015,7,13,800,429,137,566,Monday
2015,7,13,700,168,96,264,Monday
2015,7,13,600,59,48,107,Monday
2015,7,13,500,36,23,59,Monday
2015,7,13,400,38,34,72,Monday
2015,7,13,300,27,39,66,Monday
2015,7,13,200,28,60,88,Monday
2015,7,13,100,49,119,168,Monday
2015,7,12,2400,61,193,254,Sunday
2015,7,12,2300,106,320,426,Sunday
2015,7,12,2200,132,440,572,Sunday
2015,7,12,2100,218,873,1091,Sunday
2015,7,12,2000,246,1035,1281,Sunday
2015,7,12,1900,299,1229,1528,Sunday
2015,7,12,1800,441,1465,1906,Sunday
2015,7,12,1700,543,1456,1999,Sunday
2015,7,12,1600,720,1270,1990,Sunday
2015,7,12,1500,870,1225,2095,Sunday
2015,7,12,1400,892,1181,2073,Sunday
2015,7,12,1300,1033,953,1986,Sunday
2015,7,12,1200,1063,668,1731,Sunday
2015,7,12,1100,1049,438,1487,Sunday
2015,7,12,1000,987,248,1235,Sunday
2015,7,12,900,674,119,793,Sunday
2015,7,12,800,299,65,364,Sunday
2015,7,12,700,147,40,187,Sunday
2015,7,12,600,62,19,81,Sunday
2015,7,12,500,30,20,50,Sunday
2015,7,12,400,24,20,44,Sunday
2015,7,12,300,22,26,48,Sunday
2015,7,12,200,22,44,66,Sunday
2015,7,12,100,44,90,134,Sunday
2015,7,11,2400,55,131,186,Saturday
2015,7,11,2300,97,200,297,Saturday
2015,7,11,2200,119,324,443,Saturday
2015,7,11,2100,179,599,778,Saturday
2015,7,11,2000,230,878,1108,Saturday
2015,7,11,1900,279,998,1277,Saturday
2015,7,11,1800,380,1163,1543,Saturday
2015,7,11,1700,517,1119,1636,Saturday
2015,7,11,1600,678,896,1574,Saturday
2015,7,11,1500,879,781,1660,Saturday
2015,7,11,1400,1078,674,1752,Saturday
2015,7,11,1300,986,620,1606,Saturday
2015,7,11,1200,1201,410,1611,Saturday
2015,7,11,1100,1375,335,1710,Saturday
2015,7,11,1000,1196,251,1447,Saturday
2015,7,11,900,966,147,1113,Saturday
2015,7,11,800,498,93,591,Saturday
2015,7,11,700,227,60,287,Saturday
2015,7,11,600,85,45,130,Saturday
2015,7,11,500,44,36,80,Saturday
2015,7,11,400,32,27,59,Saturday
2015,7,11,300,45,42,87,Saturday
2015,7,11,200,43,60,103,Saturday
2015,7,11,100,77,103,180,Saturday
2015,7,10,2400,125,161,286,Friday
2015,7,10,2300,159,185,344,Friday
2015,7,10,2200,304,279,583,Friday
2015,7,10,2100,463,466,929,Friday
2015,7,10,2000,731,619,1350,Friday
2015,7,10,1900,827,800,1627,Friday
2015,7,10,1800,831,1139,1970,Friday
2015,7,10,1700,1007,1084,2091,Friday
2015,7,10,1600,998,935,1933,Friday
2015,7,10,1500,1108,744,1852,Friday
2015,7,10,1400,1223,609,1832,Friday
2015,7,10,1300,860,576,1436,Friday
2015,7,10,1200,1001,490,1491,Friday
2015,7,10,1100,1082,369,1451,Friday
2015,7,10,1000,1032,241,1273,Friday
2015,7,10,900,781,168,949,Friday
2015,7,10,800,433,100,533,Friday
2015,7,10,700,217,61,278,Friday
2015,7,10,600,92,53,145,Friday
2015,7,10,500,45,44,89,Friday
2015,7,10,400,48,43,91,Friday
2015,7,10,300,45,49,94,Friday
2015,7,10,200,59,61,120,Friday
2015,7,10,100,59,111,170,Friday
2015,7,9,2400,114,159,273,Thursday
2015,7,9,2300,132,225,357,Thursday
2015,7,9,2200,256,344,600,Thursday
2015,7,9,2100,328,521,849,Thursday
2015,7,9,2000,420,700,1120,Thursday
2015,7,9,1900,460,886,1346,Thursday
2015,7,9,1800,530,864,1394,Thursday
2015,7,9,1700,586,1037,1623,Thursday
2015,7,9,1600,722,838,1560,Thursday
2015,7,9,1500,814,793,1607,Thursday
2015,7,9,1400,987,589,1576,Thursday
2015,7,9,1300,756,553,1309,Thursday
2015,7,9,1200,937,385,1322,Thursday
2015,7,9,1100,1018,342,1360,Thursday
2015,7,9,1000,888,222,1110,Thursday
2015,7,9,900,723,167,890,Thursday
2015,7,9,800,374,104,478,Thursday
2015,7,9,700,161,63,224,Thursday
2015,7,9,600,89,38,127,Thursday
2015,7,9,500,46,35,81,Thursday
2015,7,9,400,35,50,85,Thursday
2015,7,9,300,35,57,92,Thursday
2015,7,9,200,47,63,110,Thursday
2015,7,9,100,55,99,154,Thursday
2015,7,8,2400,87,149,236,Wednesday
2015,7,8,2300,121,228,349,Wednesday
2015,7,8,2200,164,326,490,Wednesday
2015,7,8,2100,213,526,739,Wednesday
2015,7,8,2000,267,633,900,Wednesday
2015,7,8,1900,332,904,1236,Wednesday
2015,7,8,1800,375,912,1287,Wednesday
2015,7,8,1700,461,937,1398,Wednesday
2015,7,8,1600,510,782,1292,Wednesday
2015,7,8,1500,615,671,1286,Wednesday
2015,7,8,1400,723,572,1295,Wednesday
2015,7,8,1300,712,487,1199,Wednesday
2015,7,8,1200,968,408,1376,Wednesday
2015,7,8,1100,994,337,1331,Wednesday
2015,7,8,1000,801,214,1015,Wednesday
2015,7,8,900,627,155,782,Wednesday
2015,7,8,800,315,93,408,Wednesday
2015,7,8,700,121,78,199,Wednesday
2015,7,8,600,69,48,117,Wednesday
2015,7,8,500,36,31,67,Wednesday
2015,7,8,400,34,54,88,Wednesday
2015,7,8,300,25,46,71,Wednesday
2015,7,8,200,36,63,99,Wednesday
2015,7,8,100,56,98,154,Wednesday
2015,7,7,2400,66,116,182,Tuesday
2015,7,7,2300,124,188,312,Tuesday
2015,7,7,2200,144,309,453,Tuesday
2015,7,7,2100,211,501,712,Tuesday
2015,7,7,2000,254,864,1118,Tuesday
2015,7,7,1900,278,1025,1303,Tuesday
2015,7,7,1800,314,758,1072,Tuesday
2015,7,7,1700,383,777,1160,Tuesday
2015,7,7,1600,522,616,1138,Tuesday
2015,7,7,1500,627,601,1228,Tuesday
2015,7,7,1400,608,497,1105,Tuesday
2015,7,7,1300,683,477,1160,Tuesday
2015,7,7,1200,864,399,1263,Tuesday
2015,7,7,1100,870,313,1183,Tuesday
2015,7,7,1000,767,230,997,Tuesday
2015,7,7,900,519,186,705,Tuesday
2015,7,7,800,287,98,385,Tuesday
2015,7,7,700,159,74,233,Tuesday
2015,7,7,600,69,54,123,Tuesday
2015,7,7,500,37,34,71,Tuesday
2015,7,7,400,30,37,67,Tuesday
2015,7,7,300,26,50,76,Tuesday
2015,7,7,200,36,62,98,Tuesday
2015,7,7,100,43,87,130,Tuesday
2015,7,6,2400,74,157,231,Monday
2015,7,6,2300,110,227,337,Monday
2015,7,6,2200,145,458,603,Monday
2015,7,6,2100,180,565,745,Monday
2015,7,6,2000,235,840,1075,Monday
2015,7,6,1900,304,1057,1361,Monday
2015,7,6,1800,354,1167,1521,Monday
2015,7,6,1700,493,1154,1647,Monday
2015,7,6,1600,551,996,1547,Monday
2015,7,6,1500,686,770,1456,Monday
2015,7,6,1400,806,732,1538,Monday
2015,7,6,1300,1013,633,1646,Monday
2015,7,6,1200,992,537,1529,Monday
2015,7,6,1100,1126,404,1530,Monday
2015,7,6,1000,930,282,1212,Monday
2015,7,6,900,632,229,861,Monday
2015,7,6,800,360,160,520,Monday
2015,7,6,700,171,108,279,Monday
2015,7,6,600,86,47,133,Monday
2015,7,6,500,34,37,71,Monday
2015,7,6,400,21,37,58,Monday
2015,7,6,300,20,54,74,Monday
2015,7,6,200,37,83,120,Monday
2015,7,6,100,44,159,203,Monday
2015,7,5,2400,52,320,372,Sunday
2015,7,5,2300,93,877,970,Sunday
2015,7,5,2200,142,1376,1518,Sunday
2015,7,5,2100,196,1673,1869,Sunday
2015,7,5,2000,252,1903,2155,Sunday
2015,7,5,1900,272,1952,2224,Sunday
2015,7,5,1800,413,1567,1980,Sunday
2015,7,5,1700,523,1654,2177,Sunday
2015,7,5,1600,649,1134,1783,Sunday
2015,7,5,1500,728,1204,1932,Sunday
2015,7,5,1400,904,1462,2366,Sunday
2015,7,5,1300,1038,1317,2355,Sunday
2015,7,5,1200,1196,938,2134,Sunday
2015,7,5,1100,1094,614,1708,Sunday
2015,7,5,1000,916,334,1250,Sunday
2015,7,5,900,652,154,806,Sunday
2015,7,5,800,338,66,404,Sunday
2015,7,5,700,165,35,200,Sunday
2015,7,5,600,59,27,86,Sunday
2015,7,5,500,34,13,47,Sunday
2015,7,5,400,21,27,48,Sunday
2015,7,5,300,19,44,63,Sunday
2015,7,5,200,31,74,105,Sunday
2015,7,5,100,37,113,150,Sunday
2015,7,4,2400,61,229,290,Saturday
2015,7,4,2300,81,323,404,Saturday
2015,7,4,2200,120,521,641,Saturday
2015,7,4,2100,181,851,1032,Saturday
2015,7,4,2000,237,1124,1361,Saturday
2015,7,4,1900,321,1289,1610,Saturday
2015,7,4,1800,368,1315,1683,Saturday
2015,7,4,1700,507,1338,1845,Saturday
2015,7,4,1600,662,1151,1813,Saturday
2015,7,4,1500,789,892,1681,Saturday
2015,7,4,1400,931,802,1733,Saturday
2015,7,4,1300,1095,701,1796,Saturday
2015,7,4,1200,1351,580,1931,Saturday
2015,7,4,1100,1258,367,1625,Saturday
2015,7,4,1000,1160,258,1418,Saturday
2015,7,4,900,816,177,993,Saturday
2015,7,4,800,415,102,517,Saturday
2015,7,4,700,192,62,254,Saturday
2015,7,4,600,81,43,124,Saturday
2015,7,4,500,44,26,70,Saturday
2015,7,4,400,39,35,74,Saturday
2015,7,4,300,33,38,71,Saturday
2015,7,4,200,41,60,101,Saturday
2015,7,4,100,64,92,156,Saturday
2015,7,3,2400,107,165,272,Friday
2015,7,3,2300,177,258,435,Friday
2015,7,3,2200,283,413,696,Friday
2015,7,3,2100,445,590,1035,Friday
2015,7,3,2000,509,762,1271,Friday
2015,7,3,1900,668,1355,2023,Friday
2015,7,3,1800,695,1199,1894,Friday
2015,7,3,1700,843,1079,1922,Friday
2015,7,3,1600,935,854,1789,Friday
2015,7,3,1500,971,763,1734,Friday
2015,7,3,1400,992,739,1731,Friday
2015,7,3,1300,1089,598,1687,Friday
2015,7,3,1200,1315,529,1844,Friday
2015,7,3,1100,1248,390,1638,Friday
2015,7,3,1000,1101,257,1358,Friday
2015,7,3,900,733,187,920,Friday
2015,7,3,800,461,120,581,Friday
2015,7,3,700,205,63,268,Friday
2015,7,3,600,89,51,140,Friday
2015,7,3,500,54,35,89,Friday
2015,7,3,400,33,42,75,Friday
2015,7,3,300,41,62,103,Friday
2015,7,3,200,48,87,135,Friday
2015,7,3,100,68,114,182,Friday
2015,7,2,2400,97,194,291,Thursday
2015,7,2,2300,161,341,502,Thursday
2015,7,2,2200,242,489,731,Thursday
2015,7,2,2100,352,577,929,Thursday
2015,7,2,2000,464,893,1357,Thursday
2015,7,2,1900,481,1056,1537,Thursday
2015,7,2,1800,588,1127,1715,Thursday
2015,7,2,1700,672,1087,1759,Thursday
2015,7,2,1600,731,899,1630,Thursday
2015,7,2,1500,852,834,1686,Thursday
2015,7,2,1400,898,658,1556,Thursday
2015,7,2,1300,1038,694,1732,Thursday
2015,7,2,1200,1268,436,1704,Thursday
2015,7,2,1100,1195,265,1460,Thursday
2015,7,2,1000,999,163,1162,Thursday
2015,7,2,900,719,150,869,Thursday
2015,7,2,800,363,86,449,Thursday
2015,7,2,700,179,43,222,Thursday
2015,7,2,600,74,19,93,Thursday
2015,7,2,500,37,14,51,Thursday
2015,7,2,400,23,34,57,Thursday
2015,7,2,300,31,32,63,Thursday
2015,7,2,200,32,57,89,Thursday
2015,7,2,100,49,86,135,Thursday
2015,7,1,2400,99,137,236,Wednesday
2015,7,1,2300,91,229,320,Wednesday
2015,7,1,2200,125,489,614,Wednesday
2015,7,1,2100,185,684,869,Wednesday
2015,7,1,2000,238,925,1163,Wednesday
2015,7,1,1900,331,1080,1411,Wednesday
2015,7,1,1800,340,1185,1525,Wednesday
2015,7,1,1700,507,1238,1745,Wednesday
2015,7,1,1600,635,1089,1724,Wednesday
2015,7,1,1500,827,958,1785,Wednesday
2015,7,1,1400,973,780,1753,Wednesday
2015,7,1,1300,1254,622,1876,Wednesday
2015,7,1,1200,1484,433,1917,Wednesday
2015,7,1,1100,1562,297,1859,Wednesday
2015,7,1,1000,1410,198,1608,Wednesday
2015,7,1,900,981,131,1112,Wednesday
2015,7,1,800,612,86,698,Wednesday
2015,7,1,700,276,59,335,Wednesday
2015,7,1,600,125,50,175,Wednesday
2015,7,1,500,52,33,85,Wednesday
2015,7,1,400,43,40,83,Wednesday
2015,7,1,300,53,58,111,Wednesday
2015,7,1,200,55,58,113,Wednesday
2015,7,1,100,84,74,158,Wednesday
2015,6,30,2400,135,125,260,Tuesday
2015,6,30,2300,213,218,431,Tuesday
2015,6,30,2200,355,306,661,Tuesday
2015,6,30,2100,471,509,980,Tuesday
2015,6,30,2000,678,633,1311,Tuesday
2015,6,30,1900,692,840,1532,Tuesday
2015,6,30,1800,740,960,1700,Tuesday
2015,6,30,1700,726,848,1574,Tuesday
2015,6,30,1600,787,845,1632,Tuesday
2015,6,30,1500,749,656,1405,Tuesday
2015,6,30,1400,741,575,1316,Tuesday
2015,6,30,1300,752,469,1221,Tuesday
2015,6,30,1200,996,370,1366,Tuesday
2015,6,30,1100,1047,286,1333,Tuesday
2015,6,30,1000,806,201,1007,Tuesday
2015,6,30,900,642,144,786,Tuesday
2015,6,30,800,365,88,453,Tuesday
2015,6,30,700,137,70,207,Tuesday
2015,6,30,600,70,51,121,Tuesday
2015,6,30,500,38,52,90,Tuesday
2015,6,30,400,24,47,71,Tuesday
2015,6,30,300,30,53,83,Tuesday
2015,6,30,200,39,58,97,Tuesday
2015,6,30,100,59,84,143,Tuesday
2015,6,29,2400,87,146,233,Monday
2015,6,29,2300,148,213,361,Monday
2015,6,29,2200,152,365,517,Monday
2015,6,29,2100,226,511,737,Monday
2015,6,29,2000,261,734,995,Monday
2015,6,29,1900,315,965,1280,Monday
2015,6,29,1800,393,852,1245,Monday
2015,6,29,1700,493,1055,1548,Monday
2015,6,29,1600,626,964,1590,Monday
2015,6,29,1500,705,824,1529,Monday
2015,6,29,1400,729,667,1396,Monday
2015,6,29,1300,848,534,1382,Monday
2015,6,29,1200,949,492,1441,Monday
2015,6,29,1100,1006,354,1360,Monday
2015,6,29,1000,863,233,1096,Monday
2015,6,29,900,584,177,761,Monday
2015,6,29,800,370,128,498,Monday
2015,6,29,700,169,88,257,Monday
2015,6,29,600,60,48,108,Monday
2015,6,29,500,42,27,69,Monday
2015,6,29,400,31,35,66,Monday
2015,6,29,300,29,48,77,Monday
2015,6,29,200,37,78,115,Monday
2015,6,29,100,51,128,179,Monday
2015,6,28,2400,62,218,280,Sunday
2015,6,28,2300,91,385,476,Sunday
2015,6,28,2200,114,637,751,Sunday
2015,6,28,2100,209,896,1105,Sunday
2015,6,28,2000,263,1183,1446,Sunday
2015,6,28,1900,304,1412,1716,Sunday
2015,6,28,1800,419,1513,1932,Sunday
2015,6,28,1700,527,1468,1995,Sunday
2015,6,28,1600,683,1303,1986,Sunday
2015,6,28,1500,774,1080,1854,Sunday
2015,6,28,1400,891,904,1795,Sunday
2015,6,28,1300,1057,872,1929,Sunday
2015,6,28,1200,1177,528,1705,Sunday
2015,6,28,1100,1226,433,1659,Sunday
2015,6,28,1000,1077,244,1321,Sunday
2015,6,28,900,709,115,824,Sunday
2015,6,28,800,407,65,472,Sunday
2015,6,28,700,164,43,207,Sunday
2015,6,28,600,62,35,97,Sunday
2015,6,28,500,51,31,82,Sunday
2015,6,28,400,26,31,57,Sunday
2015,6,28,300,17,48,65,Sunday
2015,6,28,200,23,60,83,Sunday
2015,6,28,100,48,122,170,Sunday
2015,6,27,2400,87,159,246,Saturday
2015,6,27,2300,112,203,315,Saturday
2015,6,27,2200,150,346,496,Saturday
2015,6,27,2100,196,473,669,Saturday
2015,6,27,2000,253,662,915,Saturday
2015,6,27,1900,335,864,1199,Saturday
2015,6,27,1800,452,942,1394,Saturday
2015,6,27,1700,580,893,1473,Saturday
2015,6,27,1600,816,798,1614,Saturday
2015,6,27,1500,921,679,1600,Saturday
2015,6,27,1400,1092,534,1626,Saturday
2015,6,27,1300,1319,444,1763,Saturday
2015,6,27,1200,1472,383,1855,Saturday
2015,6,27,1100,1391,309,1700,Saturday
2015,6,27,1000,1339,205,1544,Saturday
2015,6,27,900,977,117,1094,Saturday
2015,6,27,800,615,91,706,Saturday
2015,6,27,700,324,54,378,Saturday
2015,6,27,600,121,36,157,Saturday
2015,6,27,500,70,40,110,Saturday
2015,6,27,400,43,39,82,Saturday
2015,6,27,300,42,35,77,Saturday
2015,6,27,200,53,40,93,Saturday
2015,6,27,100,90,87,177,Saturday
2015,6,26,2400,176,132,308,Friday
2015,6,26,2300,251,203,454,Friday
2015,6,26,2200,442,299,741,Friday
2015,6,26,2100,668,400,1068,Friday
2015,6,26,2000,1061,539,1600,Friday
2015,6,26,1900,1042,635,1677,Friday
2015,6,26,1800,1111,743,1854,Friday
2015,6,26,1700,1202,730,1932,Friday
2015,6,26,1600,1186,690,1876,Friday
2015,6,26,1500,1224,603,1827,Friday
2015,6,26,1400,1003,491,1494,Friday
2015,6,26,1300,1190,481,1671,Friday
2015,6,26,1200,1002,377,1379,Friday
2015,6,26,1100,1087,289,1376,Friday
2015,6,26,1000,929,238,1167,Friday
2015,6,26,900,781,151,932,Friday
2015,6,26,800,480,94,574,Friday
2015,6,26,700,222,66,288,Friday
2015,6,26,600,110,34,144,Friday
2015,6,26,500,75,44,119,Friday
2015,6,26,400,37,31,68,Friday
2015,6,26,300,34,44,78,Friday
2015,6,26,200,46,58,104,Friday
2015,6,26,100,72,101,173,Friday
2015,6,25,2400,115,127,242,Thursday
2015,6,25,2300,170,184,354,Thursday
2015,6,25,2200,238,284,522,Thursday
2015,6,25,2100,327,403,730,Thursday
2015,6,25,2000,405,540,945,Thursday
2015,6,25,1900,466,628,1094,Thursday
2015,6,25,1800,563,729,1292,Thursday
2015,6,25,1700,547,641,1188,Thursday
2015,6,25,1600,565,662,1227,Thursday
2015,6,25,1500,635,548,1183,Thursday
2015,6,25,1400,636,497,1133,Thursday
2015,6,25,1300,675,361,1036,Thursday
2015,6,25,1200,766,291,1057,Thursday
2015,6,25,1100,906,258,1164,Thursday
2015,6,25,1000,768,178,946,Thursday
2015,6,25,900,591,162,753,Thursday
2015,6,25,800,324,93,417,Thursday
2015,6,25,700,167,64,231,Thursday
2015,6,25,600,95,46,141,Thursday
2015,6,25,500,51,21,72,Thursday
2015,6,25,400,33,28,61,Thursday
2015,6,25,300,35,40,75,Thursday
2015,6,25,200,30,56,86,Thursday
2015,6,25,100,54,69,123,Thursday
2015,6,24,2400,89,94,183,Wednesday
2015,6,24,2300,123,175,298,Wednesday
2015,6,24,2200,181,278,459,Wednesday
2015,6,24,2100,196,390,586,Wednesday
2015,6,24,2000,229,500,729,Wednesday
2015,6,24,1900,261,608,869,Wednesday
2015,6,24,1800,353,656,1009,Wednesday
2015,6,24,1700,345,736,1081,Wednesday
2015,6,24,1600,416,567,983,Wednesday
2015,6,24,1500,474,476,950,Wednesday
2015,6,24,1400,489,362,851,Wednesday
2015,6,24,1300,555,311,866,Wednesday
2015,6,24,1200,649,276,925,Wednesday
2015,6,24,1100,766,247,1013,Wednesday
2015,6,24,1000,628,152,780,Wednesday
2015,6,24,900,476,130,606,Wednesday
2015,6,24,800,238,94,332,Wednesday
2015,6,24,700,138,68,206,Wednesday
2015,6,24,600,53,36,89,Wednesday
2015,6,24,500,36,27,63,Wednesday
2015,6,24,400,23,47,70,Wednesday
2015,6,24,300,36,48,84,Wednesday
2015,6,24,200,24,47,71,Wednesday
2015,6,24,100,50,84,134,Wednesday
2015,6,23,2400,100,112,212,Tuesday
2015,6,23,2300,113,166,279,Tuesday
2015,6,23,2200,125,242,367,Tuesday
2015,6,23,2100,174,322,496,Tuesday
2015,6,23,2000,200,418,618,Tuesday
2015,6,23,1900,198,554,752,Tuesday
2015,6,23,1800,262,625,887,Tuesday
2015,6,23,1700,311,567,878,Tuesday
2015,6,23,1600,399,564,963,Tuesday
2015,6,23,1500,396,452,848,Tuesday
2015,6,23,1400,417,368,785,Tuesday
2015,6,23,1300,472,392,864,Tuesday
2015,6,23,1200,554,309,863,Tuesday
2015,6,23,1100,625,244,869,Tuesday
2015,6,23,1000,562,183,745,Tuesday
2015,6,23,900,419,134,553,Tuesday
2015,6,23,800,217,92,309,Tuesday
2015,6,23,700,122,69,191,Tuesday
2015,6,23,600,56,36,92,Tuesday
2015,6,23,500,37,33,70,Tuesday
2015,6,23,400,28,55,83,Tuesday
2015,6,23,300,19,54,73,Tuesday
2015,6,23,200,44,55,99,Tuesday
2015,6,23,100,66,96,162,Tuesday
2015,6,22,2400,73,114,187,Monday
2015,6,22,2300,91,197,288,Monday
2015,6,22,2200,137,301,438,Monday
2015,6,22,2100,179,461,640,Monday
2015,6,22,2000,190,619,809,Monday
2015,6,22,1900,231,757,988,Monday
2015,6,22,1800,299,774,1073,Monday
2015,6,22,1700,316,777,1093,Monday
2015,6,22,1600,422,662,1084,Monday
2015,6,22,1500,448,563,1011,Monday
2015,6,22,1400,497,467,964,Monday
2015,6,22,1300,615,367,982,Monday
2015,6,22,1200,738,360,1098,Monday
2015,6,22,1100,826,244,1070,Monday
2015,6,22,1000,629,199,828,Monday
2015,6,22,900,517,144,661,Monday
2015,6,22,800,270,105,375,Monday
2015,6,22,700,142,63,205,Monday
2015,6,22,600,59,51,110,Monday
2015,6,22,500,27,22,49,Monday
2015,6,22,400,32,39,71,Monday
2015,6,22,300,20,39,59,Monday
2015,6,22,200,29,50,79,Monday
2015,6,22,100,43,107,150,Monday
2015,6,21,2400,45,143,188,Sunday
2015,6,21,2300,78,292,370,Sunday
2015,6,21,2200,130,502,632,Sunday
2015,6,21,2100,190,708,898,Sunday
2015,6,21,2000,206,1024,1230,Sunday
2015,6,21,1900,232,1028,1260,Sunday
2015,6,21,1800,306,1255,1561,Sunday
2015,6,21,1700,395,1222,1617,Sunday
2015,6,21,1600,433,1109,1542,Sunday
2015,6,21,1500,551,1005,1556,Sunday
2015,6,21,1400,663,919,1582,Sunday
2015,6,21,1300,748,792,1540,Sunday
2015,6,21,1200,776,719,1495,Sunday
2015,6,21,1100,800,430,1230,Sunday
2015,6,21,1000,730,258,988,Sunday
2015,6,21,900,433,142,575,Sunday
2015,6,21,800,185,72,257,Sunday
2015,6,21,700,105,33,138,Sunday
2015,6,21,600,46,18,64,Sunday
2015,6,21,500,20,17,37,Sunday
2015,6,21,400,22,17,39,Sunday
2015,6,21,300,15,20,35,Sunday
2015,6,21,200,14,45,59,Sunday
2015,6,21,100,32,53,85,Sunday
2015,6,20,2400,47,94,141,Saturday
2015,6,20,2300,65,152,217,Saturday
2015,6,20,2200,137,249,386,Saturday
2015,6,20,2100,143,351,494,Saturday
2015,6,20,2000,196,513,709,Saturday
2015,6,20,1900,232,651,883,Saturday
2015,6,20,1800,266,705,971,Saturday
2015,6,20,1700,362,764,1126,Saturday
2015,6,20,1600,440,671,1111,Saturday
2015,6,20,1500,478,462,940,Saturday
2015,6,20,1400,697,440,1137,Saturday
2015,6,20,1300,581,367,948,Saturday
2015,6,20,1200,824,341,1165,Saturday
2015,6,20,1100,855,253,1108,Saturday
2015,6,20,1000,818,193,1011,Saturday
2015,6,20,900,539,108,647,Saturday
2015,6,20,800,293,100,393,Saturday
2015,6,20,700,139,59,198,Saturday
2015,6,20,600,74,44,118,Saturday
2015,6,20,500,36,22,58,Saturday
2015,6,20,400,29,28,57,Saturday
2015,6,20,300,35,34,69,Saturday
2015,6,20,200,43,43,86,Saturday
2015,6,20,100,69,67,136,Saturday
2015,6,19,2400,108,92,200,Friday
2015,6,19,2300,202,156,358,Friday
2015,6,19,2200,622,224,846,Friday
2015,6,19,2100,583,333,916,Friday
2015,6,19,2000,520,394,914,Friday
2015,6,19,1900,479,467,946,Friday
2015,6,19,1800,645,628,1273,Friday
2015,6,19,1700,736,662,1398,Friday
2015,6,19,1600,716,557,1273,Friday
2015,6,19,1500,703,569,1272,Friday
2015,6,19,1400,667,432,1099,Friday
2015,6,19,1300,742,381,1123,Friday
2015,6,19,1200,789,323,1112,Friday
2015,6,19,1100,831,281,1112,Friday
2015,6,19,1000,658,201,859,Friday
2015,6,19,900,466,142,608,Friday
2015,6,19,800,290,93,383,Friday
2015,6,19,700,170,54,224,Friday
2015,6,19,600,72,39,111,Friday
2015,6,19,500,31,34,65,Friday
2015,6,19,400,42,39,81,Friday
2015,6,19,300,34,44,78,Friday
2015,6,19,200,47,39,86,Friday
2015,6,19,100,57,75,132,Friday
2015,6,18,2400,105,115,220,Thursday
2015,6,18,2300,128,167,295,Thursday
2015,6,18,2200,195,201,396,Thursday
2015,6,18,2100,264,339,603,Thursday
2015,6,18,2000,399,385,784,Thursday
2015,6,18,1900,411,480,891,Thursday
2015,6,18,1800,405,561,966,Thursday
2015,6,18,1700,461,642,1103,Thursday
2015,6,18,1600,481,529,1010,Thursday
2015,6,18,1500,492,456,948,Thursday
2015,6,18,1400,533,347,880,Thursday
2015,6,18,1300,550,359,909,Thursday
2015,6,18,1200,661,339,1000,Thursday
2015,6,18,1100,698,246,944,Thursday
2015,6,18,1000,607,150,757,Thursday
2015,6,18,900,403,153,556,Thursday
2015,6,18,800,249,84,333,Thursday
2015,6,18,700,130,53,183,Thursday
2015,6,18,600,75,35,110,Thursday
2015,6,18,500,22,27,49,Thursday
2015,6,18,400,40,22,62,Thursday
2015,6,18,300,41,34,75,Thursday
2015,6,18,200,38,45,83,Thursday
2015,6,18,100,64,53,117,Thursday
2015,6,17,2400,73,84,157,Wednesday
2015,6,17,2300,110,122,232,Wednesday
2015,6,17,2200,135,192,327,Wednesday
2015,6,17,2100,185,292,477,Wednesday
2015,6,17,2000,199,360,559,Wednesday
2015,6,17,1900,236,504,740,Wednesday
2015,6,17,1800,272,511,783,Wednesday
2015,6,17,1700,306,529,835,Wednesday
2015,6,17,1600,380,442,822,Wednesday
2015,6,17,1500,392,370,762,Wednesday
2015,6,17,1400,410,351,761,Wednesday
2015,6,17,1300,405,292,697,Wednesday
2015,6,17,1200,553,266,819,Wednesday
2015,6,17,1100,576,219,795,Wednesday
2015,6,17,1000,476,169,645,Wednesday
2015,6,17,900,355,159,514,Wednesday
2015,6,17,800,213,83,296,Wednesday
2015,6,17,700,116,59,175,Wednesday
2015,6,17,600,59,36,95,Wednesday
2015,6,17,500,27,28,55,Wednesday
2015,6,17,400,23,34,57,Wednesday
2015,6,17,300,31,45,76,Wednesday
2015,6,17,200,26,58,84,Wednesday
2015,6,17,100,44,84,128,Wednesday
2015,6,16,2400,69,111,180,Tuesday
2015,6,16,2300,87,161,248,Tuesday
2015,6,16,2200,117,264,381,Tuesday
2015,6,16,2100,148,324,472,Tuesday
2015,6,16,2000,180,360,540,Tuesday
2015,6,16,1900,168,488,656,Tuesday
2015,6,16,1800,272,511,783,Tuesday
2015,6,16,1700,297,719,1016,Tuesday
2015,6,16,1600,307,528,835,Tuesday
2015,6,16,1500,321,416,737,Tuesday
2015,6,16,1400,377,393,770,Tuesday
2015,6,16,1300,483,346,829,Tuesday
2015,6,16,1200,573,306,879,Tuesday
2015,6,16,1100,601,198,799,Tuesday
2015,6,16,1000,600,159,759,Tuesday
2015,6,16,900,404,134,538,Tuesday
2015,6,16,800,233,88,321,Tuesday
2015,6,16,700,111,52,163,Tuesday
2015,6,16,600,63,41,104,Tuesday
2015,6,16,500,34,37,71,Tuesday
2015,6,16,400,22,23,45,Tuesday
2015,6,16,300,29,21,50,Tuesday
2015,6,16,200,19,64,83,Tuesday
2015,6,16,100,51,59,110,Tuesday
2015,6,15,2400,65,128,193,Monday
2015,6,15,2300,97,165,262,Monday
2015,6,15,2200,111,276,387,Monday
2015,6,15,2100,146,347,493,Monday
2015,6,15,2000,194,517,711,Monday
2015,6,15,1900,189,603,792,Monday
2015,6,15,1800,251,762,1013,Monday
2015,6,15,1700,287,716,1003,Monday
2015,6,15,1600,359,626,985,Monday
2015,6,15,1500,393,500,893,Monday
2015,6,15,1400,507,457,964,Monday
2015,6,15,1300,530,324,854,Monday
2015,6,15,1200,619,366,985,Monday
2015,6,15,1100,712,258,970,Monday
2015,6,15,1000,711,188,899,Monday
2015,6,15,900,418,129,547,Monday
2015,6,15,800,242,91,333,Monday
2015,6,15,700,134,78,212,Monday
2015,6,15,600,53,30,83,Monday
2015,6,15,500,25,24,49,Monday
2015,6,15,400,17,26,43,Monday
2015,6,15,300,26,28,54,Monday
2015,6,15,200,22,47,69,Monday
2015,6,15,100,44,81,125,Monday
2015,6,14,2400,41,148,189,Sunday
2015,6,14,2300,77,238,315,Sunday
2015,6,14,2200,110,433,543,Sunday
2015,6,14,2100,142,701,843,Sunday
2015,6,14,2000,190,850,1040,Sunday
2015,6,14,1900,232,1033,1265,Sunday
2015,6,14,1800,276,1253,1529,Sunday
2015,6,14,1700,354,1299,1653,Sunday
2015,6,14,1600,414,1161,1575,Sunday
2015,6,14,1500,468,867,1335,Sunday
2015,6,14,1400,555,786,1341,Sunday
2015,6,14,1300,592,777,1369,Sunday
2015,6,14,1200,690,599,1289,Sunday
2015,6,14,1100,678,379,1057,Sunday
2015,6,14,1000,575,219,794,Sunday
2015,6,14,900,386,118,504,Sunday
2015,6,14,800,194,62,256,Sunday
2015,6,14,700,73,29,102,Sunday
2015,6,14,600,45,17,62,Sunday
2015,6,14,500,18,21,39,Sunday
2015,6,14,400,21,13,34,Sunday
2015,6,14,300,19,26,45,Sunday
2015,6,14,200,20,27,47,Sunday
2015,6,14,100,56,44,100,Sunday
2015,6,13,2400,49,73,122,Saturday
2015,6,13,2300,68,131,199,Saturday
2015,6,13,2200,124,238,362,Saturday
2015,6,13,2100,138,410,548,Saturday
2015,6,13,2000,155,459,614,Saturday
2015,6,13,1900,191,589,780,Saturday
2015,6,13,1800,260,624,884,Saturday
2015,6,13,1700,371,698,1069,Saturday
2015,6,13,1600,424,604,1028,Saturday
2015,6,13,1500,497,518,1015,Saturday
2015,6,13,1400,540,408,948,Saturday
2015,6,13,1300,655,363,1018,Saturday
2015,6,13,1200,776,324,1100,Saturday
2015,6,13,1100,781,250,1031,Saturday
2015,6,13,1000,686,189,875,Saturday
2015,6,13,900,456,123,579,Saturday
2015,6,13,800,232,75,307,Saturday
2015,6,13,700,116,47,163,Saturday
2015,6,13,600,75,32,107,Saturday
2015,6,13,500,21,24,45,Saturday
2015,6,13,400,30,20,50,Saturday
2015,6,13,300,20,29,49,Saturday
2015,6,13,200,35,41,76,Saturday
2015,6,13,100,74,74,148,Saturday
2015,6,12,2400,114,109,223,Friday
2015,6,12,2300,153,128,281,Friday
2015,6,12,2200,229,247,476,Friday
2015,6,12,2100,414,289,703,Friday
2015,6,12,2000,575,325,900,Friday
2015,6,12,1900,668,418,1086,Friday
2015,6,12,1800,774,460,1234,Friday
2015,6,12,1700,813,584,1397,Friday
2015,6,12,1600,782,551,1333,Friday
2015,6,12,1500,714,473,1187,Friday
2015,6,12,1400,641,452,1093,Friday
2015,6,12,1300,697,374,1071,Friday
2015,6,12,1200,730,337,1067,Friday
2015,6,12,1100,771,279,1050,Friday
2015,6,12,1000,623,216,839,Friday
2015,6,12,900,431,164,595,Friday
2015,6,12,800,286,87,373,Friday
2015,6,12,700,142,48,190,Friday
2015,6,12,600,67,34,101,Friday
2015,6,12,500,45,36,81,Friday
2015,6,12,400,31,52,83,Friday
2015,6,12,300,41,34,75,Friday
2015,6,12,200,46,54,100,Friday
2015,6,12,100,70,62,132,Friday
2015,6,11,2400,88,87,175,Thursday
2015,6,11,2300,128,143,271,Thursday
2015,6,11,2200,205,207,412,Thursday
2015,6,11,2100,265,296,561,Thursday
2015,6,11,2000,363,399,762,Thursday
2015,6,11,1900,342,515,857,Thursday
2015,6,11,1800,425,606,1031,Thursday
2015,6,11,1700,425,611,1036,Thursday
2015,6,11,1600,541,500,1041,Thursday
2015,6,11,1500,459,422,881,Thursday
2015,6,11,1400,435,390,825,Thursday
2015,6,11,1300,543,326,869,Thursday
2015,6,11,1200,660,272,932,Thursday
2015,6,11,1100,711,227,938,Thursday
2015,6,11,1000,575,167,742,Thursday
2015,6,11,900,428,157,585,Thursday
2015,6,11,800,220,85,305,Thursday
2015,6,11,700,130,53,183,Thursday
2015,6,11,600,59,38,97,Thursday
2015,6,11,500,29,29,58,Thursday
2015,6,11,400,26,45,71,Thursday
2015,6,11,300,31,32,63,Thursday
2015,6,11,200,40,48,88,Thursday
2015,6,11,100,75,72,147,Thursday
2015,6,10,2400,81,83,164,Wednesday
2015,6,10,2300,108,138,246,Wednesday
2015,6,10,2200,158,217,375,Wednesday
2015,6,10,2100,169,305,474,Wednesday
2015,6,10,2000,205,381,586,Wednesday
2015,6,10,1900,203,535,738,Wednesday
2015,6,10,1800,262,507,769,Wednesday
2015,6,10,1700,274,554,828,Wednesday
2015,6,10,1600,331,461,792,Wednesday
2015,6,10,1500,397,333,730,Wednesday
2015,6,10,1400,440,360,800,Wednesday
2015,6,10,1300,459,323,782,Wednesday
2015,6,10,1200,499,267,766,Wednesday
2015,6,10,1100,543,243,786,Wednesday
2015,6,10,1000,491,176,667,Wednesday
2015,6,10,900,369,126,495,Wednesday
2015,6,10,800,192,78,270,Wednesday
2015,6,10,700,97,64,161,Wednesday
2015,6,10,600,60,35,95,Wednesday
2015,6,10,500,32,37,69,Wednesday
2015,6,10,400,25,39,64,Wednesday
2015,6,10,300,25,35,60,Wednesday
2015,6,10,200,34,47,81,Wednesday
2015,6,10,100,55,72,127,Wednesday
2015,6,9,2400,74,106,180,Tuesday
2015,6,9,2300,110,142,252,Tuesday
2015,6,9,2200,98,192,290,Tuesday
2015,6,9,2100,148,323,471,Tuesday
2015,6,9,2000,189,428,617,Tuesday
2015,6,9,1900,195,546,741,Tuesday
2015,6,9,1800,205,502,707,Tuesday
2015,6,9,1700,279,546,825,Tuesday
2015,6,9,1600,307,436,743,Tuesday
2015,6,9,1500,342,374,716,Tuesday
2015,6,9,1400,379,368,747,Tuesday
2015,6,9,1300,477,303,780,Tuesday
2015,6,9,1200,491,241,732,Tuesday
2015,6,9,1100,557,232,789,Tuesday
2015,6,9,1000,486,179,665,Tuesday
2015,6,9,900,329,126,455,Tuesday
2015,6,9,800,204,85,289,Tuesday
2015,6,9,700,116,64,180,Tuesday
2015,6,9,600,56,39,95,Tuesday
2015,6,9,500,22,30,52,Tuesday
2015,6,9,400,32,39,71,Tuesday
2015,6,9,300,28,46,74,Tuesday
2015,6,9,200,34,50,84,Tuesday
2015,6,9,100,59,81,140,Tuesday
2015,6,8,2400,66,102,168,Monday
2015,6,8,2300,83,165,248,Monday
2015,6,8,2200,132,235,367,Monday
2015,6,8,2100,176,387,563,Monday
2015,6,8,2000,176,479,655,Monday
2015,6,8,1900,215,561,776,Monday
2015,6,8,1800,239,722,961,Monday
2015,6,8,1700,330,715,1045,Monday
2015,6,8,1600,382,593,975,Monday
2015,6,8,1500,443,523,966,Monday
2015,6,8,1400,484,436,920,Monday
2015,6,8,1300,488,332,820,Monday
2015,6,8,1200,644,307,951,Monday
2015,6,8,1100,632,258,890,Monday
2015,6,8,1000,516,185,701,Monday
2015,6,8,900,410,132,542,Monday
2015,6,8,800,217,113,330,Monday
2015,6,8,700,120,52,172,Monday
2015,6,8,600,58,32,90,Monday
2015,6,8,500,18,42,60,Monday
2015,6,8,400,21,35,56,Monday
2015,6,8,300,21,41,62,Monday
2015,6,8,200,32,40,72,Monday
2015,6,8,100,37,99,136,Monday
2015,6,7,2400,54,159,213,Sunday
2015,6,7,2300,65,260,325,Sunday
2015,6,7,2200,111,454,565,Sunday
2015,6,7,2100,153,721,874,Sunday
2015,6,7,2000,189,1044,1233,Sunday
2015,6,7,1900,202,1151,1353,Sunday
2015,6,7,1800,301,1363,1664,Sunday
2015,6,7,1700,364,1326,1690,Sunday
2015,6,7,1600,427,1133,1560,Sunday
2015,6,7,1500,512,927,1439,Sunday
2015,6,7,1400,602,839,1441,Sunday
2015,6,7,1300,645,669,1314,Sunday
2015,6,7,1200,832,500,1332,Sunday
2015,6,7,1100,711,352,1063,Sunday
2015,6,7,1000,545,172,717,Sunday
2015,6,7,900,398,114,512,Sunday
2015,6,7,800,181,56,237,Sunday
2015,6,7,700,84,26,110,Sunday
2015,6,7,600,36,24,60,Sunday
2015,6,7,500,19,11,30,Sunday
2015,6,7,400,17,17,34,Sunday
2015,6,7,300,21,21,42,Sunday
2015,6,7,200,20,18,38,Sunday
2015,6,7,100,30,66,96,Sunday
2015,6,6,2400,48,84,132,Saturday
2015,6,6,2300,88,166,254,Saturday
2015,6,6,2200,101,276,377,Saturday
2015,6,6,2100,153,426,579,Saturday
2015,6,6,2000,150,453,603,Saturday
2015,6,6,1900,212,671,883,Saturday
2015,6,6,1800,312,715,1027,Saturday
2015,6,6,1700,330,693,1023,Saturday
2015,6,6,1600,416,616,1032,Saturday
2015,6,6,1500,482,466,948,Saturday
2015,6,6,1400,505,361,866,Saturday
2015,6,6,1300,742,299,1041,Saturday
2015,6,6,1200,713,301,1014,Saturday
2015,6,6,1100,856,216,1072,Saturday
2015,6,6,1000,670,144,814,Saturday
2015,6,6,900,481,99,580,Saturday
2015,6,6,800,265,85,350,Saturday
2015,6,6,700,150,39,189,Saturday
2015,6,6,600,71,32,103,Saturday
2015,6,6,500,28,30,58,Saturday
2015,6,6,400,33,34,67,Saturday
2015,6,6,300,27,28,55,Saturday
2015,6,6,200,34,45,79,Saturday
2015,6,6,100,60,68,128,Saturday
2015,6,5,2400,104,82,186,Friday
2015,6,5,2300,132,150,282,Friday
2015,6,5,2200,242,220,462,Friday
2015,6,5,2100,456,315,771,Friday
2015,6,5,2000,665,368,1033,Friday
2015,6,5,1900,724,518,1242,Friday
2015,6,5,1800,778,522,1300,Friday
2015,6,5,1700,695,609,1304,Friday
2015,6,5,1600,686,496,1182,Friday
2015,6,5,1500,641,465,1106,Friday
2015,6,5,1400,630,372,1002,Friday
2015,6,5,1300,644,314,958,Friday
2015,6,5,1200,699,260,959,Friday
2015,6,5,1100,792,214,1006,Friday
2015,6,5,1000,630,200,830,Friday
2015,6,5,900,465,118,583,Friday
2015,6,5,800,277,96,373,Friday
2015,6,5,700,170,48,218,Friday
2015,6,5,600,64,35,99,Friday
2015,6,5,500,27,40,67,Friday
2015,6,5,400,28,37,65,Friday
2015,6,5,300,25,50,75,Friday
2015,6,5,200,36,51,87,Friday
2015,6,5,100,45,71,116,Friday
2015,6,4,2400,89,92,181,Thursday
2015,6,4,2300,129,150,279,Thursday
2015,6,4,2200,159,162,321,Thursday
2015,6,4,2100,278,269,547,Thursday
2015,6,4,2000,319,330,649,Thursday
2015,6,4,1900,353,454,807,Thursday
2015,6,4,1800,384,484,868,Thursday
2015,6,4,1700,432,449,881,Thursday
2015,6,4,1600,433,434,867,Thursday
2015,6,4,1500,534,358,892,Thursday
2015,6,4,1400,440,315,755,Thursday
2015,6,4,1300,463,263,726,Thursday
2015,6,4,1200,541,246,787,Thursday
2015,6,4,1100,623,182,805,Thursday
2015,6,4,1000,537,161,698,Thursday
2015,6,4,900,415,131,546,Thursday
2015,6,4,800,203,87,290,Thursday
2015,6,4,700,112,52,164,Thursday
2015,6,4,600,53,38,91,Thursday
2015,6,4,500,30,37,67,Thursday
2015,6,4,400,35,21,56,Thursday
2015,6,4,300,23,47,70,Thursday
2015,6,4,200,29,44,73,Thursday
2015,6,4,100,42,66,108,Thursday
2015,6,3,2400,64,84,148,Wednesday
2015,6,3,2300,94,120,214,Wednesday
2015,6,3,2200,145,160,305,Wednesday
2015,6,3,2100,153,216,369,Wednesday
2015,6,3,2000,189,261,450,Wednesday
2015,6,3,1900,216,342,558,Wednesday
2015,6,3,1800,250,424,674,Wednesday
2015,6,3,1700,280,396,676,Wednesday
2015,6,3,1600,286,440,726,Wednesday
2015,6,3,1500,311,365,676,Wednesday
2015,6,3,1400,381,341,722,Wednesday
2015,6,3,1300,392,250,642,Wednesday
2015,6,3,1200,494,254,748,Wednesday
2015,6,3,1100,450,199,649,Wednesday
2015,6,3,1000,375,174,549,Wednesday
2015,6,3,900,272,101,373,Wednesday
2015,6,3,800,168,79,247,Wednesday
2015,6,3,700,108,56,164,Wednesday
2015,6,3,600,60,35,95,Wednesday
2015,6,3,500,24,14,38,Wednesday
2015,6,3,400,30,27,57,Wednesday
2015,6,3,300,32,41,73,Wednesday
2015,6,3,200,19,56,75,Wednesday
2015,6,3,100,41,62,103,Wednesday
2015,6,2,2400,73,76,149,Tuesday
2015,6,2,2300,93,107,200,Tuesday
2015,6,2,2200,118,181,299,Tuesday
2015,6,2,2100,120,191,311,Tuesday
2015,6,2,2000,157,274,431,Tuesday
2015,6,2,1900,153,402,555,Tuesday
2015,6,2,1800,200,426,626,Tuesday
2015,6,2,1700,230,441,671,Tuesday
2015,6,2,1600,273,395,668,Tuesday
2015,6,2,1500,324,374,698,Tuesday
2015,6,2,1400,313,333,646,Tuesday
2015,6,2,1300,369,292,661,Tuesday
2015,6,2,1200,436,296,732,Tuesday
2015,6,2,1100,467,240,707,Tuesday
2015,6,2,1000,338,165,503,Tuesday
2015,6,2,900,276,159,435,Tuesday
2015,6,2,800,156,82,238,Tuesday
2015,6,2,700,99,66,165,Tuesday
2015,6,2,600,63,44,107,Tuesday
2015,6,2,500,29,39,68,Tuesday
2015,6,2,400,25,41,66,Tuesday
2015,6,2,300,34,30,64,Tuesday
2015,6,2,200,21,51,72,Tuesday
2015,6,2,100,51,75,126,Tuesday
2015,6,1,2400,64,97,161,Monday
2015,6,1,2300,92,137,229,Monday
2015,6,1,2200,101,214,315,Monday
2015,6,1,2100,124,302,426,Monday
2015,6,1,2000,192,440,632,Monday
2015,6,1,1900,174,542,716,Monday
2015,6,1,1800,234,625,859,Monday
2015,6,1,1700,276,627,903,Monday
2015,6,1,1600,318,502,820,Monday
2015,6,1,1500,366,458,824,Monday
2015,6,1,1400,418,393,811,Monday
2015,6,1,1300,431,345,776,Monday
2015,6,1,1200,594,281,875,Monday
2015,6,1,1100,607,228,835,Monday
2015,6,1,1000,438,195,633,Monday
2015,6,1,900,367,129,496,Monday
2015,6,1,800,180,100,280,Monday
2015,6,1,700,111,53,164,Monday
2015,6,1,600,65,31,96,Monday
2015,6,1,500,26,23,49,Monday
2015,6,1,400,22,38,60,Monday
2015,6,1,300,25,37,62,Monday
2015,6,1,200,21,59,80,Monday
2015,6,1,100,49,95,144,Monday
2015,5,31,2400,40,134,174,Sunday
2015,5,31,2300,71,231,302,Sunday
2015,5,31,2200,121,369,490,Sunday
2015,5,31,2100,149,608,757,Sunday
2015,5,31,2000,158,726,884,Sunday
2015,5,31,1900,210,992,1202,Sunday
2015,5,31,1800,262,1139,1401,Sunday
2015,5,31,1700,349,1114,1463,Sunday
2015,5,31,1600,407,949,1356,Sunday
2015,5,31,1500,426,733,1159,Sunday
2015,5,31,1400,527,661,1188,Sunday
2015,5,31,1300,571,546,1117,Sunday
2015,5,31,1200,689,428,1117,Sunday
2015,5,31,1100,631,239,870,Sunday
2015,5,31,1000,569,197,766,Sunday
2015,5,31,900,344,106,450,Sunday
2015,5,31,800,172,56,228,Sunday
2015,5,31,700,90,32,122,Sunday
2015,5,31,600,54,9,63,Sunday
2015,5,31,500,24,14,38,Sunday
2015,5,31,400,15,15,30,Sunday
2015,5,31,300,20,19,39,Sunday
2015,5,31,200,23,29,52,Sunday
2015,5,31,100,37,41,78,Sunday
2015,5,30,2400,43,85,128,Saturday
2015,5,30,2300,56,129,185,Saturday
2015,5,30,2200,103,199,302,Saturday
2015,5,30,2100,134,304,438,Saturday
2015,5,30,2000,162,374,536,Saturday
2015,5,30,1900,206,492,698,Saturday
2015,5,30,1800,237,550,787,Saturday
2015,5,30,1700,319,521,840,Saturday
2015,5,30,1600,403,494,897,Saturday
2015,5,30,1500,395,418,813,Saturday
2015,5,30,1400,452,336,788,Saturday
2015,5,30,1300,515,338,853,Saturday
2015,5,30,1200,628,249,877,Saturday
2015,5,30,1100,612,186,798,Saturday
2015,5,30,1000,503,144,647,Saturday
2015,5,30,900,370,109,479,Saturday
2015,5,30,800,210,68,278,Saturday
2015,5,30,700,117,49,166,Saturday
2015,5,30,600,69,36,105,Saturday
2015,5,30,500,31,26,57,Saturday
2015,5,30,400,20,25,45,Saturday
2015,5,30,300,23,36,59,Saturday
2015,5,30,200,37,44,81,Saturday
2015,5,30,100,67,49,116,Saturday
2015,5,29,2400,90,90,180,Friday
2015,5,29,2300,121,108,229,Friday
2015,5,29,2200,207,188,395,Friday
2015,5,29,2100,341,233,574,Friday
2015,5,29,2000,565,298,863,Friday
2015,5,29,1900,549,410,959,Friday
2015,5,29,1800,601,476,1077,Friday
2015,5,29,1700,538,493,1031,Friday
2015,5,29,1600,536,460,996,Friday
2015,5,29,1500,580,363,943,Friday
2015,5,29,1400,501,339,840,Friday
2015,5,29,1300,530,337,867,Friday
2015,5,29,1200,628,289,917,Friday
2015,5,29,1100,603,223,826,Friday
2015,5,29,1000,513,145,658,Friday
2015,5,29,900,327,139,466,Friday
2015,5,29,800,236,77,313,Friday
2015,5,29,700,114,72,186,Friday
2015,5,29,600,78,43,121,Friday
2015,5,29,500,43,38,81,Friday
2015,5,29,400,37,38,75,Friday
2015,5,29,300,34,49,83,Friday
2015,5,29,200,29,69,98,Friday
2015,5,29,100,68,71,139,Friday
2015,5,28,2400,78,75,153,Thursday
2015,5,28,2300,89,130,219,Thursday
2015,5,28,2200,133,178,311,Thursday
2015,5,28,2100,211,264,475,Thursday
2015,5,28,2000,270,316,586,Thursday
2015,5,28,1900,312,401,713,Thursday
2015,5,28,1800,353,449,802,Thursday
2015,5,28,1700,378,367,745,Thursday
2015,5,28,1600,381,420,801,Thursday
2015,5,28,1500,404,329,733,Thursday
2015,5,28,1400,393,311,704,Thursday
2015,5,28,1300,449,266,715,Thursday
2015,5,28,1200,490,239,729,Thursday
2015,5,28,1100,481,216,697,Thursday
2015,5,28,1000,431,147,578,Thursday
2015,5,28,900,351,133,484,Thursday
2015,5,28,800,227,72,299,Thursday
2015,5,28,700,117,57,174,Thursday
2015,5,28,600,60,35,95,Thursday
2015,5,28,500,36,35,71,Thursday
2015,5,28,400,16,40,56,Thursday
2015,5,28,300,35,44,79,Thursday
2015,5,28,200,36,55,91,Thursday
2015,5,28,100,62,59,121,Thursday
2015,5,27,2400,68,84,152,Wednesday
2015,5,27,2300,101,126,227,Wednesday
2015,5,27,2200,126,176,302,Wednesday
2015,5,27,2100,136,248,384,Wednesday
2015,5,27,2000,172,311,483,Wednesday
2015,5,27,1900,179,356,535,Wednesday
2015,5,27,1800,228,440,668,Wednesday
2015,5,27,1700,272,417,689,Wednesday
2015,5,27,1600,280,417,697,Wednesday
2015,5,27,1500,333,369,702,Wednesday
2015,5,27,1400,368,300,668,Wednesday
2015,5,27,1300,382,265,647,Wednesday
2015,5,27,1200,446,242,688,Wednesday
2015,5,27,1100,467,228,695,Wednesday
2015,5,27,1000,419,184,603,Wednesday
2015,5,27,900,289,132,421,Wednesday
2015,5,27,800,159,84,243,Wednesday
2015,5,27,700,84,45,129,Wednesday
2015,5,27,600,62,46,108,Wednesday
2015,5,27,500,24,33,57,Wednesday
2015,5,27,400,28,42,70,Wednesday
2015,5,27,300,31,46,77,Wednesday
2015,5,27,200,33,37,70,Wednesday
2015,5,27,100,53,69,122,Wednesday
2015,5,26,2400,65,84,149,Tuesday
2015,5,26,2300,74,111,185,Tuesday
2015,5,26,2200,96,153,249,Tuesday
2015,5,26,2100,131,255,386,Tuesday
2015,5,26,2000,151,305,456,Tuesday
2015,5,26,1900,156,431,587,Tuesday
2015,5,26,1800,209,426,635,Tuesday
2015,5,26,1700,263,367,630,Tuesday
2015,5,26,1600,233,425,658,Tuesday
2015,5,26,1500,303,366,669,Tuesday
2015,5,26,1400,285,331,616,Tuesday
2015,5,26,1300,363,254,617,Tuesday
2015,5,26,1200,419,222,641,Tuesday
2015,5,26,1100,408,217,625,Tuesday
2015,5,26,1000,362,164,526,Tuesday
2015,5,26,900,264,143,407,Tuesday
2015,5,26,800,184,71,255,Tuesday
2015,5,26,700,105,53,158,Tuesday
2015,5,26,600,54,37,91,Tuesday
2015,5,26,500,36,42,78,Tuesday
2015,5,26,400,19,35,54,Tuesday
2015,5,26,300,19,35,54,Tuesday
2015,5,26,200,28,55,83,Tuesday
2015,5,26,100,55,71,126,Tuesday
2015,5,25,2400,56,90,146,Monday
2015,5,25,2300,70,109,179,Monday
2015,5,25,2200,108,211,319,Monday
2015,5,25,2100,152,282,434,Monday
2015,5,25,2000,149,397,546,Monday
2015,5,25,1900,180,433,613,Monday
2015,5,25,1800,203,588,791,Monday
2015,5,25,1700,237,583,820,Monday
2015,5,25,1600,319,494,813,Monday
2015,5,25,1500,373,491,864,Monday
2015,5,25,1400,310,374,684,Monday
2015,5,25,1300,422,322,744,Monday
2015,5,25,1200,518,312,830,Monday
2015,5,25,1100,535,216,751,Monday
2015,5,25,1000,428,152,580,Monday
2015,5,25,900,302,115,417,Monday
2015,5,25,800,184,99,283,Monday
2015,5,25,700,99,55,154,Monday
2015,5,25,600,55,22,77,Monday
2015,5,25,500,16,29,45,Monday
2015,5,25,400,18,15,33,Monday
2015,5,25,300,24,33,57,Monday
2015,5,25,200,17,35,52,Monday
2015,5,25,100,21,81,102,Monday
2015,5,24,2400,37,129,166,Sunday
2015,5,24,2300,63,208,271,Sunday
2015,5,24,2200,87,316,403,Sunday
2015,5,24,2100,137,541,678,Sunday
2015,5,24,2000,153,698,851,Sunday
2015,5,24,1900,210,924,1134,Sunday
2015,5,24,1800,259,1134,1393,Sunday
2015,5,24,1700,335,1102,1437,Sunday
2015,5,24,1600,374,989,1363,Sunday
2015,5,24,1500,482,784,1266,Sunday
2015,5,24,1400,534,635,1169,Sunday
2015,5,24,1300,568,559,1127,Sunday
2015,5,24,1200,611,410,1021,Sunday
2015,5,24,1100,632,249,881,Sunday
2015,5,24,1000,437,150,587,Sunday
2015,5,24,900,297,81,378,Sunday
2015,5,24,800,167,39,206,Sunday
2015,5,24,700,86,22,108,Sunday
2015,5,24,600,54,16,70,Sunday
2015,5,24,500,28,14,42,Sunday
2015,5,24,400,7,24,31,Sunday
2015,5,24,300,25,26,51,Sunday
2015,5,24,200,24,47,71,Sunday
2015,5,24,100,35,52,87,Sunday
2015,5,23,2400,43,71,114,Saturday
2015,5,23,2300,64,143,207,Saturday
2015,5,23,2200,98,200,298,Saturday
2015,5,23,2100,140,292,432,Saturday
2015,5,23,2000,140,416,556,Saturday
2015,5,23,1900,192,557,749,Saturday
2015,5,23,1800,236,602,838,Saturday
2015,5,23,1700,306,690,996,Saturday
2015,5,23,1600,400,563,963,Saturday
2015,5,23,1500,431,465,896,Saturday
2015,5,23,1400,512,359,871,Saturday
2015,5,23,1300,624,317,941,Saturday
2015,5,23,1200,672,254,926,Saturday
2015,5,23,1100,667,180,847,Saturday
2015,5,23,1000,493,160,653,Saturday
2015,5,23,900,336,99,435,Saturday
2015,5,23,800,206,59,265,Saturday
2015,5,23,700,102,41,143,Saturday
2015,5,23,600,58,25,83,Saturday
2015,5,23,500,24,21,45,Saturday
2015,5,23,400,26,27,53,Saturday
2015,5,23,300,29,28,57,Saturday
2015,5,23,200,20,56,76,Saturday
2015,5,23,100,65,65,130,Saturday
2015,5,22,2400,83,86,169,Friday
2015,5,22,2300,139,146,285,Friday
2015,5,22,2200,191,187,378,Friday
2015,5,22,2100,332,260,592,Friday
2015,5,22,2000,468,340,808,Friday
2015,5,22,1900,484,458,942,Friday
2015,5,22,1800,598,484,1082,Friday
2015,5,22,1700,527,497,1024,Friday
2015,5,22,1600,553,514,1067,Friday
2015,5,22,1500,542,411,953,Friday
2015,5,22,1400,468,346,814,Friday
2015,5,22,1300,508,325,833,Friday
2015,5,22,1200,554,256,810,Friday
2015,5,22,1100,582,221,803,Friday
2015,5,22,1000,463,144,607,Friday
2015,5,22,900,366,131,497,Friday
2015,5,22,800,208,81,289,Friday
2015,5,22,700,98,39,137,Friday
2015,5,22,600,54,42,96,Friday
2015,5,22,500,28,38,66,Friday
2015,5,22,400,24,39,63,Friday
2015,5,22,300,23,49,72,Friday
2015,5,22,200,33,56,89,Friday
2015,5,22,100,39,80,119,Friday
2015,5,21,2400,85,93,178,Thursday
2015,5,21,2300,105,123,228,Thursday
2015,5,21,2200,128,174,302,Thursday
2015,5,21,2100,216,242,458,Thursday
2015,5,21,2000,278,348,626,Thursday
2015,5,21,1900,258,408,666,Thursday
2015,5,21,1800,302,452,754,Thursday
2015,5,21,1700,317,455,772,Thursday
2015,5,21,1600,352,420,772,Thursday
2015,5,21,1500,416,372,788,Thursday
2015,5,21,1400,382,332,714,Thursday
2015,5,21,1300,396,279,675,Thursday
2015,5,21,1200,477,259,736,Thursday
2015,5,21,1100,515,174,689,Thursday
2015,5,21,1000,413,139,552,Thursday
2015,5,21,900,321,127,448,Thursday
2015,5,21,800,188,76,264,Thursday
2015,5,21,700,114,55,169,Thursday
2015,5,21,600,42,28,70,Thursday
2015,5,21,500,29,33,62,Thursday
2015,5,21,400,24,54,78,Thursday
2015,5,21,300,33,39,72,Thursday
2015,5,21,200,30,56,86,Thursday
2015,5,21,100,48,68,116,Thursday
2015,5,20,2400,68,83,151,Wednesday
2015,5,20,2300,86,103,189,Wednesday
2015,5,20,2200,111,190,301,Wednesday
2015,5,20,2100,141,254,395,Wednesday
2015,5,20,2000,161,322,483,Wednesday
2015,5,20,1900,191,446,637,Wednesday
2015,5,20,1800,217,468,685,Wednesday
2015,5,20,1700,268,480,748,Wednesday
2015,5,20,1600,298,454,752,Wednesday
2015,5,20,1500,403,421,824,Wednesday
2015,5,20,1400,337,315,652,Wednesday
2015,5,20,1300,350,319,669,Wednesday
2015,5,20,1200,440,270,710,Wednesday
2015,5,20,1100,470,180,650,Wednesday
2015,5,20,1000,347,168,515,Wednesday
2015,5,20,900,280,125,405,Wednesday
2015,5,20,800,171,75,246,Wednesday
2015,5,20,700,96,59,155,Wednesday
2015,5,20,600,40,34,74,Wednesday
2015,5,20,500,25,43,68,Wednesday
2015,5,20,400,28,50,78,Wednesday
2015,5,20,300,21,43,64,Wednesday
2015,5,20,200,33,58,91,Wednesday
2015,5,20,100,42,93,135,Wednesday
2015,5,19,2400,73,114,187,Tuesday
2015,5,19,2300,85,181,266,Tuesday
2015,5,19,2200,115,266,381,Tuesday
2015,5,19,2100,156,386,542,Tuesday
2015,5,19,2000,157,501,658,Tuesday
2015,5,19,1900,202,678,880,Tuesday
2015,5,19,1800,238,789,1027,Tuesday
2015,5,19,1700,253,749,1002,Tuesday
2015,5,19,1600,333,665,998,Tuesday
2015,5,19,1500,346,634,980,Tuesday
2015,5,19,1400,367,562,929,Tuesday
2015,5,19,1300,429,507,936,Tuesday
2015,5,19,1200,440,392,832,Tuesday
2015,5,19,1100,482,296,778,Tuesday
2015,5,19,1000,380,201,581,Tuesday
2015,5,19,900,311,176,487,Tuesday
2015,5,19,800,170,124,294,Tuesday
2015,5,19,700,95,74,169,Tuesday
2015,5,19,600,34,58,92,Tuesday
2015,5,19,500,28,27,55,Tuesday
2015,5,19,400,16,32,48,Tuesday
2015,5,19,300,17,69,86,Tuesday
2015,5,19,200,20,94,114,Tuesday
2015,5,19,100,31,159,190,Tuesday
2015,5,18,2400,36,280,316,Monday
2015,5,18,2300,62,477,539,Monday
2015,5,18,2200,90,884,974,Monday
2015,5,18,2100,114,1895,2009,Monday
2015,5,18,2000,145,2049,2194,Monday
2015,5,18,1900,180,2262,2442,Monday
2015,5,18,1800,234,2087,2321,Monday
2015,5,18,1700,308,2400,2708,Monday
2015,5,18,1600,425,2182,2607,Monday
2015,5,18,1500,494,1893,2387,Monday
2015,5,18,1400,588,1816,2404,Monday
2015,5,18,1300,718,1472,2190,Monday
2015,5,18,1200,785,1033,1818,Monday
2015,5,18,1100,660,541,1201,Monday
2015,5,18,1000,504,297,801,Monday
2015,5,18,900,307,168,475,Monday
2015,5,18,800,174,68,242,Monday
2015,5,18,700,77,37,114,Monday
2015,5,18,600,45,16,61,Monday
2015,5,18,500,16,25,41,Monday
2015,5,18,400,17,33,50,Monday
2015,5,18,300,21,52,73,Monday
2015,5,18,200,19,56,75,Monday
2015,5,18,100,38,115,153,Monday
2015,5,17,2400,40,166,206,Sunday
2015,5,17,2300,86,269,355,Sunday
2015,5,17,2200,115,470,585,Sunday
2015,5,17,2100,144,616,760,Sunday
2015,5,17,2000,164,814,978,Sunday
2015,5,17,1900,225,1002,1227,Sunday
2015,5,17,1800,316,1075,1391,Sunday
2015,5,17,1700,390,1067,1457,Sunday
2015,5,17,1600,501,973,1474,Sunday
2015,5,17,1500,519,776,1295,Sunday
2015,5,17,1400,631,662,1293,Sunday
2015,5,17,1300,803,541,1344,Sunday
2015,5,17,1200,830,372,1202,Sunday
2015,5,17,1100,792,254,1046,Sunday
2015,5,17,1000,546,142,688,Sunday
2015,5,17,900,292,109,401,Sunday
2015,5,17,800,173,51,224,Sunday
2015,5,17,700,59,35,94,Sunday
2015,5,17,600,41,12,53,Sunday
2015,5,17,500,27,6,33,Sunday
2015,5,17,400,21,19,40,Sunday
2015,5,17,300,17,21,38,Sunday
2015,5,17,200,13,28,41,Sunday
2015,5,17,100,48,45,93,Sunday
2015,5,16,2400,48,63,111,Saturday
2015,5,16,2300,72,129,201,Saturday
2015,5,16,2200,117,173,290,Saturday
2015,5,16,2100,155,249,404,Saturday
2015,5,16,2000,231,356,587,Saturday
2015,5,16,1900,277,455,732,Saturday
2015,5,16,1800,348,484,832,Saturday
2015,5,16,1700,434,538,972,Saturday
2015,5,16,1600,564,499,1063,Saturday
2015,5,16,1500,660,455,1115,Saturday
2015,5,16,1400,809,386,1195,Saturday
2015,5,16,1300,883,330,1213,Saturday
2015,5,16,1200,1028,295,1323,Saturday
2015,5,16,1100,1029,198,1227,Saturday
2015,5,16,1000,778,162,940,Saturday
2015,5,16,900,676,103,779,Saturday
2015,5,16,800,544,64,608,Saturday
2015,5,16,700,237,40,277,Saturday
2015,5,16,600,70,32,102,Saturday
2015,5,16,500,51,36,87,Saturday
2015,5,16,400,48,30,78,Saturday
2015,5,16,300,36,46,82,Saturday
2015,5,16,200,64,44,108,Saturday
2015,5,16,100,109,64,173,Saturday
2015,5,15,2400,131,85,216,Friday
2015,5,15,2300,249,150,399,Friday
2015,5,15,2200,372,201,573,Friday
2015,5,15,2100,709,231,940,Friday
2015,5,15,2000,1057,328,1385,Friday
2015,5,15,1900,1425,354,1779,Friday
2015,5,15,1800,1377,434,1811,Friday
2015,5,15,1700,1417,513,1930,Friday
2015,5,15,1600,1466,507,1973,Friday
2015,5,15,1500,1406,437,1843,Friday
2015,5,15,1400,1207,338,1545,Friday
2015,5,15,1300,1187,313,1500,Friday
2015,5,15,1200,1251,261,1512,Friday
2015,5,15,1100,1226,198,1424,Friday
2015,5,15,1000,1017,176,1193,Friday
2015,5,15,900,738,135,873,Friday
2015,5,15,800,501,92,593,Friday
2015,5,15,700,265,53,318,Friday
2015,5,15,600,137,52,189,Friday
2015,5,15,500,55,36,91,Friday
2015,5,15,400,46,62,108,Friday
2015,5,15,300,35,58,93,Friday
2015,5,15,200,66,36,102,Friday
2015,5,15,100,90,81,171,Friday
2015,5,14,2400,138,91,229,Thursday
2015,5,14,2300,202,111,313,Thursday
2015,5,14,2200,334,138,472,Thursday
2015,5,14,2100,600,201,801,Thursday
2015,5,14,2000,832,273,1105,Thursday
2015,5,14,1900,830,312,1142,Thursday
2015,5,14,1800,752,438,1190,Thursday
2015,5,14,1700,717,520,1237,Thursday
2015,5,14,1600,672,463,1135,Thursday
2015,5,14,1500,681,421,1102,Thursday
2015,5,14,1400,623,341,964,Thursday
2015,5,14,1300,605,233,838,Thursday
2015,5,14,1200,674,208,882,Thursday
2015,5,14,1100,656,157,813,Thursday
2015,5,14,1000,538,148,686,Thursday
2015,5,14,900,448,112,560,Thursday
2015,5,14,800,272,71,343,Thursday
2015,5,14,700,179,44,223,Thursday
2015,5,14,600,60,28,88,Thursday
2015,5,14,500,40,43,83,Thursday
2015,5,14,400,37,45,82,Thursday
2015,5,14,300,32,42,74,Thursday
2015,5,14,200,35,47,82,Thursday
2015,5,14,100,61,69,130,Thursday
2015,5,13,2400,83,80,163,Wednesday
2015,5,13,2300,87,105,192,Wednesday
2015,5,13,2200,145,169,314,Wednesday
2015,5,13,2100,196,178,374,Wednesday
2015,5,13,2000,248,251,499,Wednesday
2015,5,13,1900,245,316,561,Wednesday
2015,5,13,1800,296,437,733,Wednesday
2015,5,13,1700,334,394,728,Wednesday
2015,5,13,1600,339,363,702,Wednesday
2015,5,13,1500,351,333,684,Wednesday
2015,5,13,1400,378,288,666,Wednesday
2015,5,13,1300,370,233,603,Wednesday
2015,5,13,1200,429,203,632,Wednesday
2015,5,13,1100,440,167,607,Wednesday
2015,5,13,1000,339,162,501,Wednesday
2015,5,13,900,285,131,416,Wednesday
2015,5,13,800,206,84,290,Wednesday
2015,5,13,700,126,60,186,Wednesday
2015,5,13,600,47,48,95,Wednesday
2015,5,13,500,34,27,61,Wednesday
2015,5,13,400,23,46,69,Wednesday
2015,5,13,300,38,41,79,Wednesday
2015,5,13,200,36,60,96,Wednesday
2015,5,13,100,51,48,99,Wednesday
2015,5,12,2400,85,88,173,Tuesday
2015,5,12,2300,73,122,195,Tuesday
2015,5,12,2200,117,149,266,Tuesday
2015,5,12,2100,141,205,346,Tuesday
2015,5,12,2000,140,245,385,Tuesday
2015,5,12,1900,159,338,497,Tuesday
2015,5,12,1800,200,362,562,Tuesday
2015,5,12,1700,244,372,616,Tuesday
2015,5,12,1600,278,386,664,Tuesday
2015,5,12,1500,306,312,618,Tuesday
2015,5,12,1400,326,264,590,Tuesday
2015,5,12,1300,324,276,600,Tuesday
2015,5,12,1200,404,217,621,Tuesday
2015,5,12,1100,402,172,574,Tuesday
2015,5,12,1000,319,146,465,Tuesday
2015,5,12,900,229,134,363,Tuesday
2015,5,12,800,157,75,232,Tuesday
2015,5,12,700,122,53,175,Tuesday
2015,5,12,600,59,42,101,Tuesday
2015,5,12,500,31,32,63,Tuesday
2015,5,12,400,26,33,59,Tuesday
2015,5,12,300,25,42,67,Tuesday
2015,5,12,200,32,67,99,Tuesday
2015,5,12,100,49,50,99,Tuesday
2015,5,11,2400,62,92,154,Monday
2015,5,11,2300,67,131,198,Monday
2015,5,11,2200,109,148,257,Monday
2015,5,11,2100,113,231,344,Monday
2015,5,11,2000,164,271,435,Monday
2015,5,11,1900,196,379,575,Monday
2015,5,11,1800,209,425,634,Monday
2015,5,11,1700,258,420,678,Monday
2015,5,11,1600,333,378,711,Monday
2015,5,11,1500,356,364,720,Monday
2015,5,11,1400,357,311,668,Monday
2015,5,11,1300,396,256,652,Monday
2015,5,11,1200,454,262,716,Monday
2015,5,11,1100,444,209,653,Monday
2015,5,11,1000,378,135,513,Monday
2015,5,11,900,258,122,380,Monday
2015,5,11,800,160,74,234,Monday
2015,5,11,700,111,47,158,Monday
2015,5,11,600,46,43,89,Monday
2015,5,11,500,20,23,43,Monday
2015,5,11,400,15,22,37,Monday
2015,5,11,300,19,27,46,Monday
2015,5,11,200,16,46,62,Monday
2015,5,11,100,21,70,91,Monday
2015,5,10,2400,39,140,179,Sunday
2015,5,10,2300,60,208,268,Sunday
2015,5,10,2200,83,263,346,Sunday
2015,5,10,2100,118,394,512,Sunday
2015,5,10,2000,180,494,674,Sunday
2015,5,10,1900,173,634,807,Sunday
2015,5,10,1800,211,885,1096,Sunday
2015,5,10,1700,254,928,1182,Sunday
2015,5,10,1600,337,821,1158,Sunday
2015,5,10,1500,433,698,1131,Sunday
2015,5,10,1400,464,584,1048,Sunday
2015,5,10,1300,520,478,998,Sunday
2015,5,10,1200,562,346,908,Sunday
2015,5,10,1100,511,230,741,Sunday
2015,5,10,1000,441,152,593,Sunday
2015,5,10,900,232,55,287,Sunday
2015,5,10,800,140,44,184,Sunday
2015,5,10,700,60,22,82,Sunday
2015,5,10,600,39,18,57,Sunday
2015,5,10,500,16,15,31,Sunday
2015,5,10,400,10,15,25,Sunday
2015,5,10,300,18,26,44,Sunday
2015,5,10,200,16,37,53,Sunday
2015,5,10,100,35,38,73,Sunday
2015,5,9,2400,48,61,109,Saturday
2015,5,9,2300,57,86,143,Saturday
2015,5,9,2200,98,174,272,Saturday
2015,5,9,2100,110,214,324,Saturday
2015,5,9,2000,132,296,428,Saturday
2015,5,9,1900,146,468,614,Saturday
2015,5,9,1800,225,542,767,Saturday
2015,5,9,1700,243,588,831,Saturday
2015,5,9,1600,348,462,810,Saturday
2015,5,9,1500,368,384,752,Saturday
2015,5,9,1400,501,324,825,Saturday
2015,5,9,1300,537,299,836,Saturday
2015,5,9,1200,650,251,901,Saturday
2015,5,9,1100,593,185,778,Saturday
2015,5,9,1000,521,147,668,Saturday
2015,5,9,900,355,90,445,Saturday
2015,5,9,800,191,49,240,Saturday
2015,5,9,700,109,48,157,Saturday
2015,5,9,600,48,24,72,Saturday
2015,5,9,500,24,16,40,Saturday
2015,5,9,400,12,32,44,Saturday
2015,5,9,300,29,28,57,Saturday
2015,5,9,200,30,57,87,Saturday
2015,5,9,100,45,44,89,Saturday
2015,5,8,2400,75,64,139,Friday
2015,5,8,2300,109,111,220,Friday
2015,5,8,2200,150,133,283,Friday
2015,5,8,2100,237,225,462,Friday
2015,5,8,2000,369,305,674,Friday
2015,5,8,1900,473,342,815,Friday
2015,5,8,1800,501,438,939,Friday
2015,5,8,1700,451,497,948,Friday
2015,5,8,1600,484,414,898,Friday
2015,5,8,1500,460,361,821,Friday
2015,5,8,1400,445,362,807,Friday
2015,5,8,1300,463,300,763,Friday
2015,5,8,1200,542,267,809,Friday
2015,5,8,1100,518,208,726,Friday
2015,5,8,1000,447,150,597,Friday
2015,5,8,900,352,124,476,Friday
2015,5,8,800,186,69,255,Friday
2015,5,8,700,125,46,171,Friday
2015,5,8,600,66,35,101,Friday
2015,5,8,500,23,27,50,Friday
2015,5,8,400,26,44,70,Friday
2015,5,8,300,29,31,60,Friday
2015,5,8,200,36,47,83,Friday
2015,5,8,100,36,57,93,Friday
2015,5,7,2400,58,84,142,Thursday
2015,5,7,2300,79,112,191,Thursday
2015,5,7,2200,106,130,236,Thursday
2015,5,7,2100,160,219,379,Thursday
2015,5,7,2000,242,263,505,Thursday
2015,5,7,1900,244,322,566,Thursday
2015,5,7,1800,315,392,707,Thursday
2015,5,7,1700,307,417,724,Thursday
2015,5,7,1600,361,323,684,Thursday
2015,5,7,1500,359,446,805,Thursday
2015,5,7,1400,340,312,652,Thursday
2015,5,7,1300,403,221,624,Thursday
2015,5,7,1200,419,170,589,Thursday
2015,5,7,1100,438,148,586,Thursday
2015,5,7,1000,373,146,519,Thursday
2015,5,7,900,283,123,406,Thursday
2015,5,7,800,156,56,212,Thursday
2015,5,7,700,98,48,146,Thursday
2015,5,7,600,48,29,77,Thursday
2015,5,7,500,26,28,54,Thursday
2015,5,7,400,25,29,54,Thursday
2015,5,7,300,26,36,62,Thursday
2015,5,7,200,35,49,84,Thursday
2015,5,7,100,46,53,99,Thursday
2015,5,6,2400,62,64,126,Wednesday
2015,5,6,2300,58,92,150,Wednesday
2015,5,6,2200,93,103,196,Wednesday
2015,5,6,2100,153,185,338,Wednesday
2015,5,6,2000,164,213,377,Wednesday
2015,5,6,1900,166,291,457,Wednesday
2015,5,6,1800,212,351,563,Wednesday
2015,5,6,1700,265,347,612,Wednesday
2015,5,6,1600,273,313,586,Wednesday
2015,5,6,1500,243,351,594,Wednesday
2015,5,6,1400,269,258,527,Wednesday
2015,5,6,1300,355,223,578,Wednesday
2015,5,6,1200,342,266,608,Wednesday
2015,5,6,1100,336,260,596,Wednesday
2015,5,6,1000,308,210,518,Wednesday
2015,5,6,900,263,157,420,Wednesday
2015,5,6,800,169,76,245,Wednesday
2015,5,6,700,100,58,158,Wednesday
2015,5,6,600,41,32,73,Wednesday
2015,5,6,500,17,25,42,Wednesday
2015,5,6,400,33,31,64,Wednesday
2015,5,6,300,30,34,64,Wednesday
2015,5,6,200,32,49,81,Wednesday
2015,5,6,100,53,54,107,Wednesday
2015,5,5,2400,54,80,134,Tuesday
2015,5,5,2300,56,96,152,Tuesday
2015,5,5,2200,96,147,243,Tuesday
2015,5,5,2100,134,163,297,Tuesday
2015,5,5,2000,146,239,385,Tuesday
2015,5,5,1900,154,268,422,Tuesday
2015,5,5,1800,213,378,591,Tuesday
2015,5,5,1700,222,383,605,Tuesday
2015,5,5,1600,238,373,611,Tuesday
2015,5,5,1500,275,353,628,Tuesday
2015,5,5,1400,307,299,606,Tuesday
2015,5,5,1300,296,263,559,Tuesday
2015,5,5,1200,412,215,627,Tuesday
2015,5,5,1100,485,180,665,Tuesday
2015,5,5,1000,138,138,276,Tuesday
2015,5,5,900,221,129,350,Tuesday
2015,5,5,800,152,85,237,Tuesday
2015,5,5,700,101,65,166,Tuesday
2015,5,5,600,46,38,84,Tuesday
2015,5,5,500,21,30,51,Tuesday
2015,5,5,400,19,40,59,Tuesday
2015,5,5,300,22,53,75,Tuesday
2015,5,5,200,28,46,74,Tuesday
2015,5,5,100,42,66,108,Tuesday
2015,5,4,2400,65,70,135,Monday
2015,5,4,2300,63,123,186,Monday
2015,5,4,2200,102,172,274,Monday
2015,5,4,2100,120,223,343,Monday
2015,5,4,2000,161,295,456,Monday
2015,5,4,1900,203,386,589,Monday
2015,5,4,1800,202,524,726,Monday
2015,5,4,1700,250,478,728,Monday
2015,5,4,1600,279,435,714,Monday
2015,5,4,1500,325,349,674,Monday
2015,5,4,1400,366,333,699,Monday
2015,5,4,1300,399,265,664,Monday
2015,5,4,1200,455,240,695,Monday
2015,5,4,1100,419,201,620,Monday
2015,5,4,1000,404,137,541,Monday
2015,5,4,900,295,98,393,Monday
2015,5,4,800,159,65,224,Monday
2015,5,4,700,103,44,147,Monday
2015,5,4,600,46,29,75,Monday
2015,5,4,500,12,25,37,Monday
2015,5,4,400,21,33,54,Monday
2015,5,4,300,11,33,44,Monday
2015,5,4,200,18,61,79,Monday
2015,5,4,100,36,101,137,Monday
2015,5,3,2400,45,95,140,Sunday
2015,5,3,2300,50,133,183,Sunday
2015,5,3,2200,76,241,317,Sunday
2015,5,3,2100,127,402,529,Sunday
2015,5,3,2000,162,533,695,Sunday
2015,5,3,1900,235,672,907,Sunday
2015,5,3,1800,243,999,1242,Sunday
2015,5,3,1700,324,1016,1340,Sunday
2015,5,3,1600,390,847,1237,Sunday
2015,5,3,1500,436,679,1115,Sunday
2015,5,3,1400,428,603,1031,Sunday
2015,5,3,1300,500,535,1035,Sunday
2015,5,3,1200,558,363,921,Sunday
2015,5,3,1100,536,265,801,Sunday
2015,5,3,1000,443,179,622,Sunday
2015,5,3,900,295,90,385,Sunday
2015,5,3,800,150,44,194,Sunday
2015,5,3,700,64,34,98,Sunday
2015,5,3,600,38,19,57,Sunday
2015,5,3,500,18,17,35,Sunday
2015,5,3,400,15,26,41,Sunday
2015,5,3,300,20,29,49,Sunday
2015,5,3,200,21,23,44,Sunday
2015,5,3,100,33,41,74,Sunday
2015,5,2,2400,40,54,94,Saturday
2015,5,2,2300,57,106,163,Saturday
2015,5,2,2200,84,153,237,Saturday
2015,5,2,2100,100,169,269,Saturday
2015,5,2,2000,149,283,432,Saturday
2015,5,2,1900,186,391,577,Saturday
2015,5,2,1800,215,501,716,Saturday
2015,5,2,1700,275,619,894,Saturday
2015,5,2,1600,351,570,921,Saturday
2015,5,2,1500,372,437,809,Saturday
2015,5,2,1400,380,375,755,Saturday
2015,5,2,1300,476,315,791,Saturday
2015,5,2,1200,545,294,839,Saturday
2015,5,2,1100,561,196,757,Saturday
2015,5,2,1000,517,143,660,Saturday
2015,5,2,900,368,100,468,Saturday
2015,5,2,800,209,54,263,Saturday
2015,5,2,700,100,36,136,Saturday
2015,5,2,600,46,12,58,Saturday
2015,5,2,500,28,33,61,Saturday
2015,5,2,400,23,42,65,Saturday
2015,5,2,300,25,50,75,Saturday
2015,5,2,200,23,54,77,Saturday
2015,5,2,100,47,46,93,Saturday
2015,5,1,2400,81,90,171,Friday
2015,5,1,2300,113,89,202,Friday
2015,5,1,2200,142,139,281,Friday
2015,5,1,2100,272,191,463,Friday
2015,5,1,2000,400,262,662,Friday
2015,5,1,1900,473,370,843,Friday
2015,5,1,1800,520,437,957,Friday
2015,5,1,1700,547,501,1048,Friday
2015,5,1,1600,511,468,979,Friday
2015,5,1,1500,513,416,929,Friday
2015,5,1,1400,482,387,869,Friday
2015,5,1,1300,513,339,852,Friday
2015,5,1,1200,552,253,805,Friday
2015,5,1,1100,536,236,772,Friday
2015,5,1,1000,468,122,590,Friday
2015,5,1,900,377,127,504,Friday
2015,5,1,800,209,58,267,Friday
2015,5,1,700,129,62,191,Friday
2015,5,1,600,43,35,78,Friday
2015,5,1,500,24,23,47,Friday
2015,5,1,400,22,43,65,Friday
2015,5,1,300,39,46,85,Friday
2015,5,1,200,35,47,82,Friday
2015,5,1,100,59,61,120,Friday
2015,4,30,2400,68,78,146,Thursday
2015,4,30,2300,96,114,210,Thursday
2015,4,30,2200,114,156,270,Thursday
2015,4,30,2100,195,180,375,Thursday
2015,4,30,2000,250,242,492,Thursday
2015,4,30,1900,267,361,628,Thursday
2015,4,30,1800,318,435,753,Thursday
2015,4,30,1700,352,430,782,Thursday
2015,4,30,1600,385,383,768,Thursday
2015,4,30,1500,425,361,786,Thursday
2015,4,30,1400,404,302,706,Thursday
2015,4,30,1300,360,265,625,Thursday
2015,4,30,1200,458,229,687,Thursday
2015,4,30,1100,485,164,649,Thursday
2015,4,30,1000,419,149,568,Thursday
2015,4,30,900,302,116,418,Thursday
2015,4,30,800,203,54,257,Thursday
2015,4,30,700,105,61,166,Thursday
2015,4,30,600,43,35,78,Thursday
2015,4,30,500,27,25,52,Thursday
2015,4,30,400,25,55,80,Thursday
2015,4,30,300,33,51,84,Thursday
2015,4,30,200,29,42,71,Thursday
2015,4,30,100,47,55,102,Thursday
2015,4,29,2400,80,99,179,Wednesday
2015,4,29,2300,92,99,191,Wednesday
2015,4,29,2200,121,155,276,Wednesday
2015,4,29,2100,162,160,322,Wednesday
2015,4,29,2000,167,210,377,Wednesday
2015,4,29,1900,194,284,478,Wednesday
2015,4,29,1800,234,406,640,Wednesday
2015,4,29,1700,236,393,629,Wednesday
2015,4,29,1600,276,356,632,Wednesday
2015,4,29,1500,303,255,558,Wednesday
2015,4,29,1400,320,306,626,Wednesday
2015,4,29,1300,346,273,619,Wednesday
2015,4,29,1200,369,233,602,Wednesday
2015,4,29,1100,362,190,552,Wednesday
2015,4,29,1000,267,130,397,Wednesday
2015,4,29,900,214,111,325,Wednesday
2015,4,29,800,173,63,236,Wednesday
2015,4,29,700,106,40,146,Wednesday
2015,4,29,600,40,43,83,Wednesday
2015,4,29,500,12,22,34,Wednesday
2015,4,29,400,35,36,71,Wednesday
2015,4,29,300,26,40,66,Wednesday
2015,4,29,200,28,57,85,Wednesday
2015,4,29,100,44,67,111,Wednesday
2015,4,28,2400,48,71,119,Tuesday
2015,4,28,2300,87,103,190,Tuesday
2015,4,28,2200,113,164,277,Tuesday
2015,4,28,2100,133,228,361,Tuesday
2015,4,28,2000,147,208,355,Tuesday
2015,4,28,1900,175,347,522,Tuesday
2015,4,28,1800,176,393,569,Tuesday
2015,4,28,1700,229,418,647,Tuesday
2015,4,28,1600,223,379,602,Tuesday
2015,4,28,1500,286,357,643,Tuesday
2015,4,28,1400,291,297,588,Tuesday
2015,4,28,1300,323,266,589,Tuesday
2015,4,28,1200,357,215,572,Tuesday
2015,4,28,1100,380,189,569,Tuesday
2015,4,28,1000,322,146,468,Tuesday
2015,4,28,900,235,121,356,Tuesday
2015,4,28,800,145,70,215,Tuesday
2015,4,28,700,90,46,136,Tuesday
2015,4,28,600,52,37,89,Tuesday
2015,4,28,500,30,31,61,Tuesday
2015,4,28,400,24,43,67,Tuesday
2015,4,28,300,23,54,77,Tuesday
2015,4,28,200,17,49,66,Tuesday
2015,4,28,100,50,68,118,Tuesday
2015,4,27,2400,60,81,141,Monday
2015,4,27,2300,85,98,183,Monday
2015,4,27,2200,107,119,226,Monday
2015,4,27,2100,112,236,348,Monday
2015,4,27,2000,143,276,419,Monday
2015,4,27,1900,140,346,486,Monday
2015,4,27,1800,198,427,625,Monday
2015,4,27,1700,239,453,692,Monday
2015,4,27,1600,281,412,693,Monday
2015,4,27,1500,333,373,706,Monday
2015,4,27,1400,339,320,659,Monday
2015,4,27,1300,407,301,708,Monday
2015,4,27,1200,395,212,607,Monday
2015,4,27,1100,422,192,614,Monday
2015,4,27,1000,331,123,454,Monday
2015,4,27,900,254,109,363,Monday
2015,4,27,800,164,70,234,Monday
2015,4,27,700,93,41,134,Monday
2015,4,27,600,52,23,75,Monday
2015,4,27,500,23,25,48,Monday
2015,4,27,400,18,18,36,Monday
2015,4,27,300,16,42,58,Monday
2015,4,27,200,25,34,59,Monday
2015,4,27,100,32,56,88,Monday
2015,4,26,2400,44,114,158,Sunday
2015,4,26,2300,50,175,225,Sunday
2015,4,26,2200,76,218,294,Sunday
2015,4,26,2100,142,280,422,Sunday
2015,4,26,2000,179,447,626,Sunday
2015,4,26,1900,182,658,840,Sunday
2015,4,26,1800,225,868,1093,Sunday
2015,4,26,1700,284,931,1215,Sunday
2015,4,26,1600,348,889,1237,Sunday
2015,4,26,1500,398,729,1127,Sunday
2015,4,26,1400,417,581,998,Sunday
2015,4,26,1300,468,553,1021,Sunday
2015,4,26,1200,565,414,979,Sunday
2015,4,26,1100,538,245,783,Sunday
2015,4,26,1000,402,159,561,Sunday
2015,4,26,900,333,87,420,Sunday
2015,4,26,800,144,44,188,Sunday
2015,4,26,700,69,25,94,Sunday
2015,4,26,600,35,13,48,Sunday
2015,4,26,500,18,9,27,Sunday
2015,4,26,400,14,18,32,Sunday
2015,4,26,300,19,21,40,Sunday
2015,4,26,200,15,32,47,Sunday
2015,4,26,100,32,38,70,Sunday
2015,4,25,2400,27,55,82,Saturday
2015,4,25,2300,58,78,136,Saturday
2015,4,25,2200,63,144,207,Saturday
2015,4,25,2100,85,172,257,Saturday
2015,4,25,2000,126,241,367,Saturday
2015,4,25,1900,149,339,488,Saturday
2015,4,25,1800,180,481,661,Saturday
2015,4,25,1700,223,584,807,Saturday
2015,4,25,1600,286,459,745,Saturday
2015,4,25,1500,298,422,720,Saturday
2015,4,25,1400,373,315,688,Saturday
2015,4,25,1300,403,315,718,Saturday
2015,4,25,1200,508,250,758,Saturday
2015,4,25,1100,501,205,706,Saturday
2015,4,25,1000,518,168,686,Saturday
2015,4,25,900,450,121,571,Saturday
2015,4,25,800,233,92,325,Saturday
2015,4,25,700,109,70,179,Saturday
2015,4,25,600,52,85,137,Saturday
2015,4,25,500,28,81,109,Saturday
2015,4,25,400,18,13,31,Saturday
2015,4,25,300,23,38,61,Saturday
2015,4,25,200,37,52,89,Saturday
2015,4,25,100,51,50,101,Saturday
2015,4,24,2400,67,13,80,Friday
2015,4,24,2300,75,59,134,Friday
2015,4,24,2200,164,38,202,Friday
2015,4,24,2100,255,98,353,Friday
2015,4,24,2000,354,220,574,Friday
2015,4,24,1900,404,309,713,Friday
2015,4,24,1800,487,374,861,Friday
2015,4,24,1700,469,406,875,Friday
2015,4,24,1600,433,410,843,Friday
2015,4,24,1500,428,381,809,Friday
2015,4,24,1400,389,303,692,Friday
2015,4,24,1300,362,285,647,Friday
2015,4,24,1200,478,248,726,Friday
2015,4,24,1100,422,189,611,Friday
2015,4,24,1000,375,130,505,Friday
2015,4,24,900,270,101,371,Friday
2015,4,24,800,194,54,248,Friday
2015,4,24,700,89,47,136,Friday
2015,4,24,600,53,36,89,Friday
2015,4,24,500,25,28,53,Friday
2015,4,24,400,30,41,71,Friday
2015,4,24,300,26,24,50,Friday
2015,4,24,200,28,48,76,Friday
2015,4,24,100,43,54,97,Friday
2015,4,23,2400,76,79,155,Thursday
2015,4,23,2300,83,118,201,Thursday
2015,4,23,2200,112,131,243,Thursday
2015,4,23,2100,188,166,354,Thursday
2015,4,23,2000,216,224,440,Thursday
2015,4,23,1900,237,276,513,Thursday
2015,4,23,1800,297,362,659,Thursday
2015,4,23,1700,294,385,679,Thursday
2015,4,23,1600,311,342,653,Thursday
2015,4,23,1500,313,304,617,Thursday
2015,4,23,1400,316,297,613,Thursday
2015,4,23,1300,337,238,575,Thursday
2015,4,23,1200,387,222,609,Thursday
2015,4,23,1100,382,167,549,Thursday
2015,4,23,1000,347,113,460,Thursday
2015,4,23,900,279,110,389,Thursday
2015,4,23,800,173,61,234,Thursday
2015,4,23,700,93,31,124,Thursday
2015,4,23,600,45,35,80,Thursday
2015,4,23,500,22,27,49,Thursday
2015,4,23,400,24,35,59,Thursday
2015,4,23,300,31,34,65,Thursday
2015,4,23,200,23,36,59,Thursday
2015,4,23,100,39,52,91,Thursday
2015,4,22,2400,60,56,116,Wednesday
2015,4,22,2300,81,95,176,Wednesday
2015,4,22,2200,95,124,219,Wednesday
2015,4,22,2100,160,156,316,Wednesday
2015,4,22,2000,177,218,395,Wednesday
2015,4,22,1900,179,252,431,Wednesday
2015,4,22,1800,209,290,499,Wednesday
2015,4,22,1700,248,358,606,Wednesday
2015,4,22,1600,237,367,604,Wednesday
2015,4,22,1500,250,306,556,Wednesday
2015,4,22,1400,279,292,571,Wednesday
2015,4,22,1300,270,224,494,Wednesday
2015,4,22,1200,328,208,536,Wednesday
2015,4,22,1100,311,173,484,Wednesday
2015,4,22,1000,280,137,417,Wednesday
2015,4,22,900,186,116,302,Wednesday
2015,4,22,800,126,48,174,Wednesday
2015,4,22,700,77,51,128,Wednesday
2015,4,22,600,55,38,93,Wednesday
2015,4,22,500,23,25,48,Wednesday
2015,4,22,400,19,31,50,Wednesday
2015,4,22,300,25,33,58,Wednesday
2015,4,22,200,33,48,81,Wednesday
2015,4,22,100,34,60,94,Wednesday
2015,4,21,2400,65,72,137,Tuesday
2015,4,21,2300,76,84,160,Tuesday
2015,4,21,2200,76,107,183,Tuesday
2015,4,21,2100,120,173,293,Tuesday
2015,4,21,2000,117,184,301,Tuesday
2015,4,21,1900,131,269,400,Tuesday
2015,4,21,1800,170,348,518,Tuesday
2015,4,21,1700,204,499,703,Tuesday
2015,4,21,1600,228,391,619,Tuesday
2015,4,21,1500,226,311,537,Tuesday
2015,4,21,1400,267,245,512,Tuesday
2015,4,21,1300,290,246,536,Tuesday
2015,4,21,1200,358,208,566,Tuesday
2015,4,21,1100,310,197,507,Tuesday
2015,4,21,1000,264,129,393,Tuesday
2015,4,21,900,212,104,316,Tuesday
2015,4,21,800,142,73,215,Tuesday
2015,4,21,700,102,48,150,Tuesday
2015,4,21,600,53,35,88,Tuesday
2015,4,21,500,25,32,57,Tuesday
2015,4,21,400,22,40,62,Tuesday
2015,4,21,300,19,34,53,Tuesday
2015,4,21,200,26,51,77,Tuesday
2015,4,21,100,46,55,101,Tuesday
2015,4,20,2400,44,86,130,Monday
2015,4,20,2300,54,102,156,Monday
2015,4,20,2200,90,159,249,Monday
2015,4,20,2100,90,208,298,Monday
2015,4,20,2000,148,252,400,Monday
2015,4,20,1900,134,317,451,Monday
2015,4,20,1800,173,391,564,Monday
2015,4,20,1700,199,414,613,Monday
2015,4,20,1600,267,375,642,Monday
2015,4,20,1500,292,348,640,Monday
2015,4,20,1400,295,277,572,Monday
2015,4,20,1300,348,242,590,Monday
2015,4,20,1200,389,222,611,Monday
2015,4,20,1100,408,178,586,Monday
2015,4,20,1000,370,122,492,Monday
2015,4,20,900,247,102,349,Monday
2015,4,20,800,147,70,217,Monday
2015,4,20,700,102,48,150,Monday
2015,4,20,600,39,25,64,Monday
2015,4,20,500,18,27,45,Monday
2015,4,20,400,13,25,38,Monday
2015,4,20,300,21,41,62,Monday
2015,4,20,200,29,42,71,Monday
2015,4,20,100,40,62,102,Monday
2015,4,19,2400,29,111,140,Sunday
2015,4,19,2300,60,119,179,Sunday
2015,4,19,2200,84,206,290,Sunday
2015,4,19,2100,107,293,400,Sunday
2015,4,19,2000,135,408,543,Sunday
2015,4,19,1900,154,598,752,Sunday
2015,4,19,1800,181,950,1131,Sunday
2015,4,19,1700,258,1082,1340,Sunday
2015,4,19,1600,292,778,1070,Sunday
2015,4,19,1500,336,625,961,Sunday
2015,4,19,1400,362,536,898,Sunday
2015,4,19,1300,396,420,816,Sunday
2015,4,19,1200,458,323,781,Sunday
2015,4,19,1100,443,222,665,Sunday
2015,4,19,1000,509,109,618,Sunday
2015,4,19,900,473,81,554,Sunday
2015,4,19,800,187,42,229,Sunday
2015,4,19,700,78,22,100,Sunday
2015,4,19,600,37,19,56,Sunday
2015,4,19,500,15,11,26,Sunday
2015,4,19,400,17,11,28,Sunday
2015,4,19,300,17,25,42,Sunday
2015,4,19,200,21,25,46,Sunday
2015,4,19,100,29,28,57,Sunday
2015,4,18,2400,29,48,77,Saturday
2015,4,18,2300,60,66,126,Saturday
2015,4,18,2200,76,136,212,Saturday
2015,4,18,2100,101,183,284,Saturday
2015,4,18,2000,126,234,360,Saturday
2015,4,18,1900,164,373,537,Saturday
2015,4,18,1800,201,650,851,Saturday
2015,4,18,1700,250,691,941,Saturday
2015,4,18,1600,306,506,812,Saturday
2015,4,18,1500,301,366,667,Saturday
2015,4,18,1400,355,326,681,Saturday
2015,4,18,1300,421,301,722,Saturday
2015,4,18,1200,485,230,715,Saturday
2015,4,18,1100,493,168,661,Saturday
2015,4,18,1000,569,148,717,Saturday
2015,4,18,900,622,104,726,Saturday
2015,4,18,800,261,67,328,Saturday
2015,4,18,700,96,37,133,Saturday
2015,4,18,600,51,29,80,Saturday
2015,4,18,500,24,30,54,Saturday
2015,4,18,400,9,30,39,Saturday
2015,4,18,300,19,20,39,Saturday
2015,4,18,200,32,35,67,Saturday
2015,4,18,100,39,58,97,Saturday
2015,4,17,2400,68,54,122,Friday
2015,4,17,2300,101,69,170,Friday
2015,4,17,2200,140,112,252,Friday
2015,4,17,2100,254,154,408,Friday
2015,4,17,2000,346,188,534,Friday
2015,4,17,1900,417,282,699,Friday
2015,4,17,1800,505,398,903,Friday
2015,4,17,1700,418,505,923,Friday
2015,4,17,1600,429,456,885,Friday
2015,4,17,1500,446,340,786,Friday
2015,4,17,1400,399,304,703,Friday
2015,4,17,1300,347,289,636,Friday
2015,4,17,1200,466,220,686,Friday
2015,4,17,1100,457,190,647,Friday
2015,4,17,1000,472,150,622,Friday
2015,4,17,900,340,80,420,Friday
2015,4,17,800,229,76,305,Friday
2015,4,17,700,113,50,163,Friday
2015,4,17,600,59,36,95,Friday
2015,4,17,500,34,25,59,Friday
2015,4,17,400,26,33,59,Friday
2015,4,17,300,35,42,77,Friday
2015,4,17,200,42,57,99,Friday
2015,4,17,100,37,60,97,Friday
2015,4,16,2400,63,82,145,Thursday
2015,4,16,2300,103,102,205,Thursday
2015,4,16,2200,124,111,235,Thursday
2015,4,16,2100,157,143,300,Thursday
2015,4,16,2000,227,184,411,Thursday
2015,4,16,1900,228,268,496,Thursday
2015,4,16,1800,278,318,596,Thursday
2015,4,16,1700,285,425,710,Thursday
2015,4,16,1600,334,347,681,Thursday
2015,4,16,1500,316,302,618,Thursday
2015,4,16,1400,313,275,588,Thursday
2015,4,16,1300,324,236,560,Thursday
2015,4,16,1200,339,182,521,Thursday
2015,4,16,1100,382,165,547,Thursday
2015,4,16,1000,355,133,488,Thursday
2015,4,16,900,266,121,387,Thursday
2015,4,16,800,167,74,241,Thursday
2015,4,16,700,97,35,132,Thursday
2015,4,16,600,44,31,75,Thursday
2015,4,16,500,22,31,53,Thursday
2015,4,16,400,38,37,75,Thursday
2015,4,16,300,24,33,57,Thursday
2015,4,16,200,31,62,93,Thursday
2015,4,16,100,42,51,93,Thursday
2015,4,15,2400,61,54,115,Wednesday
2015,4,15,2300,83,81,164,Wednesday
2015,4,15,2200,110,112,222,Wednesday
2015,4,15,2100,118,128,246,Wednesday
2015,4,15,2000,146,190,336,Wednesday
2015,4,15,1900,148,241,389,Wednesday
2015,4,15,1800,187,387,574,Wednesday
2015,4,15,1700,251,488,739,Wednesday
2015,4,15,1600,248,387,635,Wednesday
2015,4,15,1500,251,321,572,Wednesday
2015,4,15,1400,279,265,544,Wednesday
2015,4,15,1300,300,210,510,Wednesday
2015,4,15,1200,285,169,454,Wednesday
2015,4,15,1100,324,157,481,Wednesday
2015,4,15,1000,383,131,514,Wednesday
2015,4,15,900,373,93,466,Wednesday
2015,4,15,800,152,69,221,Wednesday
2015,4,15,700,86,46,132,Wednesday
2015,4,15,600,37,38,75,Wednesday
2015,4,15,500,30,28,58,Wednesday
2015,4,15,400,27,40,67,Wednesday
2015,4,15,300,22,32,54,Wednesday
2015,4,15,200,28,53,81,Wednesday
2015,4,15,100,40,48,88,Wednesday
2015,4,14,2400,46,47,93,Tuesday
2015,4,14,2300,68,64,132,Tuesday
2015,4,14,2200,75,106,181,Tuesday
2015,4,14,2100,100,157,257,Tuesday
2015,4,14,2000,117,156,273,Tuesday
2015,4,14,1900,109,233,342,Tuesday
2015,4,14,1800,171,300,471,Tuesday
2015,4,14,1700,185,315,500,Tuesday
2015,4,14,1600,218,325,543,Tuesday
2015,4,14,1500,201,293,494,Tuesday
2015,4,14,1400,202,219,421,Tuesday
2015,4,14,1300,201,231,432,Tuesday
2015,4,14,1200,295,194,489,Tuesday
2015,4,14,1100,316,181,497,Tuesday
2015,4,14,1000,263,132,395,Tuesday
2015,4,14,900,206,103,309,Tuesday
2015,4,14,800,147,52,199,Tuesday
2015,4,14,700,60,54,114,Tuesday
2015,4,14,600,38,25,63,Tuesday
2015,4,14,500,29,28,57,Tuesday
2015,4,14,400,20,27,47,Tuesday
2015,4,14,300,22,39,61,Tuesday
2015,4,14,200,22,43,65,Tuesday
2015,4,14,100,37,60,97,Tuesday
2015,4,13,2400,61,68,129,Monday
2015,4,13,2300,61,99,160,Monday
2015,4,13,2200,92,112,204,Monday
2015,4,13,2100,112,150,262,Monday
2015,4,13,2000,140,220,360,Monday
2015,4,13,1900,130,230,360,Monday
2015,4,13,1800,174,387,561,Monday
2015,4,13,1700,201,450,651,Monday
2015,4,13,1600,253,426,679,Monday
2015,4,13,1500,269,336,605,Monday
2015,4,13,1400,258,303,561,Monday
2015,4,13,1300,294,211,505,Monday
2015,4,13,1200,362,217,579,Monday
2015,4,13,1100,389,154,543,Monday
2015,4,13,1000,357,135,492,Monday
2015,4,13,900,258,97,355,Monday
2015,4,13,800,154,69,223,Monday
2015,4,13,700,68,33,101,Monday
2015,4,13,600,31,20,51,Monday
2015,4,13,500,29,15,44,Monday
2015,4,13,400,14,26,40,Monday
2015,4,13,300,13,22,35,Monday
2015,4,13,200,22,38,60,Monday
2015,4,13,100,27,65,92,Monday
2015,4,12,2400,34,103,137,Sunday
2015,4,12,2300,35,142,177,Sunday
2015,4,12,2200,68,275,343,Sunday
2015,4,12,2100,87,380,467,Sunday
2015,4,12,2000,108,483,591,Sunday
2015,4,12,1900,169,639,808,Sunday
2015,4,12,1800,154,873,1027,Sunday
2015,4,12,1700,193,1104,1297,Sunday
2015,4,12,1600,256,912,1168,Sunday
2015,4,12,1500,300,708,1008,Sunday
2015,4,12,1400,311,581,892,Sunday
2015,4,12,1300,337,446,783,Sunday
2015,4,12,1200,401,358,759,Sunday
2015,4,12,1100,403,257,660,Sunday
2015,4,12,1000,504,153,657,Sunday
2015,4,12,900,650,41,691,Sunday
2015,4,12,800,250,27,277,Sunday
2015,4,12,700,78,23,101,Sunday
2015,4,12,600,33,5,38,Sunday
2015,4,12,500,9,7,16,Sunday
2015,4,12,400,14,10,24,Sunday
2015,4,12,300,17,19,36,Sunday
2015,4,12,200,15,17,32,Sunday
2015,4,12,100,21,25,46,Sunday
2015,4,11,2400,25,48,73,Saturday
2015,4,11,2300,46,94,140,Saturday
2015,4,11,2200,68,111,179,Saturday
2015,4,11,2100,90,170,260,Saturday
2015,4,11,2000,94,261,355,Saturday
2015,4,11,1900,138,372,510,Saturday
2015,4,11,1800,198,645,843,Saturday
2015,4,11,1700,212,897,1109,Saturday
2015,4,11,1600,238,607,845,Saturday
2015,4,11,1500,269,429,698,Saturday
2015,4,11,1400,351,329,680,Saturday
2015,4,11,1300,355,353,708,Saturday
2015,4,11,1200,461,344,805,Saturday
2015,4,11,1100,490,174,664,Saturday
2015,4,11,1000,647,149,796,Saturday
2015,4,11,900,623,103,726,Saturday
2015,4,11,800,263,38,301,Saturday
2015,4,11,700,78,30,108,Saturday
2015,4,11,600,42,24,66,Saturday
2015,4,11,500,25,21,46,Saturday
2015,4,11,400,14,25,39,Saturday
2015,4,11,300,24,26,50,Saturday
2015,4,11,200,24,44,68,Saturday
2015,4,11,100,39,81,120,Saturday
2015,4,10,2400,73,105,178,Friday
2015,4,10,2300,78,78,156,Friday
2015,4,10,2200,152,134,286,Friday
2015,4,10,2100,213,185,398,Friday
2015,4,10,2000,330,244,574,Friday
2015,4,10,1900,381,295,676,Friday
2015,4,10,1800,444,485,929,Friday
2015,4,10,1700,452,638,1090,Friday
2015,4,10,1600,355,482,837,Friday
2015,4,10,1500,378,435,813,Friday
2015,4,10,1400,360,307,667,Friday
2015,4,10,1300,403,359,762,Friday
2015,4,10,1200,463,272,735,Friday
2015,4,10,1100,473,229,702,Friday
2015,4,10,1000,443,160,603,Friday
2015,4,10,900,389,107,496,Friday
2015,4,10,800,191,63,254,Friday
2015,4,10,700,107,34,141,Friday
2015,4,10,600,51,33,84,Friday
2015,4,10,500,29,22,51,Friday
2015,4,10,400,17,33,50,Friday
2015,4,10,300,32,45,77,Friday
2015,4,10,200,26,53,79,Friday
2015,4,10,100,43,47,90,Friday
2015,4,9,2400,65,75,140,Thursday
2015,4,9,2300,95,103,198,Thursday
2015,4,9,2200,117,129,246,Thursday
2015,4,9,2100,177,178,355,Thursday
2015,4,9,2000,202,232,434,Thursday
2015,4,9,1900,221,323,544,Thursday
2015,4,9,1800,294,482,776,Thursday
2015,4,9,1700,316,520,836,Thursday
2015,4,9,1600,323,457,780,Thursday
2015,4,9,1500,374,356,730,Thursday
2015,4,9,1400,360,322,682,Thursday
2015,4,9,1300,345,279,624,Thursday
2015,4,9,1200,398,207,605,Thursday
2015,4,9,1100,422,187,609,Thursday
2015,4,9,1000,462,140,602,Thursday
2015,4,9,900,306,91,397,Thursday
2015,4,9,800,177,58,235,Thursday
2015,4,9,700,100,36,136,Thursday
2015,4,9,600,33,44,77,Thursday
2015,4,9,500,21,29,50,Thursday
2015,4,9,400,27,33,60,Thursday
2015,4,9,300,31,29,60,Thursday
2015,4,9,200,18,39,57,Thursday
2015,4,9,100,49,57,106,Thursday
2015,4,8,2400,54,62,116,Wednesday
2015,4,8,2300,85,103,188,Wednesday
2015,4,8,2200,111,125,236,Wednesday
2015,4,8,2100,133,151,284,Wednesday
2015,4,8,2000,178,219,397,Wednesday
2015,4,8,1900,196,336,532,Wednesday
2015,4,8,1800,232,489,721,Wednesday
2015,4,8,1700,266,580,846,Wednesday
2015,4,8,1600,243,402,645,Wednesday
2015,4,8,1500,277,360,637,Wednesday
2015,4,8,1400,287,291,578,Wednesday
2015,4,8,1300,308,273,581,Wednesday
2015,4,8,1200,372,230,602,Wednesday
2015,4,8,1100,392,174,566,Wednesday
2015,4,8,1000,408,135,543,Wednesday
2015,4,8,900,373,96,469,Wednesday
2015,4,8,800,150,75,225,Wednesday
2015,4,8,700,81,42,123,Wednesday
2015,4,8,600,33,43,76,Wednesday
2015,4,8,500,23,34,57,Wednesday
2015,4,8,400,17,31,48,Wednesday
2015,4,8,300,25,31,56,Wednesday
2015,4,8,200,26,40,66,Wednesday
2015,4,8,100,41,54,95,Wednesday
2015,4,7,2400,51,55,106,Tuesday
2015,4,7,2300,76,101,177,Tuesday
2015,4,7,2200,81,127,208,Tuesday
2015,4,7,2100,97,176,273,Tuesday
2015,4,7,2000,147,289,436,Tuesday
2015,4,7,1900,143,387,530,Tuesday
2015,4,7,1800,186,543,729,Tuesday
2015,4,7,1700,237,641,878,Tuesday
2015,4,7,1600,220,549,769,Tuesday
2015,4,7,1500,255,435,690,Tuesday
2015,4,7,1400,322,372,694,Tuesday
2015,4,7,1300,328,315,643,Tuesday
2015,4,7,1200,407,250,657,Tuesday
2015,4,7,1100,452,216,668,Tuesday
2015,4,7,1000,410,128,538,Tuesday
2015,4,7,900,351,143,494,Tuesday
2015,4,7,800,149,77,226,Tuesday
2015,4,7,700,85,39,124,Tuesday
2015,4,7,600,30,34,64,Tuesday
2015,4,7,500,21,34,55,Tuesday
2015,4,7,400,22,35,57,Tuesday
2015,4,7,300,15,42,57,Tuesday
2015,4,7,200,31,48,79,Tuesday
2015,4,7,100,36,76,112,Tuesday
2015,4,6,2400,49,105,154,Monday
2015,4,6,2300,49,165,214,Monday
2015,4,6,2200,94,212,306,Monday
2015,4,6,2100,91,367,458,Monday
2015,4,6,2000,111,539,650,Monday
2015,4,6,1900,156,731,887,Monday
2015,4,6,1800,217,1126,1343,Monday
2015,4,6,1700,235,1232,1467,Monday
2015,4,6,1600,314,1214,1528,Monday
2015,4,6,1500,401,968,1369,Monday
2015,4,6,1400,451,845,1296,Monday
2015,4,6,1300,524,662,1186,Monday
2015,4,6,1200,588,503,1091,Monday
2015,4,6,1100,695,326,1021,Monday
2015,4,6,1000,649,179,828,Monday
2015,4,6,900,550,117,667,Monday
2015,4,6,800,208,59,267,Monday
2015,4,6,700,78,42,120,Monday
2015,4,6,600,31,32,63,Monday
2015,4,6,500,18,22,40,Monday
2015,4,6,400,11,40,51,Monday
2015,4,6,300,16,46,62,Monday
2015,4,6,200,20,52,72,Monday
2015,4,6,100,17,62,79,Monday
2015,4,5,2400,25,123,148,Sunday
2015,4,5,2300,32,178,210,Sunday
2015,4,5,2200,59,269,328,Sunday
2015,4,5,2100,89,442,531,Sunday
2015,4,5,2000,94,662,756,Sunday
2015,4,5,1900,133,992,1125,Sunday
2015,4,5,1800,188,1363,1551,Sunday
2015,4,5,1700,254,1515,1769,Sunday
2015,4,5,1600,282,1418,1700,Sunday
2015,4,5,1500,342,1163,1505,Sunday
2015,4,5,1400,401,1001,1402,Sunday
2015,4,5,1300,439,850,1289,Sunday
2015,4,5,1200,488,584,1072,Sunday
2015,4,5,1100,467,301,768,Sunday
2015,4,5,1000,555,149,704,Sunday
2015,4,5,900,667,78,745,Sunday
2015,4,5,800,269,33,302,Sunday
2015,4,5,700,57,20,77,Sunday
2015,4,5,600,24,9,33,Sunday
2015,4,5,500,15,23,38,Sunday
2015,4,5,400,14,14,28,Sunday
2015,4,5,300,8,20,28,Sunday
2015,4,5,200,15,30,45,Sunday
2015,4,5,100,31,41,72,Sunday
2015,4,4,2400,32,49,81,Saturday
2015,4,4,2300,47,68,115,Saturday
2015,4,4,2200,60,107,167,Saturday
2015,4,4,2100,93,190,283,Saturday
2015,4,4,2000,128,272,400,Saturday
2015,4,4,1900,181,393,574,Saturday
2015,4,4,1800,208,778,986,Saturday
2015,4,4,1700,259,818,1077,Saturday
2015,4,4,1600,360,679,1039,Saturday
2015,4,4,1500,378,535,913,Saturday
2015,4,4,1400,440,450,890,Saturday
2015,4,4,1300,499,378,877,Saturday
2015,4,4,1200,558,320,878,Saturday
2015,4,4,1100,551,226,777,Saturday
2015,4,4,1000,614,139,753,Saturday
2015,4,4,900,556,86,642,Saturday
2015,4,4,800,245,27,272,Saturday
2015,4,4,700,76,23,99,Saturday
2015,4,4,600,35,16,51,Saturday
2015,4,4,500,12,13,25,Saturday
2015,4,4,400,13,4,17,Saturday
2015,4,4,300,19,14,33,Saturday
2015,4,4,200,27,23,50,Saturday
2015,4,4,100,39,37,76,Saturday
2015,4,3,2400,44,60,104,Friday
2015,4,3,2300,63,82,145,Friday
2015,4,3,2200,106,142,248,Friday
2015,4,3,2100,111,216,327,Friday
2015,4,3,2000,192,292,484,Friday
2015,4,3,1900,225,497,722,Friday
2015,4,3,1800,400,922,1322,Friday
2015,4,3,1700,539,983,1522,Friday
2015,4,3,1600,710,803,1513,Friday
2015,4,3,1500,854,616,1470,Friday
2015,4,3,1400,1010,563,1573,Friday
2015,4,3,1300,1121,450,1571,Friday
2015,4,3,1200,1360,347,1707,Friday
2015,4,3,1100,1386,242,1628,Friday
2015,4,3,1000,1289,175,1464,Friday
2015,4,3,900,1012,114,1126,Friday
2015,4,3,800,534,56,590,Friday
2015,4,3,700,212,43,255,Friday
2015,4,3,600,105,34,139,Friday
2015,4,3,500,55,37,92,Friday
2015,4,3,400,40,46,86,Friday
2015,4,3,300,43,31,74,Friday
2015,4,3,200,56,49,105,Friday
2015,4,3,100,75,64,139,Friday
2015,4,2,2400,133,101,234,Thursday
2015,4,2,2300,227,128,355,Thursday
2015,4,2,2200,375,164,539,Thursday
2015,4,2,2100,655,182,837,Thursday
2015,4,2,2000,849,288,1137,Thursday
2015,4,2,1900,1028,371,1399,Thursday
2015,4,2,1800,964,533,1497,Thursday
2015,4,2,1700,822,615,1437,Thursday
2015,4,2,1600,822,514,1336,Thursday
2015,4,2,1500,715,373,1088,Thursday
2015,4,2,1400,575,367,942,Thursday
2015,4,2,1300,575,311,886,Thursday
2015,4,2,1200,580,250,830,Thursday
2015,4,2,1100,633,222,855,Thursday
2015,4,2,1000,609,176,785,Thursday
2015,4,2,900,487,115,602,Thursday
2015,4,2,800,247,87,334,Thursday
2015,4,2,700,117,64,181,Thursday
2015,4,2,600,79,43,122,Thursday
2015,4,2,500,43,27,70,Thursday
2015,4,2,400,22,30,52,Thursday
2015,4,2,300,25,38,63,Thursday
2015,4,2,200,36,49,85,Thursday
2015,4,2,100,61,63,124,Thursday
2015,4,1,2400,66,63,129,Wednesday
2015,4,1,2300,104,78,182,Wednesday
2015,4,1,2200,132,136,268,Wednesday
2015,4,1,2100,139,140,279,Wednesday
2015,4,1,2000,245,170,415,Wednesday
2015,4,1,1900,247,296,543,Wednesday
2015,4,1,1800,294,427,721,Wednesday
2015,4,1,1700,301,572,873,Wednesday
2015,4,1,1600,353,434,787,Wednesday
2015,4,1,1500,338,331,669,Wednesday
2015,4,1,1400,347,291,638,Wednesday
2015,4,1,1300,342,249,591,Wednesday
2015,4,1,1200,425,210,635,Wednesday
2015,4,1,1100,428,160,588,Wednesday
2015,4,1,1000,402,160,562,Wednesday
2015,4,1,900,373,84,457,Wednesday
2015,4,1,800,187,75,262,Wednesday
2015,4,1,700,83,41,124,Wednesday
2015,4,1,600,52,32,84,Wednesday
2015,4,1,500,22,35,57,Wednesday
2015,4,1,400,18,40,58,Wednesday
2015,4,1,300,28,23,51,Wednesday
2015,4,1,200,35,47,82,Wednesday
2015,4,1,100,42,64,106,Wednesday
2015,3,31,2400,65,58,123,Tuesday
2015,3,31,2300,89,89,178,Tuesday
2015,3,31,2200,90,102,192,Tuesday
2015,3,31,2100,137,136,273,Tuesday
2015,3,31,2000,142,155,297,Tuesday
2015,3,31,1900,195,313,508,Tuesday
2015,3,31,1800,203,379,582,Tuesday
2015,3,31,1700,223,391,614,Tuesday
2015,3,31,1600,253,390,643,Tuesday
2015,3,31,1500,275,406,681,Tuesday
2015,3,31,1400,259,308,567,Tuesday
2015,3,31,1300,279,250,529,Tuesday
2015,3,31,1200,311,210,521,Tuesday
2015,3,31,1100,355,168,523,Tuesday
2015,3,31,1000,314,140,454,Tuesday
2015,3,31,900,291,94,385,Tuesday
2015,3,31,800,141,80,221,Tuesday
2015,3,31,700,68,52,120,Tuesday
2015,3,31,600,41,33,74,Tuesday
2015,3,31,500,26,26,52,Tuesday
2015,3,31,400,18,36,54,Tuesday
2015,3,31,300,32,38,70,Tuesday
2015,3,31,200,44,41,85,Tuesday
2015,3,31,100,37,41,78,Tuesday
2015,3,30,2400,49,91,140,Monday
2015,3,30,2300,59,82,141,Monday
2015,3,30,2200,80,126,206,Monday
2015,3,30,2100,111,175,286,Monday
2015,3,30,2000,131,225,356,Monday
2015,3,30,1900,149,321,470,Monday
2015,3,30,1800,238,546,784,Monday
2015,3,30,1700,269,552,821,Monday
2015,3,30,1600,302,459,761,Monday
2015,3,30,1500,367,370,737,Monday
2015,3,30,1400,339,311,650,Monday
2015,3,30,1300,350,246,596,Monday
2015,3,30,1200,346,244,590,Monday
2015,3,30,1100,406,158,564,Monday
2015,3,30,1000,424,132,556,Monday
2015,3,30,900,338,84,422,Monday
2015,3,30,800,151,62,213,Monday
2015,3,30,700,70,36,106,Monday
2015,3,30,600,44,31,75,Monday
2015,3,30,500,9,16,25,Monday
2015,3,30,400,27,24,51,Monday
2015,3,30,300,14,33,47,Monday
2015,3,30,200,24,39,63,Monday
2015,3,30,100,37,48,85,Monday
2015,3,29,2400,27,63,90,Sunday
2015,3,29,2300,49,108,157,Sunday
2015,3,29,2200,90,165,255,Sunday
2015,3,29,2100,98,276,374,Sunday
2015,3,29,2000,125,425,550,Sunday
2015,3,29,1900,171,688,859,Sunday
2015,3,29,1800,232,1124,1356,Sunday
2015,3,29,1700,307,1185,1492,Sunday
2015,3,29,1600,377,903,1280,Sunday
2015,3,29,1500,415,831,1246,Sunday
2015,3,29,1400,446,707,1153,Sunday
2015,3,29,1300,433,587,1020,Sunday
2015,3,29,1200,471,431,902,Sunday
2015,3,29,1100,466,228,694,Sunday
2015,3,29,1000,469,116,585,Sunday
2015,3,29,900,484,83,567,Sunday
2015,3,29,800,248,47,295,Sunday
2015,3,29,700,82,23,105,Sunday
2015,3,29,600,37,16,53,Sunday
2015,3,29,500,16,13,29,Sunday
2015,3,29,400,15,20,35,Sunday
2015,3,29,300,9,18,27,Sunday
2015,3,29,200,24,31,55,Sunday
2015,3,29,100,24,33,57,Sunday
2015,3,28,2400,34,46,80,Saturday
2015,3,28,2300,76,87,163,Saturday
2015,3,28,2200,84,141,225,Saturday
2015,3,28,2100,121,171,292,Saturday
2015,3,28,2000,115,283,398,Saturday
2015,3,28,1900,152,451,603,Saturday
2015,3,28,1800,226,709,935,Saturday
2015,3,28,1700,306,780,1086,Saturday
2015,3,28,1600,341,537,878,Saturday
2015,3,28,1500,442,448,890,Saturday
2015,3,28,1400,455,402,857,Saturday
2015,3,28,1300,510,348,858,Saturday
2015,3,28,1200,523,248,771,Saturday
2015,3,28,1100,576,207,783,Saturday
2015,3,28,1000,613,140,753,Saturday
2015,3,28,900,555,75,630,Saturday
2015,3,28,800,337,61,398,Saturday
2015,3,28,700,128,39,167,Saturday
2015,3,28,600,45,33,78,Saturday
2015,3,28,500,28,23,51,Saturday
2015,3,28,400,20,29,49,Saturday
2015,3,28,300,15,34,49,Saturday
2015,3,28,200,28,37,65,Saturday
2015,3,28,100,45,49,94,Saturday
2015,3,27,2400,80,80,160,Friday
2015,3,27,2300,118,80,198,Friday
2015,3,27,2200,178,117,295,Friday
2015,3,27,2100,317,190,507,Friday
2015,3,27,2000,445,267,712,Friday
2015,3,27,1900,491,339,830,Friday
2015,3,27,1800,510,566,1076,Friday
2015,3,27,1700,487,597,1084,Friday
2015,3,27,1600,500,450,950,Friday
2015,3,27,1500,492,369,861,Friday
2015,3,27,1400,465,315,780,Friday
2015,3,27,1300,465,255,720,Friday
2015,3,27,1200,514,226,740,Friday
2015,3,27,1100,492,181,673,Friday
2015,3,27,1000,472,138,610,Friday
2015,3,27,900,412,110,522,Friday
2015,3,27,800,230,51,281,Friday
2015,3,27,700,86,36,122,Friday
2015,3,27,600,53,44,97,Friday
2015,3,27,500,22,17,39,Friday
2015,3,27,400,22,41,63,Friday
2015,3,27,300,25,32,57,Friday
2015,3,27,200,38,47,85,Friday
2015,3,27,100,48,68,116,Friday
2015,3,26,2400,72,66,138,Thursday
2015,3,26,2300,82,86,168,Thursday
2015,3,26,2200,142,108,250,Thursday
2015,3,26,2100,179,147,326,Thursday
2015,3,26,2000,243,214,457,Thursday
2015,3,26,1900,302,298,600,Thursday
2015,3,26,1800,295,388,683,Thursday
2015,3,26,1700,347,498,845,Thursday
2015,3,26,1600,338,352,690,Thursday
2015,3,26,1500,335,321,656,Thursday
2015,3,26,1400,326,268,594,Thursday
2015,3,26,1300,366,247,613,Thursday
2015,3,26,1200,398,202,600,Thursday
2015,3,26,1100,362,151,513,Thursday
2015,3,26,1000,338,134,472,Thursday
2015,3,26,900,279,114,393,Thursday
2015,3,26,800,166,53,219,Thursday
2015,3,26,700,77,35,112,Thursday
2015,3,26,600,39,34,73,Thursday
2015,3,26,500,23,33,56,Thursday
2015,3,26,400,30,31,61,Thursday
2015,3,26,300,29,27,56,Thursday
2015,3,26,200,41,37,78,Thursday
2015,3,26,100,45,55,100,Thursday
2015,3,25,2400,59,65,124,Wednesday
2015,3,25,2300,72,69,141,Wednesday
2015,3,25,2200,99,103,202,Wednesday
2015,3,25,2100,117,156,273,Wednesday
2015,3,25,2000,147,200,347,Wednesday
2015,3,25,1900,191,236,427,Wednesday
2015,3,25,1800,213,380,593,Wednesday
2015,3,25,1700,239,383,622,Wednesday
2015,3,25,1600,263,347,610,Wednesday
2015,3,25,1500,267,291,558,Wednesday
2015,3,25,1400,317,274,591,Wednesday
2015,3,25,1300,297,213,510,Wednesday
2015,3,25,1200,334,220,554,Wednesday
2015,3,25,1100,327,145,472,Wednesday
2015,3,25,1000,286,135,421,Wednesday
2015,3,25,900,264,89,353,Wednesday
2015,3,25,800,154,60,214,Wednesday
2015,3,25,700,64,59,123,Wednesday
2015,3,25,600,51,28,79,Wednesday
2015,3,25,500,26,27,53,Wednesday
2015,3,25,400,26,28,54,Wednesday
2015,3,25,300,20,37,57,Wednesday
2015,3,25,200,17,44,61,Wednesday
2015,3,25,100,39,40,79,Wednesday
2015,3,24,2400,68,72,140,Tuesday
2015,3,24,2300,71,90,161,Tuesday
2015,3,24,2200,97,99,196,Tuesday
2015,3,24,2100,108,130,238,Tuesday
2015,3,24,2000,138,188,326,Tuesday
2015,3,24,1900,162,253,415,Tuesday
2015,3,24,1800,156,359,515,Tuesday
2015,3,24,1700,227,402,629,Tuesday
2015,3,24,1600,232,292,524,Tuesday
2015,3,24,1500,267,277,544,Tuesday
2015,3,24,1400,274,285,559,Tuesday
2015,3,24,1300,280,215,495,Tuesday
2015,3,24,1200,314,232,546,Tuesday
2015,3,24,1100,327,137,464,Tuesday
2015,3,24,1000,276,112,388,Tuesday
2015,3,24,900,261,100,361,Tuesday
2015,3,24,800,141,49,190,Tuesday
2015,3,24,700,81,64,145,Tuesday
2015,3,24,600,48,36,84,Tuesday
2015,3,24,500,23,32,55,Tuesday
2015,3,24,400,15,32,47,Tuesday
2015,3,24,300,22,37,59,Tuesday
2015,3,24,200,35,51,86,Tuesday
2015,3,24,100,37,58,95,Tuesday
2015,3,23,2400,58,55,113,Monday
2015,3,23,2300,62,87,149,Monday
2015,3,23,2200,83,84,167,Monday
2015,3,23,2100,121,144,265,Monday
2015,3,23,2000,108,172,280,Monday
2015,3,23,1900,154,262,416,Monday
2015,3,23,1800,200,370,570,Monday
2015,3,23,1700,254,512,766,Monday
2015,3,23,1600,259,358,617,Monday
2015,3,23,1500,273,330,603,Monday
2015,3,23,1400,316,285,601,Monday
2015,3,23,1300,340,243,583,Monday
2015,3,23,1200,359,208,567,Monday
2015,3,23,1100,357,171,528,Monday
2015,3,23,1000,338,114,452,Monday
2015,3,23,900,280,79,359,Monday
2015,3,23,800,163,55,218,Monday
2015,3,23,700,58,36,94,Monday
2015,3,23,600,34,17,51,Monday
2015,3,23,500,16,14,30,Monday
2015,3,23,400,21,21,42,Monday
2015,3,23,300,21,14,35,Monday
2015,3,23,200,16,32,48,Monday
2015,3,23,100,21,50,71,Monday
2015,3,22,2400,39,68,107,Sunday
2015,3,22,2300,51,117,168,Sunday
2015,3,22,2200,88,187,275,Sunday
2015,3,22,2100,107,294,401,Sunday
2015,3,22,2000,130,429,559,Sunday
2015,3,22,1900,181,636,817,Sunday
2015,3,22,1800,218,1079,1297,Sunday
2015,3,22,1700,281,1101,1382,Sunday
2015,3,22,1600,285,824,1109,Sunday
2015,3,22,1500,358,691,1049,Sunday
2015,3,22,1400,414,521,935,Sunday
2015,3,22,1300,464,498,962,Sunday
2015,3,22,1200,487,374,861,Sunday
2015,3,22,1100,480,228,708,Sunday
2015,3,22,1000,565,122,687,Sunday
2015,3,22,900,694,77,771,Sunday
2015,3,22,800,296,24,320,Sunday
2015,3,22,700,76,22,98,Sunday
2015,3,22,600,42,12,54,Sunday
2015,3,22,500,11,10,21,Sunday
2015,3,22,400,12,15,27,Sunday
2015,3,22,300,19,8,27,Sunday
2015,3,22,200,19,16,35,Sunday
2015,3,22,100,17,30,47,Sunday
2015,3,21,2400,41,52,93,Saturday
2015,3,21,2300,51,70,121,Saturday
2015,3,21,2200,90,94,184,Saturday
2015,3,21,2100,105,135,240,Saturday
2015,3,21,2000,141,166,307,Saturday
2015,3,21,1900,159,260,419,Saturday
2015,3,21,1800,224,563,787,Saturday
2015,3,21,1700,252,810,1062,Saturday
2015,3,21,1600,333,550,883,Saturday
2015,3,21,1500,399,411,810,Saturday
2015,3,21,1400,380,304,684,Saturday
2015,3,21,1300,430,265,695,Saturday
2015,3,21,1200,527,234,761,Saturday
2015,3,21,1100,564,192,756,Saturday
2015,3,21,1000,628,129,757,Saturday
2015,3,21,900,640,78,718,Saturday
2015,3,21,800,274,57,331,Saturday
2015,3,21,700,102,33,135,Saturday
2015,3,21,600,53,24,77,Saturday
2015,3,21,500,15,21,36,Saturday
2015,3,21,400,19,29,48,Saturday
2015,3,21,300,18,25,43,Saturday
2015,3,21,200,25,25,50,Saturday
2015,3,21,100,41,32,73,Saturday
2015,3,20,2400,68,56,124,Friday
2015,3,20,2300,118,86,204,Friday
2015,3,20,2200,165,90,255,Friday
2015,3,20,2100,286,127,413,Friday
2015,3,20,2000,408,183,591,Friday
2015,3,20,1900,490,285,775,Friday
2015,3,20,1800,514,451,965,Friday
2015,3,20,1700,503,500,1003,Friday
2015,3,20,1600,545,370,915,Friday
2015,3,20,1500,470,350,820,Friday
2015,3,20,1400,434,289,723,Friday
2015,3,20,1300,422,254,676,Friday
2015,3,20,1200,463,246,709,Friday
2015,3,20,1100,468,162,630,Friday
2015,3,20,1000,496,126,622,Friday
2015,3,20,900,398,92,490,Friday
2015,3,20,800,222,64,286,Friday
2015,3,20,700,90,44,134,Friday
2015,3,20,600,46,34,80,Friday
2015,3,20,500,35,26,61,Friday
2015,3,20,400,28,46,74,Friday
2015,3,20,300,27,45,72,Friday
2015,3,20,200,23,40,63,Friday
2015,3,20,100,69,83,152,Friday
2015,3,19,2400,53,17,70,Thursday
2015,3,19,2300,116,99,215,Thursday
2015,3,19,2200,121,100,221,Thursday
2015,3,19,2100,196,130,326,Thursday
2015,3,19,2000,250,162,412,Thursday
2015,3,19,1900,243,259,502,Thursday
2015,3,19,1800,297,365,662,Thursday
2015,3,19,1700,293,413,706,Thursday
2015,3,19,1600,307,355,662,Thursday
2015,3,19,1500,299,301,600,Thursday
2015,3,19,1400,288,267,555,Thursday
2015,3,19,1300,298,242,540,Thursday
2015,3,19,1200,321,191,512,Thursday
2015,3,19,1100,338,142,480,Thursday
2015,3,19,1000,306,135,441,Thursday
2015,3,19,900,281,100,381,Thursday
2015,3,19,800,184,46,230,Thursday
2015,3,19,700,83,48,131,Thursday
2015,3,19,600,39,25,64,Thursday
2015,3,19,500,26,23,49,Thursday
2015,3,19,400,25,28,53,Thursday
2015,3,19,300,25,30,55,Thursday
2015,3,19,200,25,39,64,Thursday
2015,3,19,100,30,41,71,Thursday
2015,3,18,2400,56,69,125,Wednesday
2015,3,18,2300,84,77,161,Wednesday
2015,3,18,2200,99,94,193,Wednesday
2015,3,18,2100,131,115,246,Wednesday
2015,3,18,2000,164,172,336,Wednesday
2015,3,18,1900,158,238,396,Wednesday
2015,3,18,1800,187,329,516,Wednesday
2015,3,18,1700,234,406,640,Wednesday
2015,3,18,1600,253,325,578,Wednesday
2015,3,18,1500,237,274,511,Wednesday
2015,3,18,1400,217,214,431,Wednesday
2015,3,18,1300,291,207,498,Wednesday
2015,3,18,1200,283,189,472,Wednesday
2015,3,18,1100,267,177,444,Wednesday
2015,3,18,1000,279,153,432,Wednesday
2015,3,18,900,231,93,324,Wednesday
2015,3,18,800,144,65,209,Wednesday
2015,3,18,700,61,32,93,Wednesday
2015,3,18,600,34,26,60,Wednesday
2015,3,18,500,23,25,48,Wednesday
2015,3,18,400,17,31,48,Wednesday
2015,3,18,300,24,37,61,Wednesday
2015,3,18,200,26,37,63,Wednesday
2015,3,18,100,40,39,79,Wednesday
2015,3,17,2400,58,65,123,Tuesday
2015,3,17,2300,84,74,158,Tuesday
2015,3,17,2200,68,102,170,Tuesday
2015,3,17,2100,107,133,240,Tuesday
2015,3,17,2000,128,170,298,Tuesday
2015,3,17,1900,143,285,428,Tuesday
2015,3,17,1800,187,356,543,Tuesday
2015,3,17,1700,204,425,629,Tuesday
2015,3,17,1600,224,304,528,Tuesday
2015,3,17,1500,229,244,473,Tuesday
2015,3,17,1400,212,207,419,Tuesday
2015,3,17,1300,281,209,490,Tuesday
2015,3,17,1200,307,189,496,Tuesday
2015,3,17,1100,275,184,459,Tuesday
2015,3,17,1000,291,125,416,Tuesday
2015,3,17,900,263,118,381,Tuesday
2015,3,17,800,124,52,176,Tuesday
2015,3,17,700,79,48,127,Tuesday
2015,3,17,600,33,35,68,Tuesday
2015,3,17,500,23,26,49,Tuesday
2015,3,17,400,26,30,56,Tuesday
2015,3,17,300,15,33,48,Tuesday
2015,3,17,200,24,62,86,Tuesday
2015,3,17,100,41,46,87,Tuesday
2015,3,16,2400,53,49,102,Monday
2015,3,16,2300,72,76,148,Monday
2015,3,16,2200,104,108,212,Monday
2015,3,16,2100,98,112,210,Monday
2015,3,16,2000,125,176,301,Monday
2015,3,16,1900,138,327,465,Monday
2015,3,16,1800,221,424,645,Monday
2015,3,16,1700,220,396,616,Monday
2015,3,16,1600,258,352,610,Monday
2015,3,16,1500,247,317,564,Monday
2015,3,16,1400,258,251,509,Monday
2015,3,16,1300,292,231,523,Monday
2015,3,16,1200,320,186,506,Monday
2015,3,16,1100,338,174,512,Monday
2015,3,16,1000,300,127,427,Monday
2015,3,16,900,272,93,365,Monday
2015,3,16,800,120,66,186,Monday
2015,3,16,700,49,57,106,Monday
2015,3,16,600,26,33,59,Monday
2015,3,16,500,16,36,52,Monday
2015,3,16,400,13,27,40,Monday
2015,3,16,300,23,33,56,Monday
2015,3,16,200,17,38,55,Monday
2015,3,16,100,23,44,67,Monday
2015,3,15,2400,22,87,109,Sunday
2015,3,15,2300,50,109,159,Sunday
2015,3,15,2200,69,182,251,Sunday
2015,3,15,2100,63,226,289,Sunday
2015,3,15,2000,120,340,460,Sunday
2015,3,15,1900,113,519,632,Sunday
2015,3,15,1800,205,805,1010,Sunday
2015,3,15,1700,230,1035,1265,Sunday
2015,3,15,1600,258,843,1101,Sunday
2015,3,15,1500,283,711,994,Sunday
2015,3,15,1400,332,611,943,Sunday
2015,3,15,1300,394,471,865,Sunday
2015,3,15,1200,395,360,755,Sunday
2015,3,15,1100,364,213,577,Sunday
2015,3,15,1000,435,141,576,Sunday
2015,3,15,900,504,60,564,Sunday
2015,3,15,800,183,39,222,Sunday
2015,3,15,700,65,16,81,Sunday
2015,3,15,600,33,11,44,Sunday
2015,3,15,500,13,16,29,Sunday
2015,3,15,400,10,21,31,Sunday
2015,3,15,300,18,17,35,Sunday
2015,3,15,200,22,25,47,Sunday
2015,3,15,100,31,24,55,Sunday
2015,3,14,2400,45,48,93,Saturday
2015,3,14,2300,52,53,105,Saturday
2015,3,14,2200,83,93,176,Saturday
2015,3,14,2100,115,148,263,Saturday
2015,3,14,2000,103,181,284,Saturday
2015,3,14,1900,138,287,425,Saturday
2015,3,14,1800,193,601,794,Saturday
2015,3,14,1700,231,853,1084,Saturday
2015,3,14,1600,322,583,905,Saturday
2015,3,14,1500,348,463,811,Saturday
2015,3,14,1400,351,416,767,Saturday
2015,3,14,1300,408,317,725,Saturday
2015,3,14,1200,483,267,750,Saturday
2015,3,14,1100,487,174,661,Saturday
2015,3,14,1000,563,171,734,Saturday
2015,3,14,900,658,92,750,Saturday
2015,3,14,800,252,56,308,Saturday
2015,3,14,700,101,32,133,Saturday
2015,3,14,600,46,32,78,Saturday
2015,3,14,500,20,23,43,Saturday
2015,3,14,400,18,31,49,Saturday
2015,3,14,300,28,29,57,Saturday
2015,3,14,200,33,22,55,Saturday
2015,3,14,100,46,51,97,Saturday
2015,3,13,2400,77,66,143,Friday
2015,3,13,2300,101,93,194,Friday
2015,3,13,2200,178,96,274,Friday
2015,3,13,2100,284,150,434,Friday
2015,3,13,2000,377,202,579,Friday
2015,3,13,1900,441,308,749,Friday
2015,3,13,1800,481,429,910,Friday
2015,3,13,1700,443,532,975,Friday
2015,3,13,1600,413,370,783,Friday
2015,3,13,1500,376,325,701,Friday
2015,3,13,1400,353,280,633,Friday
2015,3,13,1300,347,257,604,Friday
2015,3,13,1200,392,185,577,Friday
2015,3,13,1100,381,167,548,Friday
2015,3,13,1000,372,123,495,Friday
2015,3,13,900,310,89,399,Friday
2015,3,13,800,176,60,236,Friday
2015,3,13,700,86,45,131,Friday
2015,3,13,600,44,35,79,Friday
2015,3,13,500,27,24,51,Friday
2015,3,13,400,25,39,64,Friday
2015,3,13,300,27,32,59,Friday
2015,3,13,200,32,36,68,Friday
2015,3,13,100,41,43,84,Friday
2015,3,12,2400,60,58,118,Thursday
2015,3,12,2300,103,76,179,Thursday
2015,3,12,2200,139,101,240,Thursday
2015,3,12,2100,203,119,322,Thursday
2015,3,12,2000,213,175,388,Thursday
2015,3,12,1900,245,253,498,Thursday
2015,3,12,1800,233,378,611,Thursday
2015,3,12,1700,263,383,646,Thursday
2015,3,12,1600,251,341,592,Thursday
2015,3,12,1500,325,275,600,Thursday
2015,3,12,1400,297,214,511,Thursday
2015,3,12,1300,275,203,478,Thursday
2015,3,12,1200,274,184,458,Thursday
2015,3,12,1100,284,154,438,Thursday
2015,3,12,1000,305,120,425,Thursday
2015,3,12,900,246,104,350,Thursday
2015,3,12,800,155,57,212,Thursday
2015,3,12,700,70,28,98,Thursday
2015,3,12,600,46,31,77,Thursday
2015,3,12,500,24,23,47,Thursday
2015,3,12,400,25,24,49,Thursday
2015,3,12,300,28,33,61,Thursday
2015,3,12,200,40,34,74,Thursday
2015,3,12,100,33,43,76,Thursday
2015,3,11,2400,49,64,113,Wednesday
2015,3,11,2300,87,55,142,Wednesday
2015,3,11,2200,98,106,204,Wednesday
2015,3,11,2100,123,129,252,Wednesday
2015,3,11,2000,128,151,279,Wednesday
2015,3,11,1900,153,214,367,Wednesday
2015,3,11,1800,177,310,487,Wednesday
2015,3,11,1700,197,353,550,Wednesday
2015,3,11,1600,219,241,460,Wednesday
2015,3,11,1500,223,246,469,Wednesday
2015,3,11,1400,222,220,442,Wednesday
2015,3,11,1300,233,218,451,Wednesday
2015,3,11,1200,249,170,419,Wednesday
2015,3,11,1100,261,178,439,Wednesday
2015,3,11,1000,229,117,346,Wednesday
2015,3,11,900,167,80,247,Wednesday
2015,3,11,800,146,65,211,Wednesday
2015,3,11,700,75,51,126,Wednesday
2015,3,11,600,38,31,69,Wednesday
2015,3,11,500,20,31,51,Wednesday
2015,3,11,400,30,23,53,Wednesday
2015,3,11,300,21,23,44,Wednesday
2015,3,11,200,29,41,70,Wednesday
2015,3,11,100,41,55,96,Wednesday
2015,3,10,2400,57,85,142,Tuesday
2015,3,10,2300,54,76,130,Tuesday
2015,3,10,2200,87,93,180,Tuesday
2015,3,10,2100,117,133,250,Tuesday
2015,3,10,2000,121,184,305,Tuesday
2015,3,10,1900,129,244,373,Tuesday
2015,3,10,1800,169,372,541,Tuesday
2015,3,10,1700,198,404,602,Tuesday
2015,3,10,1600,220,287,507,Tuesday
2015,3,10,1500,234,267,501,Tuesday
2015,3,10,1400,229,229,458,Tuesday
2015,3,10,1300,228,166,394,Tuesday
2015,3,10,1200,282,157,439,Tuesday
2015,3,10,1100,272,147,419,Tuesday
2015,3,10,1000,299,124,423,Tuesday
2015,3,10,900,210,105,315,Tuesday
2015,3,10,800,138,76,214,Tuesday
2015,3,10,700,70,46,116,Tuesday
2015,3,10,600,33,32,65,Tuesday
2015,3,10,500,19,27,46,Tuesday
2015,3,10,400,19,33,52,Tuesday
2015,3,10,300,26,43,69,Tuesday
2015,3,10,200,22,38,60,Tuesday
2015,3,10,100,44,50,94,Tuesday
2015,3,9,2400,46,67,113,Monday
2015,3,9,2300,73,71,144,Monday
2015,3,9,2200,68,106,174,Monday
2015,3,9,2100,111,129,240,Monday
2015,3,9,2000,140,178,318,Monday
2015,3,9,1900,119,228,347,Monday
2015,3,9,1800,185,415,600,Monday
2015,3,9,1700,215,443,658,Monday
2015,3,9,1600,230,326,556,Monday
2015,3,9,1500,230,326,556,Monday
2015,3,9,1400,250,235,485,Monday
2015,3,9,1300,267,246,513,Monday
2015,3,9,1200,307,194,501,Monday
2015,3,9,1100,298,153,451,Monday
2015,3,9,1000,263,115,378,Monday
2015,3,9,900,237,98,335,Monday
2015,3,9,800,130,53,183,Monday
2015,3,9,700,64,35,99,Monday
2015,3,9,600,51,28,79,Monday
2015,3,9,500,10,16,26,Monday
2015,3,9,400,17,18,35,Monday
2015,3,9,300,24,26,50,Monday
2015,3,9,200,20,47,67,Monday
2015,3,9,100,25,48,73,Monday
2015,3,8,2400,45,75,120,Sunday
2015,3,8,2300,60,107,167,Sunday
2015,3,8,2200,71,156,227,Sunday
2015,3,8,2100,86,247,333,Sunday
2015,3,8,2000,109,409,518,Sunday
2015,3,8,1900,143,677,820,Sunday
2015,3,8,1800,182,1069,1251,Sunday
2015,3,8,1700,227,1119,1346,Sunday
2015,3,8,1600,287,855,1142,Sunday
2015,3,8,1500,318,714,1032,Sunday
2015,3,8,1400,372,544,916,Sunday
2015,3,8,1300,381,477,858,Sunday
2015,3,8,1200,401,340,741,Sunday
2015,3,8,1100,386,180,566,Sunday
2015,3,8,1000,414,121,535,Sunday
2015,3,8,900,459,62,521,Sunday
2015,3,8,800,200,40,240,Sunday
2015,3,8,700,60,29,89,Sunday
2015,3,8,600,33,8,41,Sunday
2015,3,8,500,23,21,44,Sunday
2015,3,8,400,16,14,30,Sunday
2015,3,8,300,0,0,0,Sunday
2015,3,8,200,25,26,51,Sunday
2015,3,8,100,19,32,51,Sunday
2015,3,7,2400,38,42,80,Saturday
2015,3,7,2300,54,66,120,Saturday
2015,3,7,2200,83,56,139,Saturday
2015,3,7,2100,96,107,203,Saturday
2015,3,7,2000,91,198,289,Saturday
2015,3,7,1900,125,367,492,Saturday
2015,3,7,1800,150,762,912,Saturday
2015,3,7,1700,254,916,1170,Saturday
2015,3,7,1600,287,513,800,Saturday
2015,3,7,1500,290,376,666,Saturday
2015,3,7,1400,348,322,670,Saturday
2015,3,7,1300,423,284,707,Saturday
2015,3,7,1200,435,228,663,Saturday
2015,3,7,1100,490,174,664,Saturday
2015,3,7,1000,608,131,739,Saturday
2015,3,7,900,717,96,813,Saturday
2015,3,7,800,380,53,433,Saturday
2015,3,7,700,99,41,140,Saturday
2015,3,7,600,39,24,63,Saturday
2015,3,7,500,20,30,50,Saturday
2015,3,7,400,21,18,39,Saturday
2015,3,7,300,26,27,53,Saturday
2015,3,7,200,24,37,61,Saturday
2015,3,7,100,43,40,83,Saturday
2015,3,6,2400,65,42,107,Friday
2015,3,6,2300,100,59,159,Friday
2015,3,6,2200,165,82,247,Friday
2015,3,6,2100,286,129,415,Friday
2015,3,6,2000,400,174,574,Friday
2015,3,6,1900,437,246,683,Friday
2015,3,6,1800,552,419,971,Friday
2015,3,6,1700,523,507,1030,Friday
2015,3,6,1600,467,423,890,Friday
2015,3,6,1500,408,303,711,Friday
2015,3,6,1400,349,305,654,Friday
2015,3,6,1300,338,228,566,Friday
2015,3,6,1200,402,217,619,Friday
2015,3,6,1100,395,175,570,Friday
2015,3,6,1000,425,128,553,Friday
2015,3,6,900,401,96,497,Friday
2015,3,6,800,200,57,257,Friday
2015,3,6,700,95,37,132,Friday
2015,3,6,600,37,23,60,Friday
2015,3,6,500,26,34,60,Friday
2015,3,6,400,29,36,65,Friday
2015,3,6,300,31,32,63,Friday
2015,3,6,200,31,29,60,Friday
2015,3,6,100,25,45,70,Friday
2015,3,5,2400,62,53,115,Thursday
2015,3,5,2300,99,76,175,Thursday
2015,3,5,2200,129,100,229,Thursday
2015,3,5,2100,151,106,257,Thursday
2015,3,5,2000,198,144,342,Thursday
2015,3,5,1900,228,221,449,Thursday
2015,3,5,1800,236,368,604,Thursday
2015,3,5,1700,252,386,638,Thursday
2015,3,5,1600,269,339,608,Thursday
2015,3,5,1500,270,273,543,Thursday
2015,3,5,1400,253,206,459,Thursday
2015,3,5,1300,277,205,482,Thursday
2015,3,5,1200,271,158,429,Thursday
2015,3,5,1100,286,154,440,Thursday
2015,3,5,1000,361,126,487,Thursday
2015,3,5,900,303,99,402,Thursday
2015,3,5,800,180,70,250,Thursday
2015,3,5,700,80,33,113,Thursday
2015,3,5,600,41,38,79,Thursday
2015,3,5,500,26,26,52,Thursday
2015,3,5,400,24,29,53,Thursday
2015,3,5,300,29,25,54,Thursday
2015,3,5,200,33,43,76,Thursday
2015,3,5,100,35,34,69,Thursday
2015,3,4,2400,47,48,95,Wednesday
2015,3,4,2300,77,68,145,Wednesday
2015,3,4,2200,111,74,185,Wednesday
2015,3,4,2100,121,117,238,Wednesday
2015,3,4,2000,133,139,272,Wednesday
2015,3,4,1900,154,217,371,Wednesday
2015,3,4,1800,188,334,522,Wednesday
2015,3,4,1700,222,378,600,Wednesday
2015,3,4,1600,217,294,511,Wednesday
2015,3,4,1500,203,245,448,Wednesday
2015,3,4,1400,249,208,457,Wednesday
2015,3,4,1300,210,203,413,Wednesday
2015,3,4,1200,259,146,405,Wednesday
2015,3,4,1100,295,178,473,Wednesday
2015,3,4,1000,267,116,383,Wednesday
2015,3,4,900,266,102,368,Wednesday
2015,3,4,800,153,62,215,Wednesday
2015,3,4,700,74,43,117,Wednesday
2015,3,4,600,38,44,82,Wednesday
2015,3,4,500,28,25,53,Wednesday
2015,3,4,400,23,34,57,Wednesday
2015,3,4,300,27,34,61,Wednesday
2015,3,4,200,32,32,64,Wednesday
2015,3,4,100,34,49,83,Wednesday
2015,3,3,2400,55,42,97,Tuesday
2015,3,3,2300,69,77,146,Tuesday
2015,3,3,2200,76,81,157,Tuesday
2015,3,3,2100,101,121,222,Tuesday
2015,3,3,2000,128,121,249,Tuesday
2015,3,3,1900,151,234,385,Tuesday
2015,3,3,1800,153,308,461,Tuesday
2015,3,3,1700,196,322,518,Tuesday
2015,3,3,1600,221,287,508,Tuesday
2015,3,3,1500,176,222,398,Tuesday
2015,3,3,1400,204,202,406,Tuesday
2015,3,3,1300,224,180,404,Tuesday
2015,3,3,1200,230,187,417,Tuesday
2015,3,3,1100,268,175,443,Tuesday
2015,3,3,1000,257,139,396,Tuesday
2015,3,3,900,228,92,320,Tuesday
2015,3,3,800,139,54,193,Tuesday
2015,3,3,700,59,53,112,Tuesday
2015,3,3,600,48,36,84,Tuesday
2015,3,3,500,18,26,44,Tuesday
2015,3,3,400,25,34,59,Tuesday
2015,3,3,300,18,27,45,Tuesday
2015,3,3,200,33,33,66,Tuesday
2015,3,3,100,34,47,81,Tuesday
2015,3,2,2400,54,40,94,Monday
2015,3,2,2300,72,65,137,Monday
2015,3,2,2200,74,93,167,Monday
2015,3,2,2100,98,106,204,Monday
2015,3,2,2000,103,136,239,Monday
2015,3,2,1900,145,196,341,Monday
2015,3,2,1800,155,339,494,Monday
2015,3,2,1700,198,369,567,Monday
2015,3,2,1600,226,312,538,Monday
2015,3,2,1500,183,244,427,Monday
2015,3,2,1400,265,218,483,Monday
2015,3,2,1300,236,234,470,Monday
2015,3,2,1200,269,185,454,Monday
2015,3,2,1100,227,175,402,Monday
2015,3,2,1000,269,96,365,Monday
2015,3,2,900,221,78,299,Monday
2015,3,2,800,124,58,182,Monday
2015,3,2,700,50,28,78,Monday
2015,3,2,600,36,17,53,Monday
2015,3,2,500,11,13,24,Monday
2015,3,2,400,15,28,43,Monday
2015,3,2,300,17,19,36,Monday
2015,3,2,200,20,29,49,Monday
2015,3,2,100,22,46,68,Monday
2015,3,1,2400,35,55,90,Sunday
2015,3,1,2300,53,104,157,Sunday
2015,3,1,2200,74,108,182,Sunday
2015,3,1,2100,94,161,255,Sunday
2015,3,1,2000,98,263,361,Sunday
2015,3,1,1900,117,460,577,Sunday
2015,3,1,1800,176,835,1011,Sunday
2015,3,1,1700,223,1086,1309,Sunday
2015,3,1,1600,260,880,1140,Sunday
2015,3,1,1500,309,732,1041,Sunday
2015,3,1,1400,329,675,1004,Sunday
2015,3,1,1300,390,566,956,Sunday
2015,3,1,1200,381,454,835,Sunday
2015,3,1,1100,388,276,664,Sunday
2015,3,1,1000,488,146,634,Sunday
2015,3,1,900,622,92,714,Sunday
2015,3,1,800,198,46,244,Sunday
2015,3,1,700,66,16,82,Sunday
2015,3,1,600,33,8,41,Sunday
2015,3,1,500,20,22,42,Sunday
2015,3,1,400,14,37,51,Sunday
2015,3,1,300,18,18,36,Sunday
2015,3,1,200,23,23,46,Sunday
2015,3,1,100,39,25,64,Sunday
2015,2,28,2400,33,41,74,Saturday
2015,2,28,2300,59,55,114,Saturday
2015,2,28,2200,63,90,153,Saturday
2015,2,28,2100,87,107,194,Saturday
2015,2,28,2000,111,177,288,Saturday
2015,2,28,1900,145,338,483,Saturday
2015,2,28,1800,195,778,973,Saturday
2015,2,28,1700,233,882,1115,Saturday
2015,2,28,1600,284,552,836,Saturday
2015,2,28,1500,337,377,714,Saturday
2015,2,28,1400,320,298,618,Saturday
2015,2,28,1300,401,257,658,Saturday
2015,2,28,1200,450,238,688,Saturday
2015,2,28,1100,521,182,703,Saturday
2015,2,28,1000,652,146,798,Saturday
2015,2,28,900,801,100,901,Saturday
2015,2,28,800,312,47,359,Saturday
2015,2,28,700,84,38,122,Saturday
2015,2,28,600,51,32,83,Saturday
2015,2,28,500,20,18,38,Saturday
2015,2,28,400,15,27,42,Saturday
2015,2,28,300,17,11,28,Saturday
2015,2,28,200,18,36,54,Saturday
2015,2,28,100,39,37,76,Saturday
2015,2,27,2400,77,39,116,Friday
2015,2,27,2300,105,56,161,Friday
2015,2,27,2200,171,94,265,Friday
2015,2,27,2100,245,83,328,Friday
2015,2,27,2000,369,147,516,Friday
2015,2,27,1900,394,245,639,Friday
2015,2,27,1800,457,407,864,Friday
2015,2,27,1700,449,511,960,Friday
2015,2,27,1600,426,362,788,Friday
2015,2,27,1500,362,326,688,Friday
2015,2,27,1400,318,245,563,Friday
2015,2,27,1300,302,237,539,Friday
2015,2,27,1200,324,220,544,Friday
2015,2,27,1100,411,176,587,Friday
2015,2,27,1000,451,152,603,Friday
2015,2,27,900,349,118,467,Friday
2015,2,27,800,171,61,232,Friday
2015,2,27,700,74,58,132,Friday
2015,2,27,600,44,43,87,Friday
2015,2,27,500,23,25,48,Friday
2015,2,27,400,30,40,70,Friday
2015,2,27,300,23,29,52,Friday
2015,2,27,200,31,38,69,Friday
2015,2,27,100,45,38,83,Friday
2015,2,26,2400,65,58,123,Thursday
2015,2,26,2300,82,82,164,Thursday
2015,2,26,2200,138,86,224,Thursday
2015,2,26,2100,181,105,286,Thursday
2015,2,26,2000,208,131,339,Thursday
2015,2,26,1900,216,198,414,Thursday
2015,2,26,1800,257,355,612,Thursday
2015,2,26,1700,283,420,703,Thursday
2015,2,26,1600,309,311,620,Thursday
2015,2,26,1500,273,228,501,Thursday
2015,2,26,1400,277,231,508,Thursday
2015,2,26,1300,250,168,418,Thursday
2015,2,26,1200,266,178,444,Thursday
2015,2,26,1100,282,141,423,Thursday
2015,2,26,1000,289,116,405,Thursday
2015,2,26,900,280,114,394,Thursday
2015,2,26,800,140,61,201,Thursday
2015,2,26,700,65,41,106,Thursday
2015,2,26,600,32,33,65,Thursday
2015,2,26,500,21,28,49,Thursday
2015,2,26,400,29,20,49,Thursday
2015,2,26,300,24,30,54,Thursday
2015,2,26,200,27,30,57,Thursday
2015,2,26,100,52,37,89,Thursday
2015,2,25,2400,51,50,101,Wednesday
2015,2,25,2300,68,85,153,Wednesday
2015,2,25,2200,92,99,191,Wednesday
2015,2,25,2100,92,103,195,Wednesday
2015,2,25,2000,137,137,274,Wednesday
2015,2,25,1900,126,196,322,Wednesday
2015,2,25,1800,169,298,467,Wednesday
2015,2,25,1700,221,302,523,Wednesday
2015,2,25,1600,199,264,463,Wednesday
2015,2,25,1500,205,245,450,Wednesday
2015,2,25,1400,233,201,434,Wednesday
2015,2,25,1300,239,164,403,Wednesday
2015,2,25,1200,253,157,410,Wednesday
2015,2,25,1100,221,153,374,Wednesday
2015,2,25,1000,275,114,389,Wednesday
2015,2,25,900,239,93,332,Wednesday
2015,2,25,800,133,61,194,Wednesday
2015,2,25,700,62,49,111,Wednesday
2015,2,25,600,38,23,61,Wednesday
2015,2,25,500,21,17,38,Wednesday
2015,2,25,400,15,34,49,Wednesday
2015,2,25,300,42,21,63,Wednesday
2015,2,25,200,22,31,53,Wednesday
2015,2,25,100,35,29,64,Wednesday
2015,2,24,2400,44,52,96,Tuesday
2015,2,24,2300,73,78,151,Tuesday
2015,2,24,2200,89,72,161,Tuesday
2015,2,24,2100,72,106,178,Tuesday
2015,2,24,2000,90,139,229,Tuesday
2015,2,24,1900,115,190,305,Tuesday
2015,2,24,1800,145,297,442,Tuesday
2015,2,24,1700,202,367,569,Tuesday
2015,2,24,1600,196,307,503,Tuesday
2015,2,24,1500,181,255,436,Tuesday
2015,2,24,1400,210,234,444,Tuesday
2015,2,24,1300,207,191,398,Tuesday
2015,2,24,1200,218,170,388,Tuesday
2015,2,24,1100,236,176,412,Tuesday
2015,2,24,1000,260,127,387,Tuesday
2015,2,24,900,261,89,350,Tuesday
2015,2,24,800,140,81,221,Tuesday
2015,2,24,700,67,51,118,Tuesday
2015,2,24,600,41,24,65,Tuesday
2015,2,24,500,14,24,38,Tuesday
2015,2,24,400,18,39,57,Tuesday
2015,2,24,300,12,36,48,Tuesday
2015,2,24,200,21,43,64,Tuesday
2015,2,24,100,27,54,81,Tuesday
2015,2,23,2400,53,58,111,Monday
2015,2,23,2300,56,70,126,Monday
2015,2,23,2200,72,81,153,Monday
2015,2,23,2100,78,112,190,Monday
2015,2,23,2000,116,146,262,Monday
2015,2,23,1900,134,242,376,Monday
2015,2,23,1800,156,400,556,Monday
2015,2,23,1700,187,457,644,Monday
2015,2,23,1600,236,315,551,Monday
2015,2,23,1500,235,294,529,Monday
2015,2,23,1400,228,222,450,Monday
2015,2,23,1300,229,223,452,Monday
2015,2,23,1200,303,192,495,Monday
2015,2,23,1100,279,193,472,Monday
2015,2,23,1000,301,127,428,Monday
2015,2,23,900,274,82,356,Monday
2015,2,23,800,138,61,199,Monday
2015,2,23,700,73,40,113,Monday
2015,2,23,600,35,18,53,Monday
2015,2,23,500,15,25,40,Monday
2015,2,23,400,17,13,30,Monday
2015,2,23,300,13,26,39,Monday
2015,2,23,200,23,33,56,Monday
2015,2,23,100,23,37,60,Monday
2015,2,22,2400,24,59,83,Sunday
2015,2,22,2300,26,76,102,Sunday
2015,2,22,2200,58,136,194,Sunday
2015,2,22,2100,93,202,295,Sunday
2015,2,22,2000,104,363,467,Sunday
2015,2,22,1900,114,516,630,Sunday
2015,2,22,1800,149,955,1104,Sunday
2015,2,22,1700,169,1201,1370,Sunday
2015,2,22,1600,231,824,1055,Sunday
2015,2,22,1500,223,762,985,Sunday
2015,2,22,1400,319,652,971,Sunday
2015,2,22,1300,375,621,996,Sunday
2015,2,22,1200,402,445,847,Sunday
2015,2,22,1100,373,243,616,Sunday
2015,2,22,1000,466,152,618,Sunday
2015,2,22,900,558,69,627,Sunday
2015,2,22,800,229,30,259,Sunday
2015,2,22,700,65,36,101,Sunday
2015,2,22,600,28,17,45,Sunday
2015,2,22,500,19,11,30,Sunday
2015,2,22,400,17,17,34,Sunday
2015,2,22,300,8,17,25,Sunday
2015,2,22,200,19,28,47,Sunday
2015,2,22,100,13,33,46,Sunday
2015,2,21,2400,43,35,78,Saturday
2015,2,21,2300,69,67,136,Saturday
2015,2,21,2200,63,77,140,Saturday
2015,2,21,2100,92,128,220,Saturday
2015,2,21,2000,97,231,328,Saturday
2015,2,21,1900,116,347,463,Saturday
2015,2,21,1800,162,884,1046,Saturday
2015,2,21,1700,223,876,1099,Saturday
2015,2,21,1600,240,540,780,Saturday
2015,2,21,1500,250,392,642,Saturday
2015,2,21,1400,285,309,594,Saturday
2015,2,21,1300,339,304,643,Saturday
2015,2,21,1200,420,302,722,Saturday
2015,2,21,1100,427,191,618,Saturday
2015,2,21,1000,608,152,760,Saturday
2015,2,21,900,821,111,932,Saturday
2015,2,21,800,289,64,353,Saturday
2015,2,21,700,72,38,110,Saturday
2015,2,21,600,38,33,71,Saturday
2015,2,21,500,14,36,50,Saturday
2015,2,21,400,11,21,32,Saturday
2015,2,21,300,24,28,52,Saturday
2015,2,21,200,19,39,58,Saturday
2015,2,21,100,30,46,76,Saturday
2015,2,20,2400,61,59,120,Friday
2015,2,20,2300,117,59,176,Friday
2015,2,20,2200,157,82,239,Friday
2015,2,20,2100,325,129,454,Friday
2015,2,20,2000,363,190,553,Friday
2015,2,20,1900,308,290,598,Friday
2015,2,20,1800,431,546,977,Friday
2015,2,20,1700,483,669,1152,Friday
2015,2,20,1600,514,474,988,Friday
2015,2,20,1500,416,376,792,Friday
2015,2,20,1400,359,370,729,Friday
2015,2,20,1300,362,314,676,Friday
2015,2,20,1200,376,255,631,Friday
2015,2,20,1100,392,191,583,Friday
2015,2,20,1000,440,158,598,Friday
2015,2,20,900,476,122,598,Friday
2015,2,20,800,198,64,262,Friday
2015,2,20,700,70,36,106,Friday
2015,2,20,600,40,25,65,Friday
2015,2,20,500,19,31,50,Friday
2015,2,20,400,20,17,37,Friday
2015,2,20,300,24,24,48,Friday
2015,2,20,200,28,28,56,Friday
2015,2,20,100,47,36,83,Friday
2015,2,19,2400,58,63,121,Thursday
2015,2,19,2300,103,81,184,Thursday
2015,2,19,2200,138,95,233,Thursday
2015,2,19,2100,173,127,300,Thursday
2015,2,19,2000,209,167,376,Thursday
2015,2,19,1900,222,278,500,Thursday
2015,2,19,1800,262,539,801,Thursday
2015,2,19,1700,325,622,947,Thursday
2015,2,19,1600,329,453,782,Thursday
2015,2,19,1500,308,387,695,Thursday
2015,2,19,1400,284,309,593,Thursday
2015,2,19,1300,332,237,569,Thursday
2015,2,19,1200,343,211,554,Thursday
2015,2,19,1100,370,169,539,Thursday
2015,2,19,1000,458,129,587,Thursday
2015,2,19,900,468,100,568,Thursday
2015,2,19,800,176,64,240,Thursday
2015,2,19,700,71,66,137,Thursday
2015,2,19,600,39,47,86,Thursday
2015,2,19,500,20,1,21,Thursday
2015,2,19,400,19,11,30,Thursday
2015,2,19,300,25,27,52,Thursday
2015,2,19,200,31,29,60,Thursday
2015,2,19,100,34,46,80,Thursday
2015,2,18,2400,53,63,116,Wednesday
2015,2,18,2300,77,80,157,Wednesday
2015,2,18,2200,91,87,178,Wednesday
2015,2,18,2100,114,122,236,Wednesday
2015,2,18,2000,160,145,305,Wednesday
2015,2,18,1900,141,242,383,Wednesday
2015,2,18,1800,182,544,726,Wednesday
2015,2,18,1700,227,654,881,Wednesday
2015,2,18,1600,253,410,663,Wednesday
2015,2,18,1500,262,347,609,Wednesday
2015,2,18,1400,255,331,586,Wednesday
2015,2,18,1300,281,244,525,Wednesday
2015,2,18,1200,356,232,588,Wednesday
2015,2,18,1100,340,177,517,Wednesday
2015,2,18,1000,474,142,616,Wednesday
2015,2,18,900,403,98,501,Wednesday
2015,2,18,800,166,75,241,Wednesday
2015,2,18,700,56,28,84,Wednesday
2015,2,18,600,50,30,80,Wednesday
2015,2,18,500,20,28,48,Wednesday
2015,2,18,400,18,44,62,Wednesday
2015,2,18,300,30,31,61,Wednesday
2015,2,18,200,24,12,36,Wednesday
2015,2,18,100,48,48,96,Wednesday
2015,2,17,2400,49,55,104,Tuesday
2015,2,17,2300,73,84,157,Tuesday
2015,2,17,2200,89,92,181,Tuesday
2015,2,17,2100,121,112,233,Tuesday
2015,2,17,2000,126,171,297,Tuesday
2015,2,17,1900,135,287,422,Tuesday
2015,2,17,1800,176,577,753,Tuesday
2015,2,17,1700,267,769,1036,Tuesday
2015,2,17,1600,295,536,831,Tuesday
2015,2,17,1500,322,399,721,Tuesday
2015,2,17,1400,273,358,631,Tuesday
2015,2,17,1300,338,269,607,Tuesday
2015,2,17,1200,358,253,611,Tuesday
2015,2,17,1100,384,233,617,Tuesday
2015,2,17,1000,465,173,638,Tuesday
2015,2,17,900,470,141,611,Tuesday
2015,2,17,800,185,84,269,Tuesday
2015,2,17,700,65,57,122,Tuesday
2015,2,17,600,30,35,65,Tuesday
2015,2,17,500,18,32,50,Tuesday
2015,2,17,400,11,28,39,Tuesday
2015,2,17,300,14,29,43,Tuesday
2015,2,17,200,23,35,58,Tuesday
2015,2,17,100,21,66,87,Tuesday
2015,2,16,2400,45,98,143,Monday
2015,2,16,2300,57,106,163,Monday
2015,2,16,2200,59,178,237,Monday
2015,2,16,2100,90,250,340,Monday
2015,2,16,2000,97,405,502,Monday
2015,2,16,1900,118,807,925,Monday
2015,2,16,1800,157,1357,1514,Monday
2015,2,16,1700,239,1669,1908,Monday
2015,2,16,1600,312,1493,1805,Monday
2015,2,16,1500,380,1396,1776,Monday
2015,2,16,1400,408,1355,1763,Monday
2015,2,16,1300,410,1090,1500,Monday
2015,2,16,1200,528,814,1342,Monday
2015,2,16,1100,513,405,918,Monday
2015,2,16,1000,611,213,824,Monday
2015,2,16,900,614,107,721,Monday
2015,2,16,800,238,50,288,Monday
2015,2,16,700,79,26,105,Monday
2015,2,16,600,30,12,42,Monday
2015,2,16,500,9,15,24,Monday
2015,2,16,400,19,23,42,Monday
2015,2,16,300,15,23,38,Monday
2015,2,16,200,21,17,38,Monday
2015,2,16,100,21,51,72,Monday
2015,2,15,2400,44,58,102,Sunday
2015,2,15,2300,56,72,128,Sunday
2015,2,15,2200,87,105,192,Sunday
2015,2,15,2100,112,186,298,Sunday
2015,2,15,2000,137,298,435,Sunday
2015,2,15,1900,152,580,732,Sunday
2015,2,15,1800,226,1315,1541,Sunday
2015,2,15,1700,331,1455,1786,Sunday
2015,2,15,1600,423,1046,1469,Sunday
2015,2,15,1500,498,731,1229,Sunday
2015,2,15,1400,613,594,1207,Sunday
2015,2,15,1300,720,483,1203,Sunday
2015,2,15,1200,756,346,1102,Sunday
2015,2,15,1100,702,200,902,Sunday
2015,2,15,1000,824,125,949,Sunday
2015,2,15,900,956,75,1031,Sunday
2015,2,15,800,389,28,417,Sunday
2015,2,15,700,81,12,93,Sunday
2015,2,15,600,33,15,48,Sunday
2015,2,15,500,19,11,30,Sunday
2015,2,15,400,15,21,36,Sunday
2015,2,15,300,11,24,35,Sunday
2015,2,15,200,25,22,47,Sunday
2015,2,15,100,26,20,46,Sunday
2015,2,14,2400,37,43,80,Saturday
2015,2,14,2300,61,70,131,Saturday
2015,2,14,2200,96,92,188,Saturday
2015,2,14,2100,96,129,225,Saturday
2015,2,14,2000,161,181,342,Saturday
2015,2,14,1900,195,351,546,Saturday
2015,2,14,1800,258,915,1173,Saturday
2015,2,14,1700,413,1023,1436,Saturday
2015,2,14,1600,515,673,1188,Saturday
2015,2,14,1500,617,476,1093,Saturday
2015,2,14,1400,646,327,973,Saturday
2015,2,14,1300,647,298,945,Saturday
2015,2,14,1200,776,260,1036,Saturday
2015,2,14,1100,723,172,895,Saturday
2015,2,14,1000,764,142,906,Saturday
2015,2,14,900,960,88,1048,Saturday
2015,2,14,800,398,38,436,Saturday
2015,2,14,700,105,30,135,Saturday
2015,2,14,600,50,23,73,Saturday
2015,2,14,500,22,15,37,Saturday
2015,2,14,400,29,18,47,Saturday
2015,2,14,300,40,25,65,Saturday
2015,2,14,200,35,25,60,Saturday
2015,2,14,100,59,35,94,Saturday
2015,2,13,2400,94,48,142,Friday
2015,2,13,2300,173,52,225,Friday
2015,2,13,2200,318,70,388,Friday
2015,2,13,2100,467,102,569,Friday
2015,2,13,2000,672,159,831,Friday
2015,2,13,1900,754,254,1008,Friday
2015,2,13,1800,835,518,1353,Friday
2015,2,13,1700,855,651,1506,Friday
2015,2,13,1600,883,484,1367,Friday
2015,2,13,1500,834,353,1187,Friday
2015,2,13,1400,597,270,867,Friday
2015,2,13,1300,570,235,805,Friday
2015,2,13,1200,564,207,771,Friday
2015,2,13,1100,552,156,708,Friday
2015,2,13,1000,595,148,743,Friday
2015,2,13,900,584,84,668,Friday
2015,2,13,800,249,54,303,Friday
2015,2,13,700,104,45,149,Friday
2015,2,13,600,58,31,89,Friday
2015,2,13,500,33,28,61,Friday
2015,2,13,400,40,29,69,Friday
2015,2,13,300,26,24,50,Friday
2015,2,13,200,36,36,72,Friday
2015,2,13,100,49,24,73,Friday
2015,2,12,2400,64,58,122,Thursday
2015,2,12,2300,127,60,187,Thursday
2015,2,12,2200,168,85,253,Thursday
2015,2,12,2100,207,67,274,Thursday
2015,2,12,2000,332,132,464,Thursday
2015,2,12,1900,322,214,536,Thursday
2015,2,12,1800,354,349,703,Thursday
2015,2,12,1700,377,447,824,Thursday
2015,2,12,1600,395,362,757,Thursday
2015,2,12,1500,433,247,680,Thursday
2015,2,12,1400,406,193,599,Thursday
2015,2,12,1300,363,205,568,Thursday
2015,2,12,1200,403,138,541,Thursday
2015,2,12,1100,411,156,567,Thursday
2015,2,12,1000,414,134,548,Thursday
2015,2,12,900,398,86,484,Thursday
2015,2,12,800,177,56,233,Thursday
2015,2,12,700,81,49,130,Thursday
2015,2,12,600,42,26,68,Thursday
2015,2,12,500,23,18,41,Thursday
2015,2,12,400,24,22,46,Thursday
2015,2,12,300,20,33,53,Thursday
2015,2,12,200,32,35,67,Thursday
2015,2,12,100,39,36,75,Thursday
2015,2,11,2400,51,48,99,Wednesday
2015,2,11,2300,72,76,148,Wednesday
2015,2,11,2200,103,82,185,Wednesday
2015,2,11,2100,120,84,204,Wednesday
2015,2,11,2000,145,118,263,Wednesday
2015,2,11,1900,170,182,352,Wednesday
2015,2,11,1800,201,300,501,Wednesday
2015,2,11,1700,240,400,640,Wednesday
2015,2,11,1600,217,277,494,Wednesday
2015,2,11,1500,182,213,395,Wednesday
2015,2,11,1400,225,178,403,Wednesday
2015,2,11,1300,219,174,393,Wednesday
2015,2,11,1200,236,144,380,Wednesday
2015,2,11,1100,256,143,399,Wednesday
2015,2,11,1000,262,110,372,Wednesday
2015,2,11,900,242,101,343,Wednesday
2015,2,11,800,131,65,196,Wednesday
2015,2,11,700,60,42,102,Wednesday
2015,2,11,600,31,26,57,Wednesday
2015,2,11,500,18,29,47,Wednesday
2015,2,11,400,20,26,46,Wednesday
2015,2,11,300,20,25,45,Wednesday
2015,2,11,200,20,32,52,Wednesday
2015,2,11,100,38,42,80,Wednesday
2015,2,10,2400,52,70,122,Tuesday
2015,2,10,2300,54,65,119,Tuesday
2015,2,10,2200,63,60,123,Tuesday
2015,2,10,2100,90,64,154,Tuesday
2015,2,10,2000,92,103,195,Tuesday
2015,2,10,1900,107,171,278,Tuesday
2015,2,10,1800,161,305,466,Tuesday
2015,2,10,1700,161,408,569,Tuesday
2015,2,10,1600,161,290,451,Tuesday
2015,2,10,1500,201,253,454,Tuesday
2015,2,10,1400,184,193,377,Tuesday
2015,2,10,1300,192,142,334,Tuesday
2015,2,10,1200,235,145,380,Tuesday
2015,2,10,1100,293,105,398,Tuesday
2015,2,10,1000,302,109,411,Tuesday
2015,2,10,900,256,73,329,Tuesday
2015,2,10,800,157,41,198,Tuesday
2015,2,10,700,85,29,114,Tuesday
2015,2,10,600,21,17,38,Tuesday
2015,2,10,500,18,21,39,Tuesday
2015,2,10,400,15,18,33,Tuesday
2015,2,10,300,26,25,51,Tuesday
2015,2,10,200,26,28,54,Tuesday
2015,2,10,100,39,34,73,Tuesday
2015,2,9,2400,36,41,77,Monday
2015,2,9,2300,55,56,111,Monday
2015,2,9,2200,70,56,126,Monday
2015,2,9,2100,75,74,149,Monday
2015,2,9,2000,97,109,206,Monday
2015,2,9,1900,128,168,296,Monday
2015,2,9,1800,155,304,459,Monday
2015,2,9,1700,210,434,644,Monday
2015,2,9,1600,227,337,564,Monday
2015,2,9,1500,240,268,508,Monday
2015,2,9,1400,253,185,438,Monday
2015,2,9,1300,262,181,443,Monday
2015,2,9,1200,281,161,442,Monday
2015,2,9,1100,311,176,487,Monday
2015,2,9,1000,317,104,421,Monday
2015,2,9,900,298,69,367,Monday
2015,2,9,800,135,33,168,Monday
2015,2,9,700,73,32,105,Monday
2015,2,9,600,20,12,32,Monday
2015,2,9,500,19,17,36,Monday
2015,2,9,400,12,22,34,Monday
2015,2,9,300,16,25,41,Monday
2015,2,9,200,10,19,29,Monday
2015,2,9,100,28,36,64,Monday
2015,2,8,2400,29,53,82,Sunday
2015,2,8,2300,36,89,125,Sunday
2015,2,8,2200,53,125,178,Sunday
2015,2,8,2100,77,142,219,Sunday
2015,2,8,2000,76,235,311,Sunday
2015,2,8,1900,78,494,572,Sunday
2015,2,8,1800,124,1101,1225,Sunday
2015,2,8,1700,169,1611,1780,Sunday
2015,2,8,1600,224,717,941,Sunday
2015,2,8,1500,261,656,917,Sunday
2015,2,8,1400,270,560,830,Sunday
2015,2,8,1300,354,530,884,Sunday
2015,2,8,1200,385,358,743,Sunday
2015,2,8,1100,385,236,621,Sunday
2015,2,8,1000,541,127,668,Sunday
2015,2,8,900,932,67,999,Sunday
2015,2,8,800,379,31,410,Sunday
2015,2,8,700,61,14,75,Sunday
2015,2,8,600,18,18,36,Sunday
2015,2,8,500,16,6,22,Sunday
2015,2,8,400,9,16,25,Sunday
2015,2,8,300,11,15,26,Sunday
2015,2,8,200,13,14,27,Sunday
2015,2,8,100,16,25,41,Sunday
2015,2,7,2400,26,53,79,Saturday
2015,2,7,2300,43,47,90,Saturday
2015,2,7,2200,46,70,116,Saturday
2015,2,7,2100,68,91,159,Saturday
2015,2,7,2000,71,146,217,Saturday
2015,2,7,1900,107,551,658,Saturday
2015,2,7,1800,143,1304,1447,Saturday
2015,2,7,1700,180,1016,1196,Saturday
2015,2,7,1600,264,671,935,Saturday
2015,2,7,1500,263,438,701,Saturday
2015,2,7,1400,311,347,658,Saturday
2015,2,7,1300,396,307,703,Saturday
2015,2,7,1200,442,292,734,Saturday
2015,2,7,1100,690,327,1017,Saturday
2015,2,7,1000,1093,173,1266,Saturday
2015,2,7,900,1216,59,1275,Saturday
2015,2,7,800,633,66,699,Saturday
2015,2,7,700,110,23,133,Saturday
2015,2,7,600,34,18,52,Saturday
2015,2,7,500,13,21,34,Saturday
2015,2,7,400,20,33,53,Saturday
2015,2,7,300,21,25,46,Saturday
2015,2,7,200,20,18,38,Saturday
2015,2,7,100,41,46,87,Saturday
2015,2,6,2400,60,59,119,Friday
2015,2,6,2300,81,52,133,Friday
2015,2,6,2200,138,60,198,Friday
2015,2,6,2100,194,124,318,Friday
2015,2,6,2000,334,200,534,Friday
2015,2,6,1900,364,137,501,Friday
2015,2,6,1800,462,463,925,Friday
2015,2,6,1700,374,590,964,Friday
2015,2,6,1600,356,453,809,Friday
2015,2,6,1500,333,249,582,Friday
2015,2,6,1400,260,216,476,Friday
2015,2,6,1300,225,339,564,Friday
2015,2,6,1200,256,153,409,Friday
2015,2,6,1100,419,95,514,Friday
2015,2,6,1000,464,93,557,Friday
2015,2,6,900,594,108,702,Friday
2015,2,6,800,239,22,261,Friday
2015,2,6,700,1,11,12,Friday
2015,2,6,600,1,13,14,Friday
2015,2,6,500,1,25,26,Friday
2015,2,6,400,8,21,29,Friday
2015,2,6,300,0,23,23,Friday
2015,2,6,200,7,28,35,Friday
2015,2,6,100,37,63,100,Friday
2015,2,5,2400,52,64,116,Thursday
2015,2,5,2300,81,102,183,Thursday
2015,2,5,2200,98,58,156,Thursday
2015,2,5,2100,149,62,211,Thursday
2015,2,5,2000,182,125,307,Thursday
2015,2,5,1900,158,172,330,Thursday
2015,2,5,1800,201,286,487,Thursday
2015,2,5,1700,197,332,529,Thursday
2015,2,5,1600,236,224,460,Thursday
2015,2,5,1500,213,167,380,Thursday
2015,2,5,1400,185,203,388,Thursday
2015,2,5,1300,214,164,378,Thursday
2015,2,5,1200,222,131,353,Thursday
2015,2,5,1100,276,124,400,Thursday
2015,2,5,1000,285,98,383,Thursday
2015,2,5,900,288,72,360,Thursday
2015,2,5,800,166,57,223,Thursday
2015,2,5,700,62,32,94,Thursday
2015,2,5,600,42,30,72,Thursday
2015,2,5,500,15,20,35,Thursday
2015,2,5,400,25,25,50,Thursday
2015,2,5,300,15,37,52,Thursday
2015,2,5,200,23,31,54,Thursday
2015,2,5,100,33,36,69,Thursday
2015,2,4,2400,62,44,106,Wednesday
2015,2,4,2300,76,65,141,Wednesday
2015,2,4,2200,97,72,169,Wednesday
2015,2,4,2100,110,84,194,Wednesday
2015,2,4,2000,124,115,239,Wednesday
2015,2,4,1900,100,187,287,Wednesday
2015,2,4,1800,149,303,452,Wednesday
2015,2,4,1700,166,361,527,Wednesday
2015,2,4,1600,206,277,483,Wednesday
2015,2,4,1500,190,262,452,Wednesday
2015,2,4,1400,209,211,420,Wednesday
2015,2,4,1300,210,156,366,Wednesday
2015,2,4,1200,218,171,389,Wednesday
2015,2,4,1100,238,126,364,Wednesday
2015,2,4,1000,269,127,396,Wednesday
2015,2,4,900,262,87,349,Wednesday
2015,2,4,800,138,51,189,Wednesday
2015,2,4,700,69,36,105,Wednesday
2015,2,4,600,20,20,40,Wednesday
2015,2,4,500,24,24,48,Wednesday
2015,2,4,400,24,25,49,Wednesday
2015,2,4,300,16,33,49,Wednesday
2015,2,4,200,20,29,49,Wednesday
2015,2,4,100,34,27,61,Wednesday
2015,2,3,2400,36,48,84,Tuesday
2015,2,3,2300,66,63,129,Tuesday
2015,2,3,2200,77,76,153,Tuesday
2015,2,3,2100,89,82,171,Tuesday
2015,2,3,2000,109,140,249,Tuesday
2015,2,3,1900,121,187,308,Tuesday
2015,2,3,1800,122,255,377,Tuesday
2015,2,3,1700,136,303,439,Tuesday
2015,2,3,1600,182,269,451,Tuesday
2015,2,3,1500,192,238,430,Tuesday
2015,2,3,1400,204,145,349,Tuesday
2015,2,3,1300,180,179,359,Tuesday
2015,2,3,1200,186,153,339,Tuesday
2015,2,3,1100,188,116,304,Tuesday
2015,2,3,1000,203,105,308,Tuesday
2015,2,3,900,219,85,304,Tuesday
2015,2,3,800,124,50,174,Tuesday
2015,2,3,700,70,32,102,Tuesday
2015,2,3,600,30,33,63,Tuesday
2015,2,3,500,16,25,41,Tuesday
2015,2,3,400,22,20,42,Tuesday
2015,2,3,300,21,38,59,Tuesday
2015,2,3,200,17,35,52,Tuesday
2015,2,3,100,37,37,74,Tuesday
2015,2,2,2400,38,44,82,Monday
2015,2,2,2300,48,62,110,Monday
2015,2,2,2200,64,67,131,Monday
2015,2,2,2100,91,69,160,Monday
2015,2,2,2000,112,104,216,Monday
2015,2,2,1900,105,226,331,Monday
2015,2,2,1800,121,373,494,Monday
2015,2,2,1700,185,436,621,Monday
2015,2,2,1600,180,295,475,Monday
2015,2,2,1500,165,333,498,Monday
2015,2,2,1400,189,240,429,Monday
2015,2,2,1300,213,216,429,Monday
2015,2,2,1200,193,198,391,Monday
2015,2,2,1100,171,103,274,Monday
2015,2,2,1000,258,110,368,Monday
2015,2,2,900,219,82,301,Monday
2015,2,2,800,134,65,199,Monday
2015,2,2,700,65,89,154,Monday
2015,2,2,600,25,43,68,Monday
2015,2,2,500,12,6,18,Monday
2015,2,2,400,10,3,13,Monday
2015,2,2,300,12,4,16,Monday
2015,2,2,200,24,16,40,Monday
2015,2,2,100,17,34,51,Monday
2015,2,1,2400,31,47,78,Sunday
2015,2,1,2300,32,70,102,Sunday
2015,2,1,2200,43,97,140,Sunday
2015,2,1,2100,59,97,156,Sunday
2015,2,1,2000,96,202,298,Sunday
2015,2,1,1900,105,243,348,Sunday
2015,2,1,1800,112,732,844,Sunday
2015,2,1,1700,173,1093,1266,Sunday
2015,2,1,1600,239,935,1174,Sunday
2015,2,1,1500,212,817,1029,Sunday
2015,2,1,1400,277,647,924,Sunday
2015,2,1,1300,302,557,859,Sunday
2015,2,1,1200,345,363,708,Sunday
2015,2,1,1100,344,219,563,Sunday
2015,2,1,1000,476,124,600,Sunday
2015,2,1,900,552,62,614,Sunday
2015,2,1,800,234,28,262,Sunday
2015,2,1,700,53,10,63,Sunday
2015,2,1,600,21,9,30,Sunday
2015,2,1,500,6,10,16,Sunday
2015,2,1,400,9,9,18,Sunday
2015,2,1,300,19,32,51,Sunday
2015,2,1,200,13,22,35,Sunday
2015,2,1,100,20,28,48,Sunday
2015,1,31,2400,34,39,73,Saturday
2015,1,31,2300,44,47,91,Saturday
2015,1,31,2200,65,70,135,Saturday
2015,1,31,2100,62,128,190,Saturday
2015,1,31,2000,87,154,241,Saturday
2015,1,31,1900,124,344,468,Saturday
2015,1,31,1800,155,995,1150,Saturday
2015,1,31,1700,184,892,1076,Saturday
2015,1,31,1600,228,527,755,Saturday
2015,1,31,1500,274,338,612,Saturday
2015,1,31,1400,317,271,588,Saturday
2015,1,31,1300,330,254,584,Saturday
2015,1,31,1200,415,168,583,Saturday
2015,1,31,1100,461,114,575,Saturday
2015,1,31,1000,731,74,805,Saturday
2015,1,31,900,775,63,838,Saturday
2015,1,31,800,271,28,299,Saturday
2015,1,31,700,73,19,92,Saturday
2015,1,31,600,20,30,50,Saturday
2015,1,31,500,15,24,39,Saturday
2015,1,31,400,18,27,45,Saturday
2015,1,31,300,17,13,30,Saturday
2015,1,31,200,13,30,43,Saturday
2015,1,31,100,39,25,64,Saturday
2015,1,30,2400,69,47,116,Friday
2015,1,30,2300,98,61,159,Friday
2015,1,30,2200,139,73,212,Friday
2015,1,30,2100,222,92,314,Friday
2015,1,30,2000,377,126,503,Friday
2015,1,30,1900,448,228,676,Friday
2015,1,30,1800,444,454,898,Friday
2015,1,30,1700,407,540,947,Friday
2015,1,30,1600,463,401,864,Friday
2015,1,30,1500,466,249,715,Friday
2015,1,30,1400,399,243,642,Friday
2015,1,30,1300,392,215,607,Friday
2015,1,30,1200,370,183,553,Friday
2015,1,30,1100,385,138,523,Friday
2015,1,30,1000,479,111,590,Friday
2015,1,30,900,410,84,494,Friday
2015,1,30,800,207,52,259,Friday
2015,1,30,700,82,39,121,Friday
2015,1,30,600,28,31,59,Friday
2015,1,30,500,29,32,61,Friday
2015,1,30,400,23,32,55,Friday
2015,1,30,300,21,25,46,Friday
2015,1,30,200,33,39,72,Friday
2015,1,30,100,43,26,69,Friday
2015,1,29,2400,67,46,113,Thursday
2015,1,29,2300,85,64,149,Thursday
2015,1,29,2200,143,83,226,Thursday
2015,1,29,2100,161,92,253,Thursday
2015,1,29,2000,214,126,340,Thursday
2015,1,29,1900,277,193,470,Thursday
2015,1,29,1800,258,386,644,Thursday
2015,1,29,1700,272,402,674,Thursday
2015,1,29,1600,278,313,591,Thursday
2015,1,29,1500,249,254,503,Thursday
2015,1,29,1400,239,215,454,Thursday
2015,1,29,1300,244,185,429,Thursday
2015,1,29,1200,252,151,403,Thursday
2015,1,29,1100,293,132,425,Thursday
2015,1,29,1000,310,113,423,Thursday
2015,1,29,900,293,83,376,Thursday
2015,1,29,800,173,48,221,Thursday
2015,1,29,700,62,29,91,Thursday
2015,1,29,600,32,25,57,Thursday
2015,1,29,500,19,18,37,Thursday
2015,1,29,400,17,29,46,Thursday
2015,1,29,300,20,23,43,Thursday
2015,1,29,200,35,32,67,Thursday
2015,1,29,100,43,47,90,Thursday
2015,1,28,2400,53,79,132,Wednesday
2015,1,28,2300,75,53,128,Wednesday
2015,1,28,2200,93,87,180,Wednesday
2015,1,28,2100,107,87,194,Wednesday
2015,1,28,2000,130,113,243,Wednesday
2015,1,28,1900,126,162,288,Wednesday
2015,1,28,1800,161,313,474,Wednesday
2015,1,28,1700,202,406,608,Wednesday
2015,1,28,1600,200,272,472,Wednesday
2015,1,28,1500,196,235,431,Wednesday
2015,1,28,1400,188,183,371,Wednesday
2015,1,28,1300,210,161,371,Wednesday
2015,1,28,1200,239,141,380,Wednesday
2015,1,28,1100,248,116,364,Wednesday
2015,1,28,1000,297,99,396,Wednesday
2015,1,28,900,227,79,306,Wednesday
2015,1,28,800,150,62,212,Wednesday
2015,1,28,700,51,42,93,Wednesday
2015,1,28,600,27,28,55,Wednesday
2015,1,28,500,13,23,36,Wednesday
2015,1,28,400,21,26,47,Wednesday
2015,1,28,300,23,22,45,Wednesday
2015,1,28,200,23,30,53,Wednesday
2015,1,28,100,39,43,82,Wednesday
2015,1,27,2400,59,44,103,Tuesday
2015,1,27,2300,62,65,127,Tuesday
2015,1,27,2200,70,73,143,Tuesday
2015,1,27,2100,71,87,158,Tuesday
2015,1,27,2000,88,97,185,Tuesday
2015,1,27,1900,119,180,299,Tuesday
2015,1,27,1800,136,290,426,Tuesday
2015,1,27,1700,150,368,518,Tuesday
2015,1,27,1600,205,296,501,Tuesday
2015,1,27,1500,220,235,455,Tuesday
2015,1,27,1400,202,248,450,Tuesday
2015,1,27,1300,198,196,394,Tuesday
2015,1,27,1200,229,168,397,Tuesday
2015,1,27,1100,242,140,382,Tuesday
2015,1,27,1000,265,132,397,Tuesday
2015,1,27,900,194,98,292,Tuesday
2015,1,27,800,108,43,151,Tuesday
2015,1,27,700,50,32,82,Tuesday
2015,1,27,600,30,29,59,Tuesday
2015,1,27,500,9,23,32,Tuesday
2015,1,27,400,22,29,51,Tuesday
2015,1,27,300,15,29,44,Tuesday
2015,1,27,200,24,35,59,Tuesday
2015,1,27,100,28,36,64,Tuesday
2015,1,26,2400,38,45,83,Monday
2015,1,26,2300,44,49,93,Monday
2015,1,26,2200,71,68,139,Monday
2015,1,26,2100,73,87,160,Monday
2015,1,26,2000,110,131,241,Monday
2015,1,26,1900,110,181,291,Monday
2015,1,26,1800,138,329,467,Monday
2015,1,26,1700,185,318,503,Monday
2015,1,26,1600,195,323,518,Monday
2015,1,26,1500,188,273,461,Monday
2015,1,26,1400,201,235,436,Monday
2015,1,26,1300,249,243,492,Monday
2015,1,26,1200,257,172,429,Monday
2015,1,26,1100,265,148,413,Monday
2015,1,26,1000,238,79,317,Monday
2015,1,26,900,219,64,283,Monday
2015,1,26,800,102,51,153,Monday
2015,1,26,700,44,26,70,Monday
2015,1,26,600,23,20,43,Monday
2015,1,26,500,15,14,29,Monday
2015,1,26,400,9,19,28,Monday
2015,1,26,300,13,13,26,Monday
2015,1,26,200,14,34,48,Monday
2015,1,26,100,22,36,58,Monday
2015,1,25,2400,30,61,91,Sunday
2015,1,25,2300,33,104,137,Sunday
2015,1,25,2200,68,137,205,Sunday
2015,1,25,2100,65,178,243,Sunday
2015,1,25,2000,81,291,372,Sunday
2015,1,25,1900,92,560,652,Sunday
2015,1,25,1800,152,1314,1466,Sunday
2015,1,25,1700,204,1614,1818,Sunday
2015,1,25,1600,277,1184,1461,Sunday
2015,1,25,1500,343,980,1323,Sunday
2015,1,25,1400,488,806,1294,Sunday
2015,1,25,1300,594,707,1301,Sunday
2015,1,25,1200,656,430,1086,Sunday
2015,1,25,1100,566,217,783,Sunday
2015,1,25,1000,680,144,824,Sunday
2015,1,25,900,836,67,903,Sunday
2015,1,25,800,281,34,315,Sunday
2015,1,25,700,60,12,72,Sunday
2015,1,25,600,24,10,34,Sunday
2015,1,25,500,19,12,31,Sunday
2015,1,25,400,12,15,27,Sunday
2015,1,25,300,13,20,33,Sunday
2015,1,25,200,10,18,28,Sunday
2015,1,25,100,15,31,46,Sunday
2015,1,24,2400,43,52,95,Saturday
2015,1,24,2300,53,71,124,Saturday
2015,1,24,2200,67,91,158,Saturday
2015,1,24,2100,79,136,215,Saturday
2015,1,24,2000,98,283,381,Saturday
2015,1,24,1900,116,487,603,Saturday
2015,1,24,1800,190,1343,1533,Saturday
2015,1,24,1700,244,1324,1568,Saturday
2015,1,24,1600,313,726,1039,Saturday
2015,1,24,1500,370,497,867,Saturday
2015,1,24,1400,522,426,948,Saturday
2015,1,24,1300,572,241,813,Saturday
2015,1,24,1200,622,169,791,Saturday
2015,1,24,1100,720,159,879,Saturday
2015,1,24,1000,998,109,1107,Saturday
2015,1,24,900,1123,85,1208,Saturday
2015,1,24,800,363,56,419,Saturday
2015,1,24,700,88,24,112,Saturday
2015,1,24,600,21,24,45,Saturday
2015,1,24,500,13,31,44,Saturday
2015,1,24,400,22,60,82,Saturday
2015,1,24,300,28,30,58,Saturday
2015,1,24,200,18,28,46,Saturday
2015,1,24,100,39,18,57,Saturday
2015,1,23,2400,62,24,86,Friday
2015,1,23,2300,112,22,134,Friday
2015,1,23,2200,174,38,212,Friday
2015,1,23,2100,273,81,354,Friday
2015,1,23,2000,396,114,510,Friday
2015,1,23,1900,424,118,542,Friday
2015,1,23,1800,455,294,749,Friday
2015,1,23,1700,435,455,890,Friday
2015,1,23,1600,454,406,860,Friday
2015,1,23,1500,428,276,704,Friday
2015,1,23,1400,361,223,584,Friday
2015,1,23,1300,355,169,524,Friday
2015,1,23,1200,398,154,552,Friday
2015,1,23,1100,377,137,514,Friday
2015,1,23,1000,374,114,488,Friday
2015,1,23,900,347,81,428,Friday
2015,1,23,800,171,61,232,Friday
2015,1,23,700,73,27,100,Friday
2015,1,23,600,39,35,74,Friday
2015,1,23,500,27,31,58,Friday
2015,1,23,400,22,28,50,Friday
2015,1,23,300,23,24,47,Friday
2015,1,23,200,25,36,61,Friday
2015,1,23,100,35,39,74,Friday
2015,1,22,2400,56,43,99,Thursday
2015,1,22,2300,92,59,151,Thursday
2015,1,22,2200,136,76,212,Thursday
2015,1,22,2100,168,113,281,Thursday
2015,1,22,2000,200,139,339,Thursday
2015,1,22,1900,211,151,362,Thursday
2015,1,22,1800,204,298,502,Thursday
2015,1,22,1700,262,368,630,Thursday
2015,1,22,1600,261,305,566,Thursday
2015,1,22,1500,226,229,455,Thursday
2015,1,22,1400,259,204,463,Thursday
2015,1,22,1300,234,161,395,Thursday
2015,1,22,1200,263,132,395,Thursday
2015,1,22,1100,235,124,359,Thursday
2015,1,22,1000,283,97,380,Thursday
2015,1,22,900,232,84,316,Thursday
2015,1,22,800,130,52,182,Thursday
2015,1,22,700,65,39,104,Thursday
2015,1,22,600,27,25,52,Thursday
2015,1,22,500,22,17,39,Thursday
2015,1,22,400,25,21,46,Thursday
2015,1,22,300,21,34,55,Thursday
2015,1,22,200,24,35,59,Thursday
2015,1,22,100,43,37,80,Thursday
2015,1,21,2400,51,56,107,Wednesday
2015,1,21,2300,71,48,119,Wednesday
2015,1,21,2200,88,61,149,Wednesday
2015,1,21,2100,102,98,200,Wednesday
2015,1,21,2000,123,102,225,Wednesday
2015,1,21,1900,146,185,331,Wednesday
2015,1,21,1800,181,306,487,Wednesday
2015,1,21,1700,186,347,533,Wednesday
2015,1,21,1600,201,300,501,Wednesday
2015,1,21,1500,204,244,448,Wednesday
2015,1,21,1400,194,204,398,Wednesday
2015,1,21,1300,244,170,414,Wednesday
2015,1,21,1200,212,149,361,Wednesday
2015,1,21,1100,268,126,394,Wednesday
2015,1,21,1000,301,117,418,Wednesday
2015,1,21,900,228,77,305,Wednesday
2015,1,21,800,120,54,174,Wednesday
2015,1,21,700,60,51,111,Wednesday
2015,1,21,600,34,16,50,Wednesday
2015,1,21,500,19,30,49,Wednesday
2015,1,21,400,24,28,52,Wednesday
2015,1,21,300,24,25,49,Wednesday
2015,1,21,200,31,30,61,Wednesday
2015,1,21,100,28,28,56,Wednesday
2015,1,20,2400,43,58,101,Tuesday
2015,1,20,2300,66,50,116,Tuesday
2015,1,20,2200,76,64,140,Tuesday
2015,1,20,2100,83,97,180,Tuesday
2015,1,20,2000,99,137,236,Tuesday
2015,1,20,1900,120,187,307,Tuesday
2015,1,20,1800,143,314,457,Tuesday
2015,1,20,1700,159,391,550,Tuesday
2015,1,20,1600,164,252,416,Tuesday
2015,1,20,1500,180,204,384,Tuesday
2015,1,20,1400,194,243,437,Tuesday
2015,1,20,1300,179,113,292,Tuesday
2015,1,20,1200,221,133,354,Tuesday
2015,1,20,1100,244,145,389,Tuesday
2015,1,20,1000,253,108,361,Tuesday
2015,1,20,900,198,83,281,Tuesday
2015,1,20,800,121,54,175,Tuesday
2015,1,20,700,55,30,85,Tuesday
2015,1,20,600,27,28,55,Tuesday
2015,1,20,500,20,29,49,Tuesday
2015,1,20,400,16,29,45,Tuesday
2015,1,20,300,15,29,44,Tuesday
2015,1,20,200,23,36,59,Tuesday
2015,1,20,100,42,28,70,Tuesday
2015,1,19,2400,51,56,107,Monday
2015,1,19,2300,52,92,144,Monday
2015,1,19,2200,68,63,131,Monday
2015,1,19,2100,120,100,220,Monday
2015,1,19,2000,79,100,179,Monday
2015,1,19,1900,115,187,302,Monday
2015,1,19,1800,128,314,442,Monday
2015,1,19,1700,156,406,562,Monday
2015,1,19,1600,174,358,532,Monday
2015,1,19,1500,189,263,452,Monday
2015,1,19,1400,208,279,487,Monday
2015,1,19,1300,237,203,440,Monday
2015,1,19,1200,236,147,383,Monday
2015,1,19,1100,260,135,395,Monday
2015,1,19,1000,282,117,399,Monday
2015,1,19,900,214,72,286,Monday
2015,1,19,800,118,39,157,Monday
2015,1,19,700,65,34,99,Monday
2015,1,19,600,18,9,27,Monday
2015,1,19,500,14,17,31,Monday
2015,1,19,400,11,24,35,Monday
2015,1,19,300,16,24,40,Monday
2015,1,19,200,10,48,58,Monday
2015,1,19,100,24,129,153,Monday
2015,1,18,2400,30,49,79,Sunday
2015,1,18,2300,54,35,89,Sunday
2015,1,18,2200,54,88,142,Sunday
2015,1,18,2100,67,201,268,Sunday
2015,1,18,2000,79,315,394,Sunday
2015,1,18,1900,91,515,606,Sunday
2015,1,18,1800,130,1068,1198,Sunday
2015,1,18,1700,184,1208,1392,Sunday
2015,1,18,1600,256,918,1174,Sunday
2015,1,18,1500,282,701,983,Sunday
2015,1,18,1400,324,574,898,Sunday
2015,1,18,1300,418,587,1005,Sunday
2015,1,18,1200,463,302,765,Sunday
2015,1,18,1100,520,213,733,Sunday
2015,1,18,1000,636,90,726,Sunday
2015,1,18,900,670,51,721,Sunday
2015,1,18,800,219,19,238,Sunday
2015,1,18,700,68,13,81,Sunday
2015,1,18,600,24,8,32,Sunday
2015,1,18,500,11,12,23,Sunday
2015,1,18,400,6,20,26,Sunday
2015,1,18,300,18,16,34,Sunday
2015,1,18,200,13,22,35,Sunday
2015,1,18,100,16,20,36,Sunday
2015,1,17,2400,28,40,68,Saturday
2015,1,17,2300,61,70,131,Saturday
2015,1,17,2200,52,68,120,Saturday
2015,1,17,2100,82,123,205,Saturday
2015,1,17,2000,72,143,215,Saturday
2015,1,17,1900,115,408,523,Saturday
2015,1,17,1800,137,1082,1219,Saturday
2015,1,17,1700,217,1113,1330,Saturday
2015,1,17,1600,260,678,938,Saturday
2015,1,17,1500,385,521,906,Saturday
2015,1,17,1400,400,382,782,Saturday
2015,1,17,1300,496,272,768,Saturday
2015,1,17,1200,600,169,769,Saturday
2015,1,17,1100,631,133,764,Saturday
2015,1,17,1000,888,85,973,Saturday
2015,1,17,900,1029,62,1091,Saturday
2015,1,17,800,294,47,341,Saturday
2015,1,17,700,93,21,114,Saturday
2015,1,17,600,37,18,55,Saturday
2015,1,17,500,12,19,31,Saturday
2015,1,17,400,15,16,31,Saturday
2015,1,17,300,18,19,37,Saturday
2015,1,17,200,27,26,53,Saturday
2015,1,17,100,37,27,64,Saturday
2015,1,16,2400,60,35,95,Friday
2015,1,16,2300,112,54,166,Friday
2015,1,16,2200,180,59,239,Friday
2015,1,16,2100,254,100,354,Friday
2015,1,16,2000,376,116,492,Friday
2015,1,16,1900,397,175,572,Friday
2015,1,16,1800,431,371,802,Friday
2015,1,16,1700,463,458,921,Friday
2015,1,16,1600,422,345,767,Friday
2015,1,16,1500,337,238,575,Friday
2015,1,16,1400,326,208,534,Friday
2015,1,16,1300,255,156,411,Friday
2015,1,16,1200,302,186,488,Friday
2015,1,16,1100,286,126,412,Friday
2015,1,16,1000,330,95,425,Friday
2015,1,16,900,344,83,427,Friday
2015,1,16,800,159,61,220,Friday
2015,1,16,700,60,25,85,Friday
2015,1,16,600,36,26,62,Friday
2015,1,16,500,21,25,46,Friday
2015,1,16,400,33,24,57,Friday
2015,1,16,300,27,33,60,Friday
2015,1,16,200,34,38,72,Friday
2015,1,16,100,49,28,77,Friday
2015,1,15,2400,58,57,115,Thursday
2015,1,15,2300,86,66,152,Thursday
2015,1,15,2200,106,85,191,Thursday
2015,1,15,2100,133,94,227,Thursday
2015,1,15,2000,187,112,299,Thursday
2015,1,15,1900,166,161,327,Thursday
2015,1,15,1800,214,257,471,Thursday
2015,1,15,1700,233,356,589,Thursday
2015,1,15,1600,249,282,531,Thursday
2015,1,15,1500,213,248,461,Thursday
2015,1,15,1400,235,229,464,Thursday
2015,1,15,1300,198,182,380,Thursday
2015,1,15,1200,207,148,355,Thursday
2015,1,15,1100,231,136,367,Thursday
2015,1,15,1000,294,97,391,Thursday
2015,1,15,900,270,83,353,Thursday
2015,1,15,800,181,57,238,Thursday
2015,1,15,700,68,34,102,Thursday
2015,1,15,600,29,25,54,Thursday
2015,1,15,500,23,33,56,Thursday
2015,1,15,400,24,28,52,Thursday
2015,1,15,300,27,27,54,Thursday
2015,1,15,200,28,37,65,Thursday
2015,1,15,100,37,34,71,Thursday
2015,1,14,2400,59,50,109,Wednesday
2015,1,14,2300,65,57,122,Wednesday
2015,1,14,2200,91,73,164,Wednesday
2015,1,14,2100,89,77,166,Wednesday
2015,1,14,2000,121,123,244,Wednesday
2015,1,14,1900,107,158,265,Wednesday
2015,1,14,1800,153,234,387,Wednesday
2015,1,14,1700,166,341,507,Wednesday
2015,1,14,1600,174,248,422,Wednesday
2015,1,14,1500,174,218,392,Wednesday
2015,1,14,1400,183,176,359,Wednesday
2015,1,14,1300,194,167,361,Wednesday
2015,1,14,1200,220,160,380,Wednesday
2015,1,14,1100,222,131,353,Wednesday
2015,1,14,1000,226,107,333,Wednesday
2015,1,14,900,207,72,279,Wednesday
2015,1,14,800,114,57,171,Wednesday
2015,1,14,700,50,38,88,Wednesday
2015,1,14,600,31,28,59,Wednesday
2015,1,14,500,14,28,42,Wednesday
2015,1,14,400,21,24,45,Wednesday
2015,1,14,300,26,20,46,Wednesday
2015,1,14,200,14,31,45,Wednesday
2015,1,14,100,37,33,70,Wednesday
2015,1,13,2400,58,46,104,Tuesday
2015,1,13,2300,50,64,114,Tuesday
2015,1,13,2200,79,65,144,Tuesday
2015,1,13,2100,69,76,145,Tuesday
2015,1,13,2000,94,101,195,Tuesday
2015,1,13,1900,102,157,259,Tuesday
2015,1,13,1800,128,279,407,Tuesday
2015,1,13,1700,145,324,469,Tuesday
2015,1,13,1600,174,243,417,Tuesday
2015,1,13,1500,149,208,357,Tuesday
2015,1,13,1400,190,158,348,Tuesday
2015,1,13,1300,193,149,342,Tuesday
2015,1,13,1200,209,126,335,Tuesday
2015,1,13,1100,212,127,339,Tuesday
2015,1,13,1000,229,80,309,Tuesday
2015,1,13,900,171,73,244,Tuesday
2015,1,13,800,94,63,157,Tuesday
2015,1,13,700,56,41,97,Tuesday
2015,1,13,600,29,31,60,Tuesday
2015,1,13,500,22,24,46,Tuesday
2015,1,13,400,14,27,41,Tuesday
2015,1,13,300,18,27,45,Tuesday
2015,1,13,200,29,35,64,Tuesday
2015,1,13,100,30,49,79,Tuesday
2015,1,12,2400,42,62,104,Monday
2015,1,12,2300,54,63,117,Monday
2015,1,12,2200,74,74,148,Monday
2015,1,12,2100,70,92,162,Monday
2015,1,12,2000,112,100,212,Monday
2015,1,12,1900,94,139,233,Monday
2015,1,12,1800,132,253,385,Monday
2015,1,12,1700,177,320,497,Monday
2015,1,12,1600,160,255,415,Monday
2015,1,12,1500,185,219,404,Monday
2015,1,12,1400,212,165,377,Monday
2015,1,12,1300,192,168,360,Monday
2015,1,12,1200,226,158,384,Monday
2015,1,12,1100,204,102,306,Monday
2015,1,12,1000,224,103,327,Monday
2015,1,12,900,181,71,252,Monday
2015,1,12,800,99,43,142,Monday
2015,1,12,700,59,27,86,Monday
2015,1,12,600,21,13,34,Monday
2015,1,12,500,22,13,35,Monday
2015,1,12,400,16,15,31,Monday
2015,1,12,300,9,17,26,Monday
2015,1,12,200,18,23,41,Monday
2015,1,12,100,18,42,60,Monday
2015,1,11,2400,17,52,69,Sunday
2015,1,11,2300,35,74,109,Sunday
2015,1,11,2200,49,166,215,Sunday
2015,1,11,2100,55,151,206,Sunday
2015,1,11,2000,62,255,317,Sunday
2015,1,11,1900,89,418,507,Sunday
2015,1,11,1800,112,917,1029,Sunday
2015,1,11,1700,155,1093,1248,Sunday
2015,1,11,1600,182,710,892,Sunday
2015,1,11,1500,205,530,735,Sunday
2015,1,11,1400,210,431,641,Sunday
2015,1,11,1300,269,420,689,Sunday
2015,1,11,1200,297,283,580,Sunday
2015,1,11,1100,317,167,484,Sunday
2015,1,11,1000,538,110,648,Sunday
2015,1,11,900,719,56,775,Sunday
2015,1,11,800,226,22,248,Sunday
2015,1,11,700,46,17,63,Sunday
2015,1,11,600,17,19,36,Sunday
2015,1,11,500,13,8,21,Sunday
2015,1,11,400,5,13,18,Sunday
2015,1,11,300,11,20,31,Sunday
2015,1,11,200,12,20,32,Sunday
2015,1,11,100,18,24,42,Sunday
2015,1,10,2400,26,41,67,Saturday
2015,1,10,2300,50,58,108,Saturday
2015,1,10,2200,51,90,141,Saturday
2015,1,10,2100,73,108,181,Saturday
2015,1,10,2000,76,128,204,Saturday
2015,1,10,1900,85,246,331,Saturday
2015,1,10,1800,130,805,935,Saturday
2015,1,10,1700,174,935,1109,Saturday
2015,1,10,1600,211,533,744,Saturday
2015,1,10,1500,209,348,557,Saturday
2015,1,10,1400,216,223,439,Saturday
2015,1,10,1300,253,195,448,Saturday
2015,1,10,1200,297,139,436,Saturday
2015,1,10,1100,432,127,559,Saturday
2015,1,10,1000,710,92,802,Saturday
2015,1,10,900,992,74,1066,Saturday
2015,1,10,800,295,39,334,Saturday
2015,1,10,700,78,32,110,Saturday
2015,1,10,600,30,21,51,Saturday
2015,1,10,500,12,17,29,Saturday
2015,1,10,400,16,16,32,Saturday
2015,1,10,300,16,16,32,Saturday
2015,1,10,200,21,30,51,Saturday
2015,1,10,100,29,36,65,Saturday
2015,1,9,2400,52,38,90,Friday
2015,1,9,2300,81,53,134,Friday
2015,1,9,2200,126,56,182,Friday
2015,1,9,2100,229,92,321,Friday
2015,1,9,2000,312,111,423,Friday
2015,1,9,1900,341,200,541,Friday
2015,1,9,1800,380,329,709,Friday
2015,1,9,1700,353,412,765,Friday
2015,1,9,1600,307,320,627,Friday
2015,1,9,1500,275,229,504,Friday
2015,1,9,1400,220,180,400,Friday
2015,1,9,1300,214,186,400,Friday
2015,1,9,1200,271,165,436,Friday
2015,1,9,1100,265,123,388,Friday
2015,1,9,1000,322,106,428,Friday
2015,1,9,900,290,61,351,Friday
2015,1,9,800,128,32,160,Friday
2015,1,9,700,68,26,94,Friday
2015,1,9,600,32,14,46,Friday
2015,1,9,500,25,20,45,Friday
2015,1,9,400,19,33,52,Friday
2015,1,9,300,15,32,47,Friday
2015,1,9,200,31,32,63,Friday
2015,1,9,100,36,41,77,Friday
2015,1,8,2400,46,46,92,Thursday
2015,1,8,2300,86,74,160,Thursday
2015,1,8,2200,81,58,139,Thursday
2015,1,8,2100,121,90,211,Thursday
2015,1,8,2000,157,127,284,Thursday
2015,1,8,1900,150,180,330,Thursday
2015,1,8,1800,178,335,513,Thursday
2015,1,8,1700,218,417,635,Thursday
2015,1,8,1600,191,280,471,Thursday
2015,1,8,1500,186,240,426,Thursday
2015,1,8,1400,197,133,330,Thursday
2015,1,8,1300,199,158,357,Thursday
2015,1,8,1200,241,130,371,Thursday
2015,1,8,1100,229,132,361,Thursday
2015,1,8,1000,263,106,369,Thursday
2015,1,8,900,223,69,292,Thursday
2015,1,8,800,107,34,141,Thursday
2015,1,8,700,62,25,87,Thursday
2015,1,8,600,25,17,42,Thursday
2015,1,8,500,21,19,40,Thursday
2015,1,8,400,10,13,23,Thursday
2015,1,8,300,25,19,44,Thursday
2015,1,8,200,33,29,62,Thursday
2015,1,8,100,44,40,84,Thursday
2015,1,7,2400,75,61,136,Wednesday
2015,1,7,2300,62,58,120,Wednesday
2015,1,7,2200,85,114,199,Wednesday
2015,1,7,2100,74,145,219,Wednesday
2015,1,7,2000,79,287,366,Wednesday
2015,1,7,1900,95,371,466,Wednesday
2015,1,7,1800,93,477,570,Wednesday
2015,1,7,1700,130,473,603,Wednesday
2015,1,7,1600,127,271,398,Wednesday
2015,1,7,1500,123,190,313,Wednesday
2015,1,7,1400,152,158,310,Wednesday
2015,1,7,1300,161,123,284,Wednesday
2015,1,7,1200,201,84,285,Wednesday
2015,1,7,1100,267,79,346,Wednesday
2015,1,7,1000,333,60,393,Wednesday
2015,1,7,900,312,33,345,Wednesday
2015,1,7,800,90,25,115,Wednesday
2015,1,7,700,35,15,50,Wednesday
2015,1,7,600,15,10,25,Wednesday
2015,1,7,500,13,4,17,Wednesday
2015,1,7,400,2,7,9,Wednesday
2015,1,7,300,9,3,12,Wednesday
2015,1,7,200,17,6,23,Wednesday
2015,1,7,100,16,17,33,Wednesday
2015,1,6,2400,16,9,25,Tuesday
2015,1,6,2300,22,24,46,Tuesday
2015,1,6,2200,41,18,59,Tuesday
2015,1,6,2100,40,62,102,Tuesday
2015,1,6,2000,46,57,103,Tuesday
2015,1,6,1900,47,84,131,Tuesday
2015,1,6,1800,56,188,244,Tuesday
2015,1,6,1700,92,208,300,Tuesday
2015,1,6,1600,109,170,279,Tuesday
2015,1,6,1500,86,137,223,Tuesday
2015,1,6,1400,107,121,228,Tuesday
2015,1,6,1300,119,99,218,Tuesday
2015,1,6,1200,131,102,233,Tuesday
2015,1,6,1100,170,84,254,Tuesday
2015,1,6,1000,213,63,276,Tuesday
2015,1,6,900,185,46,231,Tuesday
2015,1,6,800,100,23,123,Tuesday
2015,1,6,700,50,13,63,Tuesday
2015,1,6,600,15,8,23,Tuesday
2015,1,6,500,13,8,21,Tuesday
2015,1,6,400,13,16,29,Tuesday
2015,1,6,300,9,11,20,Tuesday
2015,1,6,200,31,23,54,Tuesday
2015,1,6,100,28,26,54,Tuesday
2015,1,5,2400,53,36,89,Monday
2015,1,5,2300,29,57,86,Monday
2015,1,5,2200,60,76,136,Monday
2015,1,5,2100,68,91,159,Monday
2015,1,5,2000,64,135,199,Monday
2015,1,5,1900,81,212,293,Monday
2015,1,5,1800,92,418,510,Monday
2015,1,5,1700,135,360,495,Monday
2015,1,5,1600,145,218,363,Monday
2015,1,5,1500,143,204,347,Monday
2015,1,5,1400,153,177,330,Monday
2015,1,5,1300,182,211,393,Monday
2015,1,5,1200,193,133,326,Monday
2015,1,5,1100,211,108,319,Monday
2015,1,5,1000,220,96,316,Monday
2015,1,5,900,206,62,268,Monday
2015,1,5,800,90,31,121,Monday
2015,1,5,700,45,10,55,Monday
2015,1,5,600,26,4,30,Monday
2015,1,5,500,10,18,28,Monday
2015,1,5,400,17,8,25,Monday
2015,1,5,300,8,15,23,Monday
2015,1,5,200,15,38,53,Monday
2015,1,5,100,25,55,80,Monday
2015,1,4,2400,26,88,114,Sunday
2015,1,4,2300,30,88,118,Sunday
2015,1,4,2200,52,89,141,Sunday
2015,1,4,2100,47,181,228,Sunday
2015,1,4,2000,60,153,213,Sunday
2015,1,4,1900,85,237,322,Sunday
2015,1,4,1800,117,610,727,Sunday
2015,1,4,1700,123,962,1085,Sunday
2015,1,4,1600,169,917,1086,Sunday
2015,1,4,1500,191,940,1131,Sunday
2015,1,4,1400,216,806,1022,Sunday
2015,1,4,1300,234,777,1011,Sunday
2015,1,4,1200,283,565,848,Sunday
2015,1,4,1100,255,293,548,Sunday
2015,1,4,1000,298,140,438,Sunday
2015,1,4,900,359,88,447,Sunday
2015,1,4,800,204,38,242,Sunday
2015,1,4,700,43,35,78,Sunday
2015,1,4,600,19,30,49,Sunday
2015,1,4,500,9,20,29,Sunday
2015,1,4,400,10,17,27,Sunday
2015,1,4,300,12,30,42,Sunday
2015,1,4,200,10,22,32,Sunday
2015,1,4,100,14,54,68,Sunday
2015,1,3,2400,25,81,106,Saturday
2015,1,3,2300,30,127,157,Saturday
2015,1,3,2200,43,186,229,Saturday
2015,1,3,2100,64,225,289,Saturday
2015,1,3,2000,76,408,484,Saturday
2015,1,3,1900,77,591,668,Saturday
2015,1,3,1800,113,896,1009,Saturday
2015,1,3,1700,174,1165,1339,Saturday
2015,1,3,1600,207,1090,1297,Saturday
2015,1,3,1500,259,972,1231,Saturday
2015,1,3,1400,283,922,1205,Saturday
2015,1,3,1300,312,750,1062,Saturday
2015,1,3,1200,361,463,824,Saturday
2015,1,3,1100,377,283,660,Saturday
2015,1,3,1000,489,165,654,Saturday
2015,1,3,900,653,95,748,Saturday
2015,1,3,800,225,66,291,Saturday
2015,1,3,700,73,46,119,Saturday
2015,1,3,600,31,126,157,Saturday
2015,1,3,500,9,194,203,Saturday
2015,1,3,400,11,38,49,Saturday
2015,1,3,300,17,6,23,Saturday
2015,1,3,200,11,7,18,Saturday
2015,1,3,100,15,5,20,Saturday
2015,1,2,2400,38,17,55,Friday
2015,1,2,2300,47,30,77,Friday
2015,1,2,2200,87,38,125,Friday
2015,1,2,2100,83,57,140,Friday
2015,1,2,2000,111,134,245,Friday
2015,1,2,1900,133,716,849,Friday
2015,1,2,1800,193,764,957,Friday
2015,1,2,1700,226,614,840,Friday
2015,1,2,1600,287,555,842,Friday
2015,1,2,1500,392,964,1356,Friday
2015,1,2,1400,411,801,1212,Friday
2015,1,2,1300,507,742,1249,Friday
2015,1,2,1200,567,487,1054,Friday
2015,1,2,1100,634,294,928,Friday
2015,1,2,1000,813,152,965,Friday
2015,1,2,900,910,95,1005,Friday
2015,1,2,800,253,38,291,Friday
2015,1,2,700,77,19,96,Friday
2015,1,2,600,32,20,52,Friday
2015,1,2,500,13,10,23,Friday
2015,1,2,400,19,27,46,Friday
2015,1,2,300,8,18,26,Friday
2015,1,2,200,13,22,35,Friday
2015,1,2,100,24,39,63,Friday
2015,1,1,2400,25,59,84,Thursday
2015,1,1,2300,40,73,113,Thursday
2015,1,1,2200,59,103,162,Thursday
2015,1,1,2100,75,141,216,Thursday
2015,1,1,2000,93,276,369,Thursday
2015,1,1,1900,136,458,594,Thursday
2015,1,1,1800,205,963,1168,Thursday
2015,1,1,1700,263,1209,1472,Thursday
2015,1,1,1600,436,1022,1458,Thursday
2015,1,1,1500,510,830,1340,Thursday
2015,1,1,1400,588,611,1199,Thursday
2015,1,1,1300,603,508,1111,Thursday
2015,1,1,1200,592,283,875,Thursday
2015,1,1,1100,487,164,651,Thursday
2015,1,1,1000,513,69,582,Thursday
2015,1,1,900,452,55,507,Thursday
2015,1,1,800,140,28,168,Thursday
2015,1,1,700,59,11,70,Thursday
2015,1,1,600,15,5,20,Thursday
2015,1,1,500,13,23,36,Thursday
2015,1,1,400,12,11,23,Thursday
2015,1,1,300,15,24,39,Thursday
2015,1,1,200,26,30,56,Thursday
2015,1,1,100,36,17,53,Thursday
2014,12,31,2400,21,32,53,Wednesday
2014,12,31,2300,44,63,107,Wednesday
2014,12,31,2200,52,75,127,Wednesday
2014,12,31,2100,101,98,199,Wednesday
2014,12,31,2000,130,136,266,Wednesday
2014,12,31,1900,217,276,493,Wednesday
2014,12,31,1800,269,714,983,Wednesday
2014,12,31,1700,393,1118,1511,Wednesday
2014,12,31,1600,492,734,1226,Wednesday
2014,12,31,1500,612,562,1174,Wednesday
2014,12,31,1400,556,470,1026,Wednesday
2014,12,31,1300,573,428,1001,Wednesday
2014,12,31,1200,595,367,962,Wednesday
2014,12,31,1100,595,193,788,Wednesday
2014,12,31,1000,677,129,806,Wednesday
2014,12,31,900,675,78,753,Wednesday
2014,12,31,800,228,55,283,Wednesday
2014,12,31,700,71,22,93,Wednesday
2014,12,31,600,31,23,54,Wednesday
2014,12,31,500,26,13,39,Wednesday
2014,12,31,400,15,34,49,Wednesday
2014,12,31,300,26,39,65,Wednesday
2014,12,31,200,24,26,50,Wednesday
2014,12,31,100,32,42,74,Wednesday
2014,12,30,2400,59,53,112,Tuesday
2014,12,30,2300,105,75,180,Tuesday
2014,12,30,2200,118,102,220,Tuesday
2014,12,30,2100,171,175,346,Tuesday
2014,12,30,2000,199,240,439,Tuesday
2014,12,30,1900,225,585,810,Tuesday
2014,12,30,1800,298,1244,1542,Tuesday
2014,12,30,1700,410,1198,1608,Tuesday
2014,12,30,1600,572,815,1387,Tuesday
2014,12,30,1500,572,719,1291,Tuesday
2014,12,30,1400,650,633,1283,Tuesday
2014,12,30,1300,727,509,1236,Tuesday
2014,12,30,1200,763,395,1158,Tuesday
2014,12,30,1100,703,223,926,Tuesday
2014,12,30,1000,721,140,861,Tuesday
2014,12,30,900,619,53,672,Tuesday
2014,12,30,800,215,39,254,Tuesday
2014,12,30,700,70,7,77,Tuesday
2014,12,30,600,28,10,38,Tuesday
2014,12,30,500,21,14,35,Tuesday
2014,12,30,400,14,8,22,Tuesday
2014,12,30,300,26,13,39,Tuesday
2014,12,30,200,27,8,35,Tuesday
2014,12,30,100,26,46,72,Tuesday
2014,12,29,2400,60,66,126,Monday
2014,12,29,2300,65,97,162,Monday
2014,12,29,2200,100,111,211,Monday
2014,12,29,2100,113,199,312,Monday
2014,12,29,2000,162,226,388,Monday
2014,12,29,1900,189,390,579,Monday
2014,12,29,1800,290,778,1068,Monday
2014,12,29,1700,369,1018,1387,Monday
2014,12,29,1600,566,808,1374,Monday
2014,12,29,1500,621,731,1352,Monday
2014,12,29,1400,690,560,1250,Monday
2014,12,29,1300,643,471,1114,Monday
2014,12,29,1200,603,356,959,Monday
2014,12,29,1100,535,237,772,Monday
2014,12,29,1000,620,156,776,Monday
2014,12,29,900,534,70,604,Monday
2014,12,29,800,243,49,292,Monday
2014,12,29,700,82,27,109,Monday
2014,12,29,600,30,23,53,Monday
2014,12,29,500,10,17,27,Monday
2014,12,29,400,12,19,31,Monday
2014,12,29,300,27,25,52,Monday
2014,12,29,200,23,31,54,Monday
2014,12,29,100,25,62,87,Monday
2014,12,28,2400,34,61,95,Sunday
2014,12,28,2300,52,98,150,Sunday
2014,12,28,2200,85,152,237,Sunday
2014,12,28,2100,97,263,360,Sunday
2014,12,28,2000,122,291,413,Sunday
2014,12,28,1900,169,552,721,Sunday
2014,12,28,1800,275,1269,1544,Sunday
2014,12,28,1700,407,1639,2046,Sunday
2014,12,28,1600,546,1316,1862,Sunday
2014,12,28,1500,680,904,1584,Sunday
2014,12,28,1400,726,687,1413,Sunday
2014,12,28,1300,772,585,1357,Sunday
2014,12,28,1200,839,417,1256,Sunday
2014,12,28,1100,763,238,1001,Sunday
2014,12,28,1000,903,124,1027,Sunday
2014,12,28,900,855,67,922,Sunday
2014,12,28,800,342,43,385,Sunday
2014,12,28,700,69,19,88,Sunday
2014,12,28,600,28,26,54,Sunday
2014,12,28,500,12,61,73,Sunday
2014,12,28,400,7,156,163,Sunday
2014,12,28,300,11,46,57,Sunday
2014,12,28,200,21,20,41,Sunday
2014,12,28,100,27,11,38,Sunday
2014,12,27,2400,29,20,49,Saturday
2014,12,27,2300,51,23,74,Saturday
2014,12,27,2200,95,54,149,Saturday
2014,12,27,2100,92,68,160,Saturday
2014,12,27,2000,133,108,241,Saturday
2014,12,27,1900,242,297,539,Saturday
2014,12,27,1800,310,1045,1355,Saturday
2014,12,27,1700,486,1284,1770,Saturday
2014,12,27,1600,667,879,1546,Saturday
2014,12,27,1500,813,652,1465,Saturday
2014,12,27,1400,884,568,1452,Saturday
2014,12,27,1300,994,518,1512,Saturday
2014,12,27,1200,977,358,1335,Saturday
2014,12,27,1100,867,176,1043,Saturday
2014,12,27,1000,888,126,1014,Saturday
2014,12,27,900,934,41,975,Saturday
2014,12,27,800,408,44,452,Saturday
2014,12,27,700,100,18,118,Saturday
2014,12,27,600,48,8,56,Saturday
2014,12,27,500,21,9,30,Saturday
2014,12,27,400,12,15,27,Saturday
2014,12,27,300,18,21,39,Saturday
2014,12,27,200,10,20,30,Saturday
2014,12,27,100,37,37,74,Saturday
2014,12,26,2400,28,37,65,Friday
2014,12,26,2300,54,47,101,Friday
2014,12,26,2200,104,86,190,Friday
2014,12,26,2100,111,101,212,Friday
2014,12,26,2000,150,192,342,Friday
2014,12,26,1900,215,281,496,Friday
2014,12,26,1800,316,684,1000,Friday
2014,12,26,1700,499,881,1380,Friday
2014,12,26,1600,687,714,1401,Friday
2014,12,26,1500,783,605,1388,Friday
2014,12,26,1400,804,469,1273,Friday
2014,12,26,1300,801,387,1188,Friday
2014,12,26,1200,823,283,1106,Friday
2014,12,26,1100,640,179,819,Friday
2014,12,26,1000,694,90,784,Friday
2014,12,26,900,628,58,686,Friday
2014,12,26,800,253,38,291,Friday
2014,12,26,700,94,16,110,Friday
2014,12,26,600,31,7,38,Friday
2014,12,26,500,12,6,18,Friday
2014,12,26,400,6,6,12,Friday
2014,12,26,300,13,7,20,Friday
2014,12,26,200,13,11,24,Friday
2014,12,26,100,24,15,39,Friday
2014,12,25,2400,27,29,56,Thursday
2014,12,25,2300,24,31,55,Thursday
2014,12,25,2200,31,47,78,Thursday
2014,12,25,2100,45,55,100,Thursday
2014,12,25,2000,53,95,148,Thursday
2014,12,25,1900,61,158,219,Thursday
2014,12,25,1800,99,467,566,Thursday
2014,12,25,1700,193,556,749,Thursday
2014,12,25,1600,266,436,702,Thursday
2014,12,25,1500,327,316,643,Thursday
2014,12,25,1400,359,206,565,Thursday
2014,12,25,1300,405,142,547,Thursday
2014,12,25,1200,443,90,533,Thursday
2014,12,25,1100,381,63,444,Thursday
2014,12,25,1000,360,40,400,Thursday
2014,12,25,900,324,33,357,Thursday
2014,12,25,800,131,19,150,Thursday
2014,12,25,700,56,12,68,Thursday
2014,12,25,600,24,7,31,Thursday
2014,12,25,500,7,7,14,Thursday
2014,12,25,400,12,17,29,Thursday
2014,12,25,300,14,10,24,Thursday
2014,12,25,200,17,16,33,Thursday
2014,12,25,100,14,30,44,Thursday
2014,12,24,2400,39,27,66,Wednesday
2014,12,24,2300,43,38,81,Wednesday
2014,12,24,2200,65,59,124,Wednesday
2014,12,24,2100,87,70,157,Wednesday
2014,12,24,2000,119,96,215,Wednesday
2014,12,24,1900,149,179,328,Wednesday
2014,12,24,1800,214,435,649,Wednesday
2014,12,24,1700,314,503,817,Wednesday
2014,12,24,1600,489,563,1052,Wednesday
2014,12,24,1500,543,433,976,Wednesday
2014,12,24,1400,493,346,839,Wednesday
2014,12,24,1300,472,211,683,Wednesday
2014,12,24,1200,488,240,728,Wednesday
2014,12,24,1100,451,139,590,Wednesday
2014,12,24,1000,483,78,561,Wednesday
2014,12,24,900,566,66,632,Wednesday
2014,12,24,800,272,47,319,Wednesday
2014,12,24,700,69,17,86,Wednesday
2014,12,24,600,38,14,52,Wednesday
2014,12,24,500,40,13,53,Wednesday
2014,12,24,400,17,20,37,Wednesday
2014,12,24,300,35,16,51,Wednesday
2014,12,24,200,30,31,61,Wednesday
2014,12,24,100,44,50,94,Wednesday
2014,12,23,2400,74,53,127,Tuesday
2014,12,23,2300,102,76,178,Tuesday
2014,12,23,2200,113,93,206,Tuesday
2014,12,23,2100,146,124,270,Tuesday
2014,12,23,2000,206,216,422,Tuesday
2014,12,23,1900,217,300,517,Tuesday
2014,12,23,1800,325,557,882,Tuesday
2014,12,23,1700,409,748,1157,Tuesday
2014,12,23,1600,462,652,1114,Tuesday
2014,12,23,1500,526,563,1089,Tuesday
2014,12,23,1400,529,426,955,Tuesday
2014,12,23,1300,537,384,921,Tuesday
2014,12,23,1200,593,305,898,Tuesday
2014,12,23,1100,573,224,797,Tuesday
2014,12,23,1000,629,171,800,Tuesday
2014,12,23,900,543,96,639,Tuesday
2014,12,23,800,268,72,340,Tuesday
2014,12,23,700,117,30,147,Tuesday
2014,12,23,600,50,27,77,Tuesday
2014,12,23,500,27,29,56,Tuesday
2014,12,23,400,26,27,53,Tuesday
2014,12,23,300,30,29,59,Tuesday
2014,12,23,200,45,46,91,Tuesday
2014,12,23,100,49,52,101,Tuesday
2014,12,22,2400,60,60,120,Monday
2014,12,22,2300,80,79,159,Monday
2014,12,22,2200,111,111,222,Monday
2014,12,22,2100,137,145,282,Monday
2014,12,22,2000,160,178,338,Monday
2014,12,22,1900,196,278,474,Monday
2014,12,22,1800,251,553,804,Monday
2014,12,22,1700,328,790,1118,Monday
2014,12,22,1600,412,642,1054,Monday
2014,12,22,1500,462,476,938,Monday
2014,12,22,1400,500,408,908,Monday
2014,12,22,1300,526,311,837,Monday
2014,12,22,1200,569,260,829,Monday
2014,12,22,1100,545,218,763,Monday
2014,12,22,1000,613,147,760,Monday
2014,12,22,900,553,88,641,Monday
2014,12,22,800,234,58,292,Monday
2014,12,22,700,104,33,137,Monday
2014,12,22,600,46,29,75,Monday
2014,12,22,500,22,30,52,Monday
2014,12,22,400,19,14,33,Monday
2014,12,22,300,21,29,50,Monday
2014,12,22,200,40,31,71,Monday
2014,12,22,100,34,59,93,Monday
2014,12,21,2400,40,49,89,Sunday
2014,12,21,2300,65,82,147,Sunday
2014,12,21,2200,95,112,207,Sunday
2014,12,21,2100,112,157,269,Sunday
2014,12,21,2000,134,216,350,Sunday
2014,12,21,1900,146,312,458,Sunday
2014,12,21,1800,216,719,935,Sunday
2014,12,21,1700,304,903,1207,Sunday
2014,12,21,1600,402,689,1091,Sunday
2014,12,21,1500,410,560,970,Sunday
2014,12,21,1400,489,454,943,Sunday
2014,12,21,1300,514,400,914,Sunday
2014,12,21,1200,590,305,895,Sunday
2014,12,21,1100,544,132,676,Sunday
2014,12,21,1000,575,87,662,Sunday
2014,12,21,900,606,50,656,Sunday
2014,12,21,800,293,30,323,Sunday
2014,12,21,700,94,23,117,Sunday
2014,12,21,600,42,14,56,Sunday
2014,12,21,500,18,4,22,Sunday
2014,12,21,400,23,10,33,Sunday
2014,12,21,300,17,18,35,Sunday
2014,12,21,200,20,16,36,Sunday
2014,12,21,100,34,39,73,Sunday
2014,12,20,2400,47,43,90,Saturday
2014,12,20,2300,57,47,104,Saturday
2014,12,20,2200,75,81,156,Saturday
2014,12,20,2100,122,112,234,Saturday
2014,12,20,2000,169,138,307,Saturday
2014,12,20,1900,181,236,417,Saturday
2014,12,20,1800,209,561,770,Saturday
2014,12,20,1700,326,733,1059,Saturday
2014,12,20,1600,443,607,1050,Saturday
2014,12,20,1500,541,428,969,Saturday
2014,12,20,1400,518,349,867,Saturday
2014,12,20,1300,570,285,855,Saturday
2014,12,20,1200,638,226,864,Saturday
2014,12,20,1100,614,178,792,Saturday
2014,12,20,1000,714,123,837,Saturday
2014,12,20,900,659,80,739,Saturday
2014,12,20,800,348,51,399,Saturday
2014,12,20,700,142,35,177,Saturday
2014,12,20,600,70,22,92,Saturday
2014,12,20,500,37,29,66,Saturday
2014,12,20,400,38,21,59,Saturday
2014,12,20,300,28,31,59,Saturday
2014,12,20,200,30,37,67,Saturday
2014,12,20,100,68,59,127,Saturday
2014,12,19,2400,77,47,124,Friday
2014,12,19,2300,126,59,185,Friday
2014,12,19,2200,128,85,213,Friday
2014,12,19,2100,226,98,324,Friday
2014,12,19,2000,300,133,433,Friday
2014,12,19,1900,356,209,565,Friday
2014,12,19,1800,374,321,695,Friday
2014,12,19,1700,435,434,869,Friday
2014,12,19,1600,526,396,922,Friday
2014,12,19,1500,399,326,725,Friday
2014,12,19,1400,391,244,635,Friday
2014,12,19,1300,368,241,609,Friday
2014,12,19,1200,416,186,602,Friday
2014,12,19,1100,367,158,525,Friday
2014,12,19,1000,373,123,496,Friday
2014,12,19,900,335,83,418,Friday
2014,12,19,800,173,52,225,Friday
2014,12,19,700,96,37,133,Friday
2014,12,19,600,49,15,64,Friday
2014,12,19,500,19,33,52,Friday
2014,12,19,400,38,22,60,Friday
2014,12,19,300,33,31,64,Friday
2014,12,19,200,37,32,69,Friday
2014,12,19,100,44,28,72,Friday
2014,12,18,2400,62,69,131,Thursday
2014,12,18,2300,93,85,178,Thursday
2014,12,18,2200,125,64,189,Thursday
2014,12,18,2100,130,120,250,Thursday
2014,12,18,2000,151,137,288,Thursday
2014,12,18,1900,195,169,364,Thursday
2014,12,18,1800,201,313,514,Thursday
2014,12,18,1700,254,387,641,Thursday
2014,12,18,1600,281,308,589,Thursday
2014,12,18,1500,254,277,531,Thursday
2014,12,18,1400,261,161,422,Thursday
2014,12,18,1300,266,159,425,Thursday
2014,12,18,1200,315,149,464,Thursday
2014,12,18,1100,313,120,433,Thursday
2014,12,18,1000,301,125,426,Thursday
2014,12,18,900,242,93,335,Thursday
2014,12,18,800,132,60,192,Thursday
2014,12,18,700,76,40,116,Thursday
2014,12,18,600,38,27,65,Thursday
2014,12,18,500,23,28,51,Thursday
2014,12,18,400,43,37,80,Thursday
2014,12,18,300,21,33,54,Thursday
2014,12,18,200,41,32,73,Thursday
2014,12,18,100,51,27,78,Thursday
2014,12,17,2400,55,56,111,Wednesday
2014,12,17,2300,64,58,122,Wednesday
2014,12,17,2200,86,81,167,Wednesday
2014,12,17,2100,112,106,218,Wednesday
2014,12,17,2000,126,131,257,Wednesday
2014,12,17,1900,130,175,305,Wednesday
2014,12,17,1800,138,281,419,Wednesday
2014,12,17,1700,200,367,567,Wednesday
2014,12,17,1600,203,226,429,Wednesday
2014,12,17,1500,239,297,536,Wednesday
2014,12,17,1400,189,212,401,Wednesday
2014,12,17,1300,220,183,403,Wednesday
2014,12,17,1200,256,170,426,Wednesday
2014,12,17,1100,235,127,362,Wednesday
2014,12,17,1000,242,113,355,Wednesday
2014,12,17,900,205,80,285,Wednesday
2014,12,17,800,150,58,208,Wednesday
2014,12,17,700,84,32,116,Wednesday
2014,12,17,600,34,23,57,Wednesday
2014,12,17,500,15,32,47,Wednesday
2014,12,17,400,23,31,54,Wednesday
2014,12,17,300,21,30,51,Wednesday
2014,12,17,200,33,16,49,Wednesday
2014,12,17,100,32,35,67,Wednesday
2014,12,16,2400,67,65,132,Tuesday
2014,12,16,2300,65,65,130,Tuesday
2014,12,16,2200,85,68,153,Tuesday
2014,12,16,2100,102,104,206,Tuesday
2014,12,16,2000,115,122,237,Tuesday
2014,12,16,1900,126,172,298,Tuesday
2014,12,16,1800,139,240,379,Tuesday
2014,12,16,1700,172,345,517,Tuesday
2014,12,16,1600,186,273,459,Tuesday
2014,12,16,1500,196,243,439,Tuesday
2014,12,16,1400,207,204,411,Tuesday
2014,12,16,1300,199,172,371,Tuesday
2014,12,16,1200,214,149,363,Tuesday
2014,12,16,1100,223,146,369,Tuesday
2014,12,16,1000,238,114,352,Tuesday
2014,12,16,900,206,103,309,Tuesday
2014,12,16,800,118,60,178,Tuesday
2014,12,16,700,61,61,122,Tuesday
2014,12,16,600,34,24,58,Tuesday
2014,12,16,500,19,21,40,Tuesday
2014,12,16,400,21,36,57,Tuesday
2014,12,16,300,24,25,49,Tuesday
2014,12,16,200,30,25,55,Tuesday
2014,12,16,100,41,43,84,Tuesday
2014,12,15,2400,55,60,115,Monday
2014,12,15,2300,47,77,124,Monday
2014,12,15,2200,71,73,144,Monday
2014,12,15,2100,97,88,185,Monday
2014,12,15,2000,139,110,249,Monday
2014,12,15,1900,138,169,307,Monday
2014,12,15,1800,133,258,391,Monday
2014,12,15,1700,175,327,502,Monday
2014,12,15,1600,210,283,493,Monday
2014,12,15,1500,209,216,425,Monday
2014,12,15,1400,229,219,448,Monday
2014,12,15,1300,213,193,406,Monday
2014,12,15,1200,213,148,361,Monday
2014,12,15,1100,219,130,349,Monday
2014,12,15,1000,220,108,328,Monday
2014,12,15,900,237,84,321,Monday
2014,12,15,800,125,52,177,Monday
2014,12,15,700,67,37,104,Monday
2014,12,15,600,21,24,45,Monday
2014,12,15,500,13,19,32,Monday
2014,12,15,400,12,23,35,Monday
2014,12,15,300,17,24,41,Monday
2014,12,15,200,29,22,51,Monday
2014,12,15,100,26,35,61,Monday
2014,12,14,2400,38,50,88,Sunday
2014,12,14,2300,35,75,110,Sunday
2014,12,14,2200,61,104,165,Sunday
2014,12,14,2100,77,120,197,Sunday
2014,12,14,2000,79,229,308,Sunday
2014,12,14,1900,109,328,437,Sunday
2014,12,14,1800,131,671,802,Sunday
2014,12,14,1700,176,826,1002,Sunday
2014,12,14,1600,217,667,884,Sunday
2014,12,14,1500,246,532,778,Sunday
2014,12,14,1400,275,455,730,Sunday
2014,12,14,1300,253,437,690,Sunday
2014,12,14,1200,325,366,691,Sunday
2014,12,14,1100,332,253,585,Sunday
2014,12,14,1000,365,117,482,Sunday
2014,12,14,900,471,74,545,Sunday
2014,12,14,800,218,31,249,Sunday
2014,12,14,700,58,18,76,Sunday
2014,12,14,600,23,10,33,Sunday
2014,12,14,500,16,8,24,Sunday
2014,12,14,400,13,14,27,Sunday
2014,12,14,300,7,13,20,Sunday
2014,12,14,200,17,21,38,Sunday
2014,12,14,100,21,15,36,Sunday
2014,12,13,2400,33,34,67,Saturday
2014,12,13,2300,36,37,73,Saturday
2014,12,13,2200,60,52,112,Saturday
2014,12,13,2100,88,71,159,Saturday
2014,12,13,2000,88,112,200,Saturday
2014,12,13,1900,89,201,290,Saturday
2014,12,13,1800,124,458,582,Saturday
2014,12,13,1700,204,633,837,Saturday
2014,12,13,1600,257,483,740,Saturday
2014,12,13,1500,284,319,603,Saturday
2014,12,13,1400,241,268,509,Saturday
2014,12,13,1300,254,204,458,Saturday
2014,12,13,1200,320,173,493,Saturday
2014,12,13,1100,381,140,521,Saturday
2014,12,13,1000,569,117,686,Saturday
2014,12,13,900,487,89,576,Saturday
2014,12,13,800,184,38,222,Saturday
2014,12,13,700,61,30,91,Saturday
2014,12,13,600,30,28,58,Saturday
2014,12,13,500,14,21,35,Saturday
2014,12,13,400,17,17,34,Saturday
2014,12,13,300,16,24,40,Saturday
2014,12,13,200,29,28,57,Saturday
2014,12,13,100,28,39,67,Saturday
2014,12,12,2400,63,47,110,Friday
2014,12,12,2300,88,50,138,Friday
2014,12,12,2200,134,59,193,Friday
2014,12,12,2100,186,80,266,Friday
2014,12,12,2000,241,111,352,Friday
2014,12,12,1900,310,136,446,Friday
2014,12,12,1800,383,271,654,Friday
2014,12,12,1700,406,387,793,Friday
2014,12,12,1600,391,306,697,Friday
2014,12,12,1500,322,351,673,Friday
2014,12,12,1400,275,157,432,Friday
2014,12,12,1300,243,122,365,Friday
2014,12,12,1200,270,147,417,Friday
2014,12,12,1100,260,123,383,Friday
2014,12,12,1000,292,113,405,Friday
2014,12,12,900,268,79,347,Friday
2014,12,12,800,158,56,214,Friday
2014,12,12,700,76,37,113,Friday
2014,12,12,600,31,27,58,Friday
2014,12,12,500,22,20,42,Friday
2014,12,12,400,35,28,63,Friday
2014,12,12,300,36,22,58,Friday
2014,12,12,200,26,25,51,Friday
2014,12,12,100,29,52,81,Friday
2014,12,11,2400,57,42,99,Thursday
2014,12,11,2300,77,60,137,Thursday
2014,12,11,2200,97,65,162,Thursday
2014,12,11,2100,142,88,230,Thursday
2014,12,11,2000,157,113,270,Thursday
2014,12,11,1900,172,133,305,Thursday
2014,12,11,1800,171,234,405,Thursday
2014,12,11,1700,232,309,541,Thursday
2014,12,11,1600,237,259,496,Thursday
2014,12,11,1500,219,232,451,Thursday
2014,12,11,1400,221,189,410,Thursday
2014,12,11,1300,163,161,324,Thursday
2014,12,11,1200,210,143,353,Thursday
2014,12,11,1100,261,150,411,Thursday
2014,12,11,1000,240,110,350,Thursday
2014,12,11,900,215,78,293,Thursday
2014,12,11,800,118,57,175,Thursday
2014,12,11,700,60,40,100,Thursday
2014,12,11,600,41,26,67,Thursday
2014,12,11,500,25,30,55,Thursday
2014,12,11,400,30,20,50,Thursday
2014,12,11,300,20,32,52,Thursday
2014,12,11,200,47,34,81,Thursday
2014,12,11,100,43,39,82,Thursday
2014,12,10,2400,52,41,93,Wednesday
2014,12,10,2300,75,61,136,Wednesday
2014,12,10,2200,61,81,142,Wednesday
2014,12,10,2100,90,75,165,Wednesday
2014,12,10,2000,126,109,235,Wednesday
2014,12,10,1900,93,151,244,Wednesday
2014,12,10,1800,147,212,359,Wednesday
2014,12,10,1700,166,323,489,Wednesday
2014,12,10,1600,183,280,463,Wednesday
2014,12,10,1500,191,244,435,Wednesday
2014,12,10,1400,152,190,342,Wednesday
2014,12,10,1300,172,186,358,Wednesday
2014,12,10,1200,191,193,384,Wednesday
2014,12,10,1100,187,148,335,Wednesday
2014,12,10,1000,224,117,341,Wednesday
2014,12,10,900,182,95,277,Wednesday
2014,12,10,800,113,43,156,Wednesday
2014,12,10,700,65,25,90,Wednesday
2014,12,10,600,38,24,62,Wednesday
2014,12,10,500,17,26,43,Wednesday
2014,12,10,400,25,25,50,Wednesday
2014,12,10,300,22,23,45,Wednesday
2014,12,10,200,32,29,61,Wednesday
2014,12,10,100,33,46,79,Wednesday
2014,12,9,2400,44,57,101,Tuesday
2014,12,9,2300,57,65,122,Tuesday
2014,12,9,2200,72,63,135,Tuesday
2014,12,9,2100,92,78,170,Tuesday
2014,12,9,2000,110,117,227,Tuesday
2014,12,9,1900,109,144,253,Tuesday
2014,12,9,1800,105,233,338,Tuesday
2014,12,9,1700,131,266,397,Tuesday
2014,12,9,1600,175,253,428,Tuesday
2014,12,9,1500,163,195,358,Tuesday
2014,12,9,1400,141,221,362,Tuesday
2014,12,9,1300,187,170,357,Tuesday
2014,12,9,1200,182,125,307,Tuesday
2014,12,9,1100,189,120,309,Tuesday
2014,12,9,1000,185,88,273,Tuesday
2014,12,9,900,215,83,298,Tuesday
2014,12,9,800,92,54,146,Tuesday
2014,12,9,700,59,46,105,Tuesday
2014,12,9,600,36,26,62,Tuesday
2014,12,9,500,20,29,49,Tuesday
2014,12,9,400,20,27,47,Tuesday
2014,12,9,300,28,30,58,Tuesday
2014,12,9,200,39,36,75,Tuesday
2014,12,9,100,28,35,63,Tuesday
2014,12,8,2400,56,41,97,Monday
2014,12,8,2300,50,65,115,Monday
2014,12,8,2200,65,79,144,Monday
2014,12,8,2100,84,124,208,Monday
2014,12,8,2000,119,76,195,Monday
2014,12,8,1900,108,137,245,Monday
2014,12,8,1800,104,229,333,Monday
2014,12,8,1700,160,292,452,Monday
2014,12,8,1600,158,272,430,Monday
2014,12,8,1500,199,242,441,Monday
2014,12,8,1400,189,223,412,Monday
2014,12,8,1300,200,185,385,Monday
2014,12,8,1200,244,150,394,Monday
2014,12,8,1100,212,156,368,Monday
2014,12,8,1000,228,114,342,Monday
2014,12,8,900,185,83,268,Monday
2014,12,8,800,103,59,162,Monday
2014,12,8,700,54,28,82,Monday
2014,12,8,600,40,22,62,Monday
2014,12,8,500,17,35,52,Monday
2014,12,8,400,8,26,34,Monday
2014,12,8,300,17,22,39,Monday
2014,12,8,200,28,35,63,Monday
2014,12,8,100,26,44,70,Monday
2014,12,7,2400,35,47,82,Sunday
2014,12,7,2300,46,87,133,Sunday
2014,12,7,2200,56,106,162,Sunday
2014,12,7,2100,70,159,229,Sunday
2014,12,7,2000,76,198,274,Sunday
2014,12,7,1900,114,305,419,Sunday
2014,12,7,1800,160,574,734,Sunday
2014,12,7,1700,212,915,1127,Sunday
2014,12,7,1600,202,698,900,Sunday
2014,12,7,1500,245,644,889,Sunday
2014,12,7,1400,249,498,747,Sunday
2014,12,7,1300,253,373,626,Sunday
2014,12,7,1200,311,261,572,Sunday
2014,12,7,1100,373,177,550,Sunday
2014,12,7,1000,450,116,566,Sunday
2014,12,7,900,549,68,617,Sunday
2014,12,7,800,213,32,245,Sunday
2014,12,7,700,60,19,79,Sunday
2014,12,7,600,20,14,34,Sunday
2014,12,7,500,9,12,21,Sunday
2014,12,7,400,11,26,37,Sunday
2014,12,7,300,10,21,31,Sunday
2014,12,7,200,14,19,33,Sunday
2014,12,7,100,16,20,36,Sunday
2014,12,6,2400,28,16,44,Saturday
2014,12,6,2300,49,43,92,Saturday
2014,12,6,2200,57,43,100,Saturday
2014,12,6,2100,77,66,143,Saturday
2014,12,6,2000,85,76,161,Saturday
2014,12,6,1900,104,173,277,Saturday
2014,12,6,1800,112,490,602,Saturday
2014,12,6,1700,164,607,771,Saturday
2014,12,6,1600,179,529,708,Saturday
2014,12,6,1500,212,343,555,Saturday
2014,12,6,1400,225,178,403,Saturday
2014,12,6,1300,257,169,426,Saturday
2014,12,6,1200,343,153,496,Saturday
2014,12,6,1100,372,122,494,Saturday
2014,12,6,1000,482,120,602,Saturday
2014,12,6,900,622,62,684,Saturday
2014,12,6,800,255,47,302,Saturday
2014,12,6,700,87,21,108,Saturday
2014,12,6,600,30,14,44,Saturday
2014,12,6,500,15,16,31,Saturday
2014,12,6,400,12,23,35,Saturday
2014,12,6,300,17,26,43,Saturday
2014,12,6,200,25,29,54,Saturday
2014,12,6,100,28,33,61,Saturday
2014,12,5,2400,58,30,88,Friday
2014,12,5,2300,71,50,121,Friday
2014,12,5,2200,123,80,203,Friday
2014,12,5,2100,168,72,240,Friday
2014,12,5,2000,240,100,340,Friday
2014,12,5,1900,266,149,415,Friday
2014,12,5,1800,302,246,548,Friday
2014,12,5,1700,341,372,713,Friday
2014,12,5,1600,333,296,629,Friday
2014,12,5,1500,304,235,539,Friday
2014,12,5,1400,259,192,451,Friday
2014,12,5,1300,242,148,390,Friday
2014,12,5,1200,263,145,408,Friday
2014,12,5,1100,272,158,430,Friday
2014,12,5,1000,284,103,387,Friday
2014,12,5,900,281,74,355,Friday
2014,12,5,800,140,64,204,Friday
2014,12,5,700,58,41,99,Friday
2014,12,5,600,35,27,62,Friday
2014,12,5,500,21,17,38,Friday
2014,12,5,400,20,31,51,Friday
2014,12,5,300,24,39,63,Friday
2014,12,5,200,28,46,74,Friday
2014,12,5,100,45,43,88,Friday
2014,12,4,2400,65,46,111,Thursday
2014,12,4,2300,69,100,169,Thursday
2014,12,4,2200,90,82,172,Thursday
2014,12,4,2100,111,55,166,Thursday
2014,12,4,2000,146,97,243,Thursday
2014,12,4,1900,120,137,257,Thursday
2014,12,4,1800,144,225,369,Thursday
2014,12,4,1700,221,263,484,Thursday
2014,12,4,1600,200,246,446,Thursday
2014,12,4,1500,192,208,400,Thursday
2014,12,4,1400,171,150,321,Thursday
2014,12,4,1300,185,142,327,Thursday
2014,12,4,1200,206,117,323,Thursday
2014,12,4,1100,208,101,309,Thursday
2014,12,4,1000,220,105,325,Thursday
2014,12,4,900,214,89,303,Thursday
2014,12,4,800,124,45,169,Thursday
2014,12,4,700,63,32,95,Thursday
2014,12,4,600,32,26,58,Thursday
2014,12,4,500,25,27,52,Thursday
2014,12,4,400,18,27,45,Thursday
2014,12,4,300,37,23,60,Thursday
2014,12,4,200,41,30,71,Thursday
2014,12,4,100,35,30,65,Thursday
2014,12,3,2400,55,32,87,Wednesday
2014,12,3,2300,57,77,134,Wednesday
2014,12,3,2200,71,69,140,Wednesday
2014,12,3,2100,94,95,189,Wednesday
2014,12,3,2000,88,80,168,Wednesday
2014,12,3,1900,108,140,248,Wednesday
2014,12,3,1800,142,201,343,Wednesday
2014,12,3,1700,156,290,446,Wednesday
2014,12,3,1600,158,223,381,Wednesday
2014,12,3,1500,166,176,342,Wednesday
2014,12,3,1400,183,164,347,Wednesday
2014,12,3,1300,189,124,313,Wednesday
2014,12,3,1200,214,140,354,Wednesday
2014,12,3,1100,219,127,346,Wednesday
2014,12,3,1000,204,93,297,Wednesday
2014,12,3,900,177,84,261,Wednesday
2014,12,3,800,111,48,159,Wednesday
2014,12,3,700,64,36,100,Wednesday
2014,12,3,600,31,26,57,Wednesday
2014,12,3,500,19,25,44,Wednesday
2014,12,3,400,20,30,50,Wednesday
2014,12,3,300,25,18,43,Wednesday
2014,12,3,200,26,28,54,Wednesday
2014,12,3,100,49,36,85,Wednesday
2014,12,2,2400,60,55,115,Tuesday
2014,12,2,2300,57,48,105,Tuesday
2014,12,2,2200,57,77,134,Tuesday
2014,12,2,2100,82,101,183,Tuesday
2014,12,2,2000,106,96,202,Tuesday
2014,12,2,1900,92,145,237,Tuesday
2014,12,2,1800,105,196,301,Tuesday
2014,12,2,1700,131,263,394,Tuesday
2014,12,2,1600,154,240,394,Tuesday
2014,12,2,1500,166,184,350,Tuesday
2014,12,2,1400,192,151,343,Tuesday
2014,12,2,1300,144,130,274,Tuesday
2014,12,2,1200,174,148,322,Tuesday
2014,12,2,1100,180,131,311,Tuesday
2014,12,2,1000,201,107,308,Tuesday
2014,12,2,900,145,89,234,Tuesday
2014,12,2,800,106,47,153,Tuesday
2014,12,2,700,50,30,80,Tuesday
2014,12,2,600,28,24,52,Tuesday
2014,12,2,500,26,33,59,Tuesday
2014,12,2,400,17,24,41,Tuesday
2014,12,2,300,32,28,60,Tuesday
2014,12,2,200,40,33,73,Tuesday
2014,12,2,100,36,38,74,Tuesday
2014,12,1,2400,50,72,122,Monday
2014,12,1,2300,41,50,91,Monday
2014,12,1,2200,82,112,194,Monday
2014,12,1,2100,74,101,175,Monday
2014,12,1,2000,79,138,217,Monday
2014,12,1,1900,114,166,280,Monday
2014,12,1,1800,108,229,337,Monday
2014,12,1,1700,146,217,363,Monday
2014,12,1,1600,140,213,353,Monday
2014,12,1,1500,183,190,373,Monday
2014,12,1,1400,182,154,336,Monday
2014,12,1,1300,191,136,327,Monday
2014,12,1,1200,193,122,315,Monday
2014,12,1,1100,180,120,300,Monday
2014,12,1,1000,162,104,266,Monday
2014,12,1,900,135,69,204,Monday
2014,12,1,800,67,44,111,Monday
2014,12,1,700,45,35,80,Monday
2014,12,1,600,18,18,36,Monday
2014,12,1,500,34,24,58,Monday
2014,12,1,400,20,24,44,Monday
2014,12,1,300,16,16,32,Monday
2014,12,1,200,20,25,45,Monday
2014,12,1,100,25,34,59,Monday
2014,11,30,2400,36,40,76,Sunday
2014,11,30,2300,55,77,132,Sunday
2014,11,30,2200,59,97,156,Sunday
2014,11,30,2100,68,126,194,Sunday
2014,11,30,2000,57,135,192,Sunday
2014,11,30,1900,97,202,299,Sunday
2014,11,30,1800,87,321,408,Sunday
2014,11,30,1700,149,540,689,Sunday
2014,11,30,1600,154,552,706,Sunday
2014,11,30,1500,157,395,552,Sunday
2014,11,30,1400,179,252,431,Sunday
2014,11,30,1300,213,238,451,Sunday
2014,11,30,1200,228,184,412,Sunday
2014,11,30,1100,271,133,404,Sunday
2014,11,30,1000,274,68,342,Sunday
2014,11,30,900,278,44,322,Sunday
2014,11,30,800,93,28,121,Sunday
2014,11,30,700,46,14,60,Sunday
2014,11,30,600,19,18,37,Sunday
2014,11,30,500,4,11,15,Sunday
2014,11,30,400,6,12,18,Sunday
2014,11,30,300,8,12,20,Sunday
2014,11,30,200,13,16,29,Sunday
2014,11,30,100,24,28,52,Sunday
2014,11,29,2400,26,24,50,Saturday
2014,11,29,2300,34,37,71,Saturday
2014,11,29,2200,44,59,103,Saturday
2014,11,29,2100,57,73,130,Saturday
2014,11,29,2000,61,101,162,Saturday
2014,11,29,1900,75,178,253,Saturday
2014,11,29,1800,104,356,460,Saturday
2014,11,29,1700,125,441,566,Saturday
2014,11,29,1600,129,336,465,Saturday
2014,11,29,1500,157,314,471,Saturday
2014,11,29,1400,171,160,331,Saturday
2014,11,29,1300,198,136,334,Saturday
2014,11,29,1200,259,150,409,Saturday
2014,11,29,1100,289,128,417,Saturday
2014,11,29,1000,348,116,464,Saturday
2014,11,29,900,397,55,452,Saturday
2014,11,29,800,158,33,191,Saturday
2014,11,29,700,51,21,72,Saturday
2014,11,29,600,32,10,42,Saturday
2014,11,29,500,17,17,34,Saturday
2014,11,29,400,12,19,31,Saturday
2014,11,29,300,10,20,30,Saturday
2014,11,29,200,17,38,55,Saturday
2014,11,29,100,33,45,78,Saturday
2014,11,28,2400,27,61,88,Friday
2014,11,28,2300,71,41,112,Friday
2014,11,28,2200,84,82,166,Friday
2014,11,28,2100,91,100,191,Friday
2014,11,28,2000,118,82,200,Friday
2014,11,28,1900,103,115,218,Friday
2014,11,28,1800,121,280,401,Friday
2014,11,28,1700,115,212,327,Friday
2014,11,28,1600,165,190,355,Friday
2014,11,28,1500,164,295,459,Friday
2014,11,28,1400,181,58,239,Friday
2014,11,28,1300,172,28,200,Friday
2014,11,28,1200,174,70,244,Friday
2014,11,28,1100,247,78,325,Friday
2014,11,28,1000,312,88,400,Friday
2014,11,28,900,395,75,470,Friday
2014,11,28,800,118,49,167,Friday
2014,11,28,700,63,25,88,Friday
2014,11,28,600,26,14,40,Friday
2014,11,28,500,19,42,61,Friday
2014,11,28,400,14,17,31,Friday
2014,11,28,300,27,23,50,Friday
2014,11,28,200,23,39,62,Friday
2014,11,28,100,39,60,99,Friday
2014,11,27,2400,55,101,156,Thursday
2014,11,27,2300,55,119,174,Thursday
2014,11,27,2200,70,93,163,Thursday
2014,11,27,2100,93,125,218,Thursday
2014,11,27,2000,114,117,231,Thursday
2014,11,27,1900,111,191,302,Thursday
2014,11,27,1800,170,209,379,Thursday
2014,11,27,1700,158,176,334,Thursday
2014,11,27,1600,162,204,366,Thursday
2014,11,27,1500,168,147,315,Thursday
2014,11,27,1400,137,169,306,Thursday
2014,11,27,1300,137,136,273,Thursday
2014,11,27,1200,178,84,262,Thursday
2014,11,27,1100,213,80,293,Thursday
2014,11,27,1000,270,78,348,Thursday
2014,11,27,900,241,39,280,Thursday
2014,11,27,800,95,36,131,Thursday
2014,11,27,700,55,10,65,Thursday
2014,11,27,600,25,8,33,Thursday
2014,11,27,500,24,16,40,Thursday
2014,11,27,400,21,19,40,Thursday
2014,11,27,300,28,21,49,Thursday
2014,11,27,200,23,38,61,Thursday
2014,11,27,100,31,45,76,Thursday
2014,11,26,2400,51,55,106,Wednesday
2014,11,26,2300,45,44,89,Wednesday
2014,11,26,2200,62,60,122,Wednesday
2014,11,26,2100,96,72,168,Wednesday
2014,11,26,2000,102,82,184,Wednesday
2014,11,26,1900,112,118,230,Wednesday
2014,11,26,1800,117,209,326,Wednesday
2014,11,26,1700,152,205,357,Wednesday
2014,11,26,1600,186,220,406,Wednesday
2014,11,26,1500,174,172,346,Wednesday
2014,11,26,1400,174,165,339,Wednesday
2014,11,26,1300,166,136,302,Wednesday
2014,11,26,1200,196,121,317,Wednesday
2014,11,26,1100,170,107,277,Wednesday
2014,11,26,1000,164,77,241,Wednesday
2014,11,26,900,255,73,328,Wednesday
2014,11,26,800,125,52,177,Wednesday
2014,11,26,700,50,22,72,Wednesday
2014,11,26,600,31,21,52,Wednesday
2014,11,26,500,29,13,42,Wednesday
2014,11,26,400,21,18,39,Wednesday
2014,11,26,300,35,9,44,Wednesday
2014,11,26,200,31,12,43,Wednesday
2014,11,26,100,38,37,75,Wednesday
2014,11,25,2400,54,56,110,Tuesday
2014,11,25,2300,64,68,132,Tuesday
2014,11,25,2200,80,82,162,Tuesday
2014,11,25,2100,90,83,173,Tuesday
2014,11,25,2000,108,114,222,Tuesday
2014,11,25,1900,108,174,282,Tuesday
2014,11,25,1800,117,363,480,Tuesday
2014,11,25,1700,161,294,455,Tuesday
2014,11,25,1600,161,295,456,Tuesday
2014,11,25,1500,170,191,361,Tuesday
2014,11,25,1400,184,161,345,Tuesday
2014,11,25,1300,189,154,343,Tuesday
2014,11,25,1200,198,126,324,Tuesday
2014,11,25,1100,192,78,270,Tuesday
2014,11,25,1000,218,67,285,Tuesday
2014,11,25,900,167,57,224,Tuesday
2014,11,25,800,110,51,161,Tuesday
2014,11,25,700,46,22,68,Tuesday
2014,11,25,600,34,12,46,Tuesday
2014,11,25,500,13,13,26,Tuesday
2014,11,25,400,21,21,42,Tuesday
2014,11,25,300,27,20,47,Tuesday
2014,11,25,200,28,40,68,Tuesday
2014,11,25,100,52,46,98,Tuesday
2014,11,24,2400,43,50,93,Monday
2014,11,24,2300,53,48,101,Monday
2014,11,24,2200,67,85,152,Monday
2014,11,24,2100,94,115,209,Monday
2014,11,24,2000,123,103,226,Monday
2014,11,24,1900,109,136,245,Monday
2014,11,24,1800,139,266,405,Monday
2014,11,24,1700,181,249,430,Monday
2014,11,24,1600,207,308,515,Monday
2014,11,24,1500,194,241,435,Monday
2014,11,24,1400,220,194,414,Monday
2014,11,24,1300,229,183,412,Monday
2014,11,24,1200,283,139,422,Monday
2014,11,24,1100,228,126,354,Monday
2014,11,24,1000,219,106,325,Monday
2014,11,24,900,198,73,271,Monday
2014,11,24,800,127,55,182,Monday
2014,11,24,700,65,34,99,Monday
2014,11,24,600,37,22,59,Monday
2014,11,24,500,22,28,50,Monday
2014,11,24,400,12,37,49,Monday
2014,11,24,300,27,35,62,Monday
2014,11,24,200,15,45,60,Monday
2014,11,24,100,25,45,70,Monday
2014,11,23,2400,28,69,97,Sunday
2014,11,23,2300,39,201,240,Sunday
2014,11,23,2200,57,41,98,Sunday
2014,11,23,2100,69,111,180,Sunday
2014,11,23,2000,97,171,268,Sunday
2014,11,23,1900,136,248,384,Sunday
2014,11,23,1800,155,432,587,Sunday
2014,11,23,1700,188,608,796,Sunday
2014,11,23,1600,208,518,726,Sunday
2014,11,23,1500,208,473,681,Sunday
2014,11,23,1400,251,411,662,Sunday
2014,11,23,1300,303,391,694,Sunday
2014,11,23,1200,321,270,591,Sunday
2014,11,23,1100,297,195,492,Sunday
2014,11,23,1000,272,113,385,Sunday
2014,11,23,900,313,69,382,Sunday
2014,11,23,800,116,21,137,Sunday
2014,11,23,700,46,19,65,Sunday
2014,11,23,600,20,9,29,Sunday
2014,11,23,500,14,11,25,Sunday
2014,11,23,400,11,12,23,Sunday
2014,11,23,300,17,14,31,Sunday
2014,11,23,200,11,27,38,Sunday
2014,11,23,100,20,31,51,Sunday
2014,11,22,2400,23,142,165,Saturday
2014,11,22,2300,50,136,186,Saturday
2014,11,22,2200,47,53,100,Saturday
2014,11,22,2100,55,44,99,Saturday
2014,11,22,2000,88,46,134,Saturday
2014,11,22,1900,88,138,226,Saturday
2014,11,22,1800,97,356,453,Saturday
2014,11,22,1700,170,442,612,Saturday
2014,11,22,1600,197,377,574,Saturday
2014,11,22,1500,257,290,547,Saturday
2014,11,22,1400,232,281,513,Saturday
2014,11,22,1300,293,290,583,Saturday
2014,11,22,1200,308,187,495,Saturday
2014,11,22,1100,376,144,520,Saturday
2014,11,22,1000,406,118,524,Saturday
2014,11,22,900,421,60,481,Saturday
2014,11,22,800,154,39,193,Saturday
2014,11,22,700,49,21,70,Saturday
2014,11,22,600,43,19,62,Saturday
2014,11,22,500,21,4,25,Saturday
2014,11,22,400,15,16,31,Saturday
2014,11,22,300,16,18,34,Saturday
2014,11,22,200,21,29,50,Saturday
2014,11,22,100,37,24,61,Saturday
2014,11,21,2400,43,28,71,Friday
2014,11,21,2300,78,49,127,Friday
2014,11,21,2200,119,60,179,Friday
2014,11,21,2100,155,91,246,Friday
2014,11,21,2000,204,128,332,Friday
2014,11,21,1900,224,163,387,Friday
2014,11,21,1800,265,311,576,Friday
2014,11,21,1700,325,374,699,Friday
2014,11,21,1600,311,351,662,Friday
2014,11,21,1500,332,271,603,Friday
2014,11,21,1400,285,231,516,Friday
2014,11,21,1300,306,166,472,Friday
2014,11,21,1200,298,175,473,Friday
2014,11,21,1100,333,128,461,Friday
2014,11,21,1000,308,107,415,Friday
2014,11,21,900,272,75,347,Friday
2014,11,21,800,122,47,169,Friday
2014,11,21,700,59,37,96,Friday
2014,11,21,600,33,19,52,Friday
2014,11,21,500,30,23,53,Friday
2014,11,21,400,23,33,56,Friday
2014,11,21,300,27,21,48,Friday
2014,11,21,200,26,31,57,Friday
2014,11,21,100,40,45,85,Friday
2014,11,20,2400,77,49,126,Thursday
2014,11,20,2300,62,67,129,Thursday
2014,11,20,2200,92,77,169,Thursday
2014,11,20,2100,106,77,183,Thursday
2014,11,20,2000,123,141,264,Thursday
2014,11,20,1900,133,147,280,Thursday
2014,11,20,1800,171,199,370,Thursday
2014,11,20,1700,210,243,453,Thursday
2014,11,20,1600,195,224,419,Thursday
2014,11,20,1500,218,237,455,Thursday
2014,11,20,1400,215,193,408,Thursday
2014,11,20,1300,215,181,396,Thursday
2014,11,20,1200,194,143,337,Thursday
2014,11,20,1100,231,120,351,Thursday
2014,11,20,1000,186,105,291,Thursday
2014,11,20,900,164,72,236,Thursday
2014,11,20,800,121,55,176,Thursday
2014,11,20,700,55,39,94,Thursday
2014,11,20,600,36,38,74,Thursday
2014,11,20,500,37,21,58,Thursday
2014,11,20,400,24,36,60,Thursday
2014,11,20,300,32,32,64,Thursday
2014,11,20,200,44,30,74,Thursday
2014,11,20,100,44,52,96,Thursday
2014,11,19,2400,61,47,108,Wednesday
2014,11,19,2300,55,65,120,Wednesday
2014,11,19,2200,78,57,135,Wednesday
2014,11,19,2100,92,110,202,Wednesday
2014,11,19,2000,125,119,244,Wednesday
2014,11,19,1900,108,143,251,Wednesday
2014,11,19,1800,137,238,375,Wednesday
2014,11,19,1700,187,264,451,Wednesday
2014,11,19,1600,172,192,364,Wednesday
2014,11,19,1500,213,230,443,Wednesday
2014,11,19,1400,196,182,378,Wednesday
2014,11,19,1300,239,169,408,Wednesday
2014,11,19,1200,207,143,350,Wednesday
2014,11,19,1100,226,129,355,Wednesday
2014,11,19,1000,203,92,295,Wednesday
2014,11,19,900,158,90,248,Wednesday
2014,11,19,800,94,58,152,Wednesday
2014,11,19,700,48,43,91,Wednesday
2014,11,19,600,31,30,61,Wednesday
2014,11,19,500,22,25,47,Wednesday
2014,11,19,400,32,33,65,Wednesday
2014,11,19,300,34,37,71,Wednesday
2014,11,19,200,25,37,62,Wednesday
2014,11,19,100,36,32,68,Wednesday
2014,11,18,2400,51,50,101,Tuesday
2014,11,18,2300,63,69,132,Tuesday
2014,11,18,2200,65,84,149,Tuesday
2014,11,18,2100,86,61,147,Tuesday
2014,11,18,2000,102,126,228,Tuesday
2014,11,18,1900,95,153,248,Tuesday
2014,11,18,1800,118,222,340,Tuesday
2014,11,18,1700,178,267,445,Tuesday
2014,11,18,1600,155,242,397,Tuesday
2014,11,18,1500,158,244,402,Tuesday
2014,11,18,1400,169,183,352,Tuesday
2014,11,18,1300,198,168,366,Tuesday
2014,11,18,1200,215,159,374,Tuesday
2014,11,18,1100,188,120,308,Tuesday
2014,11,18,1000,180,103,283,Tuesday
2014,11,18,900,163,88,251,Tuesday
2014,11,18,800,114,56,170,Tuesday
2014,11,18,700,55,53,108,Tuesday
2014,11,18,600,30,30,60,Tuesday
2014,11,18,500,27,22,49,Tuesday
2014,11,18,400,28,27,55,Tuesday
2014,11,18,300,25,28,53,Tuesday
2014,11,18,200,19,29,48,Tuesday
2014,11,18,100,33,48,81,Tuesday
2014,11,17,2400,44,41,85,Monday
2014,11,17,2300,48,60,108,Monday
2014,11,17,2200,72,83,155,Monday
2014,11,17,2100,73,83,156,Monday
2014,11,17,2000,99,117,216,Monday
2014,11,17,1900,103,128,231,Monday
2014,11,17,1800,135,234,369,Monday
2014,11,17,1700,170,283,453,Monday
2014,11,17,1600,188,249,437,Monday
2014,11,17,1500,193,212,405,Monday
2014,11,17,1400,192,181,373,Monday
2014,11,17,1300,244,193,437,Monday
2014,11,17,1200,223,133,356,Monday
2014,11,17,1100,271,123,394,Monday
2014,11,17,1000,197,82,279,Monday
2014,11,17,900,171,62,233,Monday
2014,11,17,800,95,45,140,Monday
2014,11,17,700,46,36,82,Monday
2014,11,17,600,31,25,56,Monday
2014,11,17,500,16,24,40,Monday
2014,11,17,400,16,22,38,Monday
2014,11,17,300,25,19,44,Monday
2014,11,17,200,16,23,39,Monday
2014,11,17,100,27,41,68,Monday
2014,11,16,2400,29,67,96,Sunday
2014,11,16,2300,38,51,89,Sunday
2014,11,16,2200,62,101,163,Sunday
2014,11,16,2100,57,152,209,Sunday
2014,11,16,2000,82,200,282,Sunday
2014,11,16,1900,117,318,435,Sunday
2014,11,16,1800,130,465,595,Sunday
2014,11,16,1700,181,636,817,Sunday
2014,11,16,1600,235,568,803,Sunday
2014,11,16,1500,216,523,739,Sunday
2014,11,16,1400,248,462,710,Sunday
2014,11,16,1300,303,425,728,Sunday
2014,11,16,1200,347,321,668,Sunday
2014,11,16,1100,278,224,502,Sunday
2014,11,16,1000,312,136,448,Sunday
2014,11,16,900,279,54,333,Sunday
2014,11,16,800,116,22,138,Sunday
2014,11,16,700,43,16,59,Sunday
2014,11,16,600,19,11,30,Sunday
2014,11,16,500,13,6,19,Sunday
2014,11,16,400,11,12,23,Sunday
2014,11,16,300,11,17,28,Sunday
2014,11,16,200,12,24,36,Sunday
2014,11,16,100,14,23,37,Sunday
2014,11,15,2400,21,37,58,Saturday
2014,11,15,2300,36,40,76,Saturday
2014,11,15,2200,45,71,116,Saturday
2014,11,15,2100,74,75,149,Saturday
2014,11,15,2000,78,102,180,Saturday
2014,11,15,1900,97,178,275,Saturday
2014,11,15,1800,128,301,429,Saturday
2014,11,15,1700,198,452,650,Saturday
2014,11,15,1600,249,388,637,Saturday
2014,11,15,1500,276,321,597,Saturday
2014,11,15,1400,301,256,557,Saturday
2014,11,15,1300,356,211,567,Saturday
2014,11,15,1200,363,178,541,Saturday
2014,11,15,1100,324,148,472,Saturday
2014,11,15,1000,321,101,422,Saturday
2014,11,15,900,290,106,396,Saturday
2014,11,15,800,146,50,196,Saturday
2014,11,15,700,50,39,89,Saturday
2014,11,15,600,29,18,47,Saturday
2014,11,15,500,14,23,37,Saturday
2014,11,15,400,17,25,42,Saturday
2014,11,15,300,26,26,52,Saturday
2014,11,15,200,30,35,65,Saturday
2014,11,15,100,27,41,68,Saturday
2014,11,14,2400,43,31,74,Friday
2014,11,14,2300,71,69,140,Friday
2014,11,14,2200,105,53,158,Friday
2014,11,14,2100,163,115,278,Friday
2014,11,14,2000,222,117,339,Friday
2014,11,14,1900,239,167,406,Friday
2014,11,14,1800,270,255,525,Friday
2014,11,14,1700,318,307,625,Friday
2014,11,14,1600,310,312,622,Friday
2014,11,14,1500,352,293,645,Friday
2014,11,14,1400,296,207,503,Friday
2014,11,14,1300,287,238,525,Friday
2014,11,14,1200,292,188,480,Friday
2014,11,14,1100,253,119,372,Friday
2014,11,14,1000,268,89,357,Friday
2014,11,14,900,190,72,262,Friday
2014,11,14,800,113,83,196,Friday
2014,11,14,700,56,59,115,Friday
2014,11,14,600,35,29,64,Friday
2014,11,14,500,35,29,64,Friday
2014,11,14,400,21,30,51,Friday
2014,11,14,300,22,25,47,Friday
2014,11,14,200,33,31,64,Friday
2014,11,14,100,43,50,93,Friday
2014,11,13,2400,46,46,92,Thursday
2014,11,13,2300,66,64,130,Thursday
2014,11,13,2200,55,82,137,Thursday
2014,11,13,2100,110,99,209,Thursday
2014,11,13,2000,125,140,265,Thursday
2014,11,13,1900,142,185,327,Thursday
2014,11,13,1800,147,233,380,Thursday
2014,11,13,1700,199,273,472,Thursday
2014,11,13,1600,200,280,480,Thursday
2014,11,13,1500,179,264,443,Thursday
2014,11,13,1400,190,242,432,Thursday
2014,11,13,1300,197,185,382,Thursday
2014,11,13,1200,220,155,375,Thursday
2014,11,13,1100,218,113,331,Thursday
2014,11,13,1000,195,119,314,Thursday
2014,11,13,900,201,84,285,Thursday
2014,11,13,800,112,54,166,Thursday
2014,11,13,700,59,35,94,Thursday
2014,11,13,600,32,35,67,Thursday
2014,11,13,500,24,27,51,Thursday
2014,11,13,400,19,33,52,Thursday
2014,11,13,300,25,26,51,Thursday
2014,11,13,200,29,26,55,Thursday
2014,11,13,100,56,43,99,Thursday
2014,11,12,2400,65,56,121,Wednesday
2014,11,12,2300,53,73,126,Wednesday
2014,11,12,2200,91,163,254,Wednesday
2014,11,12,2100,100,53,153,Wednesday
2014,11,12,2000,105,51,156,Wednesday
2014,11,12,1900,118,153,271,Wednesday
2014,11,12,1800,129,205,334,Wednesday
2014,11,12,1700,188,226,414,Wednesday
2014,11,12,1600,206,251,457,Wednesday
2014,11,12,1500,179,171,350,Wednesday
2014,11,12,1400,178,167,345,Wednesday
2014,11,12,1300,204,193,397,Wednesday
2014,11,12,1200,217,148,365,Wednesday
2014,11,12,1100,179,100,279,Wednesday
2014,11,12,1000,145,97,242,Wednesday
2014,11,12,900,115,63,178,Wednesday
2014,11,12,800,98,58,156,Wednesday
2014,11,12,700,46,34,80,Wednesday
2014,11,12,600,22,24,46,Wednesday
2014,11,12,500,14,18,32,Wednesday
2014,11,12,400,15,28,43,Wednesday
2014,11,12,300,22,25,47,Wednesday
2014,11,12,200,8,32,40,Wednesday
2014,11,12,100,29,41,70,Wednesday
2014,11,11,2400,18,53,71,Tuesday
2014,11,11,2300,39,80,119,Tuesday
2014,11,11,2200,56,104,160,Tuesday
2014,11,11,2100,57,164,221,Tuesday
2014,11,11,2000,72,204,276,Tuesday
2014,11,11,1900,95,244,339,Tuesday
2014,11,11,1800,134,355,489,Tuesday
2014,11,11,1700,148,491,639,Tuesday
2014,11,11,1600,178,538,716,Tuesday
2014,11,11,1500,218,570,788,Tuesday
2014,11,11,1400,210,442,652,Tuesday
2014,11,11,1300,284,465,749,Tuesday
2014,11,11,1200,287,272,559,Tuesday
2014,11,11,1100,275,179,454,Tuesday
2014,11,11,1000,212,123,335,Tuesday
2014,11,11,900,130,71,201,Tuesday
2014,11,11,800,90,55,145,Tuesday
2014,11,11,700,44,24,68,Tuesday
2014,11,11,600,20,22,42,Tuesday
2014,11,11,500,16,28,44,Tuesday
2014,11,11,400,21,20,41,Tuesday
2014,11,11,300,27,31,58,Tuesday
2014,11,11,200,22,33,55,Tuesday
2014,11,11,100,34,35,69,Tuesday
2014,11,10,2400,50,53,103,Monday
2014,11,10,2300,47,67,114,Monday
2014,11,10,2200,71,98,169,Monday
2014,11,10,2100,97,110,207,Monday
2014,11,10,2000,95,125,220,Monday
2014,11,10,1900,122,191,313,Monday
2014,11,10,1800,160,334,494,Monday
2014,11,10,1700,164,294,458,Monday
2014,11,10,1600,215,300,515,Monday
2014,11,10,1500,230,294,524,Monday
2014,11,10,1400,250,315,565,Monday
2014,11,10,1300,267,271,538,Monday
2014,11,10,1200,244,201,445,Monday
2014,11,10,1100,222,162,384,Monday
2014,11,10,1000,201,96,297,Monday
2014,11,10,900,111,62,173,Monday
2014,11,10,800,74,33,107,Monday
2014,11,10,700,38,25,63,Monday
2014,11,10,600,20,18,38,Monday
2014,11,10,500,8,23,31,Monday
2014,11,10,400,8,21,29,Monday
2014,11,10,300,18,35,53,Monday
2014,11,10,200,17,38,55,Monday
2014,11,10,100,28,38,66,Monday
2014,11,9,2400,39,59,98,Sunday
2014,11,9,2300,36,91,127,Sunday
2014,11,9,2200,58,95,153,Sunday
2014,11,9,2100,63,151,214,Sunday
2014,11,9,2000,94,233,327,Sunday
2014,11,9,1900,113,200,313,Sunday
2014,11,9,1800,143,275,418,Sunday
2014,11,9,1700,209,361,570,Sunday
2014,11,9,1600,222,434,656,Sunday
2014,11,9,1500,240,436,676,Sunday
2014,11,9,1400,235,408,643,Sunday
2014,11,9,1300,251,339,590,Sunday
2014,11,9,1200,265,252,517,Sunday
2014,11,9,1100,232,155,387,Sunday
2014,11,9,1000,146,114,260,Sunday
2014,11,9,900,95,85,180,Sunday
2014,11,9,800,58,49,107,Sunday
2014,11,9,700,22,15,37,Sunday
2014,11,9,600,24,9,33,Sunday
2014,11,9,500,15,15,30,Sunday
2014,11,9,400,13,16,29,Sunday
2014,11,9,300,12,17,29,Sunday
2014,11,9,200,12,23,35,Sunday
2014,11,9,100,26,38,64,Sunday
2014,11,8,2400,46,38,84,Saturday
2014,11,8,2300,47,49,96,Saturday
2014,11,8,2200,64,68,132,Saturday
2014,11,8,2100,112,93,205,Saturday
2014,11,8,2000,114,125,239,Saturday
2014,11,8,1900,146,186,332,Saturday
2014,11,8,1800,206,287,493,Saturday
2014,11,8,1700,304,362,666,Saturday
2014,11,8,1600,363,407,770,Saturday
2014,11,8,1500,405,394,799,Saturday
2014,11,8,1400,462,316,778,Saturday
2014,11,8,1300,502,261,763,Saturday
2014,11,8,1200,470,221,691,Saturday
2014,11,8,1100,459,158,617,Saturday
2014,11,8,1000,360,111,471,Saturday
2014,11,8,900,203,117,320,Saturday
2014,11,8,800,155,68,223,Saturday
2014,11,8,700,79,38,117,Saturday
2014,11,8,600,37,26,63,Saturday
2014,11,8,500,27,24,51,Saturday
2014,11,8,400,19,27,46,Saturday
2014,11,8,300,21,29,50,Saturday
2014,11,8,200,26,28,54,Saturday
2014,11,8,100,34,35,69,Saturday
2014,11,7,2400,58,56,114,Friday
2014,11,7,2300,102,67,169,Friday
2014,11,7,2200,154,107,261,Friday
2014,11,7,2100,250,125,375,Friday
2014,11,7,2000,391,145,536,Friday
2014,11,7,1900,401,201,602,Friday
2014,11,7,1800,479,290,769,Friday
2014,11,7,1700,504,301,805,Friday
2014,11,7,1600,456,333,789,Friday
2014,11,7,1500,490,303,793,Friday
2014,11,7,1400,371,255,626,Friday
2014,11,7,1300,366,178,544,Friday
2014,11,7,1200,372,203,575,Friday
2014,11,7,1100,377,160,537,Friday
2014,11,7,1000,284,113,397,Friday
2014,11,7,900,187,93,280,Friday
2014,11,7,800,131,61,192,Friday
2014,11,7,700,88,24,112,Friday
2014,11,7,600,33,30,63,Friday
2014,11,7,500,31,27,58,Friday
2014,11,7,400,16,38,54,Friday
2014,11,7,300,19,35,54,Friday
2014,11,7,200,25,35,60,Friday
2014,11,7,100,42,71,113,Friday
2014,11,6,2400,66,48,114,Thursday
2014,11,6,2300,101,59,160,Thursday
2014,11,6,2200,96,82,178,Thursday
2014,11,6,2100,142,100,242,Thursday
2014,11,6,2000,192,126,318,Thursday
2014,11,6,1900,169,189,358,Thursday
2014,11,6,1800,239,202,441,Thursday
2014,11,6,1700,220,226,446,Thursday
2014,11,6,1600,233,248,481,Thursday
2014,11,6,1500,212,292,504,Thursday
2014,11,6,1400,259,229,488,Thursday
2014,11,6,1300,264,296,560,Thursday
2014,11,6,1200,256,240,496,Thursday
2014,11,6,1100,226,144,370,Thursday
2014,11,6,1000,210,127,337,Thursday
2014,11,6,900,153,85,238,Thursday
2014,11,6,800,114,58,172,Thursday
2014,11,6,700,58,59,117,Thursday
2014,11,6,600,35,24,59,Thursday
2014,11,6,500,24,23,47,Thursday
2014,11,6,400,25,35,60,Thursday
2014,11,6,300,33,23,56,Thursday
2014,11,6,200,31,27,58,Thursday
2014,11,6,100,44,62,106,Thursday
2014,11,5,2400,75,62,137,Wednesday
2014,11,5,2300,56,51,107,Wednesday
2014,11,5,2200,84,85,169,Wednesday
2014,11,5,2100,114,91,205,Wednesday
2014,11,5,2000,111,125,236,Wednesday
2014,11,5,1900,117,166,283,Wednesday
2014,11,5,1800,156,206,362,Wednesday
2014,11,5,1700,153,232,385,Wednesday
2014,11,5,1600,184,224,408,Wednesday
2014,11,5,1500,194,244,438,Wednesday
2014,11,5,1400,190,204,394,Wednesday
2014,11,5,1300,207,176,383,Wednesday
2014,11,5,1200,225,161,386,Wednesday
2014,11,5,1100,214,141,355,Wednesday
2014,11,5,1000,141,121,262,Wednesday
2014,11,5,900,140,94,234,Wednesday
2014,11,5,800,105,57,162,Wednesday
2014,11,5,700,65,52,117,Wednesday
2014,11,5,600,24,30,54,Wednesday
2014,11,5,500,20,34,54,Wednesday
2014,11,5,400,28,31,59,Wednesday
2014,11,5,300,15,18,33,Wednesday
2014,11,5,200,33,27,60,Wednesday
2014,11,5,100,38,55,93,Wednesday
2014,11,4,2400,51,48,99,Tuesday
2014,11,4,2300,58,53,111,Tuesday
2014,11,4,2200,80,81,161,Tuesday
2014,11,4,2100,89,101,190,Tuesday
2014,11,4,2000,107,102,209,Tuesday
2014,11,4,1900,93,154,247,Tuesday
2014,11,4,1800,132,236,368,Tuesday
2014,11,4,1700,138,231,369,Tuesday
2014,11,4,1600,191,204,395,Tuesday
2014,11,4,1500,185,226,411,Tuesday
2014,11,4,1400,181,187,368,Tuesday
2014,11,4,1300,205,166,371,Tuesday
2014,11,4,1200,210,170,380,Tuesday
2014,11,4,1100,188,130,318,Tuesday
2014,11,4,1000,163,127,290,Tuesday
2014,11,4,900,140,75,215,Tuesday
2014,11,4,800,94,67,161,Tuesday
2014,11,4,700,69,53,122,Tuesday
2014,11,4,600,26,28,54,Tuesday
2014,11,4,500,16,34,50,Tuesday
2014,11,4,400,19,16,35,Tuesday
2014,11,4,300,22,30,52,Tuesday
2014,11,4,200,27,30,57,Tuesday
2014,11,4,100,44,50,94,Tuesday
2014,11,3,2400,55,52,107,Monday
2014,11,3,2300,60,87,147,Monday
2014,11,3,2200,73,79,152,Monday
2014,11,3,2100,86,83,169,Monday
2014,11,3,2000,112,141,253,Monday
2014,11,3,1900,111,164,275,Monday
2014,11,3,1800,146,255,401,Monday
2014,11,3,1700,239,297,536,Monday
2014,11,3,1600,248,265,513,Monday
2014,11,3,1500,260,225,485,Monday
2014,11,3,1400,262,198,460,Monday
2014,11,3,1300,260,184,444,Monday
2014,11,3,1200,249,165,414,Monday
2014,11,3,1100,270,150,420,Monday
2014,11,3,1000,193,109,302,Monday
2014,11,3,900,141,76,217,Monday
2014,11,3,800,101,54,155,Monday
2014,11,3,700,78,52,130,Monday
2014,11,3,600,34,22,56,Monday
2014,11,3,500,14,22,36,Monday
2014,11,3,400,26,24,50,Monday
2014,11,3,300,15,22,37,Monday
2014,11,3,200,23,34,57,Monday
2014,11,3,100,19,41,60,Monday
2014,11,2,2400,32,56,88,Sunday
2014,11,2,2300,31,90,121,Sunday
2014,11,2,2200,63,114,177,Sunday
2014,11,2,2100,74,187,261,Sunday
2014,11,2,2000,95,205,300,Sunday
2014,11,2,1900,105,322,427,Sunday
2014,11,2,1800,138,406,544,Sunday
2014,11,2,1700,193,471,664,Sunday
2014,11,2,1600,210,476,686,Sunday
2014,11,2,1500,263,433,696,Sunday
2014,11,2,1400,271,340,611,Sunday
2014,11,2,1300,335,321,656,Sunday
2014,11,2,1200,257,255,512,Sunday
2014,11,2,1100,254,159,413,Sunday
2014,11,2,1000,213,87,300,Sunday
2014,11,2,900,138,70,208,Sunday
2014,11,2,800,88,31,119,Sunday
2014,11,2,700,33,18,51,Sunday
2014,11,2,600,23,9,32,Sunday
2014,11,2,500,12,13,25,Sunday
2014,11,2,400,15,12,27,Sunday
2014,11,2,300,7,17,24,Sunday
2014,11,2,200,5,20,25,Sunday
2014,11,2,100,25,35,60,Sunday
2014,11,1,2400,26,42,68,Saturday
2014,11,1,2300,47,58,105,Saturday
2014,11,1,2200,49,82,131,Saturday
2014,11,1,2100,52,118,170,Saturday
2014,11,1,2000,72,118,190,Saturday
2014,11,1,1900,107,174,281,Saturday
2014,11,1,1800,166,242,408,Saturday
2014,11,1,1700,194,282,476,Saturday
2014,11,1,1600,200,245,445,Saturday
2014,11,1,1500,226,228,454,Saturday
2014,11,1,1400,272,214,486,Saturday
2014,11,1,1300,301,174,475,Saturday
2014,11,1,1200,318,168,486,Saturday
2014,11,1,1100,235,146,381,Saturday
2014,11,1,1000,190,92,282,Saturday
2014,11,1,900,165,83,248,Saturday
2014,11,1,800,122,42,164,Saturday
2014,11,1,700,60,27,87,Saturday
2014,11,1,600,32,29,61,Saturday
2014,11,1,500,25,27,52,Saturday
2014,11,1,400,13,38,51,Saturday
2014,11,1,300,29,17,46,Saturday
2014,11,1,200,17,22,39,Saturday
2014,11,1,100,34,31,65,Saturday
2014,10,31,2400,56,46,102,Friday
2014,10,31,2300,62,51,113,Friday
2014,10,31,2200,104,69,173,Friday
2014,10,31,2100,109,101,210,Friday
2014,10,31,2000,194,138,332,Friday
2014,10,31,1900,209,179,388,Friday
2014,10,31,1800,237,217,454,Friday
2014,10,31,1700,275,263,538,Friday
2014,10,31,1600,276,286,562,Friday
2014,10,31,1500,272,238,510,Friday
2014,10,31,1400,284,240,524,Friday
2014,10,31,1300,290,198,488,Friday
2014,10,31,1200,265,205,470,Friday
2014,10,31,1100,273,114,387,Friday
2014,10,31,1000,237,125,362,Friday
2014,10,31,900,170,83,253,Friday
2014,10,31,800,104,61,165,Friday
2014,10,31,700,65,36,101,Friday
2014,10,31,600,42,18,60,Friday
2014,10,31,500,28,27,55,Friday
2014,10,31,400,18,35,53,Friday
2014,10,31,300,24,32,56,Friday
2014,10,31,200,24,36,60,Friday
2014,10,31,100,56,52,108,Friday
2014,10,30,2400,64,52,116,Thursday
2014,10,30,2300,87,66,153,Thursday
2014,10,30,2200,104,76,180,Thursday
2014,10,30,2100,129,120,249,Thursday
2014,10,30,2000,157,104,261,Thursday
2014,10,30,1900,155,200,355,Thursday
2014,10,30,1800,204,259,463,Thursday
2014,10,30,1700,236,242,478,Thursday
2014,10,30,1600,257,239,496,Thursday
2014,10,30,1500,214,251,465,Thursday
2014,10,30,1400,255,206,461,Thursday
2014,10,30,1300,246,180,426,Thursday
2014,10,30,1200,250,173,423,Thursday
2014,10,30,1100,253,140,393,Thursday
2014,10,30,1000,170,107,277,Thursday
2014,10,30,900,139,92,231,Thursday
2014,10,30,800,120,49,169,Thursday
2014,10,30,700,66,50,116,Thursday
2014,10,30,600,32,31,63,Thursday
2014,10,30,500,29,30,59,Thursday
2014,10,30,400,24,33,57,Thursday
2014,10,30,300,19,32,51,Thursday
2014,10,30,200,31,38,69,Thursday
2014,10,30,100,34,41,75,Thursday
2014,10,29,2400,56,67,123,Wednesday
2014,10,29,2300,72,73,145,Wednesday
2014,10,29,2200,82,84,166,Wednesday
2014,10,29,2100,116,105,221,Wednesday
2014,10,29,2000,144,127,271,Wednesday
2014,10,29,1900,134,197,331,Wednesday
2014,10,29,1800,178,268,446,Wednesday
2014,10,29,1700,204,235,439,Wednesday
2014,10,29,1600,194,242,436,Wednesday
2014,10,29,1500,228,229,457,Wednesday
2014,10,29,1400,210,206,416,Wednesday
2014,10,29,1300,248,164,412,Wednesday
2014,10,29,1200,262,192,454,Wednesday
2014,10,29,1100,235,130,365,Wednesday
2014,10,29,1000,181,119,300,Wednesday
2014,10,29,900,153,78,231,Wednesday
2014,10,29,800,125,64,189,Wednesday
2014,10,29,700,72,35,107,Wednesday
2014,10,29,600,35,34,69,Wednesday
2014,10,29,500,21,29,50,Wednesday
2014,10,29,400,18,40,58,Wednesday
2014,10,29,300,20,31,51,Wednesday
2014,10,29,200,26,28,54,Wednesday
2014,10,29,100,51,55,106,Wednesday
2014,10,28,2400,61,66,127,Tuesday
2014,10,28,2300,65,76,141,Tuesday
2014,10,28,2200,91,64,155,Tuesday
2014,10,28,2100,94,100,194,Tuesday
2014,10,28,2000,122,130,252,Tuesday
2014,10,28,1900,119,204,323,Tuesday
2014,10,28,1800,141,260,401,Tuesday
2014,10,28,1700,162,250,412,Tuesday
2014,10,28,1600,189,219,408,Tuesday
2014,10,28,1500,211,259,470,Tuesday
2014,10,28,1400,191,199,390,Tuesday
2014,10,28,1300,243,195,438,Tuesday
2014,10,28,1200,237,156,393,Tuesday
2014,10,28,1100,235,154,389,Tuesday
2014,10,28,1000,175,139,314,Tuesday
2014,10,28,900,132,81,213,Tuesday
2014,10,28,800,105,66,171,Tuesday
2014,10,28,700,57,42,99,Tuesday
2014,10,28,600,39,41,80,Tuesday
2014,10,28,500,29,26,55,Tuesday
2014,10,28,400,23,34,57,Tuesday
2014,10,28,300,25,26,51,Tuesday
2014,10,28,200,24,38,62,Tuesday
2014,10,28,100,41,45,86,Tuesday
2014,10,27,2400,49,76,125,Monday
2014,10,27,2300,65,73,138,Monday
2014,10,27,2200,69,113,182,Monday
2014,10,27,2100,80,107,187,Monday
2014,10,27,2000,116,148,264,Monday
2014,10,27,1900,129,243,372,Monday
2014,10,27,1800,163,294,457,Monday
2014,10,27,1700,204,307,511,Monday
2014,10,27,1600,225,319,544,Monday
2014,10,27,1500,286,281,567,Monday
2014,10,27,1400,260,228,488,Monday
2014,10,27,1300,283,192,475,Monday
2014,10,27,1200,292,200,492,Monday
2014,10,27,1100,277,119,396,Monday
2014,10,27,1000,218,106,324,Monday
2014,10,27,900,153,84,237,Monday
2014,10,27,800,115,63,178,Monday
2014,10,27,700,68,34,102,Monday
2014,10,27,600,36,29,65,Monday
2014,10,27,500,19,21,40,Monday
2014,10,27,400,27,19,46,Monday
2014,10,27,300,28,27,55,Monday
2014,10,27,200,22,29,51,Monday
2014,10,27,100,23,62,85,Monday
2014,10,26,2400,30,76,106,Sunday
2014,10,26,2300,50,99,149,Sunday
2014,10,26,2200,70,137,207,Sunday
2014,10,26,2100,75,207,282,Sunday
2014,10,26,2000,104,281,385,Sunday
2014,10,26,1900,141,388,529,Sunday
2014,10,26,1800,163,467,630,Sunday
2014,10,26,1700,222,568,790,Sunday
2014,10,26,1600,298,560,858,Sunday
2014,10,26,1500,357,553,910,Sunday
2014,10,26,1400,339,465,804,Sunday
2014,10,26,1300,338,389,727,Sunday
2014,10,26,1200,374,293,667,Sunday
2014,10,26,1100,282,191,473,Sunday
2014,10,26,1000,220,105,325,Sunday
2014,10,26,900,157,55,212,Sunday
2014,10,26,800,75,35,110,Sunday
2014,10,26,700,46,24,70,Sunday
2014,10,26,600,24,10,34,Sunday
2014,10,26,500,16,14,30,Sunday
2014,10,26,400,16,21,37,Sunday
2014,10,26,300,14,18,32,Sunday
2014,10,26,200,18,25,43,Sunday
2014,10,26,100,22,40,62,Sunday
2014,10,25,2400,37,50,87,Saturday
2014,10,25,2300,57,50,107,Saturday
2014,10,25,2200,63,96,159,Saturday
2014,10,25,2100,79,131,210,Saturday
2014,10,25,2000,115,162,277,Saturday
2014,10,25,1900,107,259,366,Saturday
2014,10,25,1800,167,374,541,Saturday
2014,10,25,1700,248,449,697,Saturday
2014,10,25,1600,258,415,673,Saturday
2014,10,25,1500,305,374,679,Saturday
2014,10,25,1400,310,314,624,Saturday
2014,10,25,1300,436,280,716,Saturday
2014,10,25,1200,411,226,637,Saturday
2014,10,25,1100,371,160,531,Saturday
2014,10,25,1000,287,109,396,Saturday
2014,10,25,900,173,73,246,Saturday
2014,10,25,800,120,60,180,Saturday
2014,10,25,700,58,35,93,Saturday
2014,10,25,600,32,24,56,Saturday
2014,10,25,500,27,26,53,Saturday
2014,10,25,400,23,32,55,Saturday
2014,10,25,300,19,22,41,Saturday
2014,10,25,200,33,31,64,Saturday
2014,10,25,100,40,35,75,Saturday
2014,10,24,2400,50,67,117,Friday
2014,10,24,2300,84,64,148,Friday
2014,10,24,2200,128,85,213,Friday
2014,10,24,2100,177,126,303,Friday
2014,10,24,2000,286,213,499,Friday
2014,10,24,1900,325,250,575,Friday
2014,10,24,1800,372,347,719,Friday
2014,10,24,1700,364,384,748,Friday
2014,10,24,1600,393,345,738,Friday
2014,10,24,1500,350,328,678,Friday
2014,10,24,1400,352,298,650,Friday
2014,10,24,1300,335,268,603,Friday
2014,10,24,1200,361,215,576,Friday
2014,10,24,1100,333,162,495,Friday
2014,10,24,1000,252,145,397,Friday
2014,10,24,900,168,86,254,Friday
2014,10,24,800,138,64,202,Friday
2014,10,24,700,86,45,131,Friday
2014,10,24,600,45,42,87,Friday
2014,10,24,500,28,32,60,Friday
2014,10,24,400,34,40,74,Friday
2014,10,24,300,27,31,58,Friday
2014,10,24,200,38,32,70,Friday
2014,10,24,100,37,46,83,Friday
2014,10,23,2400,60,56,116,Thursday
2014,10,23,2300,74,84,158,Thursday
2014,10,23,2200,107,117,224,Thursday
2014,10,23,2100,135,122,257,Thursday
2014,10,23,2000,180,144,324,Thursday
2014,10,23,1900,194,218,412,Thursday
2014,10,23,1800,205,282,487,Thursday
2014,10,23,1700,280,295,575,Thursday
2014,10,23,1600,279,308,587,Thursday
2014,10,23,1500,267,254,521,Thursday
2014,10,23,1400,291,266,557,Thursday
2014,10,23,1300,264,183,447,Thursday
2014,10,23,1200,320,202,522,Thursday
2014,10,23,1100,251,182,433,Thursday
2014,10,23,1000,245,111,356,Thursday
2014,10,23,900,182,88,270,Thursday
2014,10,23,800,108,66,174,Thursday
2014,10,23,700,73,45,118,Thursday
2014,10,23,600,29,27,56,Thursday
2014,10,23,500,24,36,60,Thursday
2014,10,23,400,29,26,55,Thursday
2014,10,23,300,26,37,63,Thursday
2014,10,23,200,30,28,58,Thursday
2014,10,23,100,50,50,100,Thursday
2014,10,22,2400,66,60,126,Wednesday
2014,10,22,2300,65,83,148,Wednesday
2014,10,22,2200,95,89,184,Wednesday
2014,10,22,2100,114,116,230,Wednesday
2014,10,22,2000,149,133,282,Wednesday
2014,10,22,1900,153,232,385,Wednesday
2014,10,22,1800,191,287,478,Wednesday
2014,10,22,1700,204,307,511,Wednesday
2014,10,22,1600,266,289,555,Wednesday
2014,10,22,1500,235,240,475,Wednesday
2014,10,22,1400,291,248,539,Wednesday
2014,10,22,1300,269,200,469,Wednesday
2014,10,22,1200,298,187,485,Wednesday
2014,10,22,1100,273,163,436,Wednesday
2014,10,22,1000,198,105,303,Wednesday
2014,10,22,900,170,89,259,Wednesday
2014,10,22,800,103,63,166,Wednesday
2014,10,22,700,73,52,125,Wednesday
2014,10,22,600,43,40,83,Wednesday
2014,10,22,500,16,38,54,Wednesday
2014,10,22,400,27,30,57,Wednesday
2014,10,22,300,22,41,63,Wednesday
2014,10,22,200,27,39,66,Wednesday
2014,10,22,100,39,48,87,Wednesday
2014,10,21,2400,70,60,130,Tuesday
2014,10,21,2300,74,80,154,Tuesday
2014,10,21,2200,81,109,190,Tuesday
2014,10,21,2100,96,124,220,Tuesday
2014,10,21,2000,132,170,302,Tuesday
2014,10,21,1900,154,204,358,Tuesday
2014,10,21,1800,181,271,452,Tuesday
2014,10,21,1700,169,300,469,Tuesday
2014,10,21,1600,220,279,499,Tuesday
2014,10,21,1500,221,277,498,Tuesday
2014,10,21,1400,241,250,491,Tuesday
2014,10,21,1300,261,202,463,Tuesday
2014,10,21,1200,262,193,455,Tuesday
2014,10,21,1100,254,173,427,Tuesday
2014,10,21,1000,205,144,349,Tuesday
2014,10,21,900,174,110,284,Tuesday
2014,10,21,800,107,68,175,Tuesday
2014,10,21,700,68,36,104,Tuesday
2014,10,21,600,40,45,85,Tuesday
2014,10,21,500,17,31,48,Tuesday
2014,10,21,400,29,45,74,Tuesday
2014,10,21,300,19,29,48,Tuesday
2014,10,21,200,28,44,72,Tuesday
2014,10,21,100,41,55,96,Tuesday
2014,10,20,2400,51,71,122,Monday
2014,10,20,2300,70,96,166,Monday
2014,10,20,2200,72,86,158,Monday
2014,10,20,2100,101,145,246,Monday
2014,10,20,2000,110,182,292,Monday
2014,10,20,1900,139,315,454,Monday
2014,10,20,1800,184,368,552,Monday
2014,10,20,1700,227,407,634,Monday
2014,10,20,1600,259,377,636,Monday
2014,10,20,1500,287,307,594,Monday
2014,10,20,1400,286,278,564,Monday
2014,10,20,1300,302,200,502,Monday
2014,10,20,1200,358,238,596,Monday
2014,10,20,1100,396,156,552,Monday
2014,10,20,1000,248,116,364,Monday
2014,10,20,900,179,80,259,Monday
2014,10,20,800,125,73,198,Monday
2014,10,20,700,69,37,106,Monday
2014,10,20,600,47,22,69,Monday
2014,10,20,500,21,23,44,Monday
2014,10,20,400,23,27,50,Monday
2014,10,20,300,19,35,54,Monday
2014,10,20,200,17,31,48,Monday
2014,10,20,100,26,44,70,Monday
2014,10,19,2400,37,77,114,Sunday
2014,10,19,2300,49,123,172,Sunday
2014,10,19,2200,66,169,235,Sunday
2014,10,19,2100,88,254,342,Sunday
2014,10,19,2000,118,419,537,Sunday
2014,10,19,1900,146,615,761,Sunday
2014,10,19,1800,189,696,885,Sunday
2014,10,19,1700,252,737,989,Sunday
2014,10,19,1600,294,758,1052,Sunday
2014,10,19,1500,365,632,997,Sunday
2014,10,19,1400,407,516,923,Sunday
2014,10,19,1300,503,388,891,Sunday
2014,10,19,1200,497,312,809,Sunday
2014,10,19,1100,448,202,650,Sunday
2014,10,19,1000,355,109,464,Sunday
2014,10,19,900,186,60,246,Sunday
2014,10,19,800,103,44,147,Sunday
2014,10,19,700,64,18,82,Sunday
2014,10,19,600,29,14,43,Sunday
2014,10,19,500,21,15,36,Sunday
2014,10,19,400,10,12,22,Sunday
2014,10,19,300,11,14,25,Sunday
2014,10,19,200,17,26,43,Sunday
2014,10,19,100,19,29,48,Sunday
2014,10,18,2400,38,50,88,Saturday
2014,10,18,2300,44,78,122,Saturday
2014,10,18,2200,76,112,188,Saturday
2014,10,18,2100,90,187,277,Saturday
2014,10,18,2000,109,225,334,Saturday
2014,10,18,1900,144,361,505,Saturday
2014,10,18,1800,183,496,679,Saturday
2014,10,18,1700,211,541,752,Saturday
2014,10,18,1600,304,516,820,Saturday
2014,10,18,1500,338,378,716,Saturday
2014,10,18,1400,424,343,767,Saturday
2014,10,18,1300,497,292,789,Saturday
2014,10,18,1200,540,234,774,Saturday
2014,10,18,1100,495,166,661,Saturday
2014,10,18,1000,381,119,500,Saturday
2014,10,18,900,250,87,337,Saturday
2014,10,18,800,128,41,169,Saturday
2014,10,18,700,65,45,110,Saturday
2014,10,18,600,42,27,69,Saturday
2014,10,18,500,19,29,48,Saturday
2014,10,18,400,27,21,48,Saturday
2014,10,18,300,20,37,57,Saturday
2014,10,18,200,25,19,44,Saturday
2014,10,18,100,40,63,103,Saturday
2014,10,17,2400,68,64,132,Friday
2014,10,17,2300,92,79,171,Friday
2014,10,17,2200,118,105,223,Friday
2014,10,17,2100,201,135,336,Friday
2014,10,17,2000,286,241,527,Friday
2014,10,17,1900,336,325,661,Friday
2014,10,17,1800,377,398,775,Friday
2014,10,17,1700,402,418,820,Friday
2014,10,17,1600,412,405,817,Friday
2014,10,17,1500,382,351,733,Friday
2014,10,17,1400,375,327,702,Friday
2014,10,17,1300,382,239,621,Friday
2014,10,17,1200,419,249,668,Friday
2014,10,17,1100,418,195,613,Friday
2014,10,17,1000,337,112,449,Friday
2014,10,17,900,222,90,312,Friday
2014,10,17,800,124,72,196,Friday
2014,10,17,700,84,45,129,Friday
2014,10,17,600,37,39,76,Friday
2014,10,17,500,25,39,64,Friday
2014,10,17,400,22,49,71,Friday
2014,10,17,300,34,24,58,Friday
2014,10,17,200,38,39,77,Friday
2014,10,17,100,61,45,106,Friday
2014,10,16,2400,64,78,142,Thursday
2014,10,16,2300,85,98,183,Thursday
2014,10,16,2200,101,122,223,Thursday
2014,10,16,2100,159,166,325,Thursday
2014,10,16,2000,185,223,408,Thursday
2014,10,16,1900,160,315,475,Thursday
2014,10,16,1800,238,359,597,Thursday
2014,10,16,1700,257,364,621,Thursday
2014,10,16,1600,285,365,650,Thursday
2014,10,16,1500,292,333,625,Thursday
2014,10,16,1400,292,241,533,Thursday
2014,10,16,1300,320,231,551,Thursday
2014,10,16,1200,342,204,546,Thursday
2014,10,16,1100,344,154,498,Thursday
2014,10,16,1000,284,138,422,Thursday
2014,10,16,900,219,92,311,Thursday
2014,10,16,800,125,72,197,Thursday
2014,10,16,700,87,46,133,Thursday
2014,10,16,600,38,29,67,Thursday
2014,10,16,500,28,34,62,Thursday
2014,10,16,400,25,30,55,Thursday
2014,10,16,300,21,32,53,Thursday
2014,10,16,200,22,42,64,Thursday
2014,10,16,100,37,52,89,Thursday
2014,10,15,2400,50,59,109,Wednesday
2014,10,15,2300,80,91,171,Wednesday
2014,10,15,2200,88,119,207,Wednesday
2014,10,15,2100,102,153,255,Wednesday
2014,10,15,2000,125,200,325,Wednesday
2014,10,15,1900,163,288,451,Wednesday
2014,10,15,1800,156,358,514,Wednesday
2014,10,15,1700,198,356,554,Wednesday
2014,10,15,1600,239,288,527,Wednesday
2014,10,15,1500,286,292,578,Wednesday
2014,10,15,1400,235,288,523,Wednesday
2014,10,15,1300,287,270,557,Wednesday
2014,10,15,1200,319,230,549,Wednesday
2014,10,15,1100,314,170,484,Wednesday
2014,10,15,1000,223,157,380,Wednesday
2014,10,15,900,197,105,302,Wednesday
2014,10,15,800,122,73,195,Wednesday
2014,10,15,700,75,49,124,Wednesday
2014,10,15,600,44,43,87,Wednesday
2014,10,15,500,21,34,55,Wednesday
2014,10,15,400,17,47,64,Wednesday
2014,10,15,300,16,44,60,Wednesday
2014,10,15,200,31,52,83,Wednesday
2014,10,15,100,51,58,109,Wednesday
2014,10,14,2400,66,84,150,Tuesday
2014,10,14,2300,58,98,156,Tuesday
2014,10,14,2200,87,166,253,Tuesday
2014,10,14,2100,109,215,324,Tuesday
2014,10,14,2000,137,337,474,Tuesday
2014,10,14,1900,143,494,637,Tuesday
2014,10,14,1800,173,571,744,Tuesday
2014,10,14,1700,254,595,849,Tuesday
2014,10,14,1600,244,524,768,Tuesday
2014,10,14,1500,282,491,773,Tuesday
2014,10,14,1400,378,416,794,Tuesday
2014,10,14,1300,443,358,801,Tuesday
2014,10,14,1200,442,286,728,Tuesday
2014,10,14,1100,447,247,694,Tuesday
2014,10,14,1000,383,142,525,Tuesday
2014,10,14,900,242,110,352,Tuesday
2014,10,14,800,145,82,227,Tuesday
2014,10,14,700,65,47,112,Tuesday
2014,10,14,600,34,30,64,Tuesday
2014,10,14,500,17,39,56,Tuesday
2014,10,14,400,19,23,42,Tuesday
2014,10,14,300,10,38,48,Tuesday
2014,10,14,200,17,50,67,Tuesday
2014,10,14,100,20,83,103,Tuesday
2014,10,13,2400,34,106,140,Monday
2014,10,13,2300,45,192,237,Monday
2014,10,13,2200,76,394,470,Monday
2014,10,13,2100,81,868,949,Monday
2014,10,13,2000,121,1171,1292,Monday
2014,10,13,1900,149,1471,1620,Monday
2014,10,13,1800,223,1631,1854,Monday
2014,10,13,1700,342,1985,2327,Monday
2014,10,13,1600,413,1810,2223,Monday
2014,10,13,1500,512,1703,2215,Monday
2014,10,13,1400,689,1421,2110,Monday
2014,10,13,1300,733,1197,1930,Monday
2014,10,13,1200,829,800,1629,Monday
2014,10,13,1100,654,413,1067,Monday
2014,10,13,1000,497,184,681,Monday
2014,10,13,900,296,111,407,Monday
2014,10,13,800,162,56,218,Monday
2014,10,13,700,83,23,106,Monday
2014,10,13,600,41,17,58,Monday
2014,10,13,500,19,20,39,Monday
2014,10,13,400,14,24,38,Monday
2014,10,13,300,11,24,35,Monday
2014,10,13,200,24,33,57,Monday
2014,10,13,100,31,49,80,Monday
2014,10,12,2400,45,76,121,Sunday
2014,10,12,2300,54,139,193,Sunday
2014,10,12,2200,73,184,257,Sunday
2014,10,12,2100,90,338,428,Sunday
2014,10,12,2000,103,485,588,Sunday
2014,10,12,1900,158,743,901,Sunday
2014,10,12,1800,199,812,1011,Sunday
2014,10,12,1700,275,939,1214,Sunday
2014,10,12,1600,328,876,1204,Sunday
2014,10,12,1500,451,672,1123,Sunday
2014,10,12,1400,514,549,1063,Sunday
2014,10,12,1300,694,467,1161,Sunday
2014,10,12,1200,725,360,1085,Sunday
2014,10,12,1100,681,210,891,Sunday
2014,10,12,1000,474,127,601,Sunday
2014,10,12,900,327,83,410,Sunday
2014,10,12,800,151,34,185,Sunday
2014,10,12,700,81,27,108,Sunday
2014,10,12,600,33,18,51,Sunday
2014,10,12,500,21,12,33,Sunday
2014,10,12,400,25,19,44,Sunday
2014,10,12,300,19,24,43,Sunday
2014,10,12,200,12,20,32,Sunday
2014,10,12,100,29,47,76,Sunday
2014,10,11,2400,44,69,113,Saturday
2014,10,11,2300,47,93,140,Saturday
2014,10,11,2200,104,114,218,Saturday
2014,10,11,2100,149,210,359,Saturday
2014,10,11,2000,172,315,487,Saturday
2014,10,11,1900,206,503,709,Saturday
2014,10,11,1800,292,741,1033,Saturday
2014,10,11,1700,395,632,1027,Saturday
2014,10,11,1600,583,660,1243,Saturday
2014,10,11,1500,728,536,1264,Saturday
2014,10,11,1400,764,411,1175,Saturday
2014,10,11,1300,1132,395,1527,Saturday
2014,10,11,1200,1323,364,1687,Saturday
2014,10,11,1100,880,247,1127,Saturday
2014,10,11,1000,804,154,958,Saturday
2014,10,11,900,564,86,650,Saturday
2014,10,11,800,314,56,370,Saturday
2014,10,11,700,141,32,173,Saturday
2014,10,11,600,64,36,100,Saturday
2014,10,11,500,37,28,65,Saturday
2014,10,11,400,34,34,68,Saturday
2014,10,11,300,25,28,53,Saturday
2014,10,11,200,45,43,88,Saturday
2014,10,11,100,77,64,141,Saturday
2014,10,10,2400,127,106,233,Friday
2014,10,10,2300,186,156,342,Friday
2014,10,10,2200,336,185,521,Friday
2014,10,10,2100,540,273,813,Friday
2014,10,10,2000,871,378,1249,Friday
2014,10,10,1900,1057,540,1597,Friday
2014,10,10,1800,1099,657,1756,Friday
2014,10,10,1700,1115,640,1755,Friday
2014,10,10,1600,1068,639,1707,Friday
2014,10,10,1500,1031,512,1543,Friday
2014,10,10,1400,883,418,1301,Friday
2014,10,10,1300,850,332,1182,Friday
2014,10,10,1200,924,311,1235,Friday
2014,10,10,1100,940,225,1165,Friday
2014,10,10,1000,740,144,884,Friday
2014,10,10,900,534,119,653,Friday
2014,10,10,800,286,78,364,Friday
2014,10,10,700,164,53,217,Friday
2014,10,10,600,79,41,120,Friday
2014,10,10,500,49,42,91,Friday
2014,10,10,400,40,43,83,Friday
2014,10,10,300,37,36,73,Friday
2014,10,10,200,52,44,96,Friday
2014,10,10,100,69,63,132,Friday
2014,10,9,2400,99,84,183,Thursday
2014,10,9,2300,147,116,263,Thursday
2014,10,9,2200,181,139,320,Thursday
2014,10,9,2100,325,229,554,Thursday
2014,10,9,2000,402,281,683,Thursday
2014,10,9,1900,460,439,899,Thursday
2014,10,9,1800,459,443,902,Thursday
2014,10,9,1700,493,480,973,Thursday
2014,10,9,1600,498,434,932,Thursday
2014,10,9,1500,478,467,945,Thursday
2014,10,9,1400,454,349,803,Thursday
2014,10,9,1300,432,272,704,Thursday
2014,10,9,1200,573,225,798,Thursday
2014,10,9,1100,491,208,699,Thursday
2014,10,9,1000,429,146,575,Thursday
2014,10,9,900,320,113,433,Thursday
2014,10,9,800,208,76,284,Thursday
2014,10,9,700,124,62,186,Thursday
2014,10,9,600,53,36,89,Thursday
2014,10,9,500,28,30,58,Thursday
2014,10,9,400,29,41,70,Thursday
2014,10,9,300,45,38,83,Thursday
2014,10,9,200,34,54,88,Thursday
2014,10,9,100,53,56,109,Thursday
2014,10,8,2400,59,71,130,Wednesday
2014,10,8,2300,82,85,167,Wednesday
2014,10,8,2200,102,112,214,Wednesday
2014,10,8,2100,149,156,305,Wednesday
2014,10,8,2000,191,217,408,Wednesday
2014,10,8,1900,179,308,487,Wednesday
2014,10,8,1800,231,395,626,Wednesday
2014,10,8,1700,254,375,629,Wednesday
2014,10,8,1600,275,415,690,Wednesday
2014,10,8,1500,316,296,612,Wednesday
2014,10,8,1400,314,288,602,Wednesday
2014,10,8,1300,347,230,577,Wednesday
2014,10,8,1200,359,228,587,Wednesday
2014,10,8,1100,385,162,547,Wednesday
2014,10,8,1000,338,107,445,Wednesday
2014,10,8,900,246,120,366,Wednesday
2014,10,8,800,156,70,226,Wednesday
2014,10,8,700,97,48,145,Wednesday
2014,10,8,600,42,38,80,Wednesday
2014,10,8,500,24,25,49,Wednesday
2014,10,8,400,30,38,68,Wednesday
2014,10,8,300,15,44,59,Wednesday
2014,10,8,200,31,36,67,Wednesday
2014,10,8,100,28,48,76,Wednesday
2014,10,7,2400,68,67,135,Tuesday
2014,10,7,2300,71,93,164,Tuesday
2014,10,7,2200,88,116,204,Tuesday
2014,10,7,2100,116,164,280,Tuesday
2014,10,7,2000,132,248,380,Tuesday
2014,10,7,1900,169,362,531,Tuesday
2014,10,7,1800,197,403,600,Tuesday
2014,10,7,1700,242,362,604,Tuesday
2014,10,7,1600,253,394,647,Tuesday
2014,10,7,1500,303,337,640,Tuesday
2014,10,7,1400,265,244,509,Tuesday
2014,10,7,1300,311,223,534,Tuesday
2014,10,7,1200,352,196,548,Tuesday
2014,10,7,1100,380,155,535,Tuesday
2014,10,7,1000,316,156,472,Tuesday
2014,10,7,900,200,123,323,Tuesday
2014,10,7,800,136,73,209,Tuesday
2014,10,7,700,76,52,128,Tuesday
2014,10,7,600,49,34,83,Tuesday
2014,10,7,500,22,36,58,Tuesday
2014,10,7,400,23,44,67,Tuesday
2014,10,7,300,18,37,55,Tuesday
2014,10,7,200,20,40,60,Tuesday
2014,10,7,100,40,74,114,Tuesday
2014,10,6,2400,51,81,132,Monday
2014,10,6,2300,83,86,169,Monday
2014,10,6,2200,90,123,213,Monday
2014,10,6,2100,136,177,313,Monday
2014,10,6,2000,146,278,424,Monday
2014,10,6,1900,166,411,577,Monday
2014,10,6,1800,225,530,755,Monday
2014,10,6,1700,246,548,794,Monday
2014,10,6,1600,300,458,758,Monday
2014,10,6,1500,323,308,631,Monday
2014,10,6,1400,304,338,642,Monday
2014,10,6,1300,415,250,665,Monday
2014,10,6,1200,452,225,677,Monday
2014,10,6,1100,452,163,615,Monday
2014,10,6,1000,384,111,495,Monday
2014,10,6,900,255,106,361,Monday
2014,10,6,800,157,78,235,Monday
2014,10,6,700,90,32,122,Monday
2014,10,6,600,42,35,77,Monday
2014,10,6,500,23,29,52,Monday
2014,10,6,400,31,27,58,Monday
2014,10,6,300,16,35,51,Monday
2014,10,6,200,31,36,67,Monday
2014,10,6,100,33,76,109,Monday
2014,10,5,2400,54,87,141,Sunday
2014,10,5,2300,59,126,185,Sunday
2014,10,5,2200,71,217,288,Sunday
2014,10,5,2100,106,354,460,Sunday
2014,10,5,2000,129,644,773,Sunday
2014,10,5,1900,172,836,1008,Sunday
2014,10,5,1800,221,1033,1254,Sunday
2014,10,5,1700,284,1004,1288,Sunday
2014,10,5,1600,359,979,1338,Sunday
2014,10,5,1500,379,723,1102,Sunday
2014,10,5,1400,469,638,1107,Sunday
2014,10,5,1300,525,562,1087,Sunday
2014,10,5,1200,615,404,1019,Sunday
2014,10,5,1100,562,231,793,Sunday
2014,10,5,1000,513,134,647,Sunday
2014,10,5,900,279,78,357,Sunday
2014,10,5,800,126,34,160,Sunday
2014,10,5,700,81,22,103,Sunday
2014,10,5,600,22,8,30,Sunday
2014,10,5,500,15,18,33,Sunday
2014,10,5,400,16,25,41,Sunday
2014,10,5,300,21,17,38,Sunday
2014,10,5,200,22,27,49,Sunday
2014,10,5,100,25,29,54,Sunday
2014,10,4,2400,37,62,99,Saturday
2014,10,4,2300,61,56,117,Saturday
2014,10,4,2200,75,125,200,Saturday
2014,10,4,2100,105,180,285,Saturday
2014,10,4,2000,131,385,516,Saturday
2014,10,4,1900,160,507,667,Saturday
2014,10,4,1800,222,718,940,Saturday
2014,10,4,1700,311,755,1066,Saturday
2014,10,4,1600,338,615,953,Saturday
2014,10,4,1500,396,477,873,Saturday
2014,10,4,1400,508,293,801,Saturday
2014,10,4,1300,643,296,939,Saturday
2014,10,4,1200,790,271,1061,Saturday
2014,10,4,1100,737,205,942,Saturday
2014,10,4,1000,616,145,761,Saturday
2014,10,4,900,402,117,519,Saturday
2014,10,4,800,182,54,236,Saturday
2014,10,4,700,90,39,129,Saturday
2014,10,4,600,44,19,63,Saturday
2014,10,4,500,26,21,47,Saturday
2014,10,4,400,14,29,43,Saturday
2014,10,4,300,27,17,44,Saturday
2014,10,4,200,26,24,50,Saturday
2014,10,4,100,37,43,80,Saturday
2014,10,3,2400,58,72,130,Friday
2014,10,3,2300,104,98,202,Friday
2014,10,3,2200,153,115,268,Friday
2014,10,3,2100,260,204,464,Friday
2014,10,3,2000,391,267,658,Friday
2014,10,3,1900,458,405,863,Friday
2014,10,3,1800,530,544,1074,Friday
2014,10,3,1700,546,515,1061,Friday
2014,10,3,1600,551,482,1033,Friday
2014,10,3,1500,554,435,989,Friday
2014,10,3,1400,460,390,850,Friday
2014,10,3,1300,524,303,827,Friday
2014,10,3,1200,573,324,897,Friday
2014,10,3,1100,565,191,756,Friday
2014,10,3,1000,463,148,611,Friday
2014,10,3,900,331,107,438,Friday
2014,10,3,800,185,69,254,Friday
2014,10,3,700,96,61,157,Friday
2014,10,3,600,61,28,89,Friday
2014,10,3,500,33,37,70,Friday
2014,10,3,400,30,26,56,Friday
2014,10,3,300,36,30,66,Friday
2014,10,3,200,37,52,89,Friday
2014,10,3,100,44,56,100,Friday
2014,10,2,2400,58,72,130,Thursday
2014,10,2,2300,88,84,172,Thursday
2014,10,2,2200,155,134,289,Thursday
2014,10,2,2100,193,202,395,Thursday
2014,10,2,2000,201,299,500,Thursday
2014,10,2,1900,220,407,627,Thursday
2014,10,2,1800,276,538,814,Thursday
2014,10,2,1700,336,354,690,Thursday
2014,10,2,1600,314,403,717,Thursday
2014,10,2,1500,352,380,732,Thursday
2014,10,2,1400,324,289,613,Thursday
2014,10,2,1300,379,263,642,Thursday
2014,10,2,1200,462,203,665,Thursday
2014,10,2,1100,462,168,630,Thursday
2014,10,2,1000,337,151,488,Thursday
2014,10,2,900,277,85,362,Thursday
2014,10,2,800,163,60,223,Thursday
2014,10,2,700,96,47,143,Thursday
2014,10,2,600,48,30,78,Thursday
2014,10,2,500,35,31,66,Thursday
2014,10,2,400,17,27,44,Thursday
2014,10,2,300,19,42,61,Thursday
2014,10,2,200,24,38,62,Thursday
2014,10,2,100,41,60,101,Thursday
2014,10,1,2400,62,66,128,Wednesday
2014,10,1,2300,83,96,179,Wednesday
2014,10,1,2200,106,113,219,Wednesday
2014,10,1,2100,132,173,305,Wednesday
2014,10,1,2000,173,255,428,Wednesday
2014,10,1,1900,192,368,560,Wednesday
2014,10,1,1800,195,512,707,Wednesday
2014,10,1,1700,252,522,774,Wednesday
2014,10,1,1600,307,409,716,Wednesday
2014,10,1,1500,352,322,674,Wednesday
2014,10,1,1400,319,268,587,Wednesday
2014,10,1,1300,375,247,622,Wednesday
2014,10,1,1200,471,254,725,Wednesday
2014,10,1,1100,488,198,686,Wednesday
2014,10,1,1000,414,120,534,Wednesday
2014,10,1,900,300,109,409,Wednesday
2014,10,1,800,172,68,240,Wednesday
2014,10,1,700,82,57,139,Wednesday
2014,10,1,600,45,40,85,Wednesday
2014,10,1,500,17,21,38,Wednesday
2014,10,1,400,21,28,49,Wednesday
2014,10,1,300,25,44,69,Wednesday
2014,10,1,200,37,48,85,Wednesday
2014,10,1,100,39,61,100,Wednesday
2014,9,30,2400,57,62,119,Tuesday
2014,9,30,2300,66,112,178,Tuesday
2014,9,30,2200,90,163,253,Tuesday
2014,9,30,2100,117,170,287,Tuesday
2014,9,30,2000,147,286,433,Tuesday
2014,9,30,1900,172,368,540,Tuesday
2014,9,30,1800,207,422,629,Tuesday
2014,9,30,1700,239,395,634,Tuesday
2014,9,30,1600,279,342,621,Tuesday
2014,9,30,1500,269,329,598,Tuesday
2014,9,30,1400,295,279,574,Tuesday
2014,9,30,1300,307,276,583,Tuesday
2014,9,30,1200,338,214,552,Tuesday
2014,9,30,1100,361,227,588,Tuesday
2014,9,30,1000,358,151,509,Tuesday
2014,9,30,900,273,112,385,Tuesday
2014,9,30,800,146,85,231,Tuesday
2014,9,30,700,89,62,151,Tuesday
2014,9,30,600,43,25,68,Tuesday
2014,9,30,500,29,34,63,Tuesday
2014,9,30,400,18,45,63,Tuesday
2014,9,30,300,21,40,61,Tuesday
2014,9,30,200,22,50,72,Tuesday
2014,9,30,100,41,58,99,Tuesday
2014,9,29,2400,46,64,110,Monday
2014,9,29,2300,75,112,187,Monday
2014,9,29,2200,88,140,228,Monday
2014,9,29,2100,156,241,397,Monday
2014,9,29,2000,136,346,482,Monday
2014,9,29,1900,176,515,691,Monday
2014,9,29,1800,192,733,925,Monday
2014,9,29,1700,254,609,863,Monday
2014,9,29,1600,317,535,852,Monday
2014,9,29,1500,355,369,724,Monday
2014,9,29,1400,370,382,752,Monday
2014,9,29,1300,414,311,725,Monday
2014,9,29,1200,555,284,839,Monday
2014,9,29,1100,509,213,722,Monday
2014,9,29,1000,436,158,594,Monday
2014,9,29,900,298,96,394,Monday
2014,9,29,800,168,83,251,Monday
2014,9,29,700,94,46,140,Monday
2014,9,29,600,60,27,87,Monday
2014,9,29,500,20,33,53,Monday
2014,9,29,400,22,20,42,Monday
2014,9,29,300,25,27,52,Monday
2014,9,29,200,20,44,64,Monday
2014,9,29,100,24,77,101,Monday
2014,9,28,2400,42,114,156,Sunday
2014,9,28,2300,61,199,260,Sunday
2014,9,28,2200,91,318,409,Sunday
2014,9,28,2100,121,521,642,Sunday
2014,9,28,2000,148,808,956,Sunday
2014,9,28,1900,196,1104,1300,Sunday
2014,9,28,1800,249,1422,1671,Sunday
2014,9,28,1700,322,1384,1706,Sunday
2014,9,28,1600,388,941,1329,Sunday
2014,9,28,1500,494,823,1317,Sunday
2014,9,28,1400,560,738,1298,Sunday
2014,9,28,1300,571,589,1160,Sunday
2014,9,28,1200,735,483,1218,Sunday
2014,9,28,1100,703,311,1014,Sunday
2014,9,28,1000,610,196,806,Sunday
2014,9,28,900,399,71,470,Sunday
2014,9,28,800,168,54,222,Sunday
2014,9,28,700,98,29,127,Sunday
2014,9,28,600,34,18,52,Sunday
2014,9,28,500,23,14,37,Sunday
2014,9,28,400,12,18,30,Sunday
2014,9,28,300,24,24,48,Sunday
2014,9,28,200,19,26,45,Sunday
2014,9,28,100,34,46,80,Sunday
2014,9,27,2400,41,57,98,Saturday
2014,9,27,2300,44,117,161,Saturday
2014,9,27,2200,84,161,245,Saturday
2014,9,27,2100,121,276,397,Saturday
2014,9,27,2000,146,464,610,Saturday
2014,9,27,1900,172,667,839,Saturday
2014,9,27,1800,231,757,988,Saturday
2014,9,27,1700,290,701,991,Saturday
2014,9,27,1600,434,580,1014,Saturday
2014,9,27,1500,426,509,935,Saturday
2014,9,27,1400,463,385,848,Saturday
2014,9,27,1300,637,301,938,Saturday
2014,9,27,1200,709,320,1029,Saturday
2014,9,27,1100,753,235,988,Saturday
2014,9,27,1000,700,165,865,Saturday
2014,9,27,900,572,97,669,Saturday
2014,9,27,800,256,64,320,Saturday
2014,9,27,700,110,50,160,Saturday
2014,9,27,600,48,26,74,Saturday
2014,9,27,500,26,20,46,Saturday
2014,9,27,400,19,23,42,Saturday
2014,9,27,300,23,27,50,Saturday
2014,9,27,200,35,23,58,Saturday
2014,9,27,100,41,57,98,Saturday
2014,9,26,2400,75,55,130,Friday
2014,9,26,2300,112,108,220,Friday
2014,9,26,2200,225,149,374,Friday
2014,9,26,2100,354,220,574,Friday
2014,9,26,2000,526,313,839,Friday
2014,9,26,1900,570,511,1081,Friday
2014,9,26,1800,607,630,1237,Friday
2014,9,26,1700,619,592,1211,Friday
2014,9,26,1600,654,537,1191,Friday
2014,9,26,1500,598,448,1046,Friday
2014,9,26,1400,577,459,1036,Friday
2014,9,26,1300,584,368,952,Friday
2014,9,26,1200,646,292,938,Friday
2014,9,26,1100,672,218,890,Friday
2014,9,26,1000,565,208,773,Friday
2014,9,26,900,404,95,499,Friday
2014,9,26,800,256,72,328,Friday
2014,9,26,700,119,73,192,Friday
2014,9,26,600,68,21,89,Friday
2014,9,26,500,28,31,59,Friday
2014,9,26,400,38,34,72,Friday
2014,9,26,300,25,37,62,Friday
2014,9,26,200,30,41,71,Friday
2014,9,26,100,63,60,123,Friday
2014,9,25,2400,71,85,156,Thursday
2014,9,25,2300,103,93,196,Thursday
2014,9,25,2200,153,164,317,Thursday
2014,9,25,2100,232,218,450,Thursday
2014,9,25,2000,274,353,627,Thursday
2014,9,25,1900,292,533,825,Thursday
2014,9,25,1800,331,599,930,Thursday
2014,9,25,1700,360,629,989,Thursday
2014,9,25,1600,370,542,912,Thursday
2014,9,25,1500,442,428,870,Thursday
2014,9,25,1400,403,344,747,Thursday
2014,9,25,1300,461,306,767,Thursday
2014,9,25,1200,544,289,833,Thursday
2014,9,25,1100,622,205,827,Thursday
2014,9,25,1000,469,183,652,Thursday
2014,9,25,900,370,106,476,Thursday
2014,9,25,800,198,67,265,Thursday
2014,9,25,700,124,68,192,Thursday
2014,9,25,600,50,38,88,Thursday
2014,9,25,500,23,33,56,Thursday
2014,9,25,400,27,37,64,Thursday
2014,9,25,300,29,26,55,Thursday
2014,9,25,200,40,52,92,Thursday
2014,9,25,100,58,61,119,Thursday
2014,9,24,2400,74,74,148,Wednesday
2014,9,24,2300,91,80,171,Wednesday
2014,9,24,2200,125,137,262,Wednesday
2014,9,24,2100,145,198,343,Wednesday
2014,9,24,2000,186,290,476,Wednesday
2014,9,24,1900,185,396,581,Wednesday
2014,9,24,1800,245,505,750,Wednesday
2014,9,24,1700,257,542,799,Wednesday
2014,9,24,1600,287,553,840,Wednesday
2014,9,24,1500,332,470,802,Wednesday
2014,9,24,1400,349,362,711,Wednesday
2014,9,24,1300,333,354,687,Wednesday
2014,9,24,1200,476,271,747,Wednesday
2014,9,24,1100,548,226,774,Wednesday
2014,9,24,1000,460,164,624,Wednesday
2014,9,24,900,333,114,447,Wednesday
2014,9,24,800,159,63,222,Wednesday
2014,9,24,700,94,52,146,Wednesday
2014,9,24,600,44,39,83,Wednesday
2014,9,24,500,18,28,46,Wednesday
2014,9,24,400,24,41,65,Wednesday
2014,9,24,300,18,33,51,Wednesday
2014,9,24,200,30,40,70,Wednesday
2014,9,24,100,37,50,87,Wednesday
2014,9,23,2400,52,56,108,Tuesday
2014,9,23,2300,78,114,192,Tuesday
2014,9,23,2200,90,114,204,Tuesday
2014,9,23,2100,143,201,344,Tuesday
2014,9,23,2000,158,331,489,Tuesday
2014,9,23,1900,160,508,668,Tuesday
2014,9,23,1800,196,523,719,Tuesday
2014,9,23,1700,257,535,792,Tuesday
2014,9,23,1600,277,467,744,Tuesday
2014,9,23,1500,293,430,723,Tuesday
2014,9,23,1400,339,365,704,Tuesday
2014,9,23,1300,398,335,733,Tuesday
2014,9,23,1200,451,314,765,Tuesday
2014,9,23,1100,442,242,684,Tuesday
2014,9,23,1000,387,197,584,Tuesday
2014,9,23,900,280,130,410,Tuesday
2014,9,23,800,169,83,252,Tuesday
2014,9,23,700,92,55,147,Tuesday
2014,9,23,600,44,43,87,Tuesday
2014,9,23,500,30,36,66,Tuesday
2014,9,23,400,14,45,59,Tuesday
2014,9,23,300,15,36,51,Tuesday
2014,9,23,200,26,64,90,Tuesday
2014,9,23,100,40,136,176,Tuesday
2014,9,22,2400,60,15,75,Monday
2014,9,22,2300,66,88,154,Monday
2014,9,22,2200,93,176,269,Monday
2014,9,22,2100,108,264,372,Monday
2014,9,22,2000,149,481,630,Monday
2014,9,22,1900,185,607,792,Monday
2014,9,22,1800,241,811,1052,Monday
2014,9,22,1700,304,704,1008,Monday
2014,9,22,1600,317,623,940,Monday
2014,9,22,1500,378,546,924,Monday
2014,9,22,1400,430,448,878,Monday
2014,9,22,1300,462,370,832,Monday
2014,9,22,1200,655,319,974,Monday
2014,9,22,1100,595,273,868,Monday
2014,9,22,1000,580,157,737,Monday
2014,9,22,900,376,131,507,Monday
2014,9,22,800,217,84,301,Monday
2014,9,22,700,117,61,178,Monday
2014,9,22,600,51,35,86,Monday
2014,9,22,500,14,20,34,Monday
2014,9,22,400,10,34,44,Monday
2014,9,22,300,25,29,54,Monday
2014,9,22,200,27,40,67,Monday
2014,9,22,100,32,75,107,Monday
2014,9,21,2400,45,134,179,Sunday
2014,9,21,2300,62,201,263,Sunday
2014,9,21,2200,78,307,385,Sunday
2014,9,21,2100,124,658,782,Sunday
2014,9,21,2000,146,1069,1215,Sunday
2014,9,21,1900,218,1300,1518,Sunday
2014,9,21,1800,305,1595,1900,Sunday
2014,9,21,1700,349,1498,1847,Sunday
2014,9,21,1600,478,1372,1850,Sunday
2014,9,21,1500,572,1095,1667,Sunday
2014,9,21,1400,649,979,1628,Sunday
2014,9,21,1300,770,917,1687,Sunday
2014,9,21,1200,845,702,1547,Sunday
2014,9,21,1100,889,475,1364,Sunday
2014,9,21,1000,845,254,1099,Sunday
2014,9,21,900,514,119,633,Sunday
2014,9,21,800,261,51,312,Sunday
2014,9,21,700,112,38,150,Sunday
2014,9,21,600,43,19,62,Sunday
2014,9,21,500,26,14,40,Sunday
2014,9,21,400,23,20,43,Sunday
2014,9,21,300,21,20,41,Sunday
2014,9,21,200,19,38,57,Sunday
2014,9,21,100,27,37,64,Sunday
2014,9,20,2400,47,69,116,Saturday
2014,9,20,2300,60,127,187,Saturday
2014,9,20,2200,104,222,326,Saturday
2014,9,20,2100,121,426,547,Saturday
2014,9,20,2000,156,777,933,Saturday
2014,9,20,1900,194,986,1180,Saturday
2014,9,20,1800,245,993,1238,Saturday
2014,9,20,1700,353,923,1276,Saturday
2014,9,20,1600,405,725,1130,Saturday
2014,9,20,1500,488,631,1119,Saturday
2014,9,20,1400,700,471,1171,Saturday
2014,9,20,1300,804,454,1258,Saturday
2014,9,20,1200,922,429,1351,Saturday
2014,9,20,1100,1094,278,1372,Saturday
2014,9,20,1000,968,125,1093,Saturday
2014,9,20,900,717,121,838,Saturday
2014,9,20,800,319,60,379,Saturday
2014,9,20,700,129,48,177,Saturday
2014,9,20,600,51,36,87,Saturday
2014,9,20,500,23,25,48,Saturday
2014,9,20,400,21,31,52,Saturday
2014,9,20,300,27,31,58,Saturday
2014,9,20,200,30,41,71,Saturday
2014,9,20,100,51,45,96,Saturday
2014,9,19,2400,79,85,164,Friday
2014,9,19,2300,112,91,203,Friday
2014,9,19,2200,244,158,402,Friday
2014,9,19,2100,425,272,697,Friday
2014,9,19,2000,605,343,948,Friday
2014,9,19,1900,659,448,1107,Friday
2014,9,19,1800,696,756,1452,Friday
2014,9,19,1700,731,659,1390,Friday
2014,9,19,1600,784,588,1372,Friday
2014,9,19,1500,765,504,1269,Friday
2014,9,19,1400,797,476,1273,Friday
2014,9,19,1300,800,347,1147,Friday
2014,9,19,1200,834,337,1171,Friday
2014,9,19,1100,778,263,1041,Friday
2014,9,19,1000,625,178,803,Friday
2014,9,19,900,544,140,684,Friday
2014,9,19,800,279,85,364,Friday
2014,9,19,700,144,65,209,Friday
2014,9,19,600,76,44,120,Friday
2014,9,19,500,24,33,57,Friday
2014,9,19,400,26,27,53,Friday
2014,9,19,300,30,46,76,Friday
2014,9,19,200,34,46,80,Friday
2014,9,19,100,53,43,96,Friday
2014,9,18,2400,82,69,151,Thursday
2014,9,18,2300,114,118,232,Thursday
2014,9,18,2200,147,163,310,Thursday
2014,9,18,2100,255,209,464,Thursday
2014,9,18,2000,282,384,666,Thursday
2014,9,18,1900,395,808,1203,Thursday
2014,9,18,1800,379,538,917,Thursday
2014,9,18,1700,399,557,956,Thursday
2014,9,18,1600,438,453,891,Thursday
2014,9,18,1500,512,528,1040,Thursday
2014,9,18,1400,495,344,839,Thursday
2014,9,18,1300,541,385,926,Thursday
2014,9,18,1200,634,265,899,Thursday
2014,9,18,1100,702,240,942,Thursday
2014,9,18,1000,615,152,767,Thursday
2014,9,18,900,403,117,520,Thursday
2014,9,18,800,239,91,330,Thursday
2014,9,18,700,124,53,177,Thursday
2014,9,18,600,48,29,77,Thursday
2014,9,18,500,25,31,56,Thursday
2014,9,18,400,26,42,68,Thursday
2014,9,18,300,34,29,63,Thursday
2014,9,18,200,28,43,71,Thursday
2014,9,18,100,46,58,104,Thursday
2014,9,17,2400,63,72,135,Wednesday
2014,9,17,2300,77,134,211,Wednesday
2014,9,17,2200,122,145,267,Wednesday
2014,9,17,2100,152,253,405,Wednesday
2014,9,17,2000,204,420,624,Wednesday
2014,9,17,1900,225,598,823,Wednesday
2014,9,17,1800,250,737,987,Wednesday
2014,9,17,1700,281,555,836,Wednesday
2014,9,17,1600,329,499,828,Wednesday
2014,9,17,1500,357,442,799,Wednesday
2014,9,17,1400,376,321,697,Wednesday
2014,9,17,1300,408,337,745,Wednesday
2014,9,17,1200,526,256,782,Wednesday
2014,9,17,1100,597,205,802,Wednesday
2014,9,17,1000,510,170,680,Wednesday
2014,9,17,900,371,127,498,Wednesday
2014,9,17,800,191,72,263,Wednesday
2014,9,17,700,102,55,157,Wednesday
2014,9,17,600,56,37,93,Wednesday
2014,9,17,500,30,34,64,Wednesday
2014,9,17,400,20,44,64,Wednesday
2014,9,17,300,26,41,67,Wednesday
2014,9,17,200,25,44,69,Wednesday
2014,9,17,100,53,56,109,Wednesday
2014,9,16,2400,58,86,144,Tuesday
2014,9,16,2300,83,112,195,Tuesday
2014,9,16,2200,101,184,285,Tuesday
2014,9,16,2100,125,355,480,Tuesday
2014,9,16,2000,152,456,608,Tuesday
2014,9,16,1900,181,513,694,Tuesday
2014,9,16,1800,196,778,974,Tuesday
2014,9,16,1700,278,628,906,Tuesday
2014,9,16,1600,309,472,781,Tuesday
2014,9,16,1500,332,391,723,Tuesday
2014,9,16,1400,322,342,664,Tuesday
2014,9,16,1300,441,279,720,Tuesday
2014,9,16,1200,556,282,838,Tuesday
2014,9,16,1100,603,213,816,Tuesday
2014,9,16,1000,540,166,706,Tuesday
2014,9,16,900,383,115,498,Tuesday
2014,9,16,800,187,77,264,Tuesday
2014,9,16,700,100,61,161,Tuesday
2014,9,16,600,41,29,70,Tuesday
2014,9,16,500,36,47,83,Tuesday
2014,9,16,400,19,36,55,Tuesday
2014,9,16,300,23,41,64,Tuesday
2014,9,16,200,21,53,74,Tuesday
2014,9,16,100,46,59,105,Tuesday
2014,9,15,2400,64,87,151,Monday
2014,9,15,2300,79,126,205,Monday
2014,9,15,2200,121,193,314,Monday
2014,9,15,2100,136,302,438,Monday
2014,9,15,2000,165,507,672,Monday
2014,9,15,1900,175,649,824,Monday
2014,9,15,1800,253,755,1008,Monday
2014,9,15,1700,268,725,993,Monday
2014,9,15,1600,349,605,954,Monday
2014,9,15,1500,420,475,895,Monday
2014,9,15,1400,455,390,845,Monday
2014,9,15,1300,512,344,856,Monday
2014,9,15,1200,667,282,949,Monday
2014,9,15,1100,774,237,1011,Monday
2014,9,15,1000,577,182,759,Monday
2014,9,15,900,436,111,547,Monday
2014,9,15,800,196,80,276,Monday
2014,9,15,700,89,49,138,Monday
2014,9,15,600,32,25,57,Monday
2014,9,15,500,22,26,48,Monday
2014,9,15,400,14,19,33,Monday
2014,9,15,300,18,27,45,Monday
2014,9,15,200,24,48,72,Monday
2014,9,15,100,38,80,118,Monday
2014,9,14,2400,34,108,142,Sunday
2014,9,14,2300,74,191,265,Sunday
2014,9,14,2200,91,301,392,Sunday
2014,9,14,2100,107,750,857,Sunday
2014,9,14,2000,144,1458,1602,Sunday
2014,9,14,1900,212,890,1102,Sunday
2014,9,14,1800,270,869,1139,Sunday
2014,9,14,1700,366,592,958,Sunday
2014,9,14,1600,392,694,1086,Sunday
2014,9,14,1500,445,795,1240,Sunday
2014,9,14,1400,515,669,1184,Sunday
2014,9,14,1300,654,641,1295,Sunday
2014,9,14,1200,747,504,1251,Sunday
2014,9,14,1100,777,374,1151,Sunday
2014,9,14,1000,693,183,876,Sunday
2014,9,14,900,423,81,504,Sunday
2014,9,14,800,159,50,209,Sunday
2014,9,14,700,104,32,136,Sunday
2014,9,14,600,47,16,63,Sunday
2014,9,14,500,20,8,28,Sunday
2014,9,14,400,15,24,39,Sunday
2014,9,14,300,28,27,55,Sunday
2014,9,14,200,18,41,59,Sunday
2014,9,14,100,34,76,110,Sunday
2014,9,13,2400,52,94,146,Saturday
2014,9,13,2300,82,115,197,Saturday
2014,9,13,2200,91,191,282,Saturday
2014,9,13,2100,93,328,421,Saturday
2014,9,13,2000,136,469,605,Saturday
2014,9,13,1900,185,663,848,Saturday
2014,9,13,1800,222,693,915,Saturday
2014,9,13,1700,337,687,1024,Saturday
2014,9,13,1600,415,700,1115,Saturday
2014,9,13,1500,490,490,980,Saturday
2014,9,13,1400,558,410,968,Saturday
2014,9,13,1300,646,399,1045,Saturday
2014,9,13,1200,778,335,1113,Saturday
2014,9,13,1100,781,258,1039,Saturday
2014,9,13,1000,632,154,786,Saturday
2014,9,13,900,414,90,504,Saturday
2014,9,13,800,265,54,319,Saturday
2014,9,13,700,120,36,156,Saturday
2014,9,13,600,54,28,82,Saturday
2014,9,13,500,21,21,42,Saturday
2014,9,13,400,19,44,63,Saturday
2014,9,13,300,20,31,51,Saturday
2014,9,13,200,37,30,67,Saturday
2014,9,13,100,43,56,99,Saturday
2014,9,12,2400,77,63,140,Friday
2014,9,12,2300,94,79,173,Friday
2014,9,12,2200,209,163,372,Friday
2014,9,12,2100,354,239,593,Friday
2014,9,12,2000,549,378,927,Friday
2014,9,12,1900,484,532,1016,Friday
2014,9,12,1800,596,643,1239,Friday
2014,9,12,1700,544,612,1156,Friday
2014,9,12,1600,574,627,1201,Friday
2014,9,12,1500,574,538,1112,Friday
2014,9,12,1400,563,449,1012,Friday
2014,9,12,1300,587,489,1076,Friday
2014,9,12,1200,719,355,1074,Friday
2014,9,12,1100,773,242,1015,Friday
2014,9,12,1000,645,170,815,Friday
2014,9,12,900,484,100,584,Friday
2014,9,12,800,217,75,292,Friday
2014,9,12,700,114,49,163,Friday
2014,9,12,600,55,28,83,Friday
2014,9,12,500,31,30,61,Friday
2014,9,12,400,30,43,73,Friday
2014,9,12,300,23,34,57,Friday
2014,9,12,200,30,35,65,Friday
2014,9,12,100,55,51,106,Friday
2014,9,11,2400,67,103,170,Thursday
2014,9,11,2300,112,119,231,Thursday
2014,9,11,2200,150,184,334,Thursday
2014,9,11,2100,235,314,549,Thursday
2014,9,11,2000,247,436,683,Thursday
2014,9,11,1900,345,709,1054,Thursday
2014,9,11,1800,328,675,1003,Thursday
2014,9,11,1700,342,541,883,Thursday
2014,9,11,1600,465,569,1034,Thursday
2014,9,11,1500,533,440,973,Thursday
2014,9,11,1400,517,321,838,Thursday
2014,9,11,1300,573,314,887,Thursday
2014,9,11,1200,690,326,1016,Thursday
2014,9,11,1100,668,282,950,Thursday
2014,9,11,1000,609,179,788,Thursday
2014,9,11,900,457,122,579,Thursday
2014,9,11,800,210,69,279,Thursday
2014,9,11,700,93,52,145,Thursday
2014,9,11,600,42,40,82,Thursday
2014,9,11,500,19,32,51,Thursday
2014,9,11,400,25,31,56,Thursday
2014,9,11,300,25,30,55,Thursday
2014,9,11,200,30,40,70,Thursday
2014,9,11,100,44,56,100,Thursday
2014,9,10,2400,56,57,113,Wednesday
2014,9,10,2300,100,90,190,Wednesday
2014,9,10,2200,102,135,237,Wednesday
2014,9,10,2100,111,166,277,Wednesday
2014,9,10,2000,153,247,400,Wednesday
2014,9,10,1900,187,353,540,Wednesday
2014,9,10,1800,211,416,627,Wednesday
2014,9,10,1700,260,416,676,Wednesday
2014,9,10,1600,291,374,665,Wednesday
2014,9,10,1500,315,329,644,Wednesday
2014,9,10,1400,312,259,571,Wednesday
2014,9,10,1300,392,238,630,Wednesday
2014,9,10,1200,482,240,722,Wednesday
2014,9,10,1100,302,187,489,Wednesday
2014,9,10,1000,215,138,353,Wednesday
2014,9,10,900,163,94,257,Wednesday
2014,9,10,800,77,80,157,Wednesday
2014,9,10,700,51,48,99,Wednesday
2014,9,10,600,25,36,61,Wednesday
2014,9,10,500,13,22,35,Wednesday
2014,9,10,400,15,29,44,Wednesday
2014,9,10,300,24,33,57,Wednesday
2014,9,10,200,26,39,65,Wednesday
2014,9,10,100,31,59,90,Wednesday
2014,9,9,2400,68,52,120,Tuesday
2014,9,9,2300,81,107,188,Tuesday
2014,9,9,2200,97,130,227,Tuesday
2014,9,9,2100,130,187,317,Tuesday
2014,9,9,2000,174,291,465,Tuesday
2014,9,9,1900,170,416,586,Tuesday
2014,9,9,1800,228,519,747,Tuesday
2014,9,9,1700,262,444,706,Tuesday
2014,9,9,1600,378,463,841,Tuesday
2014,9,9,1500,356,384,740,Tuesday
2014,9,9,1400,334,344,678,Tuesday
2014,9,9,1300,396,289,685,Tuesday
2014,9,9,1200,464,282,746,Tuesday
2014,9,9,1100,529,203,732,Tuesday
2014,9,9,1000,399,159,558,Tuesday
2014,9,9,900,292,92,384,Tuesday
2014,9,9,800,137,63,200,Tuesday
2014,9,9,700,82,47,129,Tuesday
2014,9,9,600,39,49,88,Tuesday
2014,9,9,500,26,32,58,Tuesday
2014,9,9,400,14,35,49,Tuesday
2014,9,9,300,21,43,64,Tuesday
2014,9,9,200,24,54,78,Tuesday
2014,9,9,100,46,63,109,Tuesday
2014,9,8,2400,49,79,128,Monday
2014,9,8,2300,77,121,198,Monday
2014,9,8,2200,87,160,247,Monday
2014,9,8,2100,113,223,336,Monday
2014,9,8,2000,137,350,487,Monday
2014,9,8,1900,168,438,606,Monday
2014,9,8,1800,220,733,953,Monday
2014,9,8,1700,231,574,805,Monday
2014,9,8,1600,305,623,928,Monday
2014,9,8,1500,411,525,936,Monday
2014,9,8,1400,404,458,862,Monday
2014,9,8,1300,463,454,917,Monday
2014,9,8,1200,620,402,1022,Monday
2014,9,8,1100,620,305,925,Monday
2014,9,8,1000,482,203,685,Monday
2014,9,8,900,335,119,454,Monday
2014,9,8,800,190,83,273,Monday
2014,9,8,700,90,62,152,Monday
2014,9,8,600,41,29,70,Monday
2014,9,8,500,22,21,43,Monday
2014,9,8,400,21,27,48,Monday
2014,9,8,300,22,31,53,Monday
2014,9,8,200,20,59,79,Monday
2014,9,8,100,30,68,98,Monday
2014,9,7,2400,48,127,175,Sunday
2014,9,7,2300,74,240,314,Sunday
2014,9,7,2200,108,406,514,Sunday
2014,9,7,2100,114,928,1042,Sunday
2014,9,7,2000,123,997,1120,Sunday
2014,9,7,1900,198,1386,1584,Sunday
2014,9,7,1800,266,1499,1765,Sunday
2014,9,7,1700,344,1467,1811,Sunday
2014,9,7,1600,468,1225,1693,Sunday
2014,9,7,1500,520,926,1446,Sunday
2014,9,7,1400,636,815,1451,Sunday
2014,9,7,1300,753,729,1482,Sunday
2014,9,7,1200,881,575,1456,Sunday
2014,9,7,1100,901,371,1272,Sunday
2014,9,7,1000,813,221,1034,Sunday
2014,9,7,900,494,113,607,Sunday
2014,9,7,800,216,63,279,Sunday
2014,9,7,700,109,25,134,Sunday
2014,9,7,600,45,12,57,Sunday
2014,9,7,500,16,17,33,Sunday
2014,9,7,400,19,18,37,Sunday
2014,9,7,300,23,30,53,Sunday
2014,9,7,200,23,35,58,Sunday
2014,9,7,100,25,57,82,Sunday
2014,9,6,2400,53,117,170,Saturday
2014,9,6,2300,98,151,249,Saturday
2014,9,6,2200,96,312,408,Saturday
2014,9,6,2100,122,549,671,Saturday
2014,9,6,2000,169,925,1094,Saturday
2014,9,6,1900,210,883,1093,Saturday
2014,9,6,1800,271,1013,1284,Saturday
2014,9,6,1700,369,832,1201,Saturday
2014,9,6,1600,416,787,1203,Saturday
2014,9,6,1500,558,548,1106,Saturday
2014,9,6,1400,668,473,1141,Saturday
2014,9,6,1300,870,476,1346,Saturday
2014,9,6,1200,954,370,1324,Saturday
2014,9,6,1100,1044,254,1298,Saturday
2014,9,6,1000,886,170,1056,Saturday
2014,9,6,900,588,87,675,Saturday
2014,9,6,800,333,90,423,Saturday
2014,9,6,700,146,55,201,Saturday
2014,9,6,600,39,29,68,Saturday
2014,9,6,500,25,20,45,Saturday
2014,9,6,400,16,28,44,Saturday
2014,9,6,300,25,38,63,Saturday
2014,9,6,200,31,43,74,Saturday
2014,9,6,100,44,85,129,Saturday
2014,9,5,2400,88,78,166,Friday
2014,9,5,2300,135,131,266,Friday
2014,9,5,2200,224,206,430,Friday
2014,9,5,2100,390,331,721,Friday
2014,9,5,2000,566,681,1247,Friday
2014,9,5,1900,623,738,1361,Friday
2014,9,5,1800,695,791,1486,Friday
2014,9,5,1700,635,701,1336,Friday
2014,9,5,1600,627,598,1225,Friday
2014,9,5,1500,676,578,1254,Friday
2014,9,5,1400,670,416,1086,Friday
2014,9,5,1300,658,408,1066,Friday
2014,9,5,1200,789,330,1119,Friday
2014,9,5,1100,876,234,1110,Friday
2014,9,5,1000,758,150,908,Friday
2014,9,5,900,501,109,610,Friday
2014,9,5,800,276,70,346,Friday
2014,9,5,700,146,44,190,Friday
2014,9,5,600,50,38,88,Friday
2014,9,5,500,38,37,75,Friday
2014,9,5,400,25,50,75,Friday
2014,9,5,300,30,37,67,Friday
2014,9,5,200,32,42,74,Friday
2014,9,5,100,73,66,139,Friday
2014,9,4,2400,64,160,224,Thursday
2014,9,4,2300,95,156,251,Thursday
2014,9,4,2200,180,81,261,Thursday
2014,9,4,2100,214,297,511,Thursday
2014,9,4,2000,294,461,755,Thursday
2014,9,4,1900,314,616,930,Thursday
2014,9,4,1800,332,810,1142,Thursday
2014,9,4,1700,370,629,999,Thursday
2014,9,4,1600,384,617,1001,Thursday
2014,9,4,1500,422,535,957,Thursday
2014,9,4,1400,500,401,901,Thursday
2014,9,4,1300,581,336,917,Thursday
2014,9,4,1200,697,287,984,Thursday
2014,9,4,1100,783,259,1042,Thursday
2014,9,4,1000,689,158,847,Thursday
2014,9,4,900,510,113,623,Thursday
2014,9,4,800,234,90,324,Thursday
2014,9,4,700,120,43,163,Thursday
2014,9,4,600,46,39,85,Thursday
2014,9,4,500,24,31,55,Thursday
2014,9,4,400,28,39,67,Thursday
2014,9,4,300,23,36,59,Thursday
2014,9,4,200,41,48,89,Thursday
2014,9,4,100,48,79,127,Thursday
2014,9,3,2400,72,71,143,Wednesday
2014,9,3,2300,81,110,191,Wednesday
2014,9,3,2200,129,216,345,Wednesday
2014,9,3,2100,159,309,468,Wednesday
2014,9,3,2000,191,478,669,Wednesday
2014,9,3,1900,225,557,782,Wednesday
2014,9,3,1800,242,706,948,Wednesday
2014,9,3,1700,333,662,995,Wednesday
2014,9,3,1600,363,578,941,Wednesday
2014,9,3,1500,415,482,897,Wednesday
2014,9,3,1400,419,371,790,Wednesday
2014,9,3,1300,445,326,771,Wednesday
2014,9,3,1200,554,325,879,Wednesday
2014,9,3,1100,558,248,806,Wednesday
2014,9,3,1000,520,175,695,Wednesday
2014,9,3,900,349,135,484,Wednesday
2014,9,3,800,181,82,263,Wednesday
2014,9,3,700,92,63,155,Wednesday
2014,9,3,600,34,32,66,Wednesday
2014,9,3,500,15,40,55,Wednesday
2014,9,3,400,20,34,54,Wednesday
2014,9,3,300,23,36,59,Wednesday
2014,9,3,200,32,59,91,Wednesday
2014,9,3,100,40,83,123,Wednesday
2014,9,2,2400,80,108,188,Tuesday
2014,9,2,2300,81,175,256,Tuesday
2014,9,2,2200,118,243,361,Tuesday
2014,9,2,2100,151,373,524,Tuesday
2014,9,2,2000,178,565,743,Tuesday
2014,9,2,1900,212,857,1069,Tuesday
2014,9,2,1800,246,704,950,Tuesday
2014,9,2,1700,334,820,1154,Tuesday
2014,9,2,1600,412,786,1198,Tuesday
2014,9,2,1500,480,744,1224,Tuesday
2014,9,2,1400,461,646,1107,Tuesday
2014,9,2,1300,551,545,1096,Tuesday
2014,9,2,1200,648,466,1114,Tuesday
2014,9,2,1100,661,384,1045,Tuesday
2014,9,2,1000,592,292,884,Tuesday
2014,9,2,900,391,177,568,Tuesday
2014,9,2,800,230,114,344,Tuesday
2014,9,2,700,102,79,181,Tuesday
2014,9,2,600,42,43,85,Tuesday
2014,9,2,500,25,38,63,Tuesday
2014,9,2,400,14,45,59,Tuesday
2014,9,2,300,13,54,67,Tuesday
2014,9,2,200,19,107,126,Tuesday
2014,9,2,100,28,139,167,Tuesday
2014,9,1,2400,43,452,495,Monday
2014,9,1,2300,62,706,768,Monday
2014,9,1,2200,102,935,1037,Monday
2014,9,1,2100,125,1067,1192,Monday
2014,9,1,2000,165,1348,1513,Monday
2014,9,1,1900,205,1650,1855,Monday
2014,9,1,1800,277,1873,2150,Monday
2014,9,1,1700,390,2048,2438,Monday
2014,9,1,1600,522,2212,2734,Monday
2014,9,1,1500,579,1985,2564,Monday
2014,9,1,1400,726,1934,2660,Monday
2014,9,1,1300,861,1734,2595,Monday
2014,9,1,1200,974,1293,2267,Monday
2014,9,1,1100,959,797,1756,Monday
2014,9,1,1000,823,440,1263,Monday
2014,9,1,900,532,194,726,Monday
2014,9,1,800,286,89,375,Monday
2014,9,1,700,151,75,226,Monday
2014,9,1,600,59,14,73,Monday
2014,9,1,500,30,25,55,Monday
2014,9,1,400,22,58,80,Monday
2014,9,1,300,25,57,82,Monday
2014,9,1,200,27,86,113,Monday
2014,9,1,100,36,128,164,Monday
2014,8,31,2400,45,245,290,Sunday
2014,8,31,2300,83,391,474,Sunday
2014,8,31,2200,100,639,739,Sunday
2014,8,31,2100,172,1138,1310,Sunday
2014,8,31,2000,218,1454,1672,Sunday
2014,8,31,1900,291,1733,2024,Sunday
2014,8,31,1800,326,1750,2076,Sunday
2014,8,31,1700,493,1604,2097,Sunday
2014,8,31,1600,640,1386,2026,Sunday
2014,8,31,1500,794,1415,2209,Sunday
2014,8,31,1400,1045,1027,2072,Sunday
2014,8,31,1300,1193,820,2013,Sunday
2014,8,31,1200,1215,642,1857,Sunday
2014,8,31,1100,1235,371,1606,Sunday
2014,8,31,1000,1011,248,1259,Sunday
2014,8,31,900,626,130,756,Sunday
2014,8,31,800,293,71,364,Sunday
2014,8,31,700,142,37,179,Sunday
2014,8,31,600,40,21,61,Sunday
2014,8,31,500,20,31,51,Sunday
2014,8,31,400,9,33,42,Sunday
2014,8,31,300,19,40,59,Sunday
2014,8,31,200,26,69,95,Sunday
2014,8,31,100,55,91,146,Sunday
2014,8,30,2400,71,187,258,Saturday
2014,8,30,2300,86,339,425,Saturday
2014,8,30,2200,174,452,626,Saturday
2014,8,30,2100,167,702,869,Saturday
2014,8,30,2000,290,937,1227,Saturday
2014,8,30,1900,351,969,1320,Saturday
2014,8,30,1800,463,1088,1551,Saturday
2014,8,30,1700,613,1122,1735,Saturday
2014,8,30,1600,788,972,1760,Saturday
2014,8,30,1500,941,821,1762,Saturday
2014,8,30,1400,1172,755,1927,Saturday
2014,8,30,1300,1315,558,1873,Saturday
2014,8,30,1200,1529,452,1981,Saturday
2014,8,30,1100,1583,360,1943,Saturday
2014,8,30,1000,1272,183,1455,Saturday
2014,8,30,900,852,129,981,Saturday
2014,8,30,800,529,60,589,Saturday
2014,8,30,700,246,60,306,Saturday
2014,8,30,600,104,45,149,Saturday
2014,8,30,500,39,38,77,Saturday
2014,8,30,400,48,46,94,Saturday
2014,8,30,300,40,41,81,Saturday
2014,8,30,200,62,59,121,Saturday
2014,8,30,100,101,94,195,Saturday
2014,8,29,2400,152,125,277,Friday
2014,8,29,2300,287,205,492,Friday
2014,8,29,2200,488,257,745,Friday
2014,8,29,2100,740,465,1205,Friday
2014,8,29,2000,1173,646,1819,Friday
2014,8,29,1900,1231,1111,2342,Friday
2014,8,29,1800,1304,1073,2377,Friday
2014,8,29,1700,1277,1093,2370,Friday
2014,8,29,1600,1320,888,2208,Friday
2014,8,29,1500,1158,745,1903,Friday
2014,8,29,1400,1073,637,1710,Friday
2014,8,29,1300,1230,548,1778,Friday
2014,8,29,1200,1279,459,1738,Friday
2014,8,29,1100,1246,325,1571,Friday
2014,8,29,1000,1066,198,1264,Friday
2014,8,29,900,809,124,933,Friday
2014,8,29,800,484,97,581,Friday
2014,8,29,700,254,63,317,Friday
2014,8,29,600,113,57,170,Friday
2014,8,29,500,43,50,93,Friday
2014,8,29,400,39,47,86,Friday
2014,8,29,300,42,52,94,Friday
2014,8,29,200,53,55,108,Friday
2014,8,29,100,74,71,145,Friday
2014,8,28,2400,127,103,230,Thursday
2014,8,28,2300,208,197,405,Thursday
2014,8,28,2200,312,307,619,Thursday
2014,8,28,2100,415,486,901,Thursday
2014,8,28,2000,695,593,1288,Thursday
2014,8,28,1900,717,740,1457,Thursday
2014,8,28,1800,701,767,1468,Thursday
2014,8,28,1700,676,781,1457,Thursday
2014,8,28,1600,710,801,1511,Thursday
2014,8,28,1500,749,676,1425,Thursday
2014,8,28,1400,731,630,1361,Thursday
2014,8,28,1300,778,619,1397,Thursday
2014,8,28,1200,962,578,1540,Thursday
2014,8,28,1100,1024,388,1412,Thursday
2014,8,28,1000,783,224,1007,Thursday
2014,8,28,900,585,138,723,Thursday
2014,8,28,800,366,103,469,Thursday
2014,8,28,700,182,77,259,Thursday
2014,8,28,600,81,45,126,Thursday
2014,8,28,500,39,48,87,Thursday
2014,8,28,400,34,52,86,Thursday
2014,8,28,300,32,50,82,Thursday
2014,8,28,200,45,61,106,Thursday
2014,8,28,100,75,98,173,Thursday
2014,8,27,2400,87,123,210,Wednesday
2014,8,27,2300,131,166,297,Wednesday
2014,8,27,2200,188,328,516,Wednesday
2014,8,27,2100,260,462,722,Wednesday
2014,8,27,2000,348,705,1053,Wednesday
2014,8,27,1900,368,938,1306,Wednesday
2014,8,27,1800,390,913,1303,Wednesday
2014,8,27,1700,491,947,1438,Wednesday
2014,8,27,1600,533,772,1305,Wednesday
2014,8,27,1500,561,640,1201,Wednesday
2014,8,27,1400,626,556,1182,Wednesday
2014,8,27,1300,822,468,1290,Wednesday
2014,8,27,1200,865,400,1265,Wednesday
2014,8,27,1100,934,289,1223,Wednesday
2014,8,27,1000,798,204,1002,Wednesday
2014,8,27,900,582,150,732,Wednesday
2014,8,27,800,294,99,393,Wednesday
2014,8,27,700,129,60,189,Wednesday
2014,8,27,600,66,38,104,Wednesday
2014,8,27,500,24,39,63,Wednesday
2014,8,27,400,34,42,76,Wednesday
2014,8,27,300,24,44,68,Wednesday
2014,8,27,200,32,51,83,Wednesday
2014,8,27,100,48,82,130,Wednesday
2014,8,26,2400,85,113,198,Tuesday
2014,8,26,2300,108,206,314,Tuesday
2014,8,26,2200,151,327,478,Tuesday
2014,8,26,2100,191,489,680,Tuesday
2014,8,26,2000,226,633,859,Tuesday
2014,8,26,1900,272,967,1239,Tuesday
2014,8,26,1800,351,977,1328,Tuesday
2014,8,26,1700,411,998,1409,Tuesday
2014,8,26,1600,431,829,1260,Tuesday
2014,8,26,1500,534,693,1227,Tuesday
2014,8,26,1400,609,540,1149,Tuesday
2014,8,26,1300,686,521,1207,Tuesday
2014,8,26,1200,869,341,1210,Tuesday
2014,8,26,1100,868,307,1175,Tuesday
2014,8,26,1000,758,228,986,Tuesday
2014,8,26,900,570,196,766,Tuesday
2014,8,26,800,288,103,391,Tuesday
2014,8,26,700,116,57,173,Tuesday
2014,8,26,600,67,42,109,Tuesday
2014,8,26,500,34,40,74,Tuesday
2014,8,26,400,21,58,79,Tuesday
2014,8,26,300,30,38,68,Tuesday
2014,8,26,200,30,79,109,Tuesday
2014,8,26,100,59,93,152,Tuesday
2014,8,25,2400,72,135,207,Monday
2014,8,25,2300,93,260,353,Monday
2014,8,25,2200,134,529,663,Monday
2014,8,25,2100,208,828,1036,Monday
2014,8,25,2000,193,1008,1201,Monday
2014,8,25,1900,258,1088,1346,Monday
2014,8,25,1800,354,1095,1449,Monday
2014,8,25,1700,430,948,1378,Monday
2014,8,25,1600,530,812,1342,Monday
2014,8,25,1500,609,809,1418,Monday
2014,8,25,1400,712,648,1360,Monday
2014,8,25,1300,818,600,1418,Monday
2014,8,25,1200,941,456,1397,Monday
2014,8,25,1100,1028,368,1396,Monday
2014,8,25,1000,864,243,1107,Monday
2014,8,25,900,577,169,746,Monday
2014,8,25,800,284,118,402,Monday
2014,8,25,700,144,77,221,Monday
2014,8,25,600,71,35,106,Monday
2014,8,25,500,25,36,61,Monday
2014,8,25,400,19,38,57,Monday
2014,8,25,300,28,55,83,Monday
2014,8,25,200,26,78,104,Monday
2014,8,25,100,39,136,175,Monday
2014,8,24,2400,47,216,263,Sunday
2014,8,24,2300,81,338,419,Sunday
2014,8,24,2200,132,657,789,Sunday
2014,8,24,2100,199,1008,1207,Sunday
2014,8,24,2000,252,1329,1581,Sunday
2014,8,24,1900,318,1730,2048,Sunday
2014,8,24,1800,441,1803,2244,Sunday
2014,8,24,1700,527,1845,2372,Sunday
2014,8,24,1600,631,1758,2389,Sunday
2014,8,24,1500,752,1444,2196,Sunday
2014,8,24,1400,848,1276,2124,Sunday
2014,8,24,1300,942,1025,1967,Sunday
2014,8,24,1200,1070,745,1815,Sunday
2014,8,24,1100,931,441,1372,Sunday
2014,8,24,1000,780,269,1049,Sunday
2014,8,24,900,559,139,698,Sunday
2014,8,24,800,263,73,336,Sunday
2014,8,24,700,126,37,163,Sunday
2014,8,24,600,46,22,68,Sunday
2014,8,24,500,20,21,41,Sunday
2014,8,24,400,17,34,51,Sunday
2014,8,24,300,16,50,66,Sunday
2014,8,24,200,31,98,129,Sunday
2014,8,24,100,30,82,112,Sunday
2014,8,23,2400,65,119,184,Saturday
2014,8,23,2300,95,283,378,Saturday
2014,8,23,2200,121,510,631,Saturday
2014,8,23,2100,176,702,878,Saturday
2014,8,23,2000,217,1037,1254,Saturday
2014,8,23,1900,286,1206,1492,Saturday
2014,8,23,1800,405,1298,1703,Saturday
2014,8,23,1700,543,1164,1707,Saturday
2014,8,23,1600,623,1008,1631,Saturday
2014,8,23,1500,892,814,1706,Saturday
2014,8,23,1400,1088,774,1862,Saturday
2014,8,23,1300,1181,690,1871,Saturday
2014,8,23,1200,1395,532,1927,Saturday
2014,8,23,1100,1391,335,1726,Saturday
2014,8,23,1000,1204,235,1439,Saturday
2014,8,23,900,760,140,900,Saturday
2014,8,23,800,402,116,518,Saturday
2014,8,23,700,228,66,294,Saturday
2014,8,23,600,63,26,89,Saturday
2014,8,23,500,55,35,90,Saturday
2014,8,23,400,37,27,64,Saturday
2014,8,23,300,39,44,83,Saturday
2014,8,23,200,48,64,112,Saturday
2014,8,23,100,64,82,146,Saturday
2014,8,22,2400,115,129,244,Friday
2014,8,22,2300,157,219,376,Friday
2014,8,22,2200,299,289,588,Friday
2014,8,22,2100,494,494,988,Friday
2014,8,22,2000,720,740,1460,Friday
2014,8,22,1900,879,791,1670,Friday
2014,8,22,1800,890,908,1798,Friday
2014,8,22,1700,936,1022,1958,Friday
2014,8,22,1600,988,879,1867,Friday
2014,8,22,1500,971,793,1764,Friday
2014,8,22,1400,903,729,1632,Friday
2014,8,22,1300,913,643,1556,Friday
2014,8,22,1200,1170,567,1737,Friday
2014,8,22,1100,1129,374,1503,Friday
2014,8,22,1000,919,222,1141,Friday
2014,8,22,900,607,148,755,Friday
2014,8,22,800,353,75,428,Friday
2014,8,22,700,182,44,226,Friday
2014,8,22,600,89,42,131,Friday
2014,8,22,500,42,30,72,Friday
2014,8,22,400,30,41,71,Friday
2014,8,22,300,30,40,70,Friday
2014,8,22,200,50,70,120,Friday
2014,8,22,100,75,77,152,Friday
2014,8,21,2400,101,133,234,Thursday
2014,8,21,2300,150,177,327,Thursday
2014,8,21,2200,222,315,537,Thursday
2014,8,21,2100,335,452,787,Thursday
2014,8,21,2000,466,658,1124,Thursday
2014,8,21,1900,484,864,1348,Thursday
2014,8,21,1800,514,953,1467,Thursday
2014,8,21,1700,609,881,1490,Thursday
2014,8,21,1600,666,724,1390,Thursday
2014,8,21,1500,660,708,1368,Thursday
2014,8,21,1400,781,584,1365,Thursday
2014,8,21,1300,853,537,1390,Thursday
2014,8,21,1200,960,441,1401,Thursday
2014,8,21,1100,966,326,1292,Thursday
2014,8,21,1000,841,221,1062,Thursday
2014,8,21,900,562,159,721,Thursday
2014,8,21,800,320,98,418,Thursday
2014,8,21,700,122,55,177,Thursday
2014,8,21,600,66,44,110,Thursday
2014,8,21,500,35,27,62,Thursday
2014,8,21,400,32,42,74,Thursday
2014,8,21,300,47,44,91,Thursday
2014,8,21,200,43,42,85,Thursday
2014,8,21,100,43,108,151,Thursday
2014,8,20,2400,89,118,207,Wednesday
2014,8,20,2300,118,205,323,Wednesday
2014,8,20,2200,192,291,483,Wednesday
2014,8,20,2100,246,460,706,Wednesday
2014,8,20,2000,325,626,951,Wednesday
2014,8,20,1900,301,781,1082,Wednesday
2014,8,20,1800,371,995,1366,Wednesday
2014,8,20,1700,469,815,1284,Wednesday
2014,8,20,1600,501,752,1253,Wednesday
2014,8,20,1500,558,656,1214,Wednesday
2014,8,20,1400,588,479,1067,Wednesday
2014,8,20,1300,677,553,1230,Wednesday
2014,8,20,1200,846,465,1311,Wednesday
2014,8,20,1100,912,316,1228,Wednesday
2014,8,20,1000,797,194,991,Wednesday
2014,8,20,900,554,137,691,Wednesday
2014,8,20,800,299,91,390,Wednesday
2014,8,20,700,136,53,189,Wednesday
2014,8,20,600,51,31,82,Wednesday
2014,8,20,500,34,27,61,Wednesday
2014,8,20,400,33,40,73,Wednesday
2014,8,20,300,26,33,59,Wednesday
2014,8,20,200,51,57,108,Wednesday
2014,8,20,100,60,66,126,Wednesday
2014,8,19,2400,81,117,198,Tuesday
2014,8,19,2300,110,225,335,Tuesday
2014,8,19,2200,114,339,453,Tuesday
2014,8,19,2100,192,479,671,Tuesday
2014,8,19,2000,256,718,974,Tuesday
2014,8,19,1900,246,881,1127,Tuesday
2014,8,19,1800,312,934,1246,Tuesday
2014,8,19,1700,432,909,1341,Tuesday
2014,8,19,1600,468,835,1303,Tuesday
2014,8,19,1500,628,681,1309,Tuesday
2014,8,19,1400,598,614,1212,Tuesday
2014,8,19,1300,705,509,1214,Tuesday
2014,8,19,1200,861,413,1274,Tuesday
2014,8,19,1100,928,303,1231,Tuesday
2014,8,19,1000,719,238,957,Tuesday
2014,8,19,900,502,165,667,Tuesday
2014,8,19,800,240,106,346,Tuesday
2014,8,19,700,127,59,186,Tuesday
2014,8,19,600,49,34,83,Tuesday
2014,8,19,500,30,38,68,Tuesday
2014,8,19,400,30,27,57,Tuesday
2014,8,19,300,15,47,62,Tuesday
2014,8,19,200,32,68,100,Tuesday
2014,8,19,100,61,114,175,Tuesday
2014,8,18,2400,84,176,260,Monday
2014,8,18,2300,103,265,368,Monday
2014,8,18,2200,144,380,524,Monday
2014,8,18,2100,196,614,810,Monday
2014,8,18,2000,208,1004,1212,Monday
2014,8,18,1900,323,1356,1679,Monday
2014,8,18,1800,380,1257,1637,Monday
2014,8,18,1700,423,1217,1640,Monday
2014,8,18,1600,586,1016,1602,Monday
2014,8,18,1500,668,814,1482,Monday
2014,8,18,1400,798,717,1515,Monday
2014,8,18,1300,958,661,1619,Monday
2014,8,18,1200,1108,455,1563,Monday
2014,8,18,1100,1196,362,1558,Monday
2014,8,18,1000,1022,251,1273,Monday
2014,8,18,900,660,147,807,Monday
2014,8,18,800,360,110,470,Monday
2014,8,18,700,163,70,233,Monday
2014,8,18,600,65,36,101,Monday
2014,8,18,500,41,36,77,Monday
2014,8,18,400,26,38,64,Monday
2014,8,18,300,21,56,77,Monday
2014,8,18,200,31,109,140,Monday
2014,8,18,100,47,143,190,Monday
2014,8,17,2400,63,207,270,Sunday
2014,8,17,2300,92,364,456,Sunday
2014,8,17,2200,126,625,751,Sunday
2014,8,17,2100,193,1059,1252,Sunday
2014,8,17,2000,220,1315,1535,Sunday
2014,8,17,1900,303,1668,1971,Sunday
2014,8,17,1800,367,1822,2189,Sunday
2014,8,17,1700,562,1844,2406,Sunday
2014,8,17,1600,644,1626,2270,Sunday
2014,8,17,1500,752,1360,2112,Sunday
2014,8,17,1400,877,1286,2163,Sunday
2014,8,17,1300,1017,1147,2164,Sunday
2014,8,17,1200,1094,771,1865,Sunday
2014,8,17,1100,1114,442,1556,Sunday
2014,8,17,1000,879,259,1138,Sunday
2014,8,17,900,574,163,737,Sunday
2014,8,17,800,268,68,336,Sunday
2014,8,17,700,103,35,138,Sunday
2014,8,17,600,56,23,79,Sunday
2014,8,17,500,18,21,39,Sunday
2014,8,17,400,23,26,49,Sunday
2014,8,17,300,25,44,69,Sunday
2014,8,17,200,28,53,81,Sunday
2014,8,17,100,42,86,128,Sunday
2014,8,16,2400,59,171,230,Saturday
2014,8,16,2300,100,312,412,Saturday
2014,8,16,2200,147,477,624,Saturday
2014,8,16,2100,161,745,906,Saturday
2014,8,16,2000,250,955,1205,Saturday
2014,8,16,1900,337,1325,1662,Saturday
2014,8,16,1800,385,1628,2013,Saturday
2014,8,16,1700,564,1251,1815,Saturday
2014,8,16,1600,641,1065,1706,Saturday
2014,8,16,1500,776,896,1672,Saturday
2014,8,16,1400,985,796,1781,Saturday
2014,8,16,1300,1141,715,1856,Saturday
2014,8,16,1200,1438,502,1940,Saturday
2014,8,16,1100,1475,386,1861,Saturday
2014,8,16,1000,1208,240,1448,Saturday
2014,8,16,900,816,166,982,Saturday
2014,8,16,800,492,82,574,Saturday
2014,8,16,700,189,44,233,Saturday
2014,8,16,600,87,45,132,Saturday
2014,8,16,500,42,38,80,Saturday
2014,8,16,400,46,48,94,Saturday
2014,8,16,300,35,38,73,Saturday
2014,8,16,200,43,60,103,Saturday
2014,8,16,100,69,100,169,Saturday
2014,8,15,2400,144,156,300,Friday
2014,8,15,2300,186,230,416,Friday
2014,8,15,2200,340,392,732,Friday
2014,8,15,2100,543,655,1198,Friday
2014,8,15,2000,809,1073,1882,Friday
2014,8,15,1900,933,1089,2022,Friday
2014,8,15,1800,895,1288,2183,Friday
2014,8,15,1700,948,1019,1967,Friday
2014,8,15,1600,947,914,1861,Friday
2014,8,15,1500,1027,696,1723,Friday
2014,8,15,1400,964,686,1650,Friday
2014,8,15,1300,1063,517,1580,Friday
2014,8,15,1200,1325,502,1827,Friday
2014,8,15,1100,1236,329,1565,Friday
2014,8,15,1000,1071,240,1311,Friday
2014,8,15,900,725,145,870,Friday
2014,8,15,800,386,97,483,Friday
2014,8,15,700,201,55,256,Friday
2014,8,15,600,92,43,135,Friday
2014,8,15,500,43,38,81,Friday
2014,8,15,400,31,39,70,Friday
2014,8,15,300,33,40,73,Friday
2014,8,15,200,47,66,113,Friday
2014,8,15,100,61,109,170,Friday
2014,8,14,2400,97,164,261,Thursday
2014,8,14,2300,167,194,361,Thursday
2014,8,14,2200,237,363,600,Thursday
2014,8,14,2100,335,491,826,Thursday
2014,8,14,2000,469,680,1149,Thursday
2014,8,14,1900,480,915,1395,Thursday
2014,8,14,1800,523,1116,1639,Thursday
2014,8,14,1700,611,1025,1636,Thursday
2014,8,14,1600,690,884,1574,Thursday
2014,8,14,1500,689,674,1363,Thursday
2014,8,14,1400,741,698,1439,Thursday
2014,8,14,1300,875,577,1452,Thursday
2014,8,14,1200,1033,425,1458,Thursday
2014,8,14,1100,1072,305,1377,Thursday
2014,8,14,1000,943,179,1122,Thursday
2014,8,14,900,680,171,851,Thursday
2014,8,14,800,382,110,492,Thursday
2014,8,14,700,184,52,236,Thursday
2014,8,14,600,68,42,110,Thursday
2014,8,14,500,34,54,88,Thursday
2014,8,14,400,34,36,70,Thursday
2014,8,14,300,33,49,82,Thursday
2014,8,14,200,44,74,118,Thursday
2014,8,14,100,37,91,128,Thursday
2014,8,13,2400,100,134,234,Wednesday
2014,8,13,2300,122,214,336,Wednesday
2014,8,13,2200,196,363,559,Wednesday
2014,8,13,2100,226,495,721,Wednesday
2014,8,13,2000,309,717,1026,Wednesday
2014,8,13,1900,324,837,1161,Wednesday
2014,8,13,1800,376,993,1369,Wednesday
2014,8,13,1700,465,949,1414,Wednesday
2014,8,13,1600,504,880,1384,Wednesday
2014,8,13,1500,625,702,1327,Wednesday
2014,8,13,1400,636,606,1242,Wednesday
2014,8,13,1300,767,529,1296,Wednesday
2014,8,13,1200,911,451,1362,Wednesday
2014,8,13,1100,939,310,1249,Wednesday
2014,8,13,1000,820,222,1042,Wednesday
2014,8,13,900,544,177,721,Wednesday
2014,8,13,800,323,89,412,Wednesday
2014,8,13,700,144,55,199,Wednesday
2014,8,13,600,62,34,96,Wednesday
2014,8,13,500,25,30,55,Wednesday
2014,8,13,400,28,44,72,Wednesday
2014,8,13,300,24,37,61,Wednesday
2014,8,13,200,33,49,82,Wednesday
2014,8,13,100,58,97,155,Wednesday
2014,8,12,2400,86,134,220,Tuesday
2014,8,12,2300,114,255,369,Tuesday
2014,8,12,2200,160,388,548,Tuesday
2014,8,12,2100,169,628,797,Tuesday
2014,8,12,2000,240,820,1060,Tuesday
2014,8,12,1900,266,1078,1344,Tuesday
2014,8,12,1800,359,1271,1630,Tuesday
2014,8,12,1700,407,987,1394,Tuesday
2014,8,12,1600,477,836,1313,Tuesday
2014,8,12,1500,549,707,1256,Tuesday
2014,8,12,1400,640,622,1262,Tuesday
2014,8,12,1300,719,534,1253,Tuesday
2014,8,12,1200,873,412,1285,Tuesday
2014,8,12,1100,995,329,1324,Tuesday
2014,8,12,1000,873,228,1101,Tuesday
2014,8,12,900,664,172,836,Tuesday
2014,8,12,800,367,118,485,Tuesday
2014,8,12,700,157,85,242,Tuesday
2014,8,12,600,63,52,115,Tuesday
2014,8,12,500,32,43,75,Tuesday
2014,8,12,400,29,70,99,Tuesday
2014,8,12,300,27,70,97,Tuesday
2014,8,12,200,34,115,149,Tuesday
2014,8,12,100,47,171,218,Tuesday
2014,8,11,2400,90,226,316,Monday
2014,8,11,2300,104,335,439,Monday
2014,8,11,2200,138,537,675,Monday
2014,8,11,2100,175,872,1047,Monday
2014,8,11,2000,250,1070,1320,Monday
2014,8,11,1900,281,1256,1537,Monday
2014,8,11,1800,354,1283,1637,Monday
2014,8,11,1700,505,1243,1748,Monday
2014,8,11,1600,595,875,1470,Monday
2014,8,11,1500,705,830,1535,Monday
2014,8,11,1400,817,697,1514,Monday
2014,8,11,1300,844,649,1493,Monday
2014,8,11,1200,1097,500,1597,Monday
2014,8,11,1100,1165,392,1557,Monday
2014,8,11,1000,939,241,1180,Monday
2014,8,11,900,694,169,863,Monday
2014,8,11,800,325,137,462,Monday
2014,8,11,700,163,85,248,Monday
2014,8,11,600,63,40,103,Monday
2014,8,11,500,29,33,62,Monday
2014,8,11,400,30,39,69,Monday
2014,8,11,300,29,43,72,Monday
2014,8,11,200,32,67,99,Monday
2014,8,11,100,31,129,160,Monday
2014,8,10,2400,76,241,317,Sunday
2014,8,10,2300,87,418,505,Sunday
2014,8,10,2200,161,738,899,Sunday
2014,8,10,2100,173,1232,1405,Sunday
2014,8,10,2000,275,1615,1890,Sunday
2014,8,10,1900,324,2001,2325,Sunday
2014,8,10,1800,460,1971,2431,Sunday
2014,8,10,1700,584,1972,2556,Sunday
2014,8,10,1600,691,1685,2376,Sunday
2014,8,10,1500,916,1394,2310,Sunday
2014,8,10,1400,953,1242,2195,Sunday
2014,8,10,1300,1132,1163,2295,Sunday
2014,8,10,1200,1225,738,1963,Sunday
2014,8,10,1100,1171,439,1610,Sunday
2014,8,10,1000,1064,267,1331,Sunday
2014,8,10,900,727,144,871,Sunday
2014,8,10,800,341,74,415,Sunday
2014,8,10,700,170,39,209,Sunday
2014,8,10,600,60,20,80,Sunday
2014,8,10,500,30,30,60,Sunday
2014,8,10,400,24,31,55,Sunday
2014,8,10,300,26,55,81,Sunday
2014,8,10,200,31,77,108,Sunday
2014,8,10,100,38,138,176,Sunday
2014,8,9,2400,54,187,241,Saturday
2014,8,9,2300,121,361,482,Saturday
2014,8,9,2200,144,553,697,Saturday
2014,8,9,2100,182,1040,1222,Saturday
2014,8,9,2000,245,1298,1543,Saturday
2014,8,9,1900,346,1438,1784,Saturday
2014,8,9,1800,430,1454,1884,Saturday
2014,8,9,1700,539,1421,1960,Saturday
2014,8,9,1600,731,1227,1958,Saturday
2014,8,9,1500,834,941,1775,Saturday
2014,8,9,1400,1109,783,1892,Saturday
2014,8,9,1300,1242,679,1921,Saturday
2014,8,9,1200,1575,513,2088,Saturday
2014,8,9,1100,1428,394,1822,Saturday
2014,8,9,1000,1147,216,1363,Saturday
2014,8,9,900,954,157,1111,Saturday
2014,8,9,800,509,80,589,Saturday
2014,8,9,700,244,69,313,Saturday
2014,8,9,600,101,32,133,Saturday
2014,8,9,500,41,26,67,Saturday
2014,8,9,400,43,33,76,Saturday
2014,8,9,300,28,42,70,Saturday
2014,8,9,200,39,71,110,Saturday
2014,8,9,100,65,116,181,Saturday
2014,8,8,2400,120,143,263,Friday
2014,8,8,2300,211,239,450,Friday
2014,8,8,2200,318,352,670,Friday
2014,8,8,2100,542,532,1074,Friday
2014,8,8,2000,774,838,1612,Friday
2014,8,8,1900,929,1087,2016,Friday
2014,8,8,1800,829,1062,1891,Friday
2014,8,8,1700,960,1015,1975,Friday
2014,8,8,1600,978,1049,2027,Friday
2014,8,8,1500,981,1062,2043,Friday
2014,8,8,1400,965,817,1782,Friday
2014,8,8,1300,1078,788,1866,Friday
2014,8,8,1200,1268,594,1862,Friday
2014,8,8,1100,1290,429,1719,Friday
2014,8,8,1000,1015,246,1261,Friday
2014,8,8,900,699,153,852,Friday
2014,8,8,800,408,104,512,Friday
2014,8,8,700,221,72,293,Friday
2014,8,8,600,101,35,136,Friday
2014,8,8,500,41,36,77,Friday
2014,8,8,400,36,42,78,Friday
2014,8,8,300,36,40,76,Friday
2014,8,8,200,52,69,121,Friday
2014,8,8,100,75,118,193,Friday
2014,8,7,2400,111,157,268,Thursday
2014,8,7,2300,166,241,407,Thursday
2014,8,7,2200,250,444,694,Thursday
2014,8,7,2100,340,519,859,Thursday
2014,8,7,2000,458,718,1176,Thursday
2014,8,7,1900,525,1027,1552,Thursday
2014,8,7,1800,562,1124,1686,Thursday
2014,8,7,1700,629,1177,1806,Thursday
2014,8,7,1600,636,938,1574,Thursday
2014,8,7,1500,798,736,1534,Thursday
2014,8,7,1400,776,652,1428,Thursday
2014,8,7,1300,844,581,1425,Thursday
2014,8,7,1200,1057,416,1473,Thursday
2014,8,7,1100,1163,322,1485,Thursday
2014,8,7,1000,970,210,1180,Thursday
2014,8,7,900,761,186,947,Thursday
2014,8,7,800,426,120,546,Thursday
2014,8,7,700,176,55,231,Thursday
2014,8,7,600,92,47,139,Thursday
2014,8,7,500,57,44,101,Thursday
2014,8,7,400,36,53,89,Thursday
2014,8,7,300,49,43,92,Thursday
2014,8,7,200,58,66,124,Thursday
2014,8,7,100,75,102,177,Thursday
2014,8,6,2400,98,143,241,Wednesday
2014,8,6,2300,149,261,410,Wednesday
2014,8,6,2200,182,420,602,Wednesday
2014,8,6,2100,253,631,884,Wednesday
2014,8,6,2000,308,845,1153,Wednesday
2014,8,6,1900,317,1001,1318,Wednesday
2014,8,6,1800,400,1143,1543,Wednesday
2014,8,6,1700,500,1096,1596,Wednesday
2014,8,6,1600,589,970,1559,Wednesday
2014,8,6,1500,657,797,1454,Wednesday
2014,8,6,1400,722,648,1370,Wednesday
2014,8,6,1300,829,559,1388,Wednesday
2014,8,6,1200,1102,445,1547,Wednesday
2014,8,6,1100,1108,367,1475,Wednesday
2014,8,6,1000,937,279,1216,Wednesday
2014,8,6,900,680,202,882,Wednesday
2014,8,6,800,373,130,503,Wednesday
2014,8,6,700,144,87,231,Wednesday
2014,8,6,600,97,53,150,Wednesday
2014,8,6,500,43,44,87,Wednesday
2014,8,6,400,51,72,123,Wednesday
2014,8,6,300,26,249,275,Wednesday
2014,8,6,200,49,415,464,Wednesday
2014,8,6,100,57,360,417,Wednesday
2014,8,5,2400,91,140,231,Tuesday
2014,8,5,2300,119,168,287,Tuesday
2014,8,5,2200,163,261,424,Tuesday
2014,8,5,2100,206,454,660,Tuesday
2014,8,5,2000,275,886,1161,Tuesday
2014,8,5,1900,304,1310,1614,Tuesday
2014,8,5,1800,432,1287,1719,Tuesday
2014,8,5,1700,484,1339,1823,Tuesday
2014,8,5,1600,584,1175,1759,Tuesday
2014,8,5,1500,747,1033,1780,Tuesday
2014,8,5,1400,787,819,1606,Tuesday
2014,8,5,1300,921,671,1592,Tuesday
2014,8,5,1200,1098,603,1701,Tuesday
2014,8,5,1100,1090,464,1554,Tuesday
2014,8,5,1000,932,321,1253,Tuesday
2014,8,5,900,639,211,850,Tuesday
2014,8,5,800,363,215,578,Tuesday
2014,8,5,700,174,105,279,Tuesday
2014,8,5,600,80,78,158,Tuesday
2014,8,5,500,28,49,77,Tuesday
2014,8,5,400,21,66,87,Tuesday
2014,8,5,300,24,97,121,Tuesday
2014,8,5,200,30,359,389,Tuesday
2014,8,5,100,50,869,919,Tuesday
2014,8,4,2400,63,884,947,Monday
2014,8,4,2300,87,1101,1188,Monday
2014,8,4,2200,127,1244,1371,Monday
2014,8,4,2100,170,1420,1590,Monday
2014,8,4,2000,238,1737,1975,Monday
2014,8,4,1900,297,2070,2367,Monday
2014,8,4,1800,398,2109,2507,Monday
2014,8,4,1700,562,2182,2744,Monday
2014,8,4,1600,647,2091,2738,Monday
2014,8,4,1500,788,1984,2772,Monday
2014,8,4,1400,932,1753,2685,Monday
2014,8,4,1300,1108,1488,2596,Monday
2014,8,4,1200,1315,1095,2410,Monday
2014,8,4,1100,1345,657,2002,Monday
2014,8,4,1000,1075,395,1470,Monday
2014,8,4,900,730,212,942,Monday
2014,8,4,800,379,117,496,Monday
2014,8,4,700,182,52,234,Monday
2014,8,4,600,69,46,115,Monday
2014,8,4,500,37,33,70,Monday
2014,8,4,400,22,41,63,Monday
2014,8,4,300,28,52,80,Monday
2014,8,4,200,31,114,145,Monday
2014,8,4,100,58,160,218,Monday
2014,8,3,2400,80,321,401,Sunday
2014,8,3,2300,125,509,634,Sunday
2014,8,3,2200,144,822,966,Sunday
2014,8,3,2100,197,1353,1550,Sunday
2014,8,3,2000,255,1770,2025,Sunday
2014,8,3,1900,293,1636,1929,Sunday
2014,8,3,1800,445,1739,2184,Sunday
2014,8,3,1700,594,1567,2161,Sunday
2014,8,3,1600,751,1208,1959,Sunday
2014,8,3,1500,984,985,1969,Sunday
2014,8,3,1400,1165,942,2107,Sunday
2014,8,3,1300,1313,804,2117,Sunday
2014,8,3,1200,1436,617,2053,Sunday
2014,8,3,1100,1423,399,1822,Sunday
2014,8,3,1000,1180,218,1398,Sunday
2014,8,3,900,804,125,929,Sunday
2014,8,3,800,437,78,515,Sunday
2014,8,3,700,168,36,204,Sunday
2014,8,3,600,83,26,109,Sunday
2014,8,3,500,43,25,68,Sunday
2014,8,3,400,27,42,69,Sunday
2014,8,3,300,31,36,67,Sunday
2014,8,3,200,27,70,97,Sunday
2014,8,3,100,51,112,163,Sunday
2014,8,2,2400,80,165,245,Saturday
2014,8,2,2300,137,355,492,Saturday
2014,8,2,2200,166,607,773,Saturday
2014,8,2,2100,223,1005,1228,Saturday
2014,8,2,2000,279,1125,1404,Saturday
2014,8,2,1900,434,1060,1494,Saturday
2014,8,2,1800,508,1309,1817,Saturday
2014,8,2,1700,684,1173,1857,Saturday
2014,8,2,1600,876,982,1858,Saturday
2014,8,2,1500,1171,848,2019,Saturday
2014,8,2,1400,1548,679,2227,Saturday
2014,8,2,1300,1615,624,2239,Saturday
2014,8,2,1200,1871,458,2329,Saturday
2014,8,2,1100,2078,336,2414,Saturday
2014,8,2,1000,1775,223,1998,Saturday
2014,8,2,900,1287,143,1430,Saturday
2014,8,2,800,834,105,939,Saturday
2014,8,2,700,391,56,447,Saturday
2014,8,2,600,241,41,282,Saturday
2014,8,2,500,75,36,111,Saturday
2014,8,2,400,63,45,108,Saturday
2014,8,2,300,81,58,139,Saturday
2014,8,2,200,95,86,181,Saturday
2014,8,2,100,143,93,236,Saturday
2014,8,1,2400,201,169,370,Friday
2014,8,1,2300,331,286,617,Friday
2014,8,1,2200,565,372,937,Friday
2014,8,1,2100,889,525,1414,Friday
2014,8,1,2000,1302,736,2038,Friday
2014,8,1,1900,1410,900,2310,Friday
2014,8,1,1800,1590,1004,2594,Friday
2014,8,1,1700,1631,1007,2638,Friday
2014,8,1,1600,1619,958,2577,Friday
2014,8,1,1500,1698,818,2516,Friday
2014,8,1,1400,1555,702,2257,Friday
2014,8,1,1300,1558,610,2168,Friday
2014,8,1,1200,1803,460,2263,Friday
2014,8,1,1100,1778,348,2126,Friday
2014,8,1,1000,1540,238,1778,Friday
2014,8,1,900,1241,147,1388,Friday
2014,8,1,800,756,101,857,Friday
2014,8,1,700,442,65,507,Friday
2014,8,1,600,219,62,281,Friday
2014,8,1,500,88,57,145,Friday
2014,8,1,400,83,48,131,Friday
2014,8,1,300,89,51,140,Friday
2014,8,1,200,71,78,149,Friday
2014,8,1,100,135,111,246,Friday
2014,7,31,2400,175,171,346,Thursday
2014,7,31,2300,309,258,567,Thursday
2014,7,31,2200,443,406,849,Thursday
2014,7,31,2100,680,494,1174,Thursday
2014,7,31,2000,874,735,1609,Thursday
2014,7,31,1900,899,822,1721,Thursday
2014,7,31,1800,915,927,1842,Thursday
2014,7,31,1700,988,920,1908,Thursday
2014,7,31,1600,1021,851,1872,Thursday
2014,7,31,1500,1092,690,1782,Thursday
2014,7,31,1400,995,597,1592,Thursday
2014,7,31,1300,1163,518,1681,Thursday
2014,7,31,1200,1311,440,1751,Thursday
2014,7,31,1100,1374,327,1701,Thursday
2014,7,31,1000,1132,220,1352,Thursday
2014,7,31,900,851,157,1008,Thursday
2014,7,31,800,467,114,581,Thursday
2014,7,31,700,236,57,293,Thursday
2014,7,31,600,91,52,143,Thursday
2014,7,31,500,58,30,88,Thursday
2014,7,31,400,56,56,112,Thursday
2014,7,31,300,39,61,100,Thursday
2014,7,31,200,81,65,146,Thursday
2014,7,31,100,94,91,185,Thursday
2014,7,30,2400,103,132,235,Wednesday
2014,7,30,2300,160,206,366,Wednesday
2014,7,30,2200,267,282,549,Wednesday
2014,7,30,2100,296,410,706,Wednesday
2014,7,30,2000,386,693,1079,Wednesday
2014,7,30,1900,366,805,1171,Wednesday
2014,7,30,1800,449,916,1365,Wednesday
2014,7,30,1700,524,921,1445,Wednesday
2014,7,30,1600,584,801,1385,Wednesday
2014,7,30,1500,661,653,1314,Wednesday
2014,7,30,1400,679,547,1226,Wednesday
2014,7,30,1300,815,474,1289,Wednesday
2014,7,30,1200,1048,367,1415,Wednesday
2014,7,30,1100,994,280,1274,Wednesday
2014,7,30,1000,902,208,1110,Wednesday
2014,7,30,900,680,138,818,Wednesday
2014,7,30,800,373,102,475,Wednesday
2014,7,30,700,173,71,244,Wednesday
2014,7,30,600,81,42,123,Wednesday
2014,7,30,500,38,32,70,Wednesday
2014,7,30,400,26,43,69,Wednesday
2014,7,30,300,26,43,69,Wednesday
2014,7,30,200,40,54,94,Wednesday
2014,7,30,100,70,92,162,Wednesday
2014,7,29,2400,93,143,236,Tuesday
2014,7,29,2300,104,218,322,Tuesday
2014,7,29,2200,169,325,494,Tuesday
2014,7,29,2100,197,502,699,Tuesday
2014,7,29,2000,270,653,923,Tuesday
2014,7,29,1900,285,836,1121,Tuesday
2014,7,29,1800,362,873,1235,Tuesday
2014,7,29,1700,421,891,1312,Tuesday
2014,7,29,1600,527,800,1327,Tuesday
2014,7,29,1500,535,654,1189,Tuesday
2014,7,29,1400,626,519,1145,Tuesday
2014,7,29,1300,711,516,1227,Tuesday
2014,7,29,1200,912,387,1299,Tuesday
2014,7,29,1100,955,283,1238,Tuesday
2014,7,29,1000,803,202,1005,Tuesday
2014,7,29,900,584,153,737,Tuesday
2014,7,29,800,303,104,407,Tuesday
2014,7,29,700,148,63,211,Tuesday
2014,7,29,600,53,54,107,Tuesday
2014,7,29,500,38,38,76,Tuesday
2014,7,29,400,25,43,68,Tuesday
2014,7,29,300,21,53,74,Tuesday
2014,7,29,200,33,56,89,Tuesday
2014,7,29,100,47,107,154,Tuesday
2014,7,28,2400,94,160,254,Monday
2014,7,28,2300,94,268,362,Monday
2014,7,28,2200,158,416,574,Monday
2014,7,28,2100,192,627,819,Monday
2014,7,28,2000,246,840,1086,Monday
2014,7,28,1900,300,1153,1453,Monday
2014,7,28,1800,408,1196,1604,Monday
2014,7,28,1700,494,1137,1631,Monday
2014,7,28,1600,637,1017,1654,Monday
2014,7,28,1500,700,816,1516,Monday
2014,7,28,1400,797,720,1517,Monday
2014,7,28,1300,868,574,1442,Monday
2014,7,28,1200,1081,505,1586,Monday
2014,7,28,1100,1068,327,1395,Monday
2014,7,28,1000,874,249,1123,Monday
2014,7,28,900,673,155,828,Monday
2014,7,28,800,371,146,517,Monday
2014,7,28,700,156,90,246,Monday
2014,7,28,600,67,41,108,Monday
2014,7,28,500,24,49,73,Monday
2014,7,28,400,24,46,70,Monday
2014,7,28,300,28,60,88,Monday
2014,7,28,200,28,105,133,Monday
2014,7,28,100,41,141,182,Monday
2014,7,27,2400,47,268,315,Sunday
2014,7,27,2300,95,427,522,Sunday
2014,7,27,2200,142,660,802,Sunday
2014,7,27,2100,216,1058,1274,Sunday
2014,7,27,2000,224,1335,1559,Sunday
2014,7,27,1900,307,1740,2047,Sunday
2014,7,27,1800,417,1772,2189,Sunday
2014,7,27,1700,491,1755,2246,Sunday
2014,7,27,1600,739,1591,2330,Sunday
2014,7,27,1500,885,1195,2080,Sunday
2014,7,27,1400,921,1060,1981,Sunday
2014,7,27,1300,1044,919,1963,Sunday
2014,7,27,1200,1182,671,1853,Sunday
2014,7,27,1100,1174,381,1555,Sunday
2014,7,27,1000,1011,251,1262,Sunday
2014,7,27,900,748,123,871,Sunday
2014,7,27,800,402,76,478,Sunday
2014,7,27,700,196,22,218,Sunday
2014,7,27,600,58,25,83,Sunday
2014,7,27,500,32,30,62,Sunday
2014,7,27,400,22,27,49,Sunday
2014,7,27,300,27,38,65,Sunday
2014,7,27,200,23,58,81,Sunday
2014,7,27,100,34,85,119,Sunday
2014,7,26,2400,75,155,230,Saturday
2014,7,26,2300,107,237,344,Saturday
2014,7,26,2200,121,429,550,Saturday
2014,7,26,2100,219,613,832,Saturday
2014,7,26,2000,272,1007,1279,Saturday
2014,7,26,1900,343,1108,1451,Saturday
2014,7,26,1800,428,1181,1609,Saturday
2014,7,26,1700,568,1151,1719,Saturday
2014,7,26,1600,742,942,1684,Saturday
2014,7,26,1500,869,751,1620,Saturday
2014,7,26,1400,1006,631,1637,Saturday
2014,7,26,1300,1257,580,1837,Saturday
2014,7,26,1200,1544,457,2001,Saturday
2014,7,26,1100,1519,350,1869,Saturday
2014,7,26,1000,1367,191,1558,Saturday
2014,7,26,900,980,129,1109,Saturday
2014,7,26,800,521,84,605,Saturday
2014,7,26,700,250,43,293,Saturday
2014,7,26,600,99,38,137,Saturday
2014,7,26,500,39,36,75,Saturday
2014,7,26,400,38,34,72,Saturday
2014,7,26,300,40,37,77,Saturday
2014,7,26,200,45,62,107,Saturday
2014,7,26,100,55,72,127,Saturday
2014,7,25,2400,145,112,257,Friday
2014,7,25,2300,208,164,372,Friday
2014,7,25,2200,397,255,652,Friday
2014,7,25,2100,574,402,976,Friday
2014,7,25,2000,1001,555,1556,Friday
2014,7,25,1900,982,670,1652,Friday
2014,7,25,1800,1006,878,1884,Friday
2014,7,25,1700,1036,926,1962,Friday
2014,7,25,1600,1079,847,1926,Friday
2014,7,25,1500,1054,738,1792,Friday
2014,7,25,1400,1021,601,1622,Friday
2014,7,25,1300,947,589,1536,Friday
2014,7,25,1200,1291,496,1787,Friday
2014,7,25,1100,1283,326,1609,Friday
2014,7,25,1000,998,205,1203,Friday
2014,7,25,900,696,145,841,Friday
2014,7,25,800,436,118,554,Friday
2014,7,25,700,228,51,279,Friday
2014,7,25,600,101,36,137,Friday
2014,7,25,500,57,42,99,Friday
2014,7,25,400,57,47,104,Friday
2014,7,25,300,33,48,81,Friday
2014,7,25,200,45,59,104,Friday
2014,7,25,100,74,87,161,Friday
2014,7,24,2400,114,106,220,Thursday
2014,7,24,2300,172,194,366,Thursday
2014,7,24,2200,302,257,559,Thursday
2014,7,24,2100,372,330,702,Thursday
2014,7,24,2000,492,518,1010,Thursday
2014,7,24,1900,519,696,1215,Thursday
2014,7,24,1800,551,931,1482,Thursday
2014,7,24,1700,705,864,1569,Thursday
2014,7,24,1600,745,829,1574,Thursday
2014,7,24,1500,674,695,1369,Thursday
2014,7,24,1400,735,614,1349,Thursday
2014,7,24,1300,885,529,1414,Thursday
2014,7,24,1200,981,416,1397,Thursday
2014,7,24,1100,1030,338,1368,Thursday
2014,7,24,1000,819,239,1058,Thursday
2014,7,24,900,552,154,706,Thursday
2014,7,24,800,344,112,456,Thursday
2014,7,24,700,169,47,216,Thursday
2014,7,24,600,60,60,120,Thursday
2014,7,24,500,39,114,153,Thursday
2014,7,24,400,35,68,103,Thursday
2014,7,24,300,29,4,33,Thursday
2014,7,24,200,44,10,54,Thursday
2014,7,24,100,71,20,91,Thursday
2014,7,23,2400,107,59,166,Wednesday
2014,7,23,2300,137,152,289,Wednesday
2014,7,23,2200,178,300,478,Wednesday
2014,7,23,2100,238,456,694,Wednesday
2014,7,23,2000,299,613,912,Wednesday
2014,7,23,1900,313,749,1062,Wednesday
2014,7,23,1800,349,866,1215,Wednesday
2014,7,23,1700,473,835,1308,Wednesday
2014,7,23,1600,480,712,1192,Wednesday
2014,7,23,1500,515,644,1159,Wednesday
2014,7,23,1400,579,523,1102,Wednesday
2014,7,23,1300,756,394,1150,Wednesday
2014,7,23,1200,865,336,1201,Wednesday
2014,7,23,1100,948,298,1246,Wednesday
2014,7,23,1000,710,178,888,Wednesday
2014,7,23,900,533,142,675,Wednesday
2014,7,23,800,324,84,408,Wednesday
2014,7,23,700,133,72,205,Wednesday
2014,7,23,600,57,39,96,Wednesday
2014,7,23,500,30,28,58,Wednesday
2014,7,23,400,32,51,83,Wednesday
2014,7,23,300,29,31,60,Wednesday
2014,7,23,200,38,43,81,Wednesday
2014,7,23,100,48,76,124,Wednesday
2014,7,22,2400,61,131,192,Tuesday
2014,7,22,2300,110,197,307,Tuesday
2014,7,22,2200,134,300,434,Tuesday
2014,7,22,2100,179,443,622,Tuesday
2014,7,22,2000,212,624,836,Tuesday
2014,7,22,1900,242,770,1012,Tuesday
2014,7,22,1800,298,900,1198,Tuesday
2014,7,22,1700,393,1004,1397,Tuesday
2014,7,22,1600,452,859,1311,Tuesday
2014,7,22,1500,505,642,1147,Tuesday
2014,7,22,1400,569,506,1075,Tuesday
2014,7,22,1300,695,410,1105,Tuesday
2014,7,22,1200,806,370,1176,Tuesday
2014,7,22,1100,895,267,1162,Tuesday
2014,7,22,1000,806,190,996,Tuesday
2014,7,22,900,566,143,709,Tuesday
2014,7,22,800,300,101,401,Tuesday
2014,7,22,700,125,62,187,Tuesday
2014,7,22,600,49,42,91,Tuesday
2014,7,22,500,24,41,65,Tuesday
2014,7,22,400,40,48,88,Tuesday
2014,7,22,300,26,55,81,Tuesday
2014,7,22,200,35,70,105,Tuesday
2014,7,22,100,67,108,175,Tuesday
2014,7,21,2400,73,172,245,Monday
2014,7,21,2300,94,260,354,Monday
2014,7,21,2200,130,418,548,Monday
2014,7,21,2100,191,562,753,Monday
2014,7,21,2000,253,793,1046,Monday
2014,7,21,1900,270,915,1185,Monday
2014,7,21,1800,331,1079,1410,Monday
2014,7,21,1700,454,981,1435,Monday
2014,7,21,1600,552,892,1444,Monday
2014,7,21,1500,609,673,1282,Monday
2014,7,21,1400,683,663,1346,Monday
2014,7,21,1300,757,587,1344,Monday
2014,7,21,1200,949,500,1449,Monday
2014,7,21,1100,909,398,1307,Monday
2014,7,21,1000,724,282,1006,Monday
2014,7,21,900,555,193,748,Monday
2014,7,21,800,372,129,501,Monday
2014,7,21,700,127,110,237,Monday
2014,7,21,600,53,48,101,Monday
2014,7,21,500,19,35,54,Monday
2014,7,21,400,30,53,83,Monday
2014,7,21,300,28,118,146,Monday
2014,7,21,200,26,388,414,Monday
2014,7,21,100,24,375,399,Monday
2014,7,20,2400,55,269,324,Sunday
2014,7,20,2300,91,322,413,Sunday
2014,7,20,2200,135,534,669,Sunday
2014,7,20,2100,181,655,836,Sunday
2014,7,20,2000,218,950,1168,Sunday
2014,7,20,1900,299,1664,1963,Sunday
2014,7,20,1800,396,1593,1989,Sunday
2014,7,20,1700,559,1761,2320,Sunday
2014,7,20,1600,621,1558,2179,Sunday
2014,7,20,1500,737,1307,2044,Sunday
2014,7,20,1400,782,1126,1908,Sunday
2014,7,20,1300,898,953,1851,Sunday
2014,7,20,1200,1047,691,1738,Sunday
2014,7,20,1100,1047,428,1475,Sunday
2014,7,20,1000,829,221,1050,Sunday
2014,7,20,900,573,112,685,Sunday
2014,7,20,800,282,50,332,Sunday
2014,7,20,700,131,43,174,Sunday
2014,7,20,600,62,22,84,Sunday
2014,7,20,500,30,11,41,Sunday
2014,7,20,400,24,18,42,Sunday
2014,7,20,300,29,32,61,Sunday
2014,7,20,200,26,32,58,Sunday
2014,7,20,100,48,69,117,Sunday
2014,7,19,2400,65,126,191,Saturday
2014,7,19,2300,106,187,293,Saturday
2014,7,19,2200,129,308,437,Saturday
2014,7,19,2100,188,656,844,Saturday
2014,7,19,2000,239,999,1238,Saturday
2014,7,19,1900,304,1043,1347,Saturday
2014,7,19,1800,368,760,1128,Saturday
2014,7,19,1700,486,786,1272,Saturday
2014,7,19,1600,554,950,1504,Saturday
2014,7,19,1500,782,800,1582,Saturday
2014,7,19,1400,899,660,1559,Saturday
2014,7,19,1300,1021,688,1709,Saturday
2014,7,19,1200,1374,523,1897,Saturday
2014,7,19,1100,1357,375,1732,Saturday
2014,7,19,1000,1158,233,1391,Saturday
2014,7,19,900,844,131,975,Saturday
2014,7,19,800,473,90,563,Saturday
2014,7,19,700,221,62,283,Saturday
2014,7,19,600,76,22,98,Saturday
2014,7,19,500,42,35,77,Saturday
2014,7,19,400,34,35,69,Saturday
2014,7,19,300,24,36,60,Saturday
2014,7,19,200,44,74,118,Saturday
2014,7,19,100,66,118,184,Saturday
2014,7,18,2400,119,219,338,Friday
2014,7,18,2300,221,205,426,Friday
2014,7,18,2200,353,145,498,Friday
2014,7,18,2100,594,332,926,Friday
2014,7,18,2000,888,553,1441,Friday
2014,7,18,1900,993,681,1674,Friday
2014,7,18,1800,922,872,1794,Friday
2014,7,18,1700,943,921,1864,Friday
2014,7,18,1600,1108,855,1963,Friday
2014,7,18,1500,1056,741,1797,Friday
2014,7,18,1400,980,703,1683,Friday
2014,7,18,1300,1027,591,1618,Friday
2014,7,18,1200,1172,486,1658,Friday
2014,7,18,1100,1109,331,1440,Friday
2014,7,18,1000,1036,176,1212,Friday
2014,7,18,900,779,150,929,Friday
2014,7,18,800,453,80,533,Friday
2014,7,18,700,216,51,267,Friday
2014,7,18,600,96,34,130,Friday
2014,7,18,500,54,38,92,Friday
2014,7,18,400,41,40,81,Friday
2014,7,18,300,34,38,72,Friday
2014,7,18,200,40,64,104,Friday
2014,7,18,100,84,85,169,Friday
2014,7,17,2400,108,98,206,Thursday
2014,7,17,2300,181,136,317,Thursday
2014,7,17,2200,260,201,461,Thursday
2014,7,17,2100,414,360,774,Thursday
2014,7,17,2000,522,493,1015,Thursday
2014,7,17,1900,524,708,1232,Thursday
2014,7,17,1800,568,876,1444,Thursday
2014,7,17,1700,639,859,1498,Thursday
2014,7,17,1600,623,818,1441,Thursday
2014,7,17,1500,642,675,1317,Thursday
2014,7,17,1400,674,559,1233,Thursday
2014,7,17,1300,824,534,1358,Thursday
2014,7,17,1200,940,399,1339,Thursday
2014,7,17,1100,974,278,1252,Thursday
2014,7,17,1000,874,188,1062,Thursday
2014,7,17,900,687,154,841,Thursday
2014,7,17,800,427,92,519,Thursday
2014,7,17,700,195,47,242,Thursday
2014,7,17,600,90,34,124,Thursday
2014,7,17,500,48,38,86,Thursday
2014,7,17,400,44,35,79,Thursday
2014,7,17,300,26,39,65,Thursday
2014,7,17,200,41,57,98,Thursday
2014,7,17,100,58,92,150,Thursday
2014,7,16,2400,106,119,225,Wednesday
2014,7,16,2300,145,160,305,Wednesday
2014,7,16,2200,173,290,463,Wednesday
2014,7,16,2100,242,365,607,Wednesday
2014,7,16,2000,298,543,841,Wednesday
2014,7,16,1900,299,688,987,Wednesday
2014,7,16,1800,363,826,1189,Wednesday
2014,7,16,1700,444,865,1309,Wednesday
2014,7,16,1600,519,816,1335,Wednesday
2014,7,16,1500,552,722,1274,Wednesday
2014,7,16,1400,550,383,933,Wednesday
2014,7,16,1300,699,461,1160,Wednesday
2014,7,16,1200,906,362,1268,Wednesday
2014,7,16,1100,938,247,1185,Wednesday
2014,7,16,1000,821,180,1001,Wednesday
2014,7,16,900,609,173,782,Wednesday
2014,7,16,800,390,88,478,Wednesday
2014,7,16,700,166,47,213,Wednesday
2014,7,16,600,56,38,94,Wednesday
2014,7,16,500,25,47,72,Wednesday
2014,7,16,400,28,32,60,Wednesday
2014,7,16,300,31,35,66,Wednesday
2014,7,16,200,37,51,88,Wednesday
2014,7,16,100,64,71,135,Wednesday
2014,7,15,2400,97,109,206,Tuesday
2014,7,15,2300,92,181,273,Tuesday
2014,7,15,2200,162,282,444,Tuesday
2014,7,15,2100,178,494,672,Tuesday
2014,7,15,2000,235,675,910,Tuesday
2014,7,15,1900,259,596,855,Tuesday
2014,7,15,1800,335,603,938,Tuesday
2014,7,15,1700,385,739,1124,Tuesday
2014,7,15,1600,455,737,1192,Tuesday
2014,7,15,1500,523,662,1185,Tuesday
2014,7,15,1400,590,511,1101,Tuesday
2014,7,15,1300,712,409,1121,Tuesday
2014,7,15,1200,830,392,1222,Tuesday
2014,7,15,1100,866,265,1131,Tuesday
2014,7,15,1000,894,234,1128,Tuesday
2014,7,15,900,624,154,778,Tuesday
2014,7,15,800,328,102,430,Tuesday
2014,7,15,700,184,62,246,Tuesday
2014,7,15,600,56,39,95,Tuesday
2014,7,15,500,29,36,65,Tuesday
2014,7,15,400,25,31,56,Tuesday
2014,7,15,300,37,49,86,Tuesday
2014,7,15,200,25,46,71,Tuesday
2014,7,15,100,53,63,116,Tuesday
2014,7,14,2400,80,117,197,Monday
2014,7,14,2300,92,190,282,Monday
2014,7,14,2200,155,274,429,Monday
2014,7,14,2100,211,463,674,Monday
2014,7,14,2000,235,686,921,Monday
2014,7,14,1900,285,881,1166,Monday
2014,7,14,1800,378,1017,1395,Monday
2014,7,14,1700,510,917,1427,Monday
2014,7,14,1600,535,781,1316,Monday
2014,7,14,1500,704,723,1427,Monday
2014,7,14,1400,781,638,1419,Monday
2014,7,14,1300,891,568,1459,Monday
2014,7,14,1200,1067,421,1488,Monday
2014,7,14,1100,1100,329,1429,Monday
2014,7,14,1000,919,227,1146,Monday
2014,7,14,900,691,160,851,Monday
2014,7,14,800,348,123,471,Monday
2014,7,14,700,153,76,229,Monday
2014,7,14,600,70,51,121,Monday
2014,7,14,500,23,36,59,Monday
2014,7,14,400,21,38,59,Monday
2014,7,14,300,31,40,71,Monday
2014,7,14,200,16,70,86,Monday
2014,7,14,100,49,115,164,Monday
2014,7,13,2400,79,201,280,Sunday
2014,7,13,2300,102,351,453,Sunday
2014,7,13,2200,134,541,675,Sunday
2014,7,13,2100,174,765,939,Sunday
2014,7,13,2000,251,1041,1292,Sunday
2014,7,13,1900,315,1240,1555,Sunday
2014,7,13,1800,373,1391,1764,Sunday
2014,7,13,1700,523,1437,1960,Sunday
2014,7,13,1600,600,1338,1938,Sunday
2014,7,13,1500,759,1215,1974,Sunday
2014,7,13,1400,868,1022,1890,Sunday
2014,7,13,1300,948,989,1937,Sunday
2014,7,13,1200,1141,676,1817,Sunday
2014,7,13,1100,1077,413,1490,Sunday
2014,7,13,1000,928,267,1195,Sunday
2014,7,13,900,635,124,759,Sunday
2014,7,13,800,345,77,422,Sunday
2014,7,13,700,119,33,152,Sunday
2014,7,13,600,62,18,80,Sunday
2014,7,13,500,34,28,62,Sunday
2014,7,13,400,32,24,56,Sunday
2014,7,13,300,22,40,62,Sunday
2014,7,13,200,38,33,71,Sunday
2014,7,13,100,38,85,123,Sunday
2014,7,12,2400,58,111,169,Saturday
2014,7,12,2300,100,200,300,Saturday
2014,7,12,2200,123,292,415,Saturday
2014,7,12,2100,168,535,703,Saturday
2014,7,12,2000,236,692,928,Saturday
2014,7,12,1900,274,914,1188,Saturday
2014,7,12,1800,376,1040,1416,Saturday
2014,7,12,1700,551,988,1539,Saturday
2014,7,12,1600,650,997,1647,Saturday
2014,7,12,1500,781,802,1583,Saturday
2014,7,12,1400,951,616,1567,Saturday
2014,7,12,1300,1133,550,1683,Saturday
2014,7,12,1200,1319,410,1729,Saturday
2014,7,12,1100,1336,326,1662,Saturday
2014,7,12,1000,1202,219,1421,Saturday
2014,7,12,900,896,113,1009,Saturday
2014,7,12,800,462,81,543,Saturday
2014,7,12,700,211,45,256,Saturday
2014,7,12,600,84,22,106,Saturday
2014,7,12,500,43,36,79,Saturday
2014,7,12,400,37,44,81,Saturday
2014,7,12,300,35,44,79,Saturday
2014,7,12,200,47,47,94,Saturday
2014,7,12,100,65,83,148,Saturday
2014,7,11,2400,141,130,271,Friday
2014,7,11,2300,201,167,368,Friday
2014,7,11,2200,316,279,595,Friday
2014,7,11,2100,500,457,957,Friday
2014,7,11,2000,734,559,1293,Friday
2014,7,11,1900,817,811,1628,Friday
2014,7,11,1800,875,842,1717,Friday
2014,7,11,1700,933,850,1783,Friday
2014,7,11,1600,1020,816,1836,Friday
2014,7,11,1500,1044,740,1784,Friday
2014,7,11,1400,987,592,1579,Friday
2014,7,11,1300,985,536,1521,Friday
2014,7,11,1200,1146,443,1589,Friday
2014,7,11,1100,1149,302,1451,Friday
2014,7,11,1000,973,243,1216,Friday
2014,7,11,900,684,171,855,Friday
2014,7,11,800,384,102,486,Friday
2014,7,11,700,197,55,252,Friday
2014,7,11,600,57,35,92,Friday
2014,7,11,500,47,45,92,Friday
2014,7,11,400,21,19,40,Friday
2014,7,11,300,38,52,90,Friday
2014,7,11,200,62,58,120,Friday
2014,7,11,100,81,85,166,Friday
2014,7,10,2400,111,158,269,Thursday
2014,7,10,2300,181,229,410,Thursday
2014,7,10,2200,201,322,523,Thursday
2014,7,10,2100,334,464,798,Thursday
2014,7,10,2000,445,627,1072,Thursday
2014,7,10,1900,479,771,1250,Thursday
2014,7,10,1800,539,823,1362,Thursday
2014,7,10,1700,623,812,1435,Thursday
2014,7,10,1600,608,744,1352,Thursday
2014,7,10,1500,731,678,1409,Thursday
2014,7,10,1400,746,557,1303,Thursday
2014,7,10,1300,797,502,1299,Thursday
2014,7,10,1200,972,427,1399,Thursday
2014,7,10,1100,998,329,1327,Thursday
2014,7,10,1000,801,240,1041,Thursday
2014,7,10,900,650,166,816,Thursday
2014,7,10,800,349,92,441,Thursday
2014,7,10,700,141,65,206,Thursday
2014,7,10,600,74,49,123,Thursday
2014,7,10,500,46,23,69,Thursday
2014,7,10,400,43,53,96,Thursday
2014,7,10,300,34,45,79,Thursday
2014,7,10,200,47,65,112,Thursday
2014,7,10,100,69,87,156,Thursday
2014,7,9,2400,94,135,229,Wednesday
2014,7,9,2300,123,226,349,Wednesday
2014,7,9,2200,167,294,461,Wednesday
2014,7,9,2100,214,433,647,Wednesday
2014,7,9,2000,253,620,873,Wednesday
2014,7,9,1900,274,773,1047,Wednesday
2014,7,9,1800,373,915,1288,Wednesday
2014,7,9,1700,384,820,1204,Wednesday
2014,7,9,1600,483,698,1181,Wednesday
2014,7,9,1500,501,613,1114,Wednesday
2014,7,9,1400,571,505,1076,Wednesday
2014,7,9,1300,734,448,1182,Wednesday
2014,7,9,1200,873,388,1261,Wednesday
2014,7,9,1100,934,286,1220,Wednesday
2014,7,9,1000,767,225,992,Wednesday
2014,7,9,900,545,161,706,Wednesday
2014,7,9,800,293,99,392,Wednesday
2014,7,9,700,123,63,186,Wednesday
2014,7,9,600,77,36,113,Wednesday
2014,7,9,500,29,35,64,Wednesday
2014,7,9,400,31,37,68,Wednesday
2014,7,9,300,24,34,58,Wednesday
2014,7,9,200,39,66,105,Wednesday
2014,7,9,100,45,90,135,Wednesday
2014,7,8,2400,84,131,215,Tuesday
2014,7,8,2300,108,211,319,Tuesday
2014,7,8,2200,153,282,435,Tuesday
2014,7,8,2100,159,420,579,Tuesday
2014,7,8,2000,208,592,800,Tuesday
2014,7,8,1900,252,694,946,Tuesday
2014,7,8,1800,284,879,1163,Tuesday
2014,7,8,1700,356,778,1134,Tuesday
2014,7,8,1600,440,678,1118,Tuesday
2014,7,8,1500,519,573,1092,Tuesday
2014,7,8,1400,555,499,1054,Tuesday
2014,7,8,1300,704,452,1156,Tuesday
2014,7,8,1200,745,378,1123,Tuesday
2014,7,8,1100,880,251,1131,Tuesday
2014,7,8,1000,779,213,992,Tuesday
2014,7,8,900,528,160,688,Tuesday
2014,7,8,800,265,104,369,Tuesday
2014,7,8,700,121,57,178,Tuesday
2014,7,8,600,47,38,85,Tuesday
2014,7,8,500,19,29,48,Tuesday
2014,7,8,400,30,32,62,Tuesday
2014,7,8,300,25,55,80,Tuesday
2014,7,8,200,32,53,85,Tuesday
2014,7,8,100,47,83,130,Tuesday
2014,7,7,2400,67,145,212,Monday
2014,7,7,2300,100,224,324,Monday
2014,7,7,2200,129,351,480,Monday
2014,7,7,2100,200,489,689,Monday
2014,7,7,2000,253,716,969,Monday
2014,7,7,1900,252,896,1148,Monday
2014,7,7,1800,329,965,1294,Monday
2014,7,7,1700,427,951,1378,Monday
2014,7,7,1600,509,847,1356,Monday
2014,7,7,1500,645,742,1387,Monday
2014,7,7,1400,695,572,1267,Monday
2014,7,7,1300,799,481,1280,Monday
2014,7,7,1200,972,437,1409,Monday
2014,7,7,1100,1023,284,1307,Monday
2014,7,7,1000,847,219,1066,Monday
2014,7,7,900,508,126,634,Monday
2014,7,7,800,271,96,367,Monday
2014,7,7,700,142,88,230,Monday
2014,7,7,600,63,43,106,Monday
2014,7,7,500,19,33,52,Monday
2014,7,7,400,16,27,43,Monday
2014,7,7,300,19,32,51,Monday
2014,7,7,200,24,67,91,Monday
2014,7,7,100,45,118,163,Monday
2014,7,6,2400,71,159,230,Sunday
2014,7,6,2300,77,292,369,Sunday
2014,7,6,2200,124,574,698,Sunday
2014,7,6,2100,180,941,1121,Sunday
2014,7,6,2000,231,1286,1517,Sunday
2014,7,6,1900,247,1638,1885,Sunday
2014,7,6,1800,370,1765,2135,Sunday
2014,7,6,1700,476,1745,2221,Sunday
2014,7,6,1600,605,1495,2100,Sunday
2014,7,6,1500,758,1235,1993,Sunday
2014,7,6,1400,848,1151,1999,Sunday
2014,7,6,1300,1026,882,1908,Sunday
2014,7,6,1200,919,636,1555,Sunday
2014,7,6,1100,942,434,1376,Sunday
2014,7,6,1000,831,243,1074,Sunday
2014,7,6,900,541,112,653,Sunday
2014,7,6,800,255,80,335,Sunday
2014,7,6,700,106,28,134,Sunday
2014,7,6,600,36,19,55,Sunday
2014,7,6,500,28,15,43,Sunday
2014,7,6,400,22,20,42,Sunday
2014,7,6,300,19,38,57,Sunday
2014,7,6,200,19,45,64,Sunday
2014,7,6,100,28,95,123,Sunday
2014,7,5,2400,52,137,189,Saturday
2014,7,5,2300,84,265,349,Saturday
2014,7,5,2200,133,404,537,Saturday
2014,7,5,2100,180,615,795,Saturday
2014,7,5,2000,238,746,984,Saturday
2014,7,5,1900,258,1104,1362,Saturday
2014,7,5,1800,344,1194,1538,Saturday
2014,7,5,1700,476,1109,1585,Saturday
2014,7,5,1600,578,910,1488,Saturday
2014,7,5,1500,755,796,1551,Saturday
2014,7,5,1400,762,650,1412,Saturday
2014,7,5,1300,1068,638,1706,Saturday
2014,7,5,1200,1208,481,1689,Saturday
2014,7,5,1100,1137,348,1485,Saturday
2014,7,5,1000,1012,202,1214,Saturday
2014,7,5,900,665,112,777,Saturday
2014,7,5,800,362,86,448,Saturday
2014,7,5,700,159,38,197,Saturday
2014,7,5,600,66,25,91,Saturday
2014,7,5,500,40,32,72,Saturday
2014,7,5,400,29,35,64,Saturday
2014,7,5,300,27,48,75,Saturday
2014,7,5,200,46,55,101,Saturday
2014,7,5,100,69,70,139,Saturday
2014,7,4,2400,109,146,255,Friday
2014,7,4,2300,164,199,363,Friday
2014,7,4,2200,272,350,622,Friday
2014,7,4,2100,378,459,837,Friday
2014,7,4,2000,528,658,1186,Friday
2014,7,4,1900,632,817,1449,Friday
2014,7,4,1800,611,950,1561,Friday
2014,7,4,1700,715,915,1630,Friday
2014,7,4,1600,807,888,1695,Friday
2014,7,4,1500,844,728,1572,Friday
2014,7,4,1400,769,653,1422,Friday
2014,7,4,1300,943,594,1537,Friday
2014,7,4,1200,1008,464,1472,Friday
2014,7,4,1100,928,365,1293,Friday
2014,7,4,1000,913,238,1151,Friday
2014,7,4,900,622,157,779,Friday
2014,7,4,800,351,95,446,Friday
2014,7,4,700,136,70,206,Friday
2014,7,4,600,85,45,130,Friday
2014,7,4,500,28,38,66,Friday
2014,7,4,400,23,50,73,Friday
2014,7,4,300,34,66,100,Friday
2014,7,4,200,38,53,91,Friday
2014,7,4,100,63,103,166,Friday
2014,7,3,2400,79,147,226,Thursday
2014,7,3,2300,117,194,311,Thursday
2014,7,3,2200,215,334,549,Thursday
2014,7,3,2100,308,488,796,Thursday
2014,7,3,2000,372,577,949,Thursday
2014,7,3,1900,383,907,1290,Thursday
2014,7,3,1800,440,1074,1514,Thursday
2014,7,3,1700,521,997,1518,Thursday
2014,7,3,1600,503,879,1382,Thursday
2014,7,3,1500,615,744,1359,Thursday
2014,7,3,1400,629,597,1226,Thursday
2014,7,3,1300,729,493,1222,Thursday
2014,7,3,1200,891,469,1360,Thursday
2014,7,3,1100,980,337,1317,Thursday
2014,7,3,1000,728,220,948,Thursday
2014,7,3,900,536,148,684,Thursday
2014,7,3,800,307,106,413,Thursday
2014,7,3,700,117,69,186,Thursday
2014,7,3,600,62,41,103,Thursday
2014,7,3,500,28,40,68,Thursday
2014,7,3,400,29,39,68,Thursday
2014,7,3,300,33,49,82,Thursday
2014,7,3,200,42,57,99,Thursday
2014,7,3,100,56,110,166,Thursday
2014,7,2,2400,84,145,229,Wednesday
2014,7,2,2300,111,249,360,Wednesday
2014,7,2,2200,132,442,574,Wednesday
2014,7,2,2100,177,582,759,Wednesday
2014,7,2,2000,241,868,1109,Wednesday
2014,7,2,1900,265,908,1173,Wednesday
2014,7,2,1800,334,1051,1385,Wednesday
2014,7,2,1700,382,1043,1425,Wednesday
2014,7,2,1600,453,876,1329,Wednesday
2014,7,2,1500,559,760,1319,Wednesday
2014,7,2,1400,586,644,1230,Wednesday
2014,7,2,1300,761,501,1262,Wednesday
2014,7,2,1200,878,406,1284,Wednesday
2014,7,2,1100,874,315,1189,Wednesday
2014,7,2,1000,778,196,974,Wednesday
2014,7,2,900,532,172,704,Wednesday
2014,7,2,800,268,159,427,Wednesday
2014,7,2,700,133,89,222,Wednesday
2014,7,2,600,51,52,103,Wednesday
2014,7,2,500,23,27,50,Wednesday
2014,7,2,400,11,32,43,Wednesday
2014,7,2,300,18,49,67,Wednesday
2014,7,2,200,18,71,89,Wednesday
2014,7,2,100,46,112,158,Wednesday
2014,7,1,2400,85,227,312,Tuesday
2014,7,1,2300,83,440,523,Tuesday
2014,7,1,2200,106,746,852,Tuesday
2014,7,1,2100,144,1203,1347,Tuesday
2014,7,1,2000,159,1496,1655,Tuesday
2014,7,1,1900,208,1887,2095,Tuesday
2014,7,1,1800,222,1856,2078,Tuesday
2014,7,1,1700,356,1710,2066,Tuesday
2014,7,1,1600,423,1741,2164,Tuesday
2014,7,1,1500,627,1440,2067,Tuesday
2014,7,1,1400,671,1124,1795,Tuesday
2014,7,1,1300,852,856,1708,Tuesday
2014,7,1,1200,1039,719,1758,Tuesday
2014,7,1,1100,1100,441,1541,Tuesday
2014,7,1,1000,1054,265,1319,Tuesday
2014,7,1,900,675,161,836,Tuesday
2014,7,1,800,362,91,453,Tuesday
2014,7,1,700,147,61,208,Tuesday
2014,7,1,600,56,37,93,Tuesday
2014,7,1,500,37,37,74,Tuesday
2014,7,1,400,32,48,80,Tuesday
2014,7,1,300,30,50,80,Tuesday
2014,7,1,200,36,75,111,Tuesday
2014,7,1,100,46,131,177,Tuesday
2014,6,30,2400,87,208,295,Monday
2014,6,30,2300,124,335,459,Monday
2014,6,30,2200,165,572,737,Monday
2014,6,30,2100,190,696,886,Monday
2014,6,30,2000,268,871,1139,Monday
2014,6,30,1900,326,1240,1566,Monday
2014,6,30,1800,458,1327,1785,Monday
2014,6,30,1700,511,1265,1776,Monday
2014,6,30,1600,566,1069,1635,Monday
2014,6,30,1500,699,878,1577,Monday
2014,6,30,1400,762,837,1599,Monday
2014,6,30,1300,862,614,1476,Monday
2014,6,30,1200,1057,486,1543,Monday
2014,6,30,1100,1054,374,1428,Monday
2014,6,30,1000,847,214,1061,Monday
2014,6,30,900,573,138,711,Monday
2014,6,30,800,278,98,376,Monday
2014,6,30,700,127,49,176,Monday
2014,6,30,600,53,28,81,Monday
2014,6,30,500,29,27,56,Monday
2014,6,30,400,20,41,61,Monday
2014,6,30,300,21,45,66,Monday
2014,6,30,200,23,61,84,Monday
2014,6,30,100,37,125,162,Monday
2014,6,29,2400,45,199,244,Sunday
2014,6,29,2300,87,262,349,Sunday
2014,6,29,2200,135,475,610,Sunday
2014,6,29,2100,206,631,837,Sunday
2014,6,29,2000,266,940,1206,Sunday
2014,6,29,1900,365,1071,1436,Sunday
2014,6,29,1800,405,1177,1582,Sunday
2014,6,29,1700,505,1049,1554,Sunday
2014,6,29,1600,698,1073,1771,Sunday
2014,6,29,1500,834,852,1686,Sunday
2014,6,29,1400,1003,735,1738,Sunday
2014,6,29,1300,1253,577,1830,Sunday
2014,6,29,1200,1092,450,1542,Sunday
2014,6,29,1100,1128,295,1423,Sunday
2014,6,29,1000,874,159,1033,Sunday
2014,6,29,900,609,93,702,Sunday
2014,6,29,800,317,53,370,Sunday
2014,6,29,700,159,31,190,Sunday
2014,6,29,600,59,19,78,Sunday
2014,6,29,500,32,22,54,Sunday
2014,6,29,400,26,17,43,Sunday
2014,6,29,300,23,24,47,Sunday
2014,6,29,200,24,42,66,Sunday
2014,6,29,100,49,55,104,Sunday
2014,6,28,2400,57,101,158,Saturday
2014,6,28,2300,138,191,329,Saturday
2014,6,28,2200,156,247,403,Saturday
2014,6,28,2100,243,448,691,Saturday
2014,6,28,2000,355,621,976,Saturday
2014,6,28,1900,481,758,1239,Saturday
2014,6,28,1800,528,806,1334,Saturday
2014,6,28,1700,757,817,1574,Saturday
2014,6,28,1600,904,759,1663,Saturday
2014,6,28,1500,1147,550,1697,Saturday
2014,6,28,1400,1184,463,1647,Saturday
2014,6,28,1300,1480,430,1910,Saturday
2014,6,28,1200,1620,368,1988,Saturday
2014,6,28,1100,1665,302,1967,Saturday
2014,6,28,1000,1323,180,1503,Saturday
2014,6,28,900,1031,123,1154,Saturday
2014,6,28,800,720,91,811,Saturday
2014,6,28,700,369,52,421,Saturday
2014,6,28,600,147,38,185,Saturday
2014,6,28,500,69,21,90,Saturday
2014,6,28,400,46,39,85,Saturday
2014,6,28,300,58,46,104,Saturday
2014,6,28,200,69,52,121,Saturday
2014,6,28,100,102,82,184,Saturday
2014,6,27,2400,207,96,303,Friday
2014,6,27,2300,343,134,477,Friday
2014,6,27,2200,506,197,703,Friday
2014,6,27,2100,918,326,1244,Friday
2014,6,27,2000,1258,452,1710,Friday
2014,6,27,1900,1432,718,2150,Friday
2014,6,27,1800,1395,696,2091,Friday
2014,6,27,1700,1443,668,2111,Friday
2014,6,27,1600,1504,709,2213,Friday
2014,6,27,1500,1427,555,1982,Friday
2014,6,27,1400,1268,444,1712,Friday
2014,6,27,1300,1218,412,1630,Friday
2014,6,27,1200,1429,381,1810,Friday
2014,6,27,1100,1360,278,1638,Friday
2014,6,27,1000,1175,184,1359,Friday
2014,6,27,900,841,151,992,Friday
2014,6,27,800,504,93,597,Friday
2014,6,27,700,272,53,325,Friday
2014,6,27,600,114,40,154,Friday
2014,6,27,500,69,41,110,Friday
2014,6,27,400,51,30,81,Friday
2014,6,27,300,46,49,95,Friday
2014,6,27,200,53,49,102,Friday
2014,6,27,100,88,77,165,Friday
2014,6,26,2400,128,124,252,Thursday
2014,6,26,2300,179,176,355,Thursday
2014,6,26,2200,280,227,507,Thursday
2014,6,26,2100,446,355,801,Thursday
2014,6,26,2000,590,446,1036,Thursday
2014,6,26,1900,593,538,1131,Thursday
2014,6,26,1800,636,634,1270,Thursday
2014,6,26,1700,632,581,1213,Thursday
2014,6,26,1600,669,569,1238,Thursday
2014,6,26,1500,659,502,1161,Thursday
2014,6,26,1400,676,420,1096,Thursday
2014,6,26,1300,714,339,1053,Thursday
2014,6,26,1200,802,297,1099,Thursday
2014,6,26,1100,827,275,1102,Thursday
2014,6,26,1000,716,156,872,Thursday
2014,6,26,900,539,151,690,Thursday
2014,6,26,800,303,102,405,Thursday
2014,6,26,700,158,52,210,Thursday
2014,6,26,600,74,45,119,Thursday
2014,6,26,500,37,23,60,Thursday
2014,6,26,400,48,38,86,Thursday
2014,6,26,300,30,39,69,Thursday
2014,6,26,200,61,49,110,Thursday
2014,6,26,100,55,92,147,Thursday
2014,6,25,2400,99,109,208,Wednesday
2014,6,25,2300,139,141,280,Wednesday
2014,6,25,2200,168,183,351,Wednesday
2014,6,25,2100,187,303,490,Wednesday
2014,6,25,2000,268,431,699,Wednesday
2014,6,25,1900,259,528,787,Wednesday
2014,6,25,1800,288,609,897,Wednesday
2014,6,25,1700,372,548,920,Wednesday
2014,6,25,1600,357,463,820,Wednesday
2014,6,25,1500,471,378,849,Wednesday
2014,6,25,1400,496,374,870,Wednesday
2014,6,25,1300,492,309,801,Wednesday
2014,6,25,1200,618,293,911,Wednesday
2014,6,25,1100,619,277,896,Wednesday
2014,6,25,1000,565,178,743,Wednesday
2014,6,25,900,377,129,506,Wednesday
2014,6,25,800,221,98,319,Wednesday
2014,6,25,700,92,47,139,Wednesday
2014,6,25,600,64,49,113,Wednesday
2014,6,25,500,26,23,49,Wednesday
2014,6,25,400,29,32,61,Wednesday
2014,6,25,300,33,35,68,Wednesday
2014,6,25,200,30,38,68,Wednesday
2014,6,25,100,49,85,134,Wednesday
2014,6,24,2400,86,77,163,Tuesday
2014,6,24,2300,96,154,250,Tuesday
2014,6,24,2200,123,209,332,Tuesday
2014,6,24,2100,166,293,459,Tuesday
2014,6,24,2000,177,394,571,Tuesday
2014,6,24,1900,175,430,605,Tuesday
2014,6,24,1800,220,599,819,Tuesday
2014,6,24,1700,298,632,930,Tuesday
2014,6,24,1600,346,659,1005,Tuesday
2014,6,24,1500,382,409,791,Tuesday
2014,6,24,1400,384,415,799,Tuesday
2014,6,24,1300,471,414,885,Tuesday
2014,6,24,1200,538,238,776,Tuesday
2014,6,24,1100,587,160,747,Tuesday
2014,6,24,1000,521,185,706,Tuesday
2014,6,24,900,361,135,496,Tuesday
2014,6,24,800,243,99,342,Tuesday
2014,6,24,700,97,73,170,Tuesday
2014,6,24,600,51,37,88,Tuesday
2014,6,24,500,24,33,57,Tuesday
2014,6,24,400,21,25,46,Tuesday
2014,6,24,300,20,47,67,Tuesday
2014,6,24,200,31,52,83,Tuesday
2014,6,24,100,41,55,96,Tuesday
2014,6,23,2400,72,111,183,Monday
2014,6,23,2300,91,166,257,Monday
2014,6,23,2200,113,246,359,Monday
2014,6,23,2100,164,392,556,Monday
2014,6,23,2000,206,470,676,Monday
2014,6,23,1900,210,554,764,Monday
2014,6,23,1800,260,673,933,Monday
2014,6,23,1700,327,672,999,Monday
2014,6,23,1600,362,587,949,Monday
2014,6,23,1500,423,597,1020,Monday
2014,6,23,1400,464,466,930,Monday
2014,6,23,1300,530,346,876,Monday
2014,6,23,1200,645,333,978,Monday
2014,6,23,1100,628,278,906,Monday
2014,6,23,1000,601,165,766,Monday
2014,6,23,900,419,149,568,Monday
2014,6,23,800,261,109,370,Monday
2014,6,23,700,106,53,159,Monday
2014,6,23,600,57,41,98,Monday
2014,6,23,500,32,22,54,Monday
2014,6,23,400,15,28,43,Monday
2014,6,23,300,16,39,55,Monday
2014,6,23,200,22,51,73,Monday
2014,6,23,100,29,107,136,Monday
2014,6,22,2400,41,162,203,Sunday
2014,6,22,2300,77,320,397,Sunday
2014,6,22,2200,102,510,612,Sunday
2014,6,22,2100,170,617,787,Sunday
2014,6,22,2000,204,966,1170,Sunday
2014,6,22,1900,252,1181,1433,Sunday
2014,6,22,1800,305,1242,1547,Sunday
2014,6,22,1700,360,1221,1581,Sunday
2014,6,22,1600,448,1171,1619,Sunday
2014,6,22,1500,488,985,1473,Sunday
2014,6,22,1400,550,792,1342,Sunday
2014,6,22,1300,651,726,1377,Sunday
2014,6,22,1200,752,524,1276,Sunday
2014,6,22,1100,718,374,1092,Sunday
2014,6,22,1000,576,227,803,Sunday
2014,6,22,900,359,99,458,Sunday
2014,6,22,800,235,65,300,Sunday
2014,6,22,700,80,34,114,Sunday
2014,6,22,600,38,18,56,Sunday
2014,6,22,500,23,17,40,Sunday
2014,6,22,400,16,15,31,Sunday
2014,6,22,300,24,29,53,Sunday
2014,6,22,200,33,33,66,Sunday
2014,6,22,100,46,46,92,Sunday
2014,6,21,2400,61,116,177,Saturday
2014,6,21,2300,88,155,243,Saturday
2014,6,21,2200,151,246,397,Saturday
2014,6,21,2100,177,353,530,Saturday
2014,6,21,2000,183,502,685,Saturday
2014,6,21,1900,209,678,887,Saturday
2014,6,21,1800,272,699,971,Saturday
2014,6,21,1700,372,645,1017,Saturday
2014,6,21,1600,477,568,1045,Saturday
2014,6,21,1500,520,525,1045,Saturday
2014,6,21,1400,652,393,1045,Saturday
2014,6,21,1300,741,373,1114,Saturday
2014,6,21,1200,788,324,1112,Saturday
2014,6,21,1100,799,274,1073,Saturday
2014,6,21,1000,668,199,867,Saturday
2014,6,21,900,506,110,616,Saturday
2014,6,21,800,241,64,305,Saturday
2014,6,21,700,121,43,164,Saturday
2014,6,21,600,61,29,90,Saturday
2014,6,21,500,34,21,55,Saturday
2014,6,21,400,16,35,51,Saturday
2014,6,21,300,25,37,62,Saturday
2014,6,21,200,39,45,84,Saturday
2014,6,21,100,53,57,110,Saturday
2014,6,20,2400,102,83,185,Friday
2014,6,20,2300,161,146,307,Friday
2014,6,20,2200,259,186,445,Friday
2014,6,20,2100,476,285,761,Friday
2014,6,20,2000,653,418,1071,Friday
2014,6,20,1900,733,488,1221,Friday
2014,6,20,1800,718,573,1291,Friday
2014,6,20,1700,644,573,1217,Friday
2014,6,20,1600,699,544,1243,Friday
2014,6,20,1500,645,503,1148,Friday
2014,6,20,1400,605,444,1049,Friday
2014,6,20,1300,665,370,1035,Friday
2014,6,20,1200,714,339,1053,Friday
2014,6,20,1100,789,263,1052,Friday
2014,6,20,1000,680,192,872,Friday
2014,6,20,900,483,111,594,Friday
2014,6,20,800,266,87,353,Friday
2014,6,20,700,150,55,205,Friday
2014,6,20,600,75,39,114,Friday
2014,6,20,500,42,24,66,Friday
2014,6,20,400,30,32,62,Friday
2014,6,20,300,30,46,76,Friday
2014,6,20,200,39,47,86,Friday
2014,6,20,100,48,74,122,Friday
2014,6,19,2400,92,84,176,Thursday
2014,6,19,2300,109,150,259,Thursday
2014,6,19,2200,175,206,381,Thursday
2014,6,19,2100,268,319,587,Thursday
2014,6,19,2000,342,357,699,Thursday
2014,6,19,1900,353,471,824,Thursday
2014,6,19,1800,386,548,934,Thursday
2014,6,19,1700,425,537,962,Thursday
2014,6,19,1600,438,443,881,Thursday
2014,6,19,1500,488,410,898,Thursday
2014,6,19,1400,441,345,786,Thursday
2014,6,19,1300,550,313,863,Thursday
2014,6,19,1200,660,279,939,Thursday
2014,6,19,1100,643,215,858,Thursday
2014,6,19,1000,648,193,841,Thursday
2014,6,19,900,431,130,561,Thursday
2014,6,19,800,204,90,294,Thursday
2014,6,19,700,134,59,193,Thursday
2014,6,19,600,54,40,94,Thursday
2014,6,19,500,30,38,68,Thursday
2014,6,19,400,29,34,63,Thursday
2014,6,19,300,27,35,62,Thursday
2014,6,19,200,34,33,67,Thursday
2014,6,19,100,44,67,111,Thursday
2014,6,18,2400,66,100,166,Wednesday
2014,6,18,2300,89,144,233,Wednesday
2014,6,18,2200,155,190,345,Wednesday
2014,6,18,2100,176,260,436,Wednesday
2014,6,18,2000,206,338,544,Wednesday
2014,6,18,1900,198,457,655,Wednesday
2014,6,18,1800,240,525,765,Wednesday
2014,6,18,1700,334,550,884,Wednesday
2014,6,18,1600,327,489,816,Wednesday
2014,6,18,1500,390,357,747,Wednesday
2014,6,18,1400,399,313,712,Wednesday
2014,6,18,1300,433,270,703,Wednesday
2014,6,18,1200,549,251,800,Wednesday
2014,6,18,1100,528,194,722,Wednesday
2014,6,18,1000,513,197,710,Wednesday
2014,6,18,900,319,152,471,Wednesday
2014,6,18,800,180,81,261,Wednesday
2014,6,18,700,133,52,185,Wednesday
2014,6,18,600,55,29,84,Wednesday
2014,6,18,500,32,34,66,Wednesday
2014,6,18,400,23,35,58,Wednesday
2014,6,18,300,25,34,59,Wednesday
2014,6,18,200,28,46,74,Wednesday
2014,6,18,100,50,55,105,Wednesday
2014,6,17,2400,63,96,159,Tuesday
2014,6,17,2300,94,134,228,Tuesday
2014,6,17,2200,102,201,303,Tuesday
2014,6,17,2100,151,247,398,Tuesday
2014,6,17,2000,151,326,477,Tuesday
2014,6,17,1900,175,410,585,Tuesday
2014,6,17,1800,196,457,653,Tuesday
2014,6,17,1700,270,498,768,Tuesday
2014,6,17,1600,273,415,688,Tuesday
2014,6,17,1500,346,340,686,Tuesday
2014,6,17,1400,352,295,647,Tuesday
2014,6,17,1300,365,274,639,Tuesday
2014,6,17,1200,485,250,735,Tuesday
2014,6,17,1100,519,205,724,Tuesday
2014,6,17,1000,455,160,615,Tuesday
2014,6,17,900,311,126,437,Tuesday
2014,6,17,800,162,75,237,Tuesday
2014,6,17,700,103,44,147,Tuesday
2014,6,17,600,38,36,74,Tuesday
2014,6,17,500,29,38,67,Tuesday
2014,6,17,400,15,27,42,Tuesday
2014,6,17,300,15,38,53,Tuesday
2014,6,17,200,30,42,72,Tuesday
2014,6,17,100,39,73,112,Tuesday
2014,6,16,2400,53,94,147,Monday
2014,6,16,2300,79,112,191,Monday
2014,6,16,2200,97,190,287,Monday
2014,6,16,2100,122,284,406,Monday
2014,6,16,2000,155,369,524,Monday
2014,6,16,1900,181,497,678,Monday
2014,6,16,1800,219,555,774,Monday
2014,6,16,1700,284,633,917,Monday
2014,6,16,1600,328,601,929,Monday
2014,6,16,1500,396,480,876,Monday
2014,6,16,1400,406,378,784,Monday
2014,6,16,1300,447,366,813,Monday
2014,6,16,1200,526,312,838,Monday
2014,6,16,1100,607,211,818,Monday
2014,6,16,1000,507,170,677,Monday
2014,6,16,900,302,116,418,Monday
2014,6,16,800,206,77,283,Monday
2014,6,16,700,116,54,170,Monday
2014,6,16,600,46,35,81,Monday
2014,6,16,500,13,18,31,Monday
2014,6,16,400,13,21,34,Monday
2014,6,16,300,16,20,36,Monday
2014,6,16,200,17,50,67,Monday
2014,6,16,100,22,64,86,Monday
2014,6,15,2400,30,124,154,Sunday
2014,6,15,2300,68,208,276,Sunday
2014,6,15,2200,100,276,376,Sunday
2014,6,15,2100,130,456,586,Sunday
2014,6,15,2000,154,616,770,Sunday
2014,6,15,1900,198,775,973,Sunday
2014,6,15,1800,243,894,1137,Sunday
2014,6,15,1700,346,1047,1393,Sunday
2014,6,15,1600,358,1076,1434,Sunday
2014,6,15,1500,432,902,1334,Sunday
2014,6,15,1400,447,800,1247,Sunday
2014,6,15,1300,489,616,1105,Sunday
2014,6,15,1200,541,496,1037,Sunday
2014,6,15,1100,536,276,812,Sunday
2014,6,15,1000,413,177,590,Sunday
2014,6,15,900,259,111,370,Sunday
2014,6,15,800,156,51,207,Sunday
2014,6,15,700,71,28,99,Sunday
2014,6,15,600,30,7,37,Sunday
2014,6,15,500,19,16,35,Sunday
2014,6,15,400,12,13,25,Sunday
2014,6,15,300,12,23,35,Sunday
2014,6,15,200,19,29,48,Sunday
2014,6,15,100,31,45,76,Sunday
2014,6,14,2400,36,98,134,Saturday
2014,6,14,2300,65,124,189,Saturday
2014,6,14,2200,97,199,296,Saturday
2014,6,14,2100,144,307,451,Saturday
2014,6,14,2000,158,371,529,Saturday
2014,6,14,1900,195,486,681,Saturday
2014,6,14,1800,224,626,850,Saturday
2014,6,14,1700,327,569,896,Saturday
2014,6,14,1600,358,573,931,Saturday
2014,6,14,1500,451,467,918,Saturday
2014,6,14,1400,486,357,843,Saturday
2014,6,14,1300,565,365,930,Saturday
2014,6,14,1200,680,299,979,Saturday
2014,6,14,1100,646,236,882,Saturday
2014,6,14,1000,573,153,726,Saturday
2014,6,14,900,381,120,501,Saturday
2014,6,14,800,208,65,273,Saturday
2014,6,14,700,102,38,140,Saturday
2014,6,14,600,40,26,66,Saturday
2014,6,14,500,33,25,58,Saturday
2014,6,14,400,24,25,49,Saturday
2014,6,14,300,24,30,54,Saturday
2014,6,14,200,23,35,58,Saturday
2014,6,14,100,52,40,92,Saturday
2014,6,13,2400,66,81,147,Friday
2014,6,13,2300,113,106,219,Friday
2014,6,13,2200,219,139,358,Friday
2014,6,13,2100,380,199,579,Friday
2014,6,13,2000,586,316,902,Friday
2014,6,13,1900,594,395,989,Friday
2014,6,13,1800,619,432,1051,Friday
2014,6,13,1700,644,475,1119,Friday
2014,6,13,1600,586,491,1077,Friday
2014,6,13,1500,575,466,1041,Friday
2014,6,13,1400,544,467,1011,Friday
2014,6,13,1300,541,414,955,Friday
2014,6,13,1200,634,313,947,Friday
2014,6,13,1100,600,240,840,Friday
2014,6,13,1000,525,162,687,Friday
2014,6,13,900,461,132,593,Friday
2014,6,13,800,273,90,363,Friday
2014,6,13,700,117,56,173,Friday
2014,6,13,600,74,33,107,Friday
2014,6,13,500,27,29,56,Friday
2014,6,13,400,39,46,85,Friday
2014,6,13,300,40,33,73,Friday
2014,6,13,200,44,42,86,Friday
2014,6,13,100,60,65,125,Friday
2014,6,12,2400,88,92,180,Thursday
2014,6,12,2300,116,143,259,Thursday
2014,6,12,2200,174,186,360,Thursday
2014,6,12,2100,281,272,553,Thursday
2014,6,12,2000,290,326,616,Thursday
2014,6,12,1900,332,417,749,Thursday
2014,6,12,1800,345,452,797,Thursday
2014,6,12,1700,401,462,863,Thursday
2014,6,12,1600,402,461,863,Thursday
2014,6,12,1500,401,446,847,Thursday
2014,6,12,1400,403,350,753,Thursday
2014,6,12,1300,462,337,799,Thursday
2014,6,12,1200,545,270,815,Thursday
2014,6,12,1100,552,192,744,Thursday
2014,6,12,1000,483,143,626,Thursday
2014,6,12,900,351,125,476,Thursday
2014,6,12,800,191,75,266,Thursday
2014,6,12,700,120,50,170,Thursday
2014,6,12,600,50,44,94,Thursday
2014,6,12,500,25,29,54,Thursday
2014,6,12,400,28,30,58,Thursday
2014,6,12,300,29,44,73,Thursday
2014,6,12,200,29,59,88,Thursday
2014,6,12,100,44,66,110,Thursday
2014,6,11,2400,75,79,154,Wednesday
2014,6,11,2300,101,127,228,Wednesday
2014,6,11,2200,137,173,310,Wednesday
2014,6,11,2100,185,249,434,Wednesday
2014,6,11,2000,210,340,550,Wednesday
2014,6,11,1900,211,391,602,Wednesday
2014,6,11,1800,229,458,687,Wednesday
2014,6,11,1700,281,417,698,Wednesday
2014,6,11,1600,337,399,736,Wednesday
2014,6,11,1500,365,333,698,Wednesday
2014,6,11,1400,374,317,691,Wednesday
2014,6,11,1300,382,256,638,Wednesday
2014,6,11,1200,429,263,692,Wednesday
2014,6,11,1100,490,184,674,Wednesday
2014,6,11,1000,433,173,606,Wednesday
2014,6,11,900,309,103,412,Wednesday
2014,6,11,800,182,89,271,Wednesday
2014,6,11,700,95,49,144,Wednesday
2014,6,11,600,38,39,77,Wednesday
2014,6,11,500,26,25,51,Wednesday
2014,6,11,400,28,42,70,Wednesday
2014,6,11,300,32,35,67,Wednesday
2014,6,11,200,33,43,76,Wednesday
2014,6,11,100,53,56,109,Wednesday
2014,6,10,2400,67,82,149,Tuesday
2014,6,10,2300,80,133,213,Tuesday
2014,6,10,2200,122,194,316,Tuesday
2014,6,10,2100,141,254,395,Tuesday
2014,6,10,2000,175,334,509,Tuesday
2014,6,10,1900,186,390,576,Tuesday
2014,6,10,1800,186,473,659,Tuesday
2014,6,10,1700,248,438,686,Tuesday
2014,6,10,1600,282,439,721,Tuesday
2014,6,10,1500,285,355,640,Tuesday
2014,6,10,1400,336,288,624,Tuesday
2014,6,10,1300,335,262,597,Tuesday
2014,6,10,1200,434,240,674,Tuesday
2014,6,10,1100,467,205,672,Tuesday
2014,6,10,1000,417,182,599,Tuesday
2014,6,10,900,307,134,441,Tuesday
2014,6,10,800,169,83,252,Tuesday
2014,6,10,700,85,52,137,Tuesday
2014,6,10,600,49,35,84,Tuesday
2014,6,10,500,16,27,43,Tuesday
2014,6,10,400,23,36,59,Tuesday
2014,6,10,300,18,51,69,Tuesday
2014,6,10,200,23,49,72,Tuesday
2014,6,10,100,53,63,116,Tuesday
2014,6,9,2400,66,103,169,Monday
2014,6,9,2300,70,153,223,Monday
2014,6,9,2200,99,187,286,Monday
2014,6,9,2100,136,305,441,Monday
2014,6,9,2000,181,431,612,Monday
2014,6,9,1900,158,504,662,Monday
2014,6,9,1800,225,606,831,Monday
2014,6,9,1700,262,638,900,Monday
2014,6,9,1600,330,503,833,Monday
2014,6,9,1500,392,459,851,Monday
2014,6,9,1400,373,462,835,Monday
2014,6,9,1300,474,365,839,Monday
2014,6,9,1200,504,308,812,Monday
2014,6,9,1100,573,236,809,Monday
2014,6,9,1000,440,167,607,Monday
2014,6,9,900,318,146,464,Monday
2014,6,9,800,156,109,265,Monday
2014,6,9,700,105,63,168,Monday
2014,6,9,600,46,37,83,Monday
2014,6,9,500,22,41,63,Monday
2014,6,9,400,21,47,68,Monday
2014,6,9,300,16,56,72,Monday
2014,6,9,200,21,87,108,Monday
2014,6,9,100,30,106,136,Monday
2014,6,8,2400,41,205,246,Sunday
2014,6,8,2300,72,285,357,Sunday
2014,6,8,2200,95,470,565,Sunday
2014,6,8,2100,132,657,789,Sunday
2014,6,8,2000,156,852,1008,Sunday
2014,6,8,1900,219,1014,1233,Sunday
2014,6,8,1800,271,1101,1372,Sunday
2014,6,8,1700,309,1280,1589,Sunday
2014,6,8,1600,419,1105,1524,Sunday
2014,6,8,1500,439,969,1408,Sunday
2014,6,8,1400,507,920,1427,Sunday
2014,6,8,1300,566,702,1268,Sunday
2014,6,8,1200,641,569,1210,Sunday
2014,6,8,1100,580,339,919,Sunday
2014,6,8,1000,485,225,710,Sunday
2014,6,8,900,315,114,429,Sunday
2014,6,8,800,163,45,208,Sunday
2014,6,8,700,91,25,116,Sunday
2014,6,8,600,29,13,42,Sunday
2014,6,8,500,12,12,24,Sunday
2014,6,8,400,16,23,39,Sunday
2014,6,8,300,13,10,23,Sunday
2014,6,8,200,14,21,35,Sunday
2014,6,8,100,33,45,78,Sunday
2014,6,7,2400,57,100,157,Saturday
2014,6,7,2300,71,138,209,Saturday
2014,6,7,2200,94,180,274,Saturday
2014,6,7,2100,161,332,493,Saturday
2014,6,7,2000,141,382,523,Saturday
2014,6,7,1900,193,513,706,Saturday
2014,6,7,1800,260,573,833,Saturday
2014,6,7,1700,308,614,922,Saturday
2014,6,7,1600,396,483,879,Saturday
2014,6,7,1500,399,411,810,Saturday
2014,6,7,1400,450,356,806,Saturday
2014,6,7,1300,577,321,898,Saturday
2014,6,7,1200,673,303,976,Saturday
2014,6,7,1100,707,221,928,Saturday
2014,6,7,1000,583,130,713,Saturday
2014,6,7,900,433,108,541,Saturday
2014,6,7,800,227,61,288,Saturday
2014,6,7,700,131,44,175,Saturday
2014,6,7,600,62,34,96,Saturday
2014,6,7,500,27,24,51,Saturday
2014,6,7,400,24,23,47,Saturday
2014,6,7,300,18,28,46,Saturday
2014,6,7,200,31,30,61,Saturday
2014,6,7,100,60,46,106,Saturday
2014,6,6,2400,82,102,184,Friday
2014,6,6,2300,124,119,243,Friday
2014,6,6,2200,228,206,434,Friday
2014,6,6,2100,411,222,633,Friday
2014,6,6,2000,573,308,881,Friday
2014,6,6,1900,691,411,1102,Friday
2014,6,6,1800,775,494,1269,Friday
2014,6,6,1700,747,536,1283,Friday
2014,6,6,1600,687,457,1144,Friday
2014,6,6,1500,642,373,1015,Friday
2014,6,6,1400,516,331,847,Friday
2014,6,6,1300,480,305,785,Friday
2014,6,6,1200,587,290,877,Friday
2014,6,6,1100,587,204,791,Friday
2014,6,6,1000,553,170,723,Friday
2014,6,6,900,398,131,529,Friday
2014,6,6,800,238,84,322,Friday
2014,6,6,700,109,36,145,Friday
2014,6,6,600,54,40,94,Friday
2014,6,6,500,28,31,59,Friday
2014,6,6,400,27,36,63,Friday
2014,6,6,300,23,36,59,Friday
2014,6,6,200,33,39,72,Friday
2014,6,6,100,51,46,97,Friday
2014,6,5,2400,71,96,167,Thursday
2014,6,5,2300,101,133,234,Thursday
2014,6,5,2200,175,160,335,Thursday
2014,6,5,2100,232,181,413,Thursday
2014,6,5,2000,295,247,542,Thursday
2014,6,5,1900,360,374,734,Thursday
2014,6,5,1800,359,426,785,Thursday
2014,6,5,1700,412,419,831,Thursday
2014,6,5,1600,413,403,816,Thursday
2014,6,5,1500,382,382,764,Thursday
2014,6,5,1400,423,272,695,Thursday
2014,6,5,1300,401,283,684,Thursday
2014,6,5,1200,424,234,658,Thursday
2014,6,5,1100,506,180,686,Thursday
2014,6,5,1000,462,153,615,Thursday
2014,6,5,900,361,112,473,Thursday
2014,6,5,800,209,85,294,Thursday
2014,6,5,700,114,40,154,Thursday
2014,6,5,600,49,48,97,Thursday
2014,6,5,500,32,27,59,Thursday
2014,6,5,400,17,34,51,Thursday
2014,6,5,300,27,25,52,Thursday
2014,6,5,200,27,67,94,Thursday
2014,6,5,100,47,60,107,Thursday
2014,6,4,2400,69,63,132,Wednesday
2014,6,4,2300,87,104,191,Wednesday
2014,6,4,2200,118,148,266,Wednesday
2014,6,4,2100,152,195,347,Wednesday
2014,6,4,2000,199,254,453,Wednesday
2014,6,4,1900,208,358,566,Wednesday
2014,6,4,1800,234,422,656,Wednesday
2014,6,4,1700,286,436,722,Wednesday
2014,6,4,1600,314,408,722,Wednesday
2014,6,4,1500,314,330,644,Wednesday
2014,6,4,1400,332,297,629,Wednesday
2014,6,4,1300,355,268,623,Wednesday
2014,6,4,1200,434,212,646,Wednesday
2014,6,4,1100,430,185,615,Wednesday
2014,6,4,1000,423,132,555,Wednesday
2014,6,4,900,280,107,387,Wednesday
2014,6,4,800,167,80,247,Wednesday
2014,6,4,700,95,49,144,Wednesday
2014,6,4,600,36,43,79,Wednesday
2014,6,4,500,23,25,48,Wednesday
2014,6,4,400,24,40,64,Wednesday
2014,6,4,300,22,34,56,Wednesday
2014,6,4,200,31,46,77,Wednesday
2014,6,4,100,62,84,146,Wednesday
2014,6,3,2400,60,216,276,Tuesday
2014,6,3,2300,82,199,281,Tuesday
2014,6,3,2200,118,73,191,Tuesday
2014,6,3,2100,147,97,244,Tuesday
2014,6,3,2000,127,176,303,Tuesday
2014,6,3,1900,170,351,521,Tuesday
2014,6,3,1800,184,440,624,Tuesday
2014,6,3,1700,212,462,674,Tuesday
2014,6,3,1600,272,413,685,Tuesday
2014,6,3,1500,264,276,540,Tuesday
2014,6,3,1400,323,289,612,Tuesday
2014,6,3,1300,362,266,628,Tuesday
2014,6,3,1200,398,247,645,Tuesday
2014,6,3,1100,415,192,607,Tuesday
2014,6,3,1000,375,142,517,Tuesday
2014,6,3,900,294,128,422,Tuesday
2014,6,3,800,171,89,260,Tuesday
2014,6,3,700,84,48,132,Tuesday
2014,6,3,600,35,32,67,Tuesday
2014,6,3,500,17,26,43,Tuesday
2014,6,3,400,15,30,45,Tuesday
2014,6,3,300,23,31,54,Tuesday
2014,6,3,200,21,49,70,Tuesday
2014,6,3,100,51,69,120,Tuesday
2014,6,2,2400,56,99,155,Monday
2014,6,2,2300,74,129,203,Monday
2014,6,2,2200,95,175,270,Monday
2014,6,2,2100,127,288,415,Monday
2014,6,2,2000,147,315,462,Monday
2014,6,2,1900,197,448,645,Monday
2014,6,2,1800,200,504,704,Monday
2014,6,2,1700,261,513,774,Monday
2014,6,2,1600,305,449,754,Monday
2014,6,2,1500,322,380,702,Monday
2014,6,2,1400,321,327,648,Monday
2014,6,2,1300,434,307,741,Monday
2014,6,2,1200,507,279,786,Monday
2014,6,2,1100,514,199,713,Monday
2014,6,2,1000,424,161,585,Monday
2014,6,2,900,301,105,406,Monday
2014,6,2,800,180,84,264,Monday
2014,6,2,700,92,50,142,Monday
2014,6,2,600,54,34,88,Monday
2014,6,2,500,15,18,33,Monday
2014,6,2,400,13,19,32,Monday
2014,6,2,300,18,38,56,Monday
2014,6,2,200,17,42,59,Monday
2014,6,2,100,27,71,98,Monday
2014,6,1,2400,39,139,178,Sunday
2014,6,1,2300,59,201,260,Sunday
2014,6,1,2200,92,330,422,Sunday
2014,6,1,2100,121,514,635,Sunday
2014,6,1,2000,135,669,804,Sunday
2014,6,1,1900,208,804,1012,Sunday
2014,6,1,1800,242,914,1156,Sunday
2014,6,1,1700,311,1032,1343,Sunday
2014,6,1,1600,366,885,1251,Sunday
2014,6,1,1500,422,670,1092,Sunday
2014,6,1,1400,431,629,1060,Sunday
2014,6,1,1300,514,563,1077,Sunday
2014,6,1,1200,562,372,934,Sunday
2014,6,1,1100,539,239,778,Sunday
2014,6,1,1000,380,153,533,Sunday
2014,6,1,900,249,77,326,Sunday
2014,6,1,800,152,44,196,Sunday
2014,6,1,700,78,19,97,Sunday
2014,6,1,600,25,16,41,Sunday
2014,6,1,500,17,15,32,Sunday
2014,6,1,400,12,25,37,Sunday
2014,6,1,300,18,28,46,Sunday
2014,6,1,200,18,27,45,Sunday
2014,6,1,100,40,52,92,Sunday
2014,5,31,2400,42,65,107,Saturday
2014,5,31,2300,54,129,183,Saturday
2014,5,31,2200,95,157,252,Saturday
2014,5,31,2100,135,292,427,Saturday
2014,5,31,2000,171,343,514,Saturday
2014,5,31,1900,190,441,631,Saturday
2014,5,31,1800,209,507,716,Saturday
2014,5,31,1700,302,473,775,Saturday
2014,5,31,1600,345,428,773,Saturday
2014,5,31,1500,427,378,805,Saturday
2014,5,31,1400,417,340,757,Saturday
2014,5,31,1300,549,314,863,Saturday
2014,5,31,1200,575,256,831,Saturday
2014,5,31,1100,608,201,809,Saturday
2014,5,31,1000,479,149,628,Saturday
2014,5,31,900,344,105,449,Saturday
2014,5,31,800,167,62,229,Saturday
2014,5,31,700,91,32,123,Saturday
2014,5,31,600,37,25,62,Saturday
2014,5,31,500,24,19,43,Saturday
2014,5,31,400,24,32,56,Saturday
2014,5,31,300,27,27,54,Saturday
2014,5,31,200,30,31,61,Saturday
2014,5,31,100,44,47,91,Saturday
2014,5,30,2400,89,77,166,Friday
2014,5,30,2300,133,109,242,Friday
2014,5,30,2200,221,179,400,Friday
2014,5,30,2100,347,225,572,Friday
2014,5,30,2000,521,271,792,Friday
2014,5,30,1900,576,367,943,Friday
2014,5,30,1800,582,399,981,Friday
2014,5,30,1700,566,426,992,Friday
2014,5,30,1600,523,408,931,Friday
2014,5,30,1500,533,404,937,Friday
2014,5,30,1400,489,363,852,Friday
2014,5,30,1300,503,279,782,Friday
2014,5,30,1200,540,270,810,Friday
2014,5,30,1100,594,194,788,Friday
2014,5,30,1000,524,154,678,Friday
2014,5,30,900,350,119,469,Friday
2014,5,30,800,196,85,281,Friday
2014,5,30,700,96,41,137,Friday
2014,5,30,600,46,32,78,Friday
2014,5,30,500,30,28,58,Friday
2014,5,30,400,24,33,57,Friday
2014,5,30,300,26,28,54,Friday
2014,5,30,200,35,44,79,Friday
2014,5,30,100,48,61,109,Friday
2014,5,29,2400,78,82,160,Thursday
2014,5,29,2300,112,122,234,Thursday
2014,5,29,2200,167,131,298,Thursday
2014,5,29,2100,200,178,378,Thursday
2014,5,29,2000,258,228,486,Thursday
2014,5,29,1900,232,325,557,Thursday
2014,5,29,1800,322,401,723,Thursday
2014,5,29,1700,303,412,715,Thursday
2014,5,29,1600,352,425,777,Thursday
2014,5,29,1500,317,327,644,Thursday
2014,5,29,1400,345,328,673,Thursday
2014,5,29,1300,329,261,590,Thursday
2014,5,29,1200,430,223,653,Thursday
2014,5,29,1100,419,184,603,Thursday
2014,5,29,1000,372,131,503,Thursday
2014,5,29,900,255,101,356,Thursday
2014,5,29,800,159,93,252,Thursday
2014,5,29,700,84,39,123,Thursday
2014,5,29,600,51,34,85,Thursday
2014,5,29,500,21,29,50,Thursday
2014,5,29,400,31,34,65,Thursday
2014,5,29,300,23,37,60,Thursday
2014,5,29,200,28,43,71,Thursday
2014,5,29,100,48,62,110,Thursday
2014,5,28,2400,64,63,127,Wednesday
2014,5,28,2300,100,123,223,Wednesday
2014,5,28,2200,109,175,284,Wednesday
2014,5,28,2100,130,176,306,Wednesday
2014,5,28,2000,162,199,361,Wednesday
2014,5,28,1900,191,306,497,Wednesday
2014,5,28,1800,202,349,551,Wednesday
2014,5,28,1700,227,322,549,Wednesday
2014,5,28,1600,288,338,626,Wednesday
2014,5,28,1500,243,356,599,Wednesday
2014,5,28,1400,286,314,600,Wednesday
2014,5,28,1300,346,327,673,Wednesday
2014,5,28,1200,352,168,520,Wednesday
2014,5,28,1100,334,135,469,Wednesday
2014,5,28,1000,318,146,464,Wednesday
2014,5,28,900,243,105,348,Wednesday
2014,5,28,800,139,85,224,Wednesday
2014,5,28,700,68,43,111,Wednesday
2014,5,28,600,43,38,81,Wednesday
2014,5,28,500,17,26,43,Wednesday
2014,5,28,400,21,41,62,Wednesday
2014,5,28,300,25,32,57,Wednesday
2014,5,28,200,37,46,83,Wednesday
2014,5,28,100,44,74,118,Wednesday
2014,5,27,2400,63,83,146,Tuesday
2014,5,27,2300,72,107,179,Tuesday
2014,5,27,2200,125,184,309,Tuesday
2014,5,27,2100,130,228,358,Tuesday
2014,5,27,2000,168,239,407,Tuesday
2014,5,27,1900,153,377,530,Tuesday
2014,5,27,1800,192,400,592,Tuesday
2014,5,27,1700,233,380,613,Tuesday
2014,5,27,1600,230,356,586,Tuesday
2014,5,27,1500,260,322,582,Tuesday
2014,5,27,1400,288,271,559,Tuesday
2014,5,27,1300,292,256,548,Tuesday
2014,5,27,1200,376,209,585,Tuesday
2014,5,27,1100,382,177,559,Tuesday
2014,5,27,1000,327,136,463,Tuesday
2014,5,27,900,267,105,372,Tuesday
2014,5,27,800,176,76,252,Tuesday
2014,5,27,700,82,36,118,Tuesday
2014,5,27,600,40,30,70,Tuesday
2014,5,27,500,14,32,46,Tuesday
2014,5,27,400,24,30,54,Tuesday
2014,5,27,300,17,38,55,Tuesday
2014,5,27,200,31,40,71,Tuesday
2014,5,27,100,38,68,106,Tuesday
2014,5,26,2400,56,105,161,Monday
2014,5,26,2300,64,130,194,Monday
2014,5,26,2200,104,161,265,Monday
2014,5,26,2100,120,253,373,Monday
2014,5,26,2000,150,268,418,Monday
2014,5,26,1900,165,411,576,Monday
2014,5,26,1800,228,466,694,Monday
2014,5,26,1700,234,464,698,Monday
2014,5,26,1600,298,428,726,Monday
2014,5,26,1500,313,409,722,Monday
2014,5,26,1400,338,410,748,Monday
2014,5,26,1300,328,297,625,Monday
2014,5,26,1200,432,250,682,Monday
2014,5,26,1100,489,192,681,Monday
2014,5,26,1000,390,129,519,Monday
2014,5,26,900,286,95,381,Monday
2014,5,26,800,134,69,203,Monday
2014,5,26,700,67,47,114,Monday
2014,5,26,600,35,29,64,Monday
2014,5,26,500,21,22,43,Monday
2014,5,26,400,13,25,38,Monday
2014,5,26,300,15,33,48,Monday
2014,5,26,200,22,60,82,Monday
2014,5,26,100,25,51,76,Monday
2014,5,25,2400,32,95,127,Sunday
2014,5,25,2300,46,149,195,Sunday
2014,5,25,2200,100,246,346,Sunday
2014,5,25,2100,104,349,453,Sunday
2014,5,25,2000,121,506,627,Sunday
2014,5,25,1900,157,652,809,Sunday
2014,5,25,1800,187,763,950,Sunday
2014,5,25,1700,286,850,1136,Sunday
2014,5,25,1600,290,780,1070,Sunday
2014,5,25,1500,380,651,1031,Sunday
2014,5,25,1400,385,610,995,Sunday
2014,5,25,1300,409,533,942,Sunday
2014,5,25,1200,429,398,827,Sunday
2014,5,25,1100,416,211,627,Sunday
2014,5,25,1000,344,131,475,Sunday
2014,5,25,900,232,68,300,Sunday
2014,5,25,800,138,62,200,Sunday
2014,5,25,700,72,20,92,Sunday
2014,5,25,600,19,20,39,Sunday
2014,5,25,500,18,14,32,Sunday
2014,5,25,400,17,14,31,Sunday
2014,5,25,300,11,26,37,Sunday
2014,5,25,200,20,38,58,Sunday
2014,5,25,100,30,52,82,Sunday
2014,5,24,2400,45,64,109,Saturday
2014,5,24,2300,83,132,215,Saturday
2014,5,24,2200,98,169,267,Saturday
2014,5,24,2100,116,244,360,Saturday
2014,5,24,2000,134,358,492,Saturday
2014,5,24,1900,172,420,592,Saturday
2014,5,24,1800,211,487,698,Saturday
2014,5,24,1700,236,548,784,Saturday
2014,5,24,1600,344,500,844,Saturday
2014,5,24,1500,358,417,775,Saturday
2014,5,24,1400,409,344,753,Saturday
2014,5,24,1300,464,316,780,Saturday
2014,5,24,1200,516,238,754,Saturday
2014,5,24,1100,532,167,699,Saturday
2014,5,24,1000,412,149,561,Saturday
2014,5,24,900,281,90,371,Saturday
2014,5,24,800,179,56,235,Saturday
2014,5,24,700,68,46,114,Saturday
2014,5,24,600,34,28,62,Saturday
2014,5,24,500,20,18,38,Saturday
2014,5,24,400,21,33,54,Saturday
2014,5,24,300,21,34,55,Saturday
2014,5,24,200,27,42,69,Saturday
2014,5,24,100,52,57,109,Saturday
2014,5,23,2400,87,60,147,Friday
2014,5,23,2300,103,100,203,Friday
2014,5,23,2200,185,153,338,Friday
2014,5,23,2100,297,202,499,Friday
2014,5,23,2000,386,273,659,Friday
2014,5,23,1900,454,357,811,Friday
2014,5,23,1800,471,410,881,Friday
2014,5,23,1700,463,420,883,Friday
2014,5,23,1600,444,409,853,Friday
2014,5,23,1500,413,331,744,Friday
2014,5,23,1400,385,342,727,Friday
2014,5,23,1300,390,282,672,Friday
2014,5,23,1200,416,224,640,Friday
2014,5,23,1100,469,205,674,Friday
2014,5,23,1000,382,147,529,Friday
2014,5,23,900,333,106,439,Friday
2014,5,23,800,205,85,290,Friday
2014,5,23,700,89,51,140,Friday
2014,5,23,600,41,33,74,Friday
2014,5,23,500,30,36,66,Friday
2014,5,23,400,22,33,55,Friday
2014,5,23,300,26,33,59,Friday
2014,5,23,200,41,35,76,Friday
2014,5,23,100,59,62,121,Friday
2014,5,22,2400,82,69,151,Thursday
2014,5,22,2300,98,117,215,Thursday
2014,5,22,2200,115,161,276,Thursday
2014,5,22,2100,180,219,399,Thursday
2014,5,22,2000,233,260,493,Thursday
2014,5,22,1900,246,311,557,Thursday
2014,5,22,1800,289,409,698,Thursday
2014,5,22,1700,284,375,659,Thursday
2014,5,22,1600,308,345,653,Thursday
2014,5,22,1500,348,306,654,Thursday
2014,5,22,1400,319,292,611,Thursday
2014,5,22,1300,348,276,624,Thursday
2014,5,22,1200,419,227,646,Thursday
2014,5,22,1100,403,189,592,Thursday
2014,5,22,1000,344,124,468,Thursday
2014,5,22,900,272,112,384,Thursday
2014,5,22,800,186,72,258,Thursday
2014,5,22,700,88,43,131,Thursday
2014,5,22,600,43,37,80,Thursday
2014,5,22,500,33,31,64,Thursday
2014,5,22,400,34,34,68,Thursday
2014,5,22,300,15,35,50,Thursday
2014,5,22,200,27,44,71,Thursday
2014,5,22,100,56,58,114,Thursday
2014,5,21,2400,51,76,127,Wednesday
2014,5,21,2300,84,115,199,Wednesday
2014,5,21,2200,108,136,244,Wednesday
2014,5,21,2100,145,201,346,Wednesday
2014,5,21,2000,169,259,428,Wednesday
2014,5,21,1900,170,350,520,Wednesday
2014,5,21,1800,209,403,612,Wednesday
2014,5,21,1700,225,410,635,Wednesday
2014,5,21,1600,264,421,685,Wednesday
2014,5,21,1500,272,341,613,Wednesday
2014,5,21,1400,284,279,563,Wednesday
2014,5,21,1300,287,292,579,Wednesday
2014,5,21,1200,357,219,576,Wednesday
2014,5,21,1100,358,188,546,Wednesday
2014,5,21,1000,306,162,468,Wednesday
2014,5,21,900,211,128,339,Wednesday
2014,5,21,800,152,101,253,Wednesday
2014,5,21,700,67,41,108,Wednesday
2014,5,21,600,43,25,68,Wednesday
2014,5,21,500,24,19,43,Wednesday
2014,5,21,400,23,46,69,Wednesday
2014,5,21,300,23,27,50,Wednesday
2014,5,21,200,27,58,85,Wednesday
2014,5,21,100,47,82,129,Wednesday
2014,5,20,2400,78,115,193,Tuesday
2014,5,20,2300,57,122,179,Tuesday
2014,5,20,2200,106,163,269,Tuesday
2014,5,20,2100,127,411,538,Tuesday
2014,5,20,2000,139,750,889,Tuesday
2014,5,20,1900,158,567,725,Tuesday
2014,5,20,1800,176,512,688,Tuesday
2014,5,20,1700,219,520,739,Tuesday
2014,5,20,1600,295,421,716,Tuesday
2014,5,20,1500,261,477,738,Tuesday
2014,5,20,1400,309,483,792,Tuesday
2014,5,20,1300,349,398,747,Tuesday
2014,5,20,1200,389,296,685,Tuesday
2014,5,20,1100,395,241,636,Tuesday
2014,5,20,1000,380,193,573,Tuesday
2014,5,20,900,294,145,439,Tuesday
2014,5,20,800,165,91,256,Tuesday
2014,5,20,700,95,68,163,Tuesday
2014,5,20,600,36,50,86,Tuesday
2014,5,20,500,19,45,64,Tuesday
2014,5,20,400,17,70,87,Tuesday
2014,5,20,300,17,72,89,Tuesday
2014,5,20,200,20,67,87,Tuesday
2014,5,20,100,31,67,98,Tuesday
2014,5,19,2400,43,231,274,Monday
2014,5,19,2300,59,358,417,Monday
2014,5,19,2200,69,616,685,Monday
2014,5,19,2100,107,1089,1196,Monday
2014,5,19,2000,126,1222,1348,Monday
2014,5,19,1900,176,1534,1710,Monday
2014,5,19,1800,208,1900,2108,Monday
2014,5,19,1700,268,1962,2230,Monday
2014,5,19,1600,341,2019,2360,Monday
2014,5,19,1500,385,1941,2326,Monday
2014,5,19,1400,456,1699,2155,Monday
2014,5,19,1300,460,1251,1711,Monday
2014,5,19,1200,536,971,1507,Monday
2014,5,19,1100,506,529,1035,Monday
2014,5,19,1000,402,229,631,Monday
2014,5,19,900,264,135,399,Monday
2014,5,19,800,168,60,228,Monday
2014,5,19,700,108,26,134,Monday
2014,5,19,600,38,18,56,Monday
2014,5,19,500,17,29,46,Monday
2014,5,19,400,10,29,39,Monday
2014,5,19,300,8,38,46,Monday
2014,5,19,200,23,67,90,Monday
2014,5,19,100,30,79,109,Monday
2014,5,18,2400,25,101,126,Sunday
2014,5,18,2300,58,165,223,Sunday
2014,5,18,2200,76,313,389,Sunday
2014,5,18,2100,112,382,494,Sunday
2014,5,18,2000,148,497,645,Sunday
2014,5,18,1900,170,631,801,Sunday
2014,5,18,1800,228,755,983,Sunday
2014,5,18,1700,306,817,1123,Sunday
2014,5,18,1600,327,755,1082,Sunday
2014,5,18,1500,438,668,1106,Sunday
2014,5,18,1400,470,536,1006,Sunday
2014,5,18,1300,556,544,1100,Sunday
2014,5,18,1200,609,374,983,Sunday
2014,5,18,1100,520,257,777,Sunday
2014,5,18,1000,409,131,540,Sunday
2014,5,18,900,217,90,307,Sunday
2014,5,18,800,134,39,173,Sunday
2014,5,18,700,84,28,112,Sunday
2014,5,18,600,32,16,48,Sunday
2014,5,18,500,17,21,38,Sunday
2014,5,18,400,13,18,31,Sunday
2014,5,18,300,15,18,33,Sunday
2014,5,18,200,20,26,46,Sunday
2014,5,18,100,27,26,53,Sunday
2014,5,17,2400,46,93,139,Saturday
2014,5,17,2300,68,95,163,Saturday
2014,5,17,2200,124,133,257,Saturday
2014,5,17,2100,152,198,350,Saturday
2014,5,17,2000,207,268,475,Saturday
2014,5,17,1900,230,362,592,Saturday
2014,5,17,1800,291,528,819,Saturday
2014,5,17,1700,399,458,857,Saturday
2014,5,17,1600,521,556,1077,Saturday
2014,5,17,1500,619,446,1065,Saturday
2014,5,17,1400,758,347,1105,Saturday
2014,5,17,1300,715,306,1021,Saturday
2014,5,17,1200,885,255,1140,Saturday
2014,5,17,1100,834,224,1058,Saturday
2014,5,17,1000,715,113,828,Saturday
2014,5,17,900,593,120,713,Saturday
2014,5,17,800,449,59,508,Saturday
2014,5,17,700,208,45,253,Saturday
2014,5,17,600,69,19,88,Saturday
2014,5,17,500,51,34,85,Saturday
2014,5,17,400,35,33,68,Saturday
2014,5,17,300,34,20,54,Saturday
2014,5,17,200,51,37,88,Saturday
2014,5,17,100,76,64,140,Saturday
2014,5,16,2400,119,83,202,Friday
2014,5,16,2300,248,134,382,Friday
2014,5,16,2200,400,180,580,Friday
2014,5,16,2100,664,232,896,Friday
2014,5,16,2000,1044,301,1345,Friday
2014,5,16,1900,1161,317,1478,Friday
2014,5,16,1800,1233,420,1653,Friday
2014,5,16,1700,1277,468,1745,Friday
2014,5,16,1600,1221,435,1656,Friday
2014,5,16,1500,1206,434,1640,Friday
2014,5,16,1400,954,393,1347,Friday
2014,5,16,1300,932,217,1149,Friday
2014,5,16,1200,981,261,1242,Friday
2014,5,16,1100,1052,210,1262,Friday
2014,5,16,1000,836,155,991,Friday
2014,5,16,900,683,118,801,Friday
2014,5,16,800,443,73,516,Friday
2014,5,16,700,200,64,264,Friday
2014,5,16,600,118,44,162,Friday
2014,5,16,500,51,34,85,Friday
2014,5,16,400,36,51,87,Friday
2014,5,16,300,35,33,68,Friday
2014,5,16,200,57,55,112,Friday
2014,5,16,100,70,65,135,Friday
2014,5,15,2400,107,86,193,Thursday
2014,5,15,2300,207,111,318,Thursday
2014,5,15,2200,354,155,509,Thursday
2014,5,15,2100,478,207,685,Thursday
2014,5,15,2000,592,208,800,Thursday
2014,5,15,1900,678,304,982,Thursday
2014,5,15,1800,677,377,1054,Thursday
2014,5,15,1700,634,361,995,Thursday
2014,5,15,1600,572,335,907,Thursday
2014,5,15,1500,570,297,867,Thursday
2014,5,15,1400,546,337,883,Thursday
2014,5,15,1300,525,267,792,Thursday
2014,5,15,1200,569,235,804,Thursday
2014,5,15,1100,561,176,737,Thursday
2014,5,15,1000,482,148,630,Thursday
2014,5,15,900,376,117,493,Thursday
2014,5,15,800,239,84,323,Thursday
2014,5,15,700,131,38,169,Thursday
2014,5,15,600,67,33,100,Thursday
2014,5,15,500,30,26,56,Thursday
2014,5,15,400,29,33,62,Thursday
2014,5,15,300,31,37,68,Thursday
2014,5,15,200,37,48,85,Thursday
2014,5,15,100,50,55,105,Thursday
2014,5,14,2400,93,69,162,Wednesday
2014,5,14,2300,92,110,202,Wednesday
2014,5,14,2200,133,131,264,Wednesday
2014,5,14,2100,173,178,351,Wednesday
2014,5,14,2000,227,200,427,Wednesday
2014,5,14,1900,187,254,441,Wednesday
2014,5,14,1800,251,307,558,Wednesday
2014,5,14,1700,263,346,609,Wednesday
2014,5,14,1600,308,319,627,Wednesday
2014,5,14,1500,276,271,547,Wednesday
2014,5,14,1400,303,225,528,Wednesday
2014,5,14,1300,332,219,551,Wednesday
2014,5,14,1200,391,185,576,Wednesday
2014,5,14,1100,416,144,560,Wednesday
2014,5,14,1000,297,129,426,Wednesday
2014,5,14,900,232,92,324,Wednesday
2014,5,14,800,178,76,254,Wednesday
2014,5,14,700,87,41,128,Wednesday
2014,5,14,600,46,23,69,Wednesday
2014,5,14,500,23,31,54,Wednesday
2014,5,14,400,26,31,57,Wednesday
2014,5,14,300,25,33,58,Wednesday
2014,5,14,200,30,46,76,Wednesday
2014,5,14,100,52,54,106,Wednesday
2014,5,13,2400,66,93,159,Tuesday
2014,5,13,2300,70,105,175,Tuesday
2014,5,13,2200,110,122,232,Tuesday
2014,5,13,2100,122,199,321,Tuesday
2014,5,13,2000,152,204,356,Tuesday
2014,5,13,1900,174,287,461,Tuesday
2014,5,13,1800,182,298,480,Tuesday
2014,5,13,1700,210,341,551,Tuesday
2014,5,13,1600,238,305,543,Tuesday
2014,5,13,1500,268,306,574,Tuesday
2014,5,13,1400,249,208,457,Tuesday
2014,5,13,1300,282,220,502,Tuesday
2014,5,13,1200,332,212,544,Tuesday
2014,5,13,1100,332,173,505,Tuesday
2014,5,13,1000,276,124,400,Tuesday
2014,5,13,900,208,117,325,Tuesday
2014,5,13,800,113,71,184,Tuesday
2014,5,13,700,69,46,115,Tuesday
2014,5,13,600,30,36,66,Tuesday
2014,5,13,500,21,45,66,Tuesday
2014,5,13,400,19,36,55,Tuesday
2014,5,13,300,17,27,44,Tuesday
2014,5,13,200,18,43,61,Tuesday
2014,5,13,100,55,59,114,Tuesday
2014,5,12,2400,60,69,129,Monday
2014,5,12,2300,62,111,173,Monday
2014,5,12,2200,106,129,235,Monday
2014,5,12,2100,121,183,304,Monday
2014,5,12,2000,143,257,400,Monday
2014,5,12,1900,161,317,478,Monday
2014,5,12,1800,186,369,555,Monday
2014,5,12,1700,250,393,643,Monday
2014,5,12,1600,249,370,619,Monday
2014,5,12,1500,312,344,656,Monday
2014,5,12,1400,269,262,531,Monday
2014,5,12,1300,364,232,596,Monday
2014,5,12,1200,452,200,652,Monday
2014,5,12,1100,364,170,534,Monday
2014,5,12,1000,324,112,436,Monday
2014,5,12,900,224,100,324,Monday
2014,5,12,800,152,75,227,Monday
2014,5,12,700,79,57,136,Monday
2014,5,12,600,27,27,54,Monday
2014,5,12,500,14,28,42,Monday
2014,5,12,400,21,26,47,Monday
2014,5,12,300,24,23,47,Monday
2014,5,12,200,24,41,65,Monday
2014,5,12,100,25,65,90,Monday
2014,5,11,2400,35,128,163,Sunday
2014,5,11,2300,56,164,220,Sunday
2014,5,11,2200,92,224,316,Sunday
2014,5,11,2100,98,333,431,Sunday
2014,5,11,2000,125,497,622,Sunday
2014,5,11,1900,172,723,895,Sunday
2014,5,11,1800,198,785,983,Sunday
2014,5,11,1700,248,919,1167,Sunday
2014,5,11,1600,326,749,1075,Sunday
2014,5,11,1500,330,587,917,Sunday
2014,5,11,1400,391,507,898,Sunday
2014,5,11,1300,483,354,837,Sunday
2014,5,11,1200,551,288,839,Sunday
2014,5,11,1100,528,218,746,Sunday
2014,5,11,1000,518,94,612,Sunday
2014,5,11,900,379,75,454,Sunday
2014,5,11,800,148,36,184,Sunday
2014,5,11,700,71,24,95,Sunday
2014,5,11,600,31,10,41,Sunday
2014,5,11,500,15,17,32,Sunday
2014,5,11,400,10,11,21,Sunday
2014,5,11,300,11,25,36,Sunday
2014,5,11,200,16,35,51,Sunday
2014,5,11,100,18,36,54,Sunday
2014,5,10,2400,38,46,84,Saturday
2014,5,10,2300,52,71,123,Saturday
2014,5,10,2200,72,113,185,Saturday
2014,5,10,2100,101,138,239,Saturday
2014,5,10,2000,120,232,352,Saturday
2014,5,10,1900,113,300,413,Saturday
2014,5,10,1800,206,525,731,Saturday
2014,5,10,1700,219,592,811,Saturday
2014,5,10,1600,264,398,662,Saturday
2014,5,10,1500,266,345,611,Saturday
2014,5,10,1400,357,342,699,Saturday
2014,5,10,1300,414,269,683,Saturday
2014,5,10,1200,505,244,749,Saturday
2014,5,10,1100,505,224,729,Saturday
2014,5,10,1000,535,131,666,Saturday
2014,5,10,900,486,96,582,Saturday
2014,5,10,800,204,56,260,Saturday
2014,5,10,700,76,32,108,Saturday
2014,5,10,600,44,28,72,Saturday
2014,5,10,500,33,13,46,Saturday
2014,5,10,400,20,25,45,Saturday
2014,5,10,300,14,25,39,Saturday
2014,5,10,200,29,31,60,Saturday
2014,5,10,100,45,55,100,Saturday
2014,5,9,2400,57,67,124,Friday
2014,5,9,2300,90,88,178,Friday
2014,5,9,2200,128,92,220,Friday
2014,5,9,2100,224,151,375,Friday
2014,5,9,2000,377,158,535,Friday
2014,5,9,1900,376,270,646,Friday
2014,5,9,1800,385,436,821,Friday
2014,5,9,1700,399,422,821,Friday
2014,5,9,1600,416,427,843,Friday
2014,5,9,1500,404,336,740,Friday
2014,5,9,1400,364,297,661,Friday
2014,5,9,1300,388,274,662,Friday
2014,5,9,1200,405,231,636,Friday
2014,5,9,1100,414,203,617,Friday
2014,5,9,1000,396,141,537,Friday
2014,5,9,900,287,88,375,Friday
2014,5,9,800,154,77,231,Friday
2014,5,9,700,88,38,126,Friday
2014,5,9,600,37,31,68,Friday
2014,5,9,500,26,30,56,Friday
2014,5,9,400,27,37,64,Friday
2014,5,9,300,25,32,57,Friday
2014,5,9,200,27,49,76,Friday
2014,5,9,100,51,64,115,Friday
2014,5,8,2400,71,61,132,Thursday
2014,5,8,2300,98,117,215,Thursday
2014,5,8,2200,122,137,259,Thursday
2014,5,8,2100,156,168,324,Thursday
2014,5,8,2000,203,239,442,Thursday
2014,5,8,1900,216,257,473,Thursday
2014,5,8,1800,252,369,621,Thursday
2014,5,8,1700,268,412,680,Thursday
2014,5,8,1600,308,384,692,Thursday
2014,5,8,1500,320,320,640,Thursday
2014,5,8,1400,283,280,563,Thursday
2014,5,8,1300,335,255,590,Thursday
2014,5,8,1200,386,206,592,Thursday
2014,5,8,1100,392,181,573,Thursday
2014,5,8,1000,347,162,509,Thursday
2014,5,8,900,288,104,392,Thursday
2014,5,8,800,188,68,256,Thursday
2014,5,8,700,91,43,134,Thursday
2014,5,8,600,48,25,73,Thursday
2014,5,8,500,23,24,47,Thursday
2014,5,8,400,22,27,49,Thursday
2014,5,8,300,22,33,55,Thursday
2014,5,8,200,32,41,73,Thursday
2014,5,8,100,41,60,101,Thursday
2014,5,7,2400,85,82,167,Wednesday
2014,5,7,2300,98,82,180,Wednesday
2014,5,7,2200,96,119,215,Wednesday
2014,5,7,2100,134,172,306,Wednesday
2014,5,7,2000,149,212,361,Wednesday
2014,5,7,1900,155,293,448,Wednesday
2014,5,7,1800,217,402,619,Wednesday
2014,5,7,1700,204,407,611,Wednesday
2014,5,7,1600,256,384,640,Wednesday
2014,5,7,1500,251,328,579,Wednesday
2014,5,7,1400,272,281,553,Wednesday
2014,5,7,1300,329,242,571,Wednesday
2014,5,7,1200,329,238,567,Wednesday
2014,5,7,1100,397,172,569,Wednesday
2014,5,7,1000,394,115,509,Wednesday
2014,5,7,900,267,105,372,Wednesday
2014,5,7,800,151,69,220,Wednesday
2014,5,7,700,82,54,136,Wednesday
2014,5,7,600,37,27,64,Wednesday
2014,5,7,500,18,28,46,Wednesday
2014,5,7,400,27,31,58,Wednesday
2014,5,7,300,18,32,50,Wednesday
2014,5,7,200,37,34,71,Wednesday
2014,5,7,100,42,47,89,Wednesday
2014,5,6,2400,72,61,133,Tuesday
2014,5,6,2300,83,84,167,Tuesday
2014,5,6,2200,96,121,217,Tuesday
2014,5,6,2100,122,135,257,Tuesday
2014,5,6,2000,109,211,320,Tuesday
2014,5,6,1900,128,216,344,Tuesday
2014,5,6,1800,173,305,478,Tuesday
2014,5,6,1700,162,355,517,Tuesday
2014,5,6,1600,196,305,501,Tuesday
2014,5,6,1500,204,309,513,Tuesday
2014,5,6,1400,191,266,457,Tuesday
2014,5,6,1300,269,212,481,Tuesday
2014,5,6,1200,285,221,506,Tuesday
2014,5,6,1100,343,164,507,Tuesday
2014,5,6,1000,277,150,427,Tuesday
2014,5,6,900,246,117,363,Tuesday
2014,5,6,800,116,73,189,Tuesday
2014,5,6,700,73,38,111,Tuesday
2014,5,6,600,29,32,61,Tuesday
2014,5,6,500,21,27,48,Tuesday
2014,5,6,400,19,25,44,Tuesday
2014,5,6,300,17,32,49,Tuesday
2014,5,6,200,22,39,61,Tuesday
2014,5,6,100,32,51,83,Tuesday
2014,5,5,2400,49,71,120,Monday
2014,5,5,2300,50,94,144,Monday
2014,5,5,2200,85,119,204,Monday
2014,5,5,2100,92,142,234,Monday
2014,5,5,2000,130,225,355,Monday
2014,5,5,1900,137,312,449,Monday
2014,5,5,1800,178,389,567,Monday
2014,5,5,1700,184,444,628,Monday
2014,5,5,1600,264,425,689,Monday
2014,5,5,1500,255,359,614,Monday
2014,5,5,1400,286,287,573,Monday
2014,5,5,1300,324,278,602,Monday
2014,5,5,1200,432,181,613,Monday
2014,5,5,1100,404,158,562,Monday
2014,5,5,1000,342,134,476,Monday
2014,5,5,900,287,94,381,Monday
2014,5,5,800,158,83,241,Monday
2014,5,5,700,71,37,108,Monday
2014,5,5,600,21,27,48,Monday
2014,5,5,500,12,12,24,Monday
2014,5,5,400,20,19,39,Monday
2014,5,5,300,14,35,49,Monday
2014,5,5,200,18,56,74,Monday
2014,5,5,100,24,59,83,Monday
2014,5,4,2400,30,81,111,Sunday
2014,5,4,2300,60,134,194,Sunday
2014,5,4,2200,75,216,291,Sunday
2014,5,4,2100,112,279,391,Sunday
2014,5,4,2000,147,358,505,Sunday
2014,5,4,1900,135,489,624,Sunday
2014,5,4,1800,162,796,958,Sunday
2014,5,4,1700,193,1153,1346,Sunday
2014,5,4,1600,249,899,1148,Sunday
2014,5,4,1500,286,771,1057,Sunday
2014,5,4,1400,298,595,893,Sunday
2014,5,4,1300,386,469,855,Sunday
2014,5,4,1200,492,373,865,Sunday
2014,5,4,1100,468,234,702,Sunday
2014,5,4,1000,595,96,691,Sunday
2014,5,4,900,689,57,746,Sunday
2014,5,4,800,212,32,244,Sunday
2014,5,4,700,53,19,72,Sunday
2014,5,4,600,21,16,37,Sunday
2014,5,4,500,6,19,25,Sunday
2014,5,4,400,10,15,25,Sunday
2014,5,4,300,13,26,39,Sunday
2014,5,4,200,6,32,38,Sunday
2014,5,4,100,22,25,47,Sunday
2014,5,3,2400,27,43,70,Saturday
2014,5,3,2300,41,76,117,Saturday
2014,5,3,2200,70,89,159,Saturday
2014,5,3,2100,82,110,192,Saturday
2014,5,3,2000,110,195,305,Saturday
2014,5,3,1900,114,339,453,Saturday
2014,5,3,1800,170,578,748,Saturday
2014,5,3,1700,218,566,784,Saturday
2014,5,3,1600,235,417,652,Saturday
2014,5,3,1500,266,358,624,Saturday
2014,5,3,1400,299,340,639,Saturday
2014,5,3,1300,503,285,788,Saturday
2014,5,3,1200,564,258,822,Saturday
2014,5,3,1100,484,223,707,Saturday
2014,5,3,1000,434,168,602,Saturday
2014,5,3,900,265,114,379,Saturday
2014,5,3,800,154,90,244,Saturday
2014,5,3,700,40,45,85,Saturday
2014,5,3,600,16,59,75,Saturday
2014,5,3,500,12,135,147,Saturday
2014,5,3,400,15,29,44,Saturday
2014,5,3,300,17,38,55,Saturday
2014,5,3,200,21,174,195,Saturday
2014,5,3,100,40,34,74,Saturday
2014,5,2,2400,68,38,106,Friday
2014,5,2,2300,45,26,71,Friday
2014,5,2,2200,153,33,186,Friday
2014,5,2,2100,196,49,245,Friday
2014,5,2,2000,346,88,434,Friday
2014,5,2,1900,334,160,494,Friday
2014,5,2,1800,377,317,694,Friday
2014,5,2,1700,433,513,946,Friday
2014,5,2,1600,392,408,800,Friday
2014,5,2,1500,406,402,808,Friday
2014,5,2,1400,386,320,706,Friday
2014,5,2,1300,376,304,680,Friday
2014,5,2,1200,441,283,724,Friday
2014,5,2,1100,453,191,644,Friday
2014,5,2,1000,392,147,539,Friday
2014,5,2,900,334,118,452,Friday
2014,5,2,800,175,87,262,Friday
2014,5,2,700,103,35,138,Friday
2014,5,2,600,42,38,80,Friday
2014,5,2,500,28,25,53,Friday
2014,5,2,400,31,30,61,Friday
2014,5,2,300,18,31,49,Friday
2014,5,2,200,32,44,76,Friday
2014,5,2,100,48,55,103,Friday
2014,5,1,2400,68,69,137,Thursday
2014,5,1,2300,85,112,197,Thursday
2014,5,1,2200,130,140,270,Thursday
2014,5,1,2100,181,198,379,Thursday
2014,5,1,2000,231,273,504,Thursday
2014,5,1,1900,239,304,543,Thursday
2014,5,1,1800,278,402,680,Thursday
2014,5,1,1700,324,437,761,Thursday
2014,5,1,1600,346,428,774,Thursday
2014,5,1,1500,357,321,678,Thursday
2014,5,1,1400,391,265,656,Thursday
2014,5,1,1300,376,247,623,Thursday
2014,5,1,1200,386,186,572,Thursday
2014,5,1,1100,497,149,646,Thursday
2014,5,1,1000,417,121,538,Thursday
2014,5,1,900,267,109,376,Thursday
2014,5,1,800,185,81,266,Thursday
2014,5,1,700,92,52,144,Thursday
2014,5,1,600,39,32,71,Thursday
2014,5,1,500,29,22,51,Thursday
2014,5,1,400,23,39,62,Thursday
2014,5,1,300,20,22,42,Thursday
2014,5,1,200,32,49,81,Thursday
2014,5,1,100,44,70,114,Thursday
2014,4,30,2400,85,65,150,Wednesday
2014,4,30,2300,75,102,177,Wednesday
2014,4,30,2200,107,136,243,Wednesday
2014,4,30,2100,147,185,332,Wednesday
2014,4,30,2000,171,227,398,Wednesday
2014,4,30,1900,196,298,494,Wednesday
2014,4,30,1800,205,403,608,Wednesday
2014,4,30,1700,238,421,659,Wednesday
2014,4,30,1600,263,343,606,Wednesday
2014,4,30,1500,260,322,582,Wednesday
2014,4,30,1400,290,236,526,Wednesday
2014,4,30,1300,314,186,500,Wednesday
2014,4,30,1200,351,186,537,Wednesday
2014,4,30,1100,378,181,559,Wednesday
2014,4,30,1000,356,137,493,Wednesday
2014,4,30,900,295,118,413,Wednesday
2014,4,30,800,153,60,213,Wednesday
2014,4,30,700,69,49,118,Wednesday
2014,4,30,600,28,33,61,Wednesday
2014,4,30,500,30,20,50,Wednesday
2014,4,30,400,16,41,57,Wednesday
2014,4,30,300,26,47,73,Wednesday
2014,4,30,200,29,43,72,Wednesday
2014,4,30,100,33,65,98,Wednesday
2014,4,29,2400,67,60,127,Tuesday
2014,4,29,2300,82,102,184,Tuesday
2014,4,29,2200,90,120,210,Tuesday
2014,4,29,2100,121,164,285,Tuesday
2014,4,29,2000,173,223,396,Tuesday
2014,4,29,1900,150,275,425,Tuesday
2014,4,29,1800,169,439,608,Tuesday
2014,4,29,1700,212,458,670,Tuesday
2014,4,29,1600,230,377,607,Tuesday
2014,4,29,1500,265,329,594,Tuesday
2014,4,29,1400,259,273,532,Tuesday
2014,4,29,1300,291,227,518,Tuesday
2014,4,29,1200,330,223,553,Tuesday
2014,4,29,1100,352,159,511,Tuesday
2014,4,29,1000,346,130,476,Tuesday
2014,4,29,900,249,110,359,Tuesday
2014,4,29,800,152,79,231,Tuesday
2014,4,29,700,78,45,123,Tuesday
2014,4,29,600,45,27,72,Tuesday
2014,4,29,500,18,27,45,Tuesday
2014,4,29,400,19,27,46,Tuesday
2014,4,29,300,24,33,57,Tuesday
2014,4,29,200,33,38,71,Tuesday
2014,4,29,100,46,52,98,Tuesday
2014,4,28,2400,55,70,125,Monday
2014,4,28,2300,82,96,178,Monday
2014,4,28,2200,84,123,207,Monday
2014,4,28,2100,127,182,309,Monday
2014,4,28,2000,132,235,367,Monday
2014,4,28,1900,161,302,463,Monday
2014,4,28,1800,148,412,560,Monday
2014,4,28,1700,251,413,664,Monday
2014,4,28,1600,258,406,664,Monday
2014,4,28,1500,304,305,609,Monday
2014,4,28,1400,299,271,570,Monday
2014,4,28,1300,337,268,605,Monday
2014,4,28,1200,391,196,587,Monday
2014,4,28,1100,357,162,519,Monday
2014,4,28,1000,327,133,460,Monday
2014,4,28,900,288,91,379,Monday
2014,4,28,800,154,69,223,Monday
2014,4,28,700,91,44,135,Monday
2014,4,28,600,35,26,61,Monday
2014,4,28,500,20,24,44,Monday
2014,4,28,400,19,33,52,Monday
2014,4,28,300,15,43,58,Monday
2014,4,28,200,11,32,43,Monday
2014,4,28,100,22,60,82,Monday
2014,4,27,2400,29,74,103,Sunday
2014,4,27,2300,71,111,182,Sunday
2014,4,27,2200,78,204,282,Sunday
2014,4,27,2100,97,326,423,Sunday
2014,4,27,2000,128,364,492,Sunday
2014,4,27,1900,170,562,732,Sunday
2014,4,27,1800,228,877,1105,Sunday
2014,4,27,1700,289,994,1283,Sunday
2014,4,27,1600,329,821,1150,Sunday
2014,4,27,1500,356,663,1019,Sunday
2014,4,27,1400,394,527,921,Sunday
2014,4,27,1300,403,446,849,Sunday
2014,4,27,1200,495,374,869,Sunday
2014,4,27,1100,513,221,734,Sunday
2014,4,27,1000,538,135,673,Sunday
2014,4,27,900,492,87,579,Sunday
2014,4,27,800,168,37,205,Sunday
2014,4,27,700,55,23,78,Sunday
2014,4,27,600,24,12,36,Sunday
2014,4,27,500,14,22,36,Sunday
2014,4,27,400,10,16,26,Sunday
2014,4,27,300,11,26,37,Sunday
2014,4,27,200,15,28,43,Sunday
2014,4,27,100,20,28,48,Sunday
2014,4,26,2400,27,74,101,Saturday
2014,4,26,2300,44,110,154,Saturday
2014,4,26,2200,65,127,192,Saturday
2014,4,26,2100,94,167,261,Saturday
2014,4,26,2000,106,236,342,Saturday
2014,4,26,1900,132,342,474,Saturday
2014,4,26,1800,167,579,746,Saturday
2014,4,26,1700,193,674,867,Saturday
2014,4,26,1600,235,525,760,Saturday
2014,4,26,1500,246,355,601,Saturday
2014,4,26,1400,310,323,633,Saturday
2014,4,26,1300,334,301,635,Saturday
2014,4,26,1200,423,219,642,Saturday
2014,4,26,1100,412,169,581,Saturday
2014,4,26,1000,507,128,635,Saturday
2014,4,26,900,574,96,670,Saturday
2014,4,26,800,220,70,290,Saturday
2014,4,26,700,78,40,118,Saturday
2014,4,26,600,31,22,53,Saturday
2014,4,26,500,18,17,35,Saturday
2014,4,26,400,21,20,41,Saturday
2014,4,26,300,13,46,59,Saturday
2014,4,26,200,40,27,67,Saturday
2014,4,26,100,45,40,85,Saturday
2014,4,25,2400,54,67,121,Friday
2014,4,25,2300,87,95,182,Friday
2014,4,25,2200,155,127,282,Friday
2014,4,25,2100,243,173,416,Friday
2014,4,25,2000,310,228,538,Friday
2014,4,25,1900,391,321,712,Friday
2014,4,25,1800,387,435,822,Friday
2014,4,25,1700,370,506,876,Friday
2014,4,25,1600,358,405,763,Friday
2014,4,25,1500,373,332,705,Friday
2014,4,25,1400,401,328,729,Friday
2014,4,25,1300,329,314,643,Friday
2014,4,25,1200,394,249,643,Friday
2014,4,25,1100,403,189,592,Friday
2014,4,25,1000,403,157,560,Friday
2014,4,25,900,323,119,442,Friday
2014,4,25,800,185,84,269,Friday
2014,4,25,700,92,34,126,Friday
2014,4,25,600,43,32,75,Friday
2014,4,25,500,23,41,64,Friday
2014,4,25,400,33,37,70,Friday
2014,4,25,300,25,59,84,Friday
2014,4,25,200,30,52,82,Friday
2014,4,25,100,48,48,96,Friday
2014,4,24,2400,75,92,167,Thursday
2014,4,24,2300,89,99,188,Thursday
2014,4,24,2200,109,103,212,Thursday
2014,4,24,2100,166,177,343,Thursday
2014,4,24,2000,196,253,449,Thursday
2014,4,24,1900,204,280,484,Thursday
2014,4,24,1800,209,390,599,Thursday
2014,4,24,1700,292,509,801,Thursday
2014,4,24,1600,276,359,635,Thursday
2014,4,24,1500,315,371,686,Thursday
2014,4,24,1400,311,328,639,Thursday
2014,4,24,1300,357,238,595,Thursday
2014,4,24,1200,382,214,596,Thursday
2014,4,24,1100,377,195,572,Thursday
2014,4,24,1000,352,145,497,Thursday
2014,4,24,900,295,115,410,Thursday
2014,4,24,800,185,82,267,Thursday
2014,4,24,700,98,37,135,Thursday
2014,4,24,600,51,50,101,Thursday
2014,4,24,500,22,33,55,Thursday
2014,4,24,400,24,32,56,Thursday
2014,4,24,300,20,38,58,Thursday
2014,4,24,200,32,36,68,Thursday
2014,4,24,100,48,49,97,Thursday
2014,4,23,2400,51,60,111,Wednesday
2014,4,23,2300,84,101,185,Wednesday
2014,4,23,2200,98,145,243,Wednesday
2014,4,23,2100,135,161,296,Wednesday
2014,4,23,2000,125,256,381,Wednesday
2014,4,23,1900,169,273,442,Wednesday
2014,4,23,1800,185,314,499,Wednesday
2014,4,23,1700,214,413,627,Wednesday
2014,4,23,1600,249,350,599,Wednesday
2014,4,23,1500,244,328,572,Wednesday
2014,4,23,1400,248,295,543,Wednesday
2014,4,23,1300,258,241,499,Wednesday
2014,4,23,1200,325,189,514,Wednesday
2014,4,23,1100,326,182,508,Wednesday
2014,4,23,1000,309,144,453,Wednesday
2014,4,23,900,227,90,317,Wednesday
2014,4,23,800,141,64,205,Wednesday
2014,4,23,700,79,52,131,Wednesday
2014,4,23,600,51,25,76,Wednesday
2014,4,23,500,23,32,55,Wednesday
2014,4,23,400,28,22,50,Wednesday
2014,4,23,300,18,44,62,Wednesday
2014,4,23,200,29,50,79,Wednesday
2014,4,23,100,41,57,98,Wednesday
2014,4,22,2400,72,78,150,Tuesday
2014,4,22,2300,69,92,161,Tuesday
2014,4,22,2200,103,126,229,Tuesday
2014,4,22,2100,96,179,275,Tuesday
2014,4,22,2000,129,279,408,Tuesday
2014,4,22,1900,152,370,522,Tuesday
2014,4,22,1800,152,467,619,Tuesday
2014,4,22,1700,197,530,727,Tuesday
2014,4,22,1600,253,503,756,Tuesday
2014,4,22,1500,299,426,725,Tuesday
2014,4,22,1400,258,342,600,Tuesday
2014,4,22,1300,301,280,581,Tuesday
2014,4,22,1200,355,265,620,Tuesday
2014,4,22,1100,388,212,600,Tuesday
2014,4,22,1000,371,161,532,Tuesday
2014,4,22,900,283,107,390,Tuesday
2014,4,22,800,164,77,241,Tuesday
2014,4,22,700,82,57,139,Tuesday
2014,4,22,600,19,34,53,Tuesday
2014,4,22,500,36,40,76,Tuesday
2014,4,22,400,14,42,56,Tuesday
2014,4,22,300,31,38,69,Tuesday
2014,4,22,200,24,50,74,Tuesday
2014,4,22,100,34,82,116,Tuesday
2014,4,21,2400,46,133,179,Monday
2014,4,21,2300,56,170,226,Monday
2014,4,21,2200,78,244,322,Monday
2014,4,21,2100,113,376,489,Monday
2014,4,21,2000,140,538,678,Monday
2014,4,21,1900,167,835,1002,Monday
2014,4,21,1800,211,1136,1347,Monday
2014,4,21,1700,264,1220,1484,Monday
2014,4,21,1600,345,1148,1493,Monday
2014,4,21,1500,400,956,1356,Monday
2014,4,21,1400,419,805,1224,Monday
2014,4,21,1300,486,696,1182,Monday
2014,4,21,1200,619,564,1183,Monday
2014,4,21,1100,605,341,946,Monday
2014,4,21,1000,658,204,862,Monday
2014,4,21,900,423,114,537,Monday
2014,4,21,800,184,63,247,Monday
2014,4,21,700,92,52,144,Monday
2014,4,21,600,31,26,57,Monday
2014,4,21,500,23,34,57,Monday
2014,4,21,400,19,35,54,Monday
2014,4,21,300,16,49,65,Monday
2014,4,21,200,15,48,63,Monday
2014,4,21,100,27,82,109,Monday
2014,4,20,2400,30,139,169,Sunday
2014,4,20,2300,44,180,224,Sunday
2014,4,20,2200,64,313,377,Sunday
2014,4,20,2100,79,476,555,Sunday
2014,4,20,2000,103,663,766,Sunday
2014,4,20,1900,124,854,978,Sunday
2014,4,20,1800,168,1228,1396,Sunday
2014,4,20,1700,224,1399,1623,Sunday
2014,4,20,1600,278,1251,1529,Sunday
2014,4,20,1500,344,1099,1443,Sunday
2014,4,20,1400,410,1026,1436,Sunday
2014,4,20,1300,414,795,1209,Sunday
2014,4,20,1200,508,549,1057,Sunday
2014,4,20,1100,528,339,867,Sunday
2014,4,20,1000,494,149,643,Sunday
2014,4,20,900,439,77,516,Sunday
2014,4,20,800,176,32,208,Sunday
2014,4,20,700,63,20,83,Sunday
2014,4,20,600,22,8,30,Sunday
2014,4,20,500,12,18,30,Sunday
2014,4,20,400,9,24,33,Sunday
2014,4,20,300,12,15,27,Sunday
2014,4,20,200,15,19,34,Sunday
2014,4,20,100,18,42,60,Sunday
2014,4,19,2400,41,53,94,Saturday
2014,4,19,2300,58,59,117,Saturday
2014,4,19,2200,64,112,176,Saturday
2014,4,19,2100,105,190,295,Saturday
2014,4,19,2000,141,348,489,Saturday
2014,4,19,1900,154,619,773,Saturday
2014,4,19,1800,218,925,1143,Saturday
2014,4,19,1700,282,1140,1422,Saturday
2014,4,19,1600,338,749,1087,Saturday
2014,4,19,1500,415,577,992,Saturday
2014,4,19,1400,436,460,896,Saturday
2014,4,19,1300,532,335,867,Saturday
2014,4,19,1200,681,268,949,Saturday
2014,4,19,1100,705,153,858,Saturday
2014,4,19,1000,830,99,929,Saturday
2014,4,19,900,901,76,977,Saturday
2014,4,19,800,328,42,370,Saturday
2014,4,19,700,85,18,103,Saturday
2014,4,19,600,25,15,40,Saturday
2014,4,19,500,19,6,25,Saturday
2014,4,19,400,15,14,29,Saturday
2014,4,19,300,19,17,36,Saturday
2014,4,19,200,14,30,44,Saturday
2014,4,19,100,22,44,66,Saturday
2014,4,18,2400,33,28,61,Friday
2014,4,18,2300,56,65,121,Friday
2014,4,18,2200,78,84,162,Friday
2014,4,18,2100,133,143,276,Friday
2014,4,18,2000,147,226,373,Friday
2014,4,18,1900,181,332,513,Friday
2014,4,18,1800,287,703,990,Friday
2014,4,18,1700,438,857,1295,Friday
2014,4,18,1600,581,742,1323,Friday
2014,4,18,1500,707,606,1313,Friday
2014,4,18,1400,863,486,1349,Friday
2014,4,18,1300,1004,395,1399,Friday
2014,4,18,1200,1200,275,1475,Friday
2014,4,18,1100,1256,228,1484,Friday
2014,4,18,1000,1322,161,1483,Friday
2014,4,18,900,1268,102,1370,Friday
2014,4,18,800,600,52,652,Friday
2014,4,18,700,223,29,252,Friday
2014,4,18,600,97,35,132,Friday
2014,4,18,500,60,21,81,Friday
2014,4,18,400,44,32,76,Friday
2014,4,18,300,25,24,49,Friday
2014,4,18,200,55,35,90,Friday
2014,4,18,100,85,64,149,Friday
2014,4,17,2400,155,84,239,Thursday
2014,4,17,2300,273,133,406,Thursday
2014,4,17,2200,383,161,544,Thursday
2014,4,17,2100,714,180,894,Thursday
2014,4,17,2000,909,238,1147,Thursday
2014,4,17,1900,1008,321,1329,Thursday
2014,4,17,1800,982,451,1433,Thursday
2014,4,17,1700,819,558,1377,Thursday
2014,4,17,1600,772,466,1238,Thursday
2014,4,17,1500,744,388,1132,Thursday
2014,4,17,1400,604,343,947,Thursday
2014,4,17,1300,502,242,744,Thursday
2014,4,17,1200,612,200,812,Thursday
2014,4,17,1100,620,181,801,Thursday
2014,4,17,1000,549,144,693,Thursday
2014,4,17,900,471,107,578,Thursday
2014,4,17,800,268,83,351,Thursday
2014,4,17,700,150,45,195,Thursday
2014,4,17,600,70,40,110,Thursday
2014,4,17,500,34,47,81,Thursday
2014,4,17,400,26,43,69,Thursday
2014,4,17,300,22,43,65,Thursday
2014,4,17,200,37,43,80,Thursday
2014,4,17,100,54,58,112,Thursday
2014,4,16,2400,67,76,143,Wednesday
2014,4,16,2300,111,93,204,Wednesday
2014,4,16,2200,119,93,212,Wednesday
2014,4,16,2100,162,142,304,Wednesday
2014,4,16,2000,217,148,365,Wednesday
2014,4,16,1900,228,224,452,Wednesday
2014,4,16,1800,268,323,591,Wednesday
2014,4,16,1700,282,380,662,Wednesday
2014,4,16,1600,285,297,582,Wednesday
2014,4,16,1500,257,239,496,Wednesday
2014,4,16,1400,317,226,543,Wednesday
2014,4,16,1300,370,222,592,Wednesday
2014,4,16,1200,270,191,461,Wednesday
2014,4,16,1100,315,145,460,Wednesday
2014,4,16,1000,261,124,385,Wednesday
2014,4,16,900,273,100,373,Wednesday
2014,4,16,800,136,78,214,Wednesday
2014,4,16,700,87,42,129,Wednesday
2014,4,16,600,34,30,64,Wednesday
2014,4,16,500,26,42,68,Wednesday
2014,4,16,400,33,37,70,Wednesday
2014,4,16,300,20,38,58,Wednesday
2014,4,16,200,35,31,66,Wednesday
2014,4,16,100,40,65,105,Wednesday
2014,4,15,2400,44,53,97,Tuesday
2014,4,15,2300,58,73,131,Tuesday
2014,4,15,2200,79,137,216,Tuesday
2014,4,15,2100,107,121,228,Tuesday
2014,4,15,2000,149,181,330,Tuesday
2014,4,15,1900,134,243,377,Tuesday
2014,4,15,1800,172,330,502,Tuesday
2014,4,15,1700,218,342,560,Tuesday
2014,4,15,1600,217,261,478,Tuesday
2014,4,15,1500,264,280,544,Tuesday
2014,4,15,1400,221,238,459,Tuesday
2014,4,15,1300,248,200,448,Tuesday
2014,4,15,1200,265,189,454,Tuesday
2014,4,15,1100,267,157,424,Tuesday
2014,4,15,1000,262,115,377,Tuesday
2014,4,15,900,262,110,372,Tuesday
2014,4,15,800,92,73,165,Tuesday
2014,4,15,700,79,45,124,Tuesday
2014,4,15,600,30,35,65,Tuesday
2014,4,15,500,27,32,59,Tuesday
2014,4,15,400,23,29,52,Tuesday
2014,4,15,300,23,30,53,Tuesday
2014,4,15,200,22,36,58,Tuesday
2014,4,15,100,36,53,89,Tuesday
2014,4,14,2400,54,62,116,Monday
2014,4,14,2300,65,80,145,Monday
2014,4,14,2200,80,104,184,Monday
2014,4,14,2100,84,125,209,Monday
2014,4,14,2000,140,185,325,Monday
2014,4,14,1900,148,284,432,Monday
2014,4,14,1800,166,400,566,Monday
2014,4,14,1700,214,445,659,Monday
2014,4,14,1600,235,337,572,Monday
2014,4,14,1500,256,282,538,Monday
2014,4,14,1400,251,263,514,Monday
2014,4,14,1300,278,199,477,Monday
2014,4,14,1200,349,182,531,Monday
2014,4,14,1100,374,163,537,Monday
2014,4,14,1000,331,121,452,Monday
2014,4,14,900,252,89,341,Monday
2014,4,14,800,163,50,213,Monday
2014,4,14,700,77,42,119,Monday
2014,4,14,600,41,23,64,Monday
2014,4,14,500,17,21,38,Monday
2014,4,14,400,16,25,41,Monday
2014,4,14,300,14,31,45,Monday
2014,4,14,200,20,33,53,Monday
2014,4,14,100,30,45,75,Monday
2014,4,13,2400,27,77,104,Sunday
2014,4,13,2300,44,120,164,Sunday
2014,4,13,2200,65,161,226,Sunday
2014,4,13,2100,84,327,411,Sunday
2014,4,13,2000,100,522,622,Sunday
2014,4,13,1900,159,615,774,Sunday
2014,4,13,1800,163,1027,1190,Sunday
2014,4,13,1700,191,1201,1392,Sunday
2014,4,13,1600,230,773,1003,Sunday
2014,4,13,1500,301,607,908,Sunday
2014,4,13,1400,325,445,770,Sunday
2014,4,13,1300,363,372,735,Sunday
2014,4,13,1200,447,278,725,Sunday
2014,4,13,1100,539,193,732,Sunday
2014,4,13,1000,620,126,746,Sunday
2014,4,13,900,608,59,667,Sunday
2014,4,13,800,234,26,260,Sunday
2014,4,13,700,72,14,86,Sunday
2014,4,13,600,33,16,49,Sunday
2014,4,13,500,13,10,23,Sunday
2014,4,13,400,9,21,30,Sunday
2014,4,13,300,15,21,36,Sunday
2014,4,13,200,15,26,41,Sunday
2014,4,13,100,28,28,56,Sunday
2014,4,12,2400,34,35,69,Saturday
2014,4,12,2300,40,76,116,Saturday
2014,4,12,2200,88,102,190,Saturday
2014,4,12,2100,82,129,211,Saturday
2014,4,12,2000,115,189,304,Saturday
2014,4,12,1900,115,303,418,Saturday
2014,4,12,1800,169,660,829,Saturday
2014,4,12,1700,201,663,864,Saturday
2014,4,12,1600,245,443,688,Saturday
2014,4,12,1500,274,282,556,Saturday
2014,4,12,1400,277,272,549,Saturday
2014,4,12,1300,366,203,569,Saturday
2014,4,12,1200,426,192,618,Saturday
2014,4,12,1100,499,150,649,Saturday
2014,4,12,1000,645,161,806,Saturday
2014,4,12,900,630,81,711,Saturday
2014,4,12,800,258,58,316,Saturday
2014,4,12,700,67,31,98,Saturday
2014,4,12,600,23,20,43,Saturday
2014,4,12,500,18,28,46,Saturday
2014,4,12,400,16,30,46,Saturday
2014,4,12,300,21,24,45,Saturday
2014,4,12,200,28,23,51,Saturday
2014,4,12,100,37,38,75,Saturday
2014,4,11,2400,72,47,119,Friday
2014,4,11,2300,93,63,156,Friday
2014,4,11,2200,138,91,229,Friday
2014,4,11,2100,213,117,330,Friday
2014,4,11,2000,363,181,544,Friday
2014,4,11,1900,404,241,645,Friday
2014,4,11,1800,419,386,805,Friday
2014,4,11,1700,379,473,852,Friday
2014,4,11,1600,398,377,775,Friday
2014,4,11,1500,393,312,705,Friday
2014,4,11,1400,320,256,576,Friday
2014,4,11,1300,324,235,559,Friday
2014,4,11,1200,366,171,537,Friday
2014,4,11,1100,420,164,584,Friday
2014,4,11,1000,362,116,478,Friday
2014,4,11,900,362,72,434,Friday
2014,4,11,800,191,68,259,Friday
2014,4,11,700,79,34,113,Friday
2014,4,11,600,41,34,75,Friday
2014,4,11,500,34,29,63,Friday
2014,4,11,400,27,29,56,Friday
2014,4,11,300,35,39,74,Friday
2014,4,11,200,28,36,64,Friday
2014,4,11,100,38,53,91,Friday
2014,4,10,2400,56,65,121,Thursday
2014,4,10,2300,101,81,182,Thursday
2014,4,10,2200,120,100,220,Thursday
2014,4,10,2100,170,123,293,Thursday
2014,4,10,2000,191,171,362,Thursday
2014,4,10,1900,210,213,423,Thursday
2014,4,10,1800,244,310,554,Thursday
2014,4,10,1700,240,425,665,Thursday
2014,4,10,1600,278,330,608,Thursday
2014,4,10,1500,274,276,550,Thursday
2014,4,10,1400,262,210,472,Thursday
2014,4,10,1300,242,220,462,Thursday
2014,4,10,1200,301,160,461,Thursday
2014,4,10,1100,311,146,457,Thursday
2014,4,10,1000,351,110,461,Thursday
2014,4,10,900,263,85,348,Thursday
2014,4,10,800,168,57,225,Thursday
2014,4,10,700,90,42,132,Thursday
2014,4,10,600,47,32,79,Thursday
2014,4,10,500,32,31,63,Thursday
2014,4,10,400,28,30,58,Thursday
2014,4,10,300,22,32,54,Thursday
2014,4,10,200,33,43,76,Thursday
2014,4,10,100,43,50,93,Thursday
2014,4,9,2400,63,67,130,Wednesday
2014,4,9,2300,83,65,148,Wednesday
2014,4,9,2200,111,92,203,Wednesday
2014,4,9,2100,124,107,231,Wednesday
2014,4,9,2000,125,151,276,Wednesday
2014,4,9,1900,140,206,346,Wednesday
2014,4,9,1800,168,299,467,Wednesday
2014,4,9,1700,216,351,567,Wednesday
2014,4,9,1600,208,253,461,Wednesday
2014,4,9,1500,202,234,436,Wednesday
2014,4,9,1400,188,179,367,Wednesday
2014,4,9,1300,231,201,432,Wednesday
2014,4,9,1200,240,160,400,Wednesday
2014,4,9,1100,247,140,387,Wednesday
2014,4,9,1000,242,119,361,Wednesday
2014,4,9,900,218,97,315,Wednesday
2014,4,9,800,147,71,218,Wednesday
2014,4,9,700,64,37,101,Wednesday
2014,4,9,600,29,43,72,Wednesday
2014,4,9,500,16,24,40,Wednesday
2014,4,9,400,23,36,59,Wednesday
2014,4,9,300,18,20,38,Wednesday
2014,4,9,200,32,36,68,Wednesday
2014,4,9,100,46,51,97,Wednesday
2014,4,8,2400,59,40,99,Tuesday
2014,4,8,2300,63,72,135,Tuesday
2014,4,8,2200,87,98,185,Tuesday
2014,4,8,2100,104,200,304,Tuesday
2014,4,8,2000,115,99,214,Tuesday
2014,4,8,1900,143,252,395,Tuesday
2014,4,8,1800,149,245,394,Tuesday
2014,4,8,1700,163,379,542,Tuesday
2014,4,8,1600,215,331,546,Tuesday
2014,4,8,1500,208,259,467,Tuesday
2014,4,8,1400,173,210,383,Tuesday
2014,4,8,1300,218,172,390,Tuesday
2014,4,8,1200,252,159,411,Tuesday
2014,4,8,1100,269,170,439,Tuesday
2014,4,8,1000,264,131,395,Tuesday
2014,4,8,900,226,114,340,Tuesday
2014,4,8,800,142,53,195,Tuesday
2014,4,8,700,57,49,106,Tuesday
2014,4,8,600,34,32,66,Tuesday
2014,4,8,500,25,26,51,Tuesday
2014,4,8,400,22,47,69,Tuesday
2014,4,8,300,19,40,59,Tuesday
2014,4,8,200,14,36,50,Tuesday
2014,4,8,100,47,59,106,Tuesday
2014,4,7,2400,61,58,119,Monday
2014,4,7,2300,56,85,141,Monday
2014,4,7,2200,86,114,200,Monday
2014,4,7,2100,81,119,200,Monday
2014,4,7,2000,115,196,311,Monday
2014,4,7,1900,125,215,340,Monday
2014,4,7,1800,171,379,550,Monday
2014,4,7,1700,180,424,604,Monday
2014,4,7,1600,202,314,516,Monday
2014,4,7,1500,235,302,537,Monday
2014,4,7,1400,219,241,460,Monday
2014,4,7,1300,238,242,480,Monday
2014,4,7,1200,278,196,474,Monday
2014,4,7,1100,273,146,419,Monday
2014,4,7,1000,286,123,409,Monday
2014,4,7,900,242,96,338,Monday
2014,4,7,800,147,69,216,Monday
2014,4,7,700,57,39,96,Monday
2014,4,7,600,26,24,50,Monday
2014,4,7,500,18,23,41,Monday
2014,4,7,400,23,26,49,Monday
2014,4,7,300,23,24,47,Monday
2014,4,7,200,21,22,43,Monday
2014,4,7,100,28,35,63,Monday
2014,4,6,2400,27,71,98,Sunday
2014,4,6,2300,54,102,156,Sunday
2014,4,6,2200,52,169,221,Sunday
2014,4,6,2100,90,249,339,Sunday
2014,4,6,2000,108,453,561,Sunday
2014,4,6,1900,115,602,717,Sunday
2014,4,6,1800,127,1278,1405,Sunday
2014,4,6,1700,177,1248,1425,Sunday
2014,4,6,1600,212,906,1118,Sunday
2014,4,6,1500,269,644,913,Sunday
2014,4,6,1400,289,594,883,Sunday
2014,4,6,1300,306,541,847,Sunday
2014,4,6,1200,419,408,827,Sunday
2014,4,6,1100,412,222,634,Sunday
2014,4,6,1000,568,119,687,Sunday
2014,4,6,900,668,70,738,Sunday
2014,4,6,800,296,30,326,Sunday
2014,4,6,700,48,12,60,Sunday
2014,4,6,600,21,10,31,Sunday
2014,4,6,500,14,18,32,Sunday
2014,4,6,400,3,20,23,Sunday
2014,4,6,300,17,25,42,Sunday
2014,4,6,200,17,30,47,Sunday
2014,4,6,100,23,34,57,Sunday
2014,4,5,2400,28,59,87,Saturday
2014,4,5,2300,53,70,123,Saturday
2014,4,5,2200,68,113,181,Saturday
2014,4,5,2100,99,160,259,Saturday
2014,4,5,2000,131,264,395,Saturday
2014,4,5,1900,124,488,612,Saturday
2014,4,5,1800,155,906,1061,Saturday
2014,4,5,1700,221,839,1060,Saturday
2014,4,5,1600,267,601,868,Saturday
2014,4,5,1500,290,481,771,Saturday
2014,4,5,1400,323,355,678,Saturday
2014,4,5,1300,360,295,655,Saturday
2014,4,5,1200,440,304,744,Saturday
2014,4,5,1100,518,211,729,Saturday
2014,4,5,1000,754,132,886,Saturday
2014,4,5,900,896,97,993,Saturday
2014,4,5,800,441,58,499,Saturday
2014,4,5,700,111,27,138,Saturday
2014,4,5,600,30,30,60,Saturday
2014,4,5,500,24,26,50,Saturday
2014,4,5,400,20,38,58,Saturday
2014,4,5,300,18,29,47,Saturday
2014,4,5,200,22,26,48,Saturday
2014,4,5,100,41,47,88,Saturday
2014,4,4,2400,56,52,108,Friday
2014,4,4,2300,111,88,199,Friday
2014,4,4,2200,175,96,271,Friday
2014,4,4,2100,273,125,398,Friday
2014,4,4,2000,411,184,595,Friday
2014,4,4,1900,483,291,774,Friday
2014,4,4,1800,512,586,1098,Friday
2014,4,4,1700,458,645,1103,Friday
2014,4,4,1600,426,514,940,Friday
2014,4,4,1500,404,346,750,Friday
2014,4,4,1400,360,303,663,Friday
2014,4,4,1300,379,281,660,Friday
2014,4,4,1200,401,236,637,Friday
2014,4,4,1100,412,160,572,Friday
2014,4,4,1000,548,143,691,Friday
2014,4,4,900,492,97,589,Friday
2014,4,4,800,224,57,281,Friday
2014,4,4,700,76,48,124,Friday
2014,4,4,600,39,26,65,Friday
2014,4,4,500,18,32,50,Friday
2014,4,4,400,25,42,67,Friday
2014,4,4,300,19,24,43,Friday
2014,4,4,200,32,30,62,Friday
2014,4,4,100,43,49,92,Friday
2014,4,3,2400,66,67,133,Thursday
2014,4,3,2300,98,63,161,Thursday
2014,4,3,2200,142,76,218,Thursday
2014,4,3,2100,165,119,284,Thursday
2014,4,3,2000,198,177,375,Thursday
2014,4,3,1900,218,242,460,Thursday
2014,4,3,1800,226,422,648,Thursday
2014,4,3,1700,249,520,769,Thursday
2014,4,3,1600,278,411,689,Thursday
2014,4,3,1500,266,293,559,Thursday
2014,4,3,1400,248,234,482,Thursday
2014,4,3,1300,262,218,480,Thursday
2014,4,3,1200,308,203,511,Thursday
2014,4,3,1100,297,146,443,Thursday
2014,4,3,1000,378,117,495,Thursday
2014,4,3,900,361,89,450,Thursday
2014,4,3,800,151,57,208,Thursday
2014,4,3,700,65,46,111,Thursday
2014,4,3,600,31,30,61,Thursday
2014,4,3,500,23,22,45,Thursday
2014,4,3,400,19,28,47,Thursday
2014,4,3,300,20,24,44,Thursday
2014,4,3,200,31,29,60,Thursday
2014,4,3,100,46,54,100,Thursday
2014,4,2,2400,56,49,105,Wednesday
2014,4,2,2300,72,77,149,Wednesday
2014,4,2,2200,107,95,202,Wednesday
2014,4,2,2100,110,130,240,Wednesday
2014,4,2,2000,136,143,279,Wednesday
2014,4,2,1900,155,222,377,Wednesday
2014,4,2,1800,169,387,556,Wednesday
2014,4,2,1700,259,478,737,Wednesday
2014,4,2,1600,206,413,619,Wednesday
2014,4,2,1500,250,263,513,Wednesday
2014,4,2,1400,233,199,432,Wednesday
2014,4,2,1300,235,229,464,Wednesday
2014,4,2,1200,302,158,460,Wednesday
2014,4,2,1100,289,162,451,Wednesday
2014,4,2,1000,362,124,486,Wednesday
2014,4,2,900,311,101,412,Wednesday
2014,4,2,800,155,58,213,Wednesday
2014,4,2,700,63,44,107,Wednesday
2014,4,2,600,25,25,50,Wednesday
2014,4,2,500,22,24,46,Wednesday
2014,4,2,400,26,30,56,Wednesday
2014,4,2,300,17,25,42,Wednesday
2014,4,2,200,24,38,62,Wednesday
2014,4,2,100,30,49,79,Wednesday
2014,4,1,2400,63,72,135,Tuesday
2014,4,1,2300,88,75,163,Tuesday
2014,4,1,2200,80,103,183,Tuesday
2014,4,1,2100,94,148,242,Tuesday
2014,4,1,2000,131,199,330,Tuesday
2014,4,1,1900,126,241,367,Tuesday
2014,4,1,1800,129,428,557,Tuesday
2014,4,1,1700,190,472,662,Tuesday
2014,4,1,1600,210,361,571,Tuesday
2014,4,1,1500,238,384,622,Tuesday
2014,4,1,1400,255,164,419,Tuesday
2014,4,1,1300,268,239,507,Tuesday
2014,4,1,1200,273,177,450,Tuesday
2014,4,1,1100,331,166,497,Tuesday
2014,4,1,1000,429,109,538,Tuesday
2014,4,1,900,324,81,405,Tuesday
2014,4,1,800,131,55,186,Tuesday
2014,4,1,700,63,34,97,Tuesday
2014,4,1,600,28,26,54,Tuesday
2014,4,1,500,21,29,50,Tuesday
2014,4,1,400,19,33,52,Tuesday
2014,4,1,300,21,24,45,Tuesday
2014,4,1,200,23,37,60,Tuesday
2014,4,1,100,27,49,76,Tuesday
2014,3,31,2400,57,62,119,Monday
2014,3,31,2300,62,89,151,Monday
2014,3,31,2200,81,115,196,Monday
2014,3,31,2100,114,113,227,Monday
2014,3,31,2000,131,180,311,Monday
2014,3,31,1900,140,248,388,Monday
2014,3,31,1800,196,524,720,Monday
2014,3,31,1700,189,763,952,Monday
2014,3,31,1600,217,358,575,Monday
2014,3,31,1500,256,214,470,Monday
2014,3,31,1400,249,288,537,Monday
2014,3,31,1300,276,243,519,Monday
2014,3,31,1200,356,201,557,Monday
2014,3,31,1100,362,181,543,Monday
2014,3,31,1000,405,120,525,Monday
2014,3,31,900,357,69,426,Monday
2014,3,31,800,121,74,195,Monday
2014,3,31,700,59,26,85,Monday
2014,3,31,600,28,33,61,Monday
2014,3,31,500,12,21,33,Monday
2014,3,31,400,10,47,57,Monday
2014,3,31,300,18,27,45,Monday
2014,3,31,200,18,26,44,Monday
2014,3,31,100,25,37,62,Monday
2014,3,30,2400,44,69,113,Sunday
2014,3,30,2300,47,108,155,Sunday
2014,3,30,2200,72,170,242,Sunday
2014,3,30,2100,77,309,386,Sunday
2014,3,30,2000,95,431,526,Sunday
2014,3,30,1900,137,647,784,Sunday
2014,3,30,1800,165,1290,1455,Sunday
2014,3,30,1700,268,1211,1479,Sunday
2014,3,30,1600,294,928,1222,Sunday
2014,3,30,1500,331,721,1052,Sunday
2014,3,30,1400,311,680,991,Sunday
2014,3,30,1300,361,576,937,Sunday
2014,3,30,1200,447,455,902,Sunday
2014,3,30,1100,423,231,654,Sunday
2014,3,30,1000,612,113,725,Sunday
2014,3,30,900,740,81,821,Sunday
2014,3,30,800,225,23,248,Sunday
2014,3,30,700,32,26,58,Sunday
2014,3,30,600,11,23,34,Sunday
2014,3,30,500,8,29,37,Sunday
2014,3,30,400,16,9,25,Sunday
2014,3,30,300,10,14,24,Sunday
2014,3,30,200,18,28,46,Sunday
2014,3,30,100,19,34,53,Sunday
2014,3,29,2400,33,38,71,Saturday
2014,3,29,2300,61,63,124,Saturday
2014,3,29,2200,72,113,185,Saturday
2014,3,29,2100,103,162,265,Saturday
2014,3,29,2000,137,274,411,Saturday
2014,3,29,1900,156,556,712,Saturday
2014,3,29,1800,220,962,1182,Saturday
2014,3,29,1700,258,988,1246,Saturday
2014,3,29,1600,312,688,1000,Saturday
2014,3,29,1500,373,529,902,Saturday
2014,3,29,1400,411,361,772,Saturday
2014,3,29,1300,393,330,723,Saturday
2014,3,29,1200,504,257,761,Saturday
2014,3,29,1100,569,193,762,Saturday
2014,3,29,1000,797,119,916,Saturday
2014,3,29,900,1066,101,1167,Saturday
2014,3,29,800,374,32,406,Saturday
2014,3,29,700,87,29,116,Saturday
2014,3,29,600,26,20,46,Saturday
2014,3,29,500,20,22,42,Saturday
2014,3,29,400,17,22,39,Saturday
2014,3,29,300,20,21,41,Saturday
2014,3,29,200,31,35,66,Saturday
2014,3,29,100,44,47,91,Saturday
2014,3,28,2400,83,48,131,Friday
2014,3,28,2300,153,72,225,Friday
2014,3,28,2200,206,98,304,Friday
2014,3,28,2100,299,156,455,Friday
2014,3,28,2000,408,225,633,Friday
2014,3,28,1900,427,299,726,Friday
2014,3,28,1800,416,654,1070,Friday
2014,3,28,1700,483,670,1153,Friday
2014,3,28,1600,448,474,922,Friday
2014,3,28,1500,424,388,812,Friday
2014,3,28,1400,391,360,751,Friday
2014,3,28,1300,353,245,598,Friday
2014,3,28,1200,457,188,645,Friday
2014,3,28,1100,430,154,584,Friday
2014,3,28,1000,537,114,651,Friday
2014,3,28,900,590,94,684,Friday
2014,3,28,800,225,59,284,Friday
2014,3,28,700,51,34,85,Friday
2014,3,28,600,35,39,74,Friday
2014,3,28,500,22,20,42,Friday
2014,3,28,400,30,40,70,Friday
2014,3,28,300,14,32,46,Friday
2014,3,28,200,27,34,61,Friday
2014,3,28,100,50,41,91,Friday
2014,3,27,2400,46,53,99,Thursday
2014,3,27,2300,90,64,154,Thursday
2014,3,27,2200,126,82,208,Thursday
2014,3,27,2100,161,137,298,Thursday
2014,3,27,2000,189,165,354,Thursday
2014,3,27,1900,233,267,500,Thursday
2014,3,27,1800,274,438,712,Thursday
2014,3,27,1700,303,508,811,Thursday
2014,3,27,1600,311,388,699,Thursday
2014,3,27,1500,324,291,615,Thursday
2014,3,27,1400,296,257,553,Thursday
2014,3,27,1300,299,257,556,Thursday
2014,3,27,1200,367,184,551,Thursday
2014,3,27,1100,325,122,447,Thursday
2014,3,27,1000,388,107,495,Thursday
2014,3,27,900,377,77,454,Thursday
2014,3,27,800,184,43,227,Thursday
2014,3,27,700,39,23,62,Thursday
2014,3,27,600,38,46,84,Thursday
2014,3,27,500,25,22,47,Thursday
2014,3,27,400,24,18,42,Thursday
2014,3,27,300,23,33,56,Thursday
2014,3,27,200,29,42,71,Thursday
2014,3,27,100,46,62,108,Thursday
2014,3,26,2400,57,39,96,Wednesday
2014,3,26,2300,76,72,148,Wednesday
2014,3,26,2200,99,91,190,Wednesday
2014,3,26,2100,106,115,221,Wednesday
2014,3,26,2000,152,172,324,Wednesday
2014,3,26,1900,153,249,402,Wednesday
2014,3,26,1800,184,388,572,Wednesday
2014,3,26,1700,189,390,579,Wednesday
2014,3,26,1600,188,341,529,Wednesday
2014,3,26,1500,214,394,608,Wednesday
2014,3,26,1400,242,284,526,Wednesday
2014,3,26,1300,235,281,516,Wednesday
2014,3,26,1200,280,142,422,Wednesday
2014,3,26,1100,287,84,371,Wednesday
2014,3,26,1000,340,89,429,Wednesday
2014,3,26,900,308,53,361,Wednesday
2014,3,26,800,133,50,183,Wednesday
2014,3,26,700,39,6,45,Wednesday
2014,3,26,600,36,12,48,Wednesday
2014,3,26,500,19,5,24,Wednesday
2014,3,26,400,14,9,23,Wednesday
2014,3,26,300,18,10,28,Wednesday
2014,3,26,200,24,37,61,Wednesday
2014,3,26,100,42,35,77,Wednesday
2014,3,25,2400,58,57,115,Tuesday
2014,3,25,2300,51,82,133,Tuesday
2014,3,25,2200,94,99,193,Tuesday
2014,3,25,2100,95,116,211,Tuesday
2014,3,25,2000,132,187,319,Tuesday
2014,3,25,1900,143,245,388,Tuesday
2014,3,25,1800,167,435,602,Tuesday
2014,3,25,1700,200,505,705,Tuesday
2014,3,25,1600,230,366,596,Tuesday
2014,3,25,1500,242,263,505,Tuesday
2014,3,25,1400,265,248,513,Tuesday
2014,3,25,1300,254,208,462,Tuesday
2014,3,25,1200,358,193,551,Tuesday
2014,3,25,1100,342,146,488,Tuesday
2014,3,25,1000,358,121,479,Tuesday
2014,3,25,900,306,78,384,Tuesday
2014,3,25,800,144,59,203,Tuesday
2014,3,25,700,39,28,67,Tuesday
2014,3,25,600,33,30,63,Tuesday
2014,3,25,500,26,26,52,Tuesday
2014,3,25,400,19,30,49,Tuesday
2014,3,25,300,20,44,64,Tuesday
2014,3,25,200,19,30,49,Tuesday
2014,3,25,100,31,55,86,Tuesday
2014,3,24,2400,46,63,109,Monday
2014,3,24,2300,55,84,139,Monday
2014,3,24,2200,69,85,154,Monday
2014,3,24,2100,105,119,224,Monday
2014,3,24,2000,109,196,305,Monday
2014,3,24,1900,165,313,478,Monday
2014,3,24,1800,182,508,690,Monday
2014,3,24,1700,242,513,755,Monday
2014,3,24,1600,246,392,638,Monday
2014,3,24,1500,321,296,617,Monday
2014,3,24,1400,275,249,524,Monday
2014,3,24,1300,346,239,585,Monday
2014,3,24,1200,407,211,618,Monday
2014,3,24,1100,342,142,484,Monday
2014,3,24,1000,417,119,536,Monday
2014,3,24,900,349,94,443,Monday
2014,3,24,800,151,56,207,Monday
2014,3,24,700,58,33,91,Monday
2014,3,24,600,29,22,51,Monday
2014,3,24,500,18,24,42,Monday
2014,3,24,400,12,19,31,Monday
2014,3,24,300,21,17,38,Monday
2014,3,24,200,13,33,46,Monday
2014,3,24,100,31,41,72,Monday
2014,3,23,2400,31,52,83,Sunday
2014,3,23,2300,51,112,163,Sunday
2014,3,23,2200,54,146,200,Sunday
2014,3,23,2100,90,230,320,Sunday
2014,3,23,2000,127,378,505,Sunday
2014,3,23,1900,149,499,648,Sunday
2014,3,23,1800,191,1076,1267,Sunday
2014,3,23,1700,232,1229,1461,Sunday
2014,3,23,1600,295,831,1126,Sunday
2014,3,23,1500,326,595,921,Sunday
2014,3,23,1400,320,478,798,Sunday
2014,3,23,1300,390,440,830,Sunday
2014,3,23,1200,439,310,749,Sunday
2014,3,23,1100,409,188,597,Sunday
2014,3,23,1000,533,114,647,Sunday
2014,3,23,900,716,52,768,Sunday
2014,3,23,800,237,29,266,Sunday
2014,3,23,700,30,12,42,Sunday
2014,3,23,600,18,14,32,Sunday
2014,3,23,500,15,10,25,Sunday
2014,3,23,400,16,13,29,Sunday
2014,3,23,300,15,17,32,Sunday
2014,3,23,200,17,29,46,Sunday
2014,3,23,100,29,20,49,Sunday
2014,3,22,2400,26,31,57,Saturday
2014,3,22,2300,56,60,116,Saturday
2014,3,22,2200,50,87,137,Saturday
2014,3,22,2100,70,97,167,Saturday
2014,3,22,2000,105,167,272,Saturday
2014,3,22,1900,130,409,539,Saturday
2014,3,22,1800,189,940,1129,Saturday
2014,3,22,1700,255,855,1110,Saturday
2014,3,22,1600,277,578,855,Saturday
2014,3,22,1500,332,344,676,Saturday
2014,3,22,1400,378,283,661,Saturday
2014,3,22,1300,451,228,679,Saturday
2014,3,22,1200,528,201,729,Saturday
2014,3,22,1100,563,173,736,Saturday
2014,3,22,1000,763,123,886,Saturday
2014,3,22,900,1116,83,1199,Saturday
2014,3,22,800,422,60,482,Saturday
2014,3,22,700,81,33,114,Saturday
2014,3,22,600,29,22,51,Saturday
2014,3,22,500,18,13,31,Saturday
2014,3,22,400,21,21,42,Saturday
2014,3,22,300,15,22,37,Saturday
2014,3,22,200,24,26,50,Saturday
2014,3,22,100,41,46,87,Saturday
2014,3,21,2400,71,56,127,Friday
2014,3,21,2300,101,66,167,Friday
2014,3,21,2200,179,70,249,Friday
2014,3,21,2100,290,126,416,Friday
2014,3,21,2000,373,179,552,Friday
2014,3,21,1900,519,242,761,Friday
2014,3,21,1800,528,491,1019,Friday
2014,3,21,1700,537,575,1112,Friday
2014,3,21,1600,495,390,885,Friday
2014,3,21,1500,429,349,778,Friday
2014,3,21,1400,407,227,634,Friday
2014,3,21,1300,356,218,574,Friday
2014,3,21,1200,386,187,573,Friday
2014,3,21,1100,460,155,615,Friday
2014,3,21,1000,538,95,633,Friday
2014,3,21,900,504,75,579,Friday
2014,3,21,800,181,41,222,Friday
2014,3,21,700,73,28,101,Friday
2014,3,21,600,37,12,49,Friday
2014,3,21,500,34,22,56,Friday
2014,3,21,400,16,37,53,Friday
2014,3,21,300,35,31,66,Friday
2014,3,21,200,25,48,73,Friday
2014,3,21,100,45,50,95,Friday
2014,3,20,2400,67,65,132,Thursday
2014,3,20,2300,87,96,183,Thursday
2014,3,20,2200,107,69,176,Thursday
2014,3,20,2100,150,98,248,Thursday
2014,3,20,2000,200,139,339,Thursday
2014,3,20,1900,210,200,410,Thursday
2014,3,20,1800,235,336,571,Thursday
2014,3,20,1700,296,364,660,Thursday
2014,3,20,1600,278,266,544,Thursday
2014,3,20,1500,237,225,462,Thursday
2014,3,20,1400,212,179,391,Thursday
2014,3,20,1300,224,149,373,Thursday
2014,3,20,1200,223,135,358,Thursday
2014,3,20,1100,263,131,394,Thursday
2014,3,20,1000,329,116,445,Thursday
2014,3,20,900,295,93,388,Thursday
2014,3,20,800,139,49,188,Thursday
2014,3,20,700,67,27,94,Thursday
2014,3,20,600,22,32,54,Thursday
2014,3,20,500,29,21,50,Thursday
2014,3,20,400,20,32,52,Thursday
2014,3,20,300,20,25,45,Thursday
2014,3,20,200,30,53,83,Thursday
2014,3,20,100,37,45,82,Thursday
2014,3,19,2400,60,68,128,Wednesday
2014,3,19,2300,70,69,139,Wednesday
2014,3,19,2200,77,103,180,Wednesday
2014,3,19,2100,121,86,207,Wednesday
2014,3,19,2000,150,142,292,Wednesday
2014,3,19,1900,163,193,356,Wednesday
2014,3,19,1800,188,346,534,Wednesday
2014,3,19,1700,203,408,611,Wednesday
2014,3,19,1600,214,247,461,Wednesday
2014,3,19,1500,196,228,424,Wednesday
2014,3,19,1400,216,231,447,Wednesday
2014,3,19,1300,200,165,365,Wednesday
2014,3,19,1200,260,154,414,Wednesday
2014,3,19,1100,285,122,407,Wednesday
2014,3,19,1000,296,101,397,Wednesday
2014,3,19,900,241,93,334,Wednesday
2014,3,19,800,140,59,199,Wednesday
2014,3,19,700,70,33,103,Wednesday
2014,3,19,600,34,37,71,Wednesday
2014,3,19,500,26,32,58,Wednesday
2014,3,19,400,24,42,66,Wednesday
2014,3,19,300,19,34,53,Wednesday
2014,3,19,200,31,23,54,Wednesday
2014,3,19,100,34,46,80,Wednesday
2014,3,18,2400,62,68,130,Tuesday
2014,3,18,2300,61,76,137,Tuesday
2014,3,18,2200,79,101,180,Tuesday
2014,3,18,2100,108,82,190,Tuesday
2014,3,18,2000,91,167,258,Tuesday
2014,3,18,1900,100,243,343,Tuesday
2014,3,18,1800,155,404,559,Tuesday
2014,3,18,1700,193,461,654,Tuesday
2014,3,18,1600,195,355,550,Tuesday
2014,3,18,1500,203,224,427,Tuesday
2014,3,18,1400,202,225,427,Tuesday
2014,3,18,1300,235,187,422,Tuesday
2014,3,18,1200,269,173,442,Tuesday
2014,3,18,1100,277,161,438,Tuesday
2014,3,18,1000,323,100,423,Tuesday
2014,3,18,900,253,91,344,Tuesday
2014,3,18,800,135,60,195,Tuesday
2014,3,18,700,59,28,87,Tuesday
2014,3,18,600,29,32,61,Tuesday
2014,3,18,500,22,26,48,Tuesday
2014,3,18,400,18,37,55,Tuesday
2014,3,18,300,17,35,52,Tuesday
2014,3,18,200,27,24,51,Tuesday
2014,3,18,100,43,44,87,Tuesday
2014,3,17,2400,52,57,109,Monday
2014,3,17,2300,55,80,135,Monday
2014,3,17,2200,67,96,163,Monday
2014,3,17,2100,90,118,208,Monday
2014,3,17,2000,134,174,308,Monday
2014,3,17,1900,132,220,352,Monday
2014,3,17,1800,162,502,664,Monday
2014,3,17,1700,148,485,633,Monday
2014,3,17,1600,182,437,619,Monday
2014,3,17,1500,207,349,556,Monday
2014,3,17,1400,195,339,534,Monday
2014,3,17,1300,218,236,454,Monday
2014,3,17,1200,299,172,471,Monday
2014,3,17,1100,303,178,481,Monday
2014,3,17,1000,416,100,516,Monday
2014,3,17,900,422,78,500,Monday
2014,3,17,800,142,47,189,Monday
2014,3,17,700,58,21,79,Monday
2014,3,17,600,27,23,50,Monday
2014,3,17,500,23,18,41,Monday
2014,3,17,400,17,15,32,Monday
2014,3,17,300,17,23,40,Monday
2014,3,17,200,16,32,48,Monday
2014,3,17,100,16,58,74,Monday
2014,3,16,2400,28,163,191,Sunday
2014,3,16,2300,49,157,206,Sunday
2014,3,16,2200,61,148,209,Sunday
2014,3,16,2100,74,347,421,Sunday
2014,3,16,2000,97,183,280,Sunday
2014,3,16,1900,114,421,535,Sunday
2014,3,16,1800,158,1311,1469,Sunday
2014,3,16,1700,189,1371,1560,Sunday
2014,3,16,1600,250,878,1128,Sunday
2014,3,16,1500,250,725,975,Sunday
2014,3,16,1400,245,615,860,Sunday
2014,3,16,1300,263,489,752,Sunday
2014,3,16,1200,338,432,770,Sunday
2014,3,16,1100,357,216,573,Sunday
2014,3,16,1000,581,124,705,Sunday
2014,3,16,900,1051,45,1096,Sunday
2014,3,16,800,355,27,382,Sunday
2014,3,16,700,46,7,53,Sunday
2014,3,16,600,17,6,23,Sunday
2014,3,16,500,11,18,29,Sunday
2014,3,16,400,11,16,27,Sunday
2014,3,16,300,10,9,19,Sunday
2014,3,16,200,12,34,46,Sunday
2014,3,16,100,21,32,53,Sunday
2014,3,15,2400,34,36,70,Saturday
2014,3,15,2300,35,63,98,Saturday
2014,3,15,2200,73,95,168,Saturday
2014,3,15,2100,93,145,238,Saturday
2014,3,15,2000,117,210,327,Saturday
2014,3,15,1900,147,469,616,Saturday
2014,3,15,1800,175,1031,1206,Saturday
2014,3,15,1700,259,1033,1292,Saturday
2014,3,15,1600,253,652,905,Saturday
2014,3,15,1500,266,441,707,Saturday
2014,3,15,1400,335,346,681,Saturday
2014,3,15,1300,391,272,663,Saturday
2014,3,15,1200,469,283,752,Saturday
2014,3,15,1100,479,181,660,Saturday
2014,3,15,1000,833,102,935,Saturday
2014,3,15,900,1149,83,1232,Saturday
2014,3,15,800,357,48,405,Saturday
2014,3,15,700,82,36,118,Saturday
2014,3,15,600,25,14,39,Saturday
2014,3,15,500,22,29,51,Saturday
2014,3,15,400,17,24,41,Saturday
2014,3,15,300,12,21,33,Saturday
2014,3,15,200,32,33,65,Saturday
2014,3,15,100,47,47,94,Saturday
2014,3,14,2400,67,69,136,Friday
2014,3,14,2300,132,64,196,Friday
2014,3,14,2200,201,99,300,Friday
2014,3,14,2100,277,106,383,Friday
2014,3,14,2000,437,199,636,Friday
2014,3,14,1900,452,275,727,Friday
2014,3,14,1800,484,575,1059,Friday
2014,3,14,1700,447,628,1075,Friday
2014,3,14,1600,424,507,931,Friday
2014,3,14,1500,373,225,598,Friday
2014,3,14,1400,331,183,514,Friday
2014,3,14,1300,301,181,482,Friday
2014,3,14,1200,374,190,564,Friday
2014,3,14,1100,408,159,567,Friday
2014,3,14,1000,514,136,650,Friday
2014,3,14,900,495,93,588,Friday
2014,3,14,800,196,44,240,Friday
2014,3,14,700,81,26,107,Friday
2014,3,14,600,35,31,66,Friday
2014,3,14,500,22,24,46,Friday
2014,3,14,400,18,30,48,Friday
2014,3,14,300,28,34,62,Friday
2014,3,14,200,34,25,59,Friday
2014,3,14,100,47,46,93,Friday
2014,3,13,2400,75,60,135,Thursday
2014,3,13,2300,105,81,186,Thursday
2014,3,13,2200,129,91,220,Thursday
2014,3,13,2100,160,131,291,Thursday
2014,3,13,2000,224,252,476,Thursday
2014,3,13,1900,254,184,438,Thursday
2014,3,13,1800,271,406,677,Thursday
2014,3,13,1700,272,445,717,Thursday
2014,3,13,1600,266,294,560,Thursday
2014,3,13,1500,247,256,503,Thursday
2014,3,13,1400,241,214,455,Thursday
2014,3,13,1300,260,186,446,Thursday
2014,3,13,1200,276,172,448,Thursday
2014,3,13,1100,316,136,452,Thursday
2014,3,13,1000,378,109,487,Thursday
2014,3,13,900,298,103,401,Thursday
2014,3,13,800,139,44,183,Thursday
2014,3,13,700,80,38,118,Thursday
2014,3,13,600,33,48,81,Thursday
2014,3,13,500,31,56,87,Thursday
2014,3,13,400,14,20,34,Thursday
2014,3,13,300,30,33,63,Thursday
2014,3,13,200,28,37,65,Thursday
2014,3,13,100,40,45,85,Thursday
2014,3,12,2400,45,72,117,Wednesday
2014,3,12,2300,69,65,134,Wednesday
2014,3,12,2200,99,78,177,Wednesday
2014,3,12,2100,126,91,217,Wednesday
2014,3,12,2000,125,155,280,Wednesday
2014,3,12,1900,135,229,364,Wednesday
2014,3,12,1800,186,400,586,Wednesday
2014,3,12,1700,187,438,625,Wednesday
2014,3,12,1600,191,334,525,Wednesday
2014,3,12,1500,202,213,415,Wednesday
2014,3,12,1400,214,209,423,Wednesday
2014,3,12,1300,247,164,411,Wednesday
2014,3,12,1200,289,175,464,Wednesday
2014,3,12,1100,309,119,428,Wednesday
2014,3,12,1000,310,114,424,Wednesday
2014,3,12,900,263,90,353,Wednesday
2014,3,12,800,148,42,190,Wednesday
2014,3,12,700,68,39,107,Wednesday
2014,3,12,600,28,32,60,Wednesday
2014,3,12,500,17,26,43,Wednesday
2014,3,12,400,18,26,44,Wednesday
2014,3,12,300,17,24,41,Wednesday
2014,3,12,200,24,29,53,Wednesday
2014,3,12,100,27,55,82,Wednesday
2014,3,11,2400,56,43,99,Tuesday
2014,3,11,2300,73,95,168,Tuesday
2014,3,11,2200,84,103,187,Tuesday
2014,3,11,2100,92,101,193,Tuesday
2014,3,11,2000,108,173,281,Tuesday
2014,3,11,1900,128,239,367,Tuesday
2014,3,11,1800,136,400,536,Tuesday
2014,3,11,1700,184,498,682,Tuesday
2014,3,11,1600,189,311,500,Tuesday
2014,3,11,1500,200,198,398,Tuesday
2014,3,11,1400,206,198,404,Tuesday
2014,3,11,1300,223,189,412,Tuesday
2014,3,11,1200,247,127,374,Tuesday
2014,3,11,1100,267,136,403,Tuesday
2014,3,11,1000,339,132,471,Tuesday
2014,3,11,900,290,88,378,Tuesday
2014,3,11,800,174,44,218,Tuesday
2014,3,11,700,50,34,84,Tuesday
2014,3,11,600,31,33,64,Tuesday
2014,3,11,500,21,21,42,Tuesday
2014,3,11,400,17,29,46,Tuesday
2014,3,11,300,20,22,42,Tuesday
2014,3,11,200,18,43,61,Tuesday
2014,3,11,100,44,45,89,Tuesday
2014,3,10,2400,53,70,123,Monday
2014,3,10,2300,57,76,133,Monday
2014,3,10,2200,70,91,161,Monday
2014,3,10,2100,90,132,222,Monday
2014,3,10,2000,107,165,272,Monday
2014,3,10,1900,144,326,470,Monday
2014,3,10,1800,154,625,779,Monday
2014,3,10,1700,192,514,706,Monday
2014,3,10,1600,205,494,699,Monday
2014,3,10,1500,164,354,518,Monday
2014,3,10,1400,220,290,510,Monday
2014,3,10,1300,214,375,589,Monday
2014,3,10,1200,265,625,890,Monday
2014,3,10,1100,359,70,429,Monday
2014,3,10,1000,430,74,504,Monday
2014,3,10,900,360,171,531,Monday
2014,3,10,800,157,120,277,Monday
2014,3,10,700,66,65,131,Monday
2014,3,10,600,42,24,66,Monday
2014,3,10,500,26,27,53,Monday
2014,3,10,400,24,27,51,Monday
2014,3,10,300,9,32,41,Monday
2014,3,10,200,13,85,98,Monday
2014,3,10,100,28,620,648,Monday
2014,3,9,2400,39,414,453,Sunday
2014,3,9,2300,42,71,113,Sunday
2014,3,9,2200,55,34,89,Sunday
2014,3,9,2100,52,132,184,Sunday
2014,3,9,2000,58,107,165,Sunday
2014,3,9,1900,83,232,315,Sunday
2014,3,9,1800,132,763,895,Sunday
2014,3,9,1700,172,814,986,Sunday
2014,3,9,1600,196,480,676,Sunday
2014,3,9,1500,193,349,542,Sunday
2014,3,9,1400,227,280,507,Sunday
2014,3,9,1300,326,207,533,Sunday
2014,3,9,1200,254,155,409,Sunday
2014,3,9,1100,296,93,389,Sunday
2014,3,9,1000,557,58,615,Sunday
2014,3,9,900,803,43,846,Sunday
2014,3,9,800,263,14,277,Sunday
2014,3,9,700,47,2,49,Sunday
2014,3,9,600,16,6,22,Sunday
2014,3,9,500,12,7,19,Sunday
2014,3,9,400,13,3,16,Sunday
2014,3,9,300,0,0,0,Sunday
2014,3,9,200,16,5,21,Sunday
2014,3,9,100,12,6,18,Sunday
2014,3,8,2400,19,28,47,Saturday
2014,3,8,2300,53,36,89,Saturday
2014,3,8,2200,76,68,144,Saturday
2014,3,8,2100,86,86,172,Saturday
2014,3,8,2000,98,187,285,Saturday
2014,3,8,1900,113,474,587,Saturday
2014,3,8,1800,190,1027,1217,Saturday
2014,3,8,1700,206,911,1117,Saturday
2014,3,8,1600,260,684,944,Saturday
2014,3,8,1500,298,496,794,Saturday
2014,3,8,1400,311,388,699,Saturday
2014,3,8,1300,350,308,658,Saturday
2014,3,8,1200,492,267,759,Saturday
2014,3,8,1100,572,245,817,Saturday
2014,3,8,1000,938,192,1130,Saturday
2014,3,8,900,1209,102,1311,Saturday
2014,3,8,800,475,44,519,Saturday
2014,3,8,700,88,29,117,Saturday
2014,3,8,600,42,19,61,Saturday
2014,3,8,500,17,17,34,Saturday
2014,3,8,400,29,31,60,Saturday
2014,3,8,300,25,30,55,Saturday
2014,3,8,200,19,28,47,Saturday
2014,3,8,100,31,37,68,Saturday
2014,3,7,2400,74,116,190,Friday
2014,3,7,2300,125,271,396,Friday
2014,3,7,2200,162,224,386,Friday
2014,3,7,2100,239,135,374,Friday
2014,3,7,2000,407,87,494,Friday
2014,3,7,1900,421,231,652,Friday
2014,3,7,1800,466,538,1004,Friday
2014,3,7,1700,378,510,888,Friday
2014,3,7,1600,408,340,748,Friday
2014,3,7,1500,368,224,592,Friday
2014,3,7,1400,325,175,500,Friday
2014,3,7,1300,251,158,409,Friday
2014,3,7,1200,322,117,439,Friday
2014,3,7,1100,372,99,471,Friday
2014,3,7,1000,451,82,533,Friday
2014,3,7,900,528,56,584,Friday
2014,3,7,800,214,25,239,Friday
2014,3,7,700,66,15,81,Friday
2014,3,7,600,23,15,38,Friday
2014,3,7,500,20,2,22,Friday
2014,3,7,400,20,7,27,Friday
2014,3,7,300,23,10,33,Friday
2014,3,7,200,22,13,35,Friday
2014,3,7,100,23,13,36,Friday
2014,3,6,2400,29,26,55,Thursday
2014,3,6,2300,76,39,115,Thursday
2014,3,6,2200,101,39,140,Thursday
2014,3,6,2100,146,95,241,Thursday
2014,3,6,2000,173,288,461,Thursday
2014,3,6,1900,199,214,413,Thursday
2014,3,6,1800,229,311,540,Thursday
2014,3,6,1700,211,241,452,Thursday
2014,3,6,1600,234,219,453,Thursday
2014,3,6,1500,188,103,291,Thursday
2014,3,6,1400,157,122,279,Thursday
2014,3,6,1300,163,126,289,Thursday
2014,3,6,1200,164,67,231,Thursday
2014,3,6,1100,250,132,382,Thursday
2014,3,6,1000,240,85,325,Thursday
2014,3,6,900,215,89,304,Thursday
2014,3,6,800,143,26,169,Thursday
2014,3,6,700,57,42,99,Thursday
2014,3,6,600,30,27,57,Thursday
2014,3,6,500,13,28,41,Thursday
2014,3,6,400,19,45,64,Thursday
2014,3,6,300,18,113,131,Thursday
2014,3,6,200,36,47,83,Thursday
2014,3,6,100,28,103,131,Thursday
2014,3,5,2400,48,26,74,Wednesday
2014,3,5,2300,57,22,79,Wednesday
2014,3,5,2200,84,15,99,Wednesday
2014,3,5,2100,101,28,129,Wednesday
2014,3,5,2000,113,72,185,Wednesday
2014,3,5,1900,106,153,259,Wednesday
2014,3,5,1800,128,240,368,Wednesday
2014,3,5,1700,178,264,442,Wednesday
2014,3,5,1600,174,215,389,Wednesday
2014,3,5,1500,172,202,374,Wednesday
2014,3,5,1400,200,143,343,Wednesday
2014,3,5,1300,174,165,339,Wednesday
2014,3,5,1200,193,129,322,Wednesday
2014,3,5,1100,241,114,355,Wednesday
2014,3,5,1000,243,99,342,Wednesday
2014,3,5,900,219,79,298,Wednesday
2014,3,5,800,122,40,162,Wednesday
2014,3,5,700,50,23,73,Wednesday
2014,3,5,600,30,19,49,Wednesday
2014,3,5,500,19,14,33,Wednesday
2014,3,5,400,18,23,41,Wednesday
2014,3,5,300,18,14,32,Wednesday
2014,3,5,200,27,34,61,Wednesday
2014,3,5,100,31,54,85,Wednesday
2014,3,4,2400,62,52,114,Tuesday
2014,3,4,2300,55,60,115,Tuesday
2014,3,4,2200,78,88,166,Tuesday
2014,3,4,2100,95,114,209,Tuesday
2014,3,4,2000,100,134,234,Tuesday
2014,3,4,1900,111,188,299,Tuesday
2014,3,4,1800,139,322,461,Tuesday
2014,3,4,1700,145,334,479,Tuesday
2014,3,4,1600,156,312,468,Tuesday
2014,3,4,1500,159,182,341,Tuesday
2014,3,4,1400,165,168,333,Tuesday
2014,3,4,1300,156,165,321,Tuesday
2014,3,4,1200,195,141,336,Tuesday
2014,3,4,1100,214,129,343,Tuesday
2014,3,4,1000,242,101,343,Tuesday
2014,3,4,900,208,83,291,Tuesday
2014,3,4,800,138,49,187,Tuesday
2014,3,4,700,53,34,87,Tuesday
2014,3,4,600,35,21,56,Tuesday
2014,3,4,500,21,13,34,Tuesday
2014,3,4,400,20,23,43,Tuesday
2014,3,4,300,19,24,43,Tuesday
2014,3,4,200,26,28,54,Tuesday
2014,3,4,100,26,60,86,Tuesday
2014,3,3,2400,46,71,117,Monday
2014,3,3,2300,52,67,119,Monday
2014,3,3,2200,89,68,157,Monday
2014,3,3,2100,83,115,198,Monday
2014,3,3,2000,83,102,185,Monday
2014,3,3,1900,106,186,292,Monday
2014,3,3,1800,121,296,417,Monday
2014,3,3,1700,140,311,451,Monday
2014,3,3,1600,171,236,407,Monday
2014,3,3,1500,153,198,351,Monday
2014,3,3,1400,159,160,319,Monday
2014,3,3,1300,193,174,367,Monday
2014,3,3,1200,218,170,388,Monday
2014,3,3,1100,239,109,348,Monday
2014,3,3,1000,218,102,320,Monday
2014,3,3,900,177,73,250,Monday
2014,3,3,800,119,38,157,Monday
2014,3,3,700,61,30,91,Monday
2014,3,3,600,16,26,42,Monday
2014,3,3,500,15,16,31,Monday
2014,3,3,400,13,16,29,Monday
2014,3,3,300,19,21,40,Monday
2014,3,3,200,10,28,38,Monday
2014,3,3,100,17,59,76,Monday
2014,3,2,2400,38,63,101,Sunday
2014,3,2,2300,47,78,125,Sunday
2014,3,2,2200,57,131,188,Sunday
2014,3,2,2100,69,157,226,Sunday
2014,3,2,2000,81,168,249,Sunday
2014,3,2,1900,103,313,416,Sunday
2014,3,2,1800,139,557,696,Sunday
2014,3,2,1700,174,614,788,Sunday
2014,3,2,1600,188,570,758,Sunday
2014,3,2,1500,221,586,807,Sunday
2014,3,2,1400,234,523,757,Sunday
2014,3,2,1300,261,463,724,Sunday
2014,3,2,1200,248,374,622,Sunday
2014,3,2,1100,237,214,451,Sunday
2014,3,2,1000,261,108,369,Sunday
2014,3,2,900,234,74,308,Sunday
2014,3,2,800,98,33,131,Sunday
2014,3,2,700,45,13,58,Sunday
2014,3,2,600,25,7,32,Sunday
2014,3,2,500,15,10,25,Sunday
2014,3,2,400,7,12,19,Sunday
2014,3,2,300,8,7,15,Sunday
2014,3,2,200,15,16,31,Sunday
2014,3,2,100,21,18,39,Sunday
2014,3,1,2400,29,37,66,Saturday
2014,3,1,2300,38,55,93,Saturday
2014,3,1,2200,57,70,127,Saturday
2014,3,1,2100,71,85,156,Saturday
2014,3,1,2000,86,128,214,Saturday
2014,3,1,1900,116,205,321,Saturday
2014,3,1,1800,182,378,560,Saturday
2014,3,1,1700,231,423,654,Saturday
2014,3,1,1600,228,291,519,Saturday
2014,3,1,1500,246,263,509,Saturday
2014,3,1,1400,284,262,546,Saturday
2014,3,1,1300,265,273,538,Saturday
2014,3,1,1200,321,200,521,Saturday
2014,3,1,1100,315,154,469,Saturday
2014,3,1,1000,315,116,431,Saturday
2014,3,1,900,253,81,334,Saturday
2014,3,1,800,165,57,222,Saturday
2014,3,1,700,72,24,96,Saturday
2014,3,1,600,23,21,44,Saturday
2014,3,1,500,16,21,37,Saturday
2014,3,1,400,19,25,44,Saturday
2014,3,1,300,11,21,32,Saturday
2014,3,1,200,29,27,56,Saturday
2014,3,1,100,33,35,68,Saturday
2014,2,28,2400,50,55,105,Friday
2014,2,28,2300,85,63,148,Friday
2014,2,28,2200,176,83,259,Friday
2014,2,28,2100,226,99,325,Friday
2014,2,28,2000,313,146,459,Friday
2014,2,28,1900,350,179,529,Friday
2014,2,28,1800,417,380,797,Friday
2014,2,28,1700,395,391,786,Friday
2014,2,28,1600,398,299,697,Friday
2014,2,28,1500,320,232,552,Friday
2014,2,28,1400,284,208,492,Friday
2014,2,28,1300,268,232,500,Friday
2014,2,28,1200,281,201,482,Friday
2014,2,28,1100,339,173,512,Friday
2014,2,28,1000,347,102,449,Friday
2014,2,28,900,292,97,389,Friday
2014,2,28,800,174,57,231,Friday
2014,2,28,700,62,32,94,Friday
2014,2,28,600,43,28,71,Friday
2014,2,28,500,29,40,69,Friday
2014,2,28,400,29,35,64,Friday
2014,2,28,300,32,19,51,Friday
2014,2,28,200,30,37,67,Friday
2014,2,28,100,39,34,73,Friday
2014,2,27,2400,57,38,95,Thursday
2014,2,27,2300,83,49,132,Thursday
2014,2,27,2200,117,70,187,Thursday
2014,2,27,2100,176,101,277,Thursday
2014,2,27,2000,198,119,317,Thursday
2014,2,27,1900,211,203,414,Thursday
2014,2,27,1800,236,378,614,Thursday
2014,2,27,1700,250,389,639,Thursday
2014,2,27,1600,261,267,528,Thursday
2014,2,27,1500,271,225,496,Thursday
2014,2,27,1400,245,201,446,Thursday
2014,2,27,1300,228,201,429,Thursday
2014,2,27,1200,243,177,420,Thursday
2014,2,27,1100,284,139,423,Thursday
2014,2,27,1000,337,131,468,Thursday
2014,2,27,900,311,92,403,Thursday
2014,2,27,800,136,45,181,Thursday
2014,2,27,700,70,28,98,Thursday
2014,2,27,600,30,22,52,Thursday
2014,2,27,500,15,17,32,Thursday
2014,2,27,400,30,24,54,Thursday
2014,2,27,300,26,27,53,Thursday
2014,2,27,200,23,23,46,Thursday
2014,2,27,100,47,36,83,Thursday
2014,2,26,2400,49,49,98,Wednesday
2014,2,26,2300,77,58,135,Wednesday
2014,2,26,2200,80,97,177,Wednesday
2014,2,26,2100,130,106,236,Wednesday
2014,2,26,2000,91,158,249,Wednesday
2014,2,26,1900,112,193,305,Wednesday
2014,2,26,1800,153,370,523,Wednesday
2014,2,26,1700,200,424,624,Wednesday
2014,2,26,1600,205,276,481,Wednesday
2014,2,26,1500,200,219,419,Wednesday
2014,2,26,1400,175,144,319,Wednesday
2014,2,26,1300,208,136,344,Wednesday
2014,2,26,1200,242,184,426,Wednesday
2014,2,26,1100,263,131,394,Wednesday
2014,2,26,1000,292,108,400,Wednesday
2014,2,26,900,247,93,340,Wednesday
2014,2,26,800,122,69,191,Wednesday
2014,2,26,700,76,18,94,Wednesday
2014,2,26,600,26,33,59,Wednesday
2014,2,26,500,21,30,51,Wednesday
2014,2,26,400,29,30,59,Wednesday
2014,2,26,300,14,23,37,Wednesday
2014,2,26,200,23,29,52,Wednesday
2014,2,26,100,44,46,90,Wednesday
2014,2,25,2400,52,47,99,Tuesday
2014,2,25,2300,63,73,136,Tuesday
2014,2,25,2200,84,87,171,Tuesday
2014,2,25,2100,96,118,214,Tuesday
2014,2,25,2000,90,95,185,Tuesday
2014,2,25,1900,140,189,329,Tuesday
2014,2,25,1800,125,290,415,Tuesday
2014,2,25,1700,164,368,532,Tuesday
2014,2,25,1600,174,237,411,Tuesday
2014,2,25,1500,151,214,365,Tuesday
2014,2,25,1400,196,193,389,Tuesday
2014,2,25,1300,196,184,380,Tuesday
2014,2,25,1200,230,154,384,Tuesday
2014,2,25,1100,242,128,370,Tuesday
2014,2,25,1000,264,130,394,Tuesday
2014,2,25,900,209,94,303,Tuesday
2014,2,25,800,112,57,169,Tuesday
2014,2,25,700,59,23,82,Tuesday
2014,2,25,600,29,33,62,Tuesday
2014,2,25,500,10,21,31,Tuesday
2014,2,25,400,28,18,46,Tuesday
2014,2,25,300,14,29,43,Tuesday
2014,2,25,200,21,22,43,Tuesday
2014,2,25,100,37,37,74,Tuesday
2014,2,24,2400,49,41,90,Monday
2014,2,24,2300,62,55,117,Monday
2014,2,24,2200,69,83,152,Monday
2014,2,24,2100,88,103,191,Monday
2014,2,24,2000,91,128,219,Monday
2014,2,24,1900,102,222,324,Monday
2014,2,24,1800,153,294,447,Monday
2014,2,24,1700,152,328,480,Monday
2014,2,24,1600,181,244,425,Monday
2014,2,24,1500,194,210,404,Monday
2014,2,24,1400,208,192,400,Monday
2014,2,24,1300,177,188,365,Monday
2014,2,24,1200,229,169,398,Monday
2014,2,24,1100,205,157,362,Monday
2014,2,24,1000,223,112,335,Monday
2014,2,24,900,178,75,253,Monday
2014,2,24,800,138,42,180,Monday
2014,2,24,700,69,32,101,Monday
2014,2,24,600,27,20,47,Monday
2014,2,24,500,20,24,44,Monday
2014,2,24,400,15,13,28,Monday
2014,2,24,300,26,19,45,Monday
2014,2,24,200,19,32,51,Monday
2014,2,24,100,11,37,48,Monday
2014,2,23,2400,31,47,78,Sunday
2014,2,23,2300,39,83,122,Sunday
2014,2,23,2200,59,118,177,Sunday
2014,2,23,2100,62,200,262,Sunday
2014,2,23,2000,86,326,412,Sunday
2014,2,23,1900,106,333,439,Sunday
2014,2,23,1800,123,672,795,Sunday
2014,2,23,1700,174,895,1069,Sunday
2014,2,23,1600,183,739,922,Sunday
2014,2,23,1500,200,613,813,Sunday
2014,2,23,1400,259,575,834,Sunday
2014,2,23,1300,220,528,748,Sunday
2014,2,23,1200,239,431,670,Sunday
2014,2,23,1100,241,266,507,Sunday
2014,2,23,1000,285,125,410,Sunday
2014,2,23,900,310,70,380,Sunday
2014,2,23,800,178,25,203,Sunday
2014,2,23,700,44,15,59,Sunday
2014,2,23,600,11,19,30,Sunday
2014,2,23,500,15,25,40,Sunday
2014,2,23,400,11,16,27,Sunday
2014,2,23,300,10,21,31,Sunday
2014,2,23,200,13,26,39,Sunday
2014,2,23,100,16,29,45,Sunday
2014,2,22,2400,20,54,74,Saturday
2014,2,22,2300,32,64,96,Saturday
2014,2,22,2200,73,91,164,Saturday
2014,2,22,2100,66,132,198,Saturday
2014,2,22,2000,75,177,252,Saturday
2014,2,22,1900,96,311,407,Saturday
2014,2,22,1800,141,858,999,Saturday
2014,2,22,1700,179,910,1089,Saturday
2014,2,22,1600,205,530,735,Saturday
2014,2,22,1500,237,418,655,Saturday
2014,2,22,1400,255,325,580,Saturday
2014,2,22,1300,319,299,618,Saturday
2014,2,22,1200,366,249,615,Saturday
2014,2,22,1100,427,181,608,Saturday
2014,2,22,1000,760,143,903,Saturday
2014,2,22,900,807,75,882,Saturday
2014,2,22,800,327,46,373,Saturday
2014,2,22,700,73,32,105,Saturday
2014,2,22,600,22,18,40,Saturday
2014,2,22,500,30,21,51,Saturday
2014,2,22,400,13,36,49,Saturday
2014,2,22,300,15,21,36,Saturday
2014,2,22,200,26,32,58,Saturday
2014,2,22,100,42,47,89,Saturday
2014,2,21,2400,58,55,113,Friday
2014,2,21,2300,92,40,132,Friday
2014,2,21,2200,173,101,274,Friday
2014,2,21,2100,251,131,382,Friday
2014,2,21,2000,305,178,483,Friday
2014,2,21,1900,364,232,596,Friday
2014,2,21,1800,466,591,1057,Friday
2014,2,21,1700,472,608,1080,Friday
2014,2,21,1600,393,445,838,Friday
2014,2,21,1500,394,409,803,Friday
2014,2,21,1400,319,310,629,Friday
2014,2,21,1300,284,245,529,Friday
2014,2,21,1200,332,251,583,Friday
2014,2,21,1100,346,148,494,Friday
2014,2,21,1000,469,108,577,Friday
2014,2,21,900,463,70,533,Friday
2014,2,21,800,205,59,264,Friday
2014,2,21,700,69,40,109,Friday
2014,2,21,600,31,26,57,Friday
2014,2,21,500,29,9,38,Friday
2014,2,21,400,18,28,46,Friday
2014,2,21,300,22,35,57,Friday
2014,2,21,200,18,31,49,Friday
2014,2,21,100,34,33,67,Friday
2014,2,20,2400,67,48,115,Thursday
2014,2,20,2300,86,75,161,Thursday
2014,2,20,2200,117,101,218,Thursday
2014,2,20,2100,154,123,277,Thursday
2014,2,20,2000,209,109,318,Thursday
2014,2,20,1900,235,231,466,Thursday
2014,2,20,1800,237,506,743,Thursday
2014,2,20,1700,253,587,840,Thursday
2014,2,20,1600,282,385,667,Thursday
2014,2,20,1500,290,304,594,Thursday
2014,2,20,1400,269,220,489,Thursday
2014,2,20,1300,249,188,437,Thursday
2014,2,20,1200,286,190,476,Thursday
2014,2,20,1100,357,135,492,Thursday
2014,2,20,1000,413,114,527,Thursday
2014,2,20,900,418,86,504,Thursday
2014,2,20,800,168,42,210,Thursday
2014,2,20,700,68,40,108,Thursday
2014,2,20,600,26,21,47,Thursday
2014,2,20,500,19,16,35,Thursday
2014,2,20,400,18,29,47,Thursday
2014,2,20,300,21,30,51,Thursday
2014,2,20,200,23,28,51,Thursday
2014,2,20,100,40,27,67,Thursday
2014,2,19,2400,64,54,118,Wednesday
2014,2,19,2300,70,63,133,Wednesday
2014,2,19,2200,80,117,197,Wednesday
2014,2,19,2100,128,113,241,Wednesday
2014,2,19,2000,99,172,271,Wednesday
2014,2,19,1900,132,268,400,Wednesday
2014,2,19,1800,191,585,776,Wednesday
2014,2,19,1700,198,665,863,Wednesday
2014,2,19,1600,219,452,671,Wednesday
2014,2,19,1500,200,221,421,Wednesday
2014,2,19,1400,206,248,454,Wednesday
2014,2,19,1300,208,135,343,Wednesday
2014,2,19,1200,265,156,421,Wednesday
2014,2,19,1100,273,115,388,Wednesday
2014,2,19,1000,423,90,513,Wednesday
2014,2,19,900,441,67,508,Wednesday
2014,2,19,800,183,23,206,Wednesday
2014,2,19,700,62,20,82,Wednesday
2014,2,19,600,23,15,38,Wednesday
2014,2,19,500,19,4,23,Wednesday
2014,2,19,400,17,7,24,Wednesday
2014,2,19,300,32,25,57,Wednesday
2014,2,19,200,19,24,43,Wednesday
2014,2,19,100,27,27,54,Wednesday
2014,2,18,2400,60,38,98,Tuesday
2014,2,18,2300,76,82,158,Tuesday
2014,2,18,2200,82,88,170,Tuesday
2014,2,18,2100,90,100,190,Tuesday
2014,2,18,2000,125,132,257,Tuesday
2014,2,18,1900,132,236,368,Tuesday
2014,2,18,1800,152,586,738,Tuesday
2014,2,18,1700,194,712,906,Tuesday
2014,2,18,1600,219,465,684,Tuesday
2014,2,18,1500,210,435,645,Tuesday
2014,2,18,1400,242,318,560,Tuesday
2014,2,18,1300,229,289,518,Tuesday
2014,2,18,1200,293,212,505,Tuesday
2014,2,18,1100,300,198,498,Tuesday
2014,2,18,1000,383,151,534,Tuesday
2014,2,18,900,519,90,609,Tuesday
2014,2,18,800,154,66,220,Tuesday
2014,2,18,700,64,46,110,Tuesday
2014,2,18,600,28,29,57,Tuesday
2014,2,18,500,14,47,61,Tuesday
2014,2,18,400,17,27,44,Tuesday
2014,2,18,300,18,30,48,Tuesday
2014,2,18,200,16,29,45,Tuesday
2014,2,18,100,23,76,99,Tuesday
2014,2,17,2400,31,72,103,Monday
2014,2,17,2300,42,111,153,Monday
2014,2,17,2200,59,213,272,Monday
2014,2,17,2100,57,301,358,Monday
2014,2,17,2000,75,401,476,Monday
2014,2,17,1900,101,718,819,Monday
2014,2,17,1800,145,1378,1523,Monday
2014,2,17,1700,219,1625,1844,Monday
2014,2,17,1600,281,1533,1814,Monday
2014,2,17,1500,307,1325,1632,Monday
2014,2,17,1400,390,1226,1616,Monday
2014,2,17,1300,464,1073,1537,Monday
2014,2,17,1200,431,692,1123,Monday
2014,2,17,1100,451,410,861,Monday
2014,2,17,1000,555,164,719,Monday
2014,2,17,900,769,97,866,Monday
2014,2,17,800,267,35,302,Monday
2014,2,17,700,69,19,88,Monday
2014,2,17,600,17,16,33,Monday
2014,2,17,500,15,9,24,Monday
2014,2,17,400,16,8,24,Monday
2014,2,17,300,15,16,31,Monday
2014,2,17,200,19,14,33,Monday
2014,2,17,100,20,41,61,Monday
2014,2,16,2400,37,68,105,Sunday
2014,2,16,2300,52,103,155,Sunday
2014,2,16,2200,61,105,166,Sunday
2014,2,16,2100,75,162,237,Sunday
2014,2,16,2000,111,324,435,Sunday
2014,2,16,1900,148,539,687,Sunday
2014,2,16,1800,233,1265,1498,Sunday
2014,2,16,1700,258,1273,1531,Sunday
2014,2,16,1600,393,959,1352,Sunday
2014,2,16,1500,405,716,1121,Sunday
2014,2,16,1400,437,546,983,Sunday
2014,2,16,1300,619,474,1093,Sunday
2014,2,16,1200,652,317,969,Sunday
2014,2,16,1100,687,222,909,Sunday
2014,2,16,1000,834,106,940,Sunday
2014,2,16,900,980,55,1035,Sunday
2014,2,16,800,327,37,364,Sunday
2014,2,16,700,67,19,86,Sunday
2014,2,16,600,19,8,27,Sunday
2014,2,16,500,17,19,36,Sunday
2014,2,16,400,8,5,13,Sunday
2014,2,16,300,16,12,28,Sunday
2014,2,16,200,16,19,35,Sunday
2014,2,16,100,20,36,56,Sunday
2014,2,15,2400,39,28,67,Saturday
2014,2,15,2300,55,66,121,Saturday
2014,2,15,2200,79,138,217,Saturday
2014,2,15,2100,102,77,179,Saturday
2014,2,15,2000,117,177,294,Saturday
2014,2,15,1900,152,406,558,Saturday
2014,2,15,1800,276,1166,1442,Saturday
2014,2,15,1700,391,1315,1706,Saturday
2014,2,15,1600,454,608,1062,Saturday
2014,2,15,1500,549,423,972,Saturday
2014,2,15,1400,641,248,889,Saturday
2014,2,15,1300,708,316,1024,Saturday
2014,2,15,1200,750,147,897,Saturday
2014,2,15,1100,796,119,915,Saturday
2014,2,15,1000,928,107,1035,Saturday
2014,2,15,900,1074,52,1126,Saturday
2014,2,15,800,456,31,487,Saturday
2014,2,15,700,160,27,187,Saturday
2014,2,15,600,28,9,37,Saturday
2014,2,15,500,20,13,33,Saturday
2014,2,15,400,19,19,38,Saturday
2014,2,15,300,14,30,44,Saturday
2014,2,15,200,34,37,71,Saturday
2014,2,15,100,53,35,88,Saturday
2014,2,14,2400,88,17,105,Friday
2014,2,14,2300,191,66,257,Friday
2014,2,14,2200,325,181,506,Friday
2014,2,14,2100,499,98,597,Friday
2014,2,14,2000,622,82,704,Friday
2014,2,14,1900,745,156,901,Friday
2014,2,14,1800,768,410,1178,Friday
2014,2,14,1700,766,565,1331,Friday
2014,2,14,1600,720,354,1074,Friday
2014,2,14,1500,709,279,988,Friday
2014,2,14,1400,588,243,831,Friday
2014,2,14,1300,509,228,737,Friday
2014,2,14,1200,506,166,672,Friday
2014,2,14,1100,484,130,614,Friday
2014,2,14,1000,543,112,655,Friday
2014,2,14,900,575,106,681,Friday
2014,2,14,800,257,63,320,Friday
2014,2,14,700,108,27,135,Friday
2014,2,14,600,46,30,76,Friday
2014,2,14,500,29,32,61,Friday
2014,2,14,400,18,22,40,Friday
2014,2,14,300,49,28,77,Friday
2014,2,14,200,14,43,57,Friday
2014,2,14,100,40,67,107,Friday
2014,2,13,2400,71,100,171,Thursday
2014,2,13,2300,130,53,183,Thursday
2014,2,13,2200,149,75,224,Thursday
2014,2,13,2100,209,89,298,Thursday
2014,2,13,2000,274,240,514,Thursday
2014,2,13,1900,291,231,522,Thursday
2014,2,13,1800,326,238,564,Thursday
2014,2,13,1700,387,350,737,Thursday
2014,2,13,1600,407,242,649,Thursday
2014,2,13,1500,365,191,556,Thursday
2014,2,13,1400,304,187,491,Thursday
2014,2,13,1300,320,219,539,Thursday
2014,2,13,1200,311,165,476,Thursday
2014,2,13,1100,368,139,507,Thursday
2014,2,13,1000,394,98,492,Thursday
2014,2,13,900,346,79,425,Thursday
2014,2,13,800,189,66,255,Thursday
2014,2,13,700,82,32,114,Thursday
2014,2,13,600,36,50,86,Thursday
2014,2,13,500,28,79,107,Thursday
2014,2,13,400,26,63,89,Thursday
2014,2,13,300,19,34,53,Thursday
2014,2,13,200,20,64,84,Thursday
2014,2,13,100,41,124,165,Thursday
2014,2,12,2400,46,60,106,Wednesday
2014,2,12,2300,77,56,133,Wednesday
2014,2,12,2200,85,34,119,Wednesday
2014,2,12,2100,125,20,145,Wednesday
2014,2,12,2000,142,68,210,Wednesday
2014,2,12,1900,126,118,244,Wednesday
2014,2,12,1800,155,184,339,Wednesday
2014,2,12,1700,175,244,419,Wednesday
2014,2,12,1600,210,202,412,Wednesday
2014,2,12,1500,185,120,305,Wednesday
2014,2,12,1400,160,100,260,Wednesday
2014,2,12,1300,194,97,291,Wednesday
2014,2,12,1200,179,99,278,Wednesday
2014,2,12,1100,211,80,291,Wednesday
2014,2,12,1000,209,85,294,Wednesday
2014,2,12,900,238,79,317,Wednesday
2014,2,12,800,129,41,170,Wednesday
2014,2,12,700,57,39,96,Wednesday
2014,2,12,600,25,18,43,Wednesday
2014,2,12,500,16,15,31,Wednesday
2014,2,12,400,21,13,34,Wednesday
2014,2,12,300,23,21,44,Wednesday
2014,2,12,200,26,30,56,Wednesday
2014,2,12,100,30,48,78,Wednesday
2014,2,11,2400,36,49,85,Tuesday
2014,2,11,2300,57,55,112,Tuesday
2014,2,11,2200,73,70,143,Tuesday
2014,2,11,2100,85,75,160,Tuesday
2014,2,11,2000,103,91,194,Tuesday
2014,2,11,1900,91,170,261,Tuesday
2014,2,11,1800,123,263,386,Tuesday
2014,2,11,1700,135,267,402,Tuesday
2014,2,11,1600,161,207,368,Tuesday
2014,2,11,1500,149,212,361,Tuesday
2014,2,11,1400,162,152,314,Tuesday
2014,2,11,1300,153,119,272,Tuesday
2014,2,11,1200,187,117,304,Tuesday
2014,2,11,1100,178,71,249,Tuesday
2014,2,11,1000,239,63,302,Tuesday
2014,2,11,900,189,55,244,Tuesday
2014,2,11,800,129,36,165,Tuesday
2014,2,11,700,45,22,67,Tuesday
2014,2,11,600,26,19,45,Tuesday
2014,2,11,500,9,11,20,Tuesday
2014,2,11,400,12,13,25,Tuesday
2014,2,11,300,20,22,42,Tuesday
2014,2,11,200,24,25,49,Tuesday
2014,2,11,100,20,34,54,Tuesday
2014,2,10,2400,37,42,79,Monday
2014,2,10,2300,51,63,114,Monday
2014,2,10,2200,82,44,126,Monday
2014,2,10,2100,90,78,168,Monday
2014,2,10,2000,107,86,193,Monday
2014,2,10,1900,115,150,265,Monday
2014,2,10,1800,178,237,415,Monday
2014,2,10,1700,199,266,465,Monday
2014,2,10,1600,225,226,451,Monday
2014,2,10,1500,204,210,414,Monday
2014,2,10,1400,248,180,428,Monday
2014,2,10,1300,224,155,379,Monday
2014,2,10,1200,257,158,415,Monday
2014,2,10,1100,228,123,351,Monday
2014,2,10,1000,221,92,313,Monday
2014,2,10,900,193,62,255,Monday
2014,2,10,800,123,46,169,Monday
2014,2,10,700,45,34,79,Monday
2014,2,10,600,20,19,39,Monday
2014,2,10,500,22,19,41,Monday
2014,2,10,400,14,24,38,Monday
2014,2,10,300,9,11,20,Monday
2014,2,10,200,19,29,48,Monday
2014,2,10,100,16,34,50,Monday
2014,2,9,2400,33,71,104,Sunday
2014,2,9,2300,29,76,105,Sunday
2014,2,9,2200,54,102,156,Sunday
2014,2,9,2100,86,127,213,Sunday
2014,2,9,2000,60,238,298,Sunday
2014,2,9,1900,97,345,442,Sunday
2014,2,9,1800,128,630,758,Sunday
2014,2,9,1700,154,730,884,Sunday
2014,2,9,1600,202,597,799,Sunday
2014,2,9,1500,224,583,807,Sunday
2014,2,9,1400,257,490,747,Sunday
2014,2,9,1300,248,490,738,Sunday
2014,2,9,1200,275,350,625,Sunday
2014,2,9,1100,265,183,448,Sunday
2014,2,9,1000,268,98,366,Sunday
2014,2,9,900,262,55,317,Sunday
2014,2,9,800,107,31,138,Sunday
2014,2,9,700,28,18,46,Sunday
2014,2,9,600,26,16,42,Sunday
2014,2,9,500,10,13,23,Sunday
2014,2,9,400,10,13,23,Sunday
2014,2,9,300,15,10,25,Sunday
2014,2,9,200,17,18,35,Sunday
2014,2,9,100,17,24,41,Sunday
2014,2,8,2400,27,31,58,Saturday
2014,2,8,2300,45,29,74,Saturday
2014,2,8,2200,44,73,117,Saturday
2014,2,8,2100,58,73,131,Saturday
2014,2,8,2000,82,108,190,Saturday
2014,2,8,1900,103,202,305,Saturday
2014,2,8,1800,139,409,548,Saturday
2014,2,8,1700,195,554,749,Saturday
2014,2,8,1600,243,328,571,Saturday
2014,2,8,1500,245,290,535,Saturday
2014,2,8,1400,241,241,482,Saturday
2014,2,8,1300,286,231,517,Saturday
2014,2,8,1200,292,181,473,Saturday
2014,2,8,1100,313,147,460,Saturday
2014,2,8,1000,396,104,500,Saturday
2014,2,8,900,343,66,409,Saturday
2014,2,8,800,167,51,218,Saturday
2014,2,8,700,58,35,93,Saturday
2014,2,8,600,16,18,34,Saturday
2014,2,8,500,18,21,39,Saturday
2014,2,8,400,15,23,38,Saturday
2014,2,8,300,20,24,44,Saturday
2014,2,8,200,21,30,51,Saturday
2014,2,8,100,19,34,53,Saturday
2014,2,7,2400,53,46,99,Friday
2014,2,7,2300,92,49,141,Friday
2014,2,7,2200,141,73,214,Friday
2014,2,7,2100,199,93,292,Friday
2014,2,7,2000,292,119,411,Friday
2014,2,7,1900,330,195,525,Friday
2014,2,7,1800,371,306,677,Friday
2014,2,7,1700,418,382,800,Friday
2014,2,7,1600,364,293,657,Friday
2014,2,7,1500,324,268,592,Friday
2014,2,7,1400,267,184,451,Friday
2014,2,7,1300,263,178,441,Friday
2014,2,7,1200,316,153,469,Friday
2014,2,7,1100,272,140,412,Friday
2014,2,7,1000,244,105,349,Friday
2014,2,7,900,207,66,273,Friday
2014,2,7,800,125,66,191,Friday
2014,2,7,700,63,28,91,Friday
2014,2,7,600,36,31,67,Friday
2014,2,7,500,18,26,44,Friday
2014,2,7,400,15,31,46,Friday
2014,2,7,300,20,22,42,Friday
2014,2,7,200,19,33,52,Friday
2014,2,7,100,33,38,71,Friday
2014,2,6,2400,59,44,103,Thursday
2014,2,6,2300,83,57,140,Thursday
2014,2,6,2200,90,79,169,Thursday
2014,2,6,2100,116,84,200,Thursday
2014,2,6,2000,164,107,271,Thursday
2014,2,6,1900,156,165,321,Thursday
2014,2,6,1800,210,258,468,Thursday
2014,2,6,1700,219,306,525,Thursday
2014,2,6,1600,242,211,453,Thursday
2014,2,6,1500,231,220,451,Thursday
2014,2,6,1400,209,165,374,Thursday
2014,2,6,1300,207,147,354,Thursday
2014,2,6,1200,231,124,355,Thursday
2014,2,6,1100,229,111,340,Thursday
2014,2,6,1000,223,105,328,Thursday
2014,2,6,900,147,64,211,Thursday
2014,2,6,800,129,43,172,Thursday
2014,2,6,700,50,37,87,Thursday
2014,2,6,600,27,33,60,Thursday
2014,2,6,500,17,26,43,Thursday
2014,2,6,400,13,30,43,Thursday
2014,2,6,300,27,16,43,Thursday
2014,2,6,200,25,24,49,Thursday
2014,2,6,100,42,33,75,Thursday
2014,2,5,2400,58,50,108,Wednesday
2014,2,5,2300,81,55,136,Wednesday
2014,2,5,2200,66,59,125,Wednesday
2014,2,5,2100,105,74,179,Wednesday
2014,2,5,2000,120,116,236,Wednesday
2014,2,5,1900,142,154,296,Wednesday
2014,2,5,1800,131,206,337,Wednesday
2014,2,5,1700,179,233,412,Wednesday
2014,2,5,1600,175,190,365,Wednesday
2014,2,5,1500,175,192,367,Wednesday
2014,2,5,1400,173,164,337,Wednesday
2014,2,5,1300,187,141,328,Wednesday
2014,2,5,1200,180,156,336,Wednesday
2014,2,5,1100,138,131,269,Wednesday
2014,2,5,1000,156,82,238,Wednesday
2014,2,5,900,149,70,219,Wednesday
2014,2,5,800,98,46,144,Wednesday
2014,2,5,700,37,31,68,Wednesday
2014,2,5,600,20,28,48,Wednesday
2014,2,5,500,7,16,23,Wednesday
2014,2,5,400,22,29,51,Wednesday
2014,2,5,300,22,27,49,Wednesday
2014,2,5,200,26,35,61,Wednesday
2014,2,5,100,29,43,72,Wednesday
2014,2,4,2400,39,54,93,Tuesday
2014,2,4,2300,54,43,97,Tuesday
2014,2,4,2200,70,80,150,Tuesday
2014,2,4,2100,63,77,140,Tuesday
2014,2,4,2000,74,116,190,Tuesday
2014,2,4,1900,112,151,263,Tuesday
2014,2,4,1800,123,238,361,Tuesday
2014,2,4,1700,152,229,381,Tuesday
2014,2,4,1600,141,192,333,Tuesday
2014,2,4,1500,158,197,355,Tuesday
2014,2,4,1400,151,166,317,Tuesday
2014,2,4,1300,181,171,352,Tuesday
2014,2,4,1200,169,153,322,Tuesday
2014,2,4,1100,152,125,277,Tuesday
2014,2,4,1000,150,103,253,Tuesday
2014,2,4,900,146,69,215,Tuesday
2014,2,4,800,101,58,159,Tuesday
2014,2,4,700,40,23,63,Tuesday
2014,2,4,600,21,35,56,Tuesday
2014,2,4,500,16,26,42,Tuesday
2014,2,4,400,14,23,37,Tuesday
2014,2,4,300,14,27,41,Tuesday
2014,2,4,200,28,32,60,Tuesday
2014,2,4,100,28,35,63,Tuesday
2014,2,3,2400,29,44,73,Monday
2014,2,3,2300,64,47,111,Monday
2014,2,3,2200,56,70,126,Monday
2014,2,3,2100,73,80,153,Monday
2014,2,3,2000,92,111,203,Monday
2014,2,3,1900,96,161,257,Monday
2014,2,3,1800,115,270,385,Monday
2014,2,3,1700,155,305,460,Monday
2014,2,3,1600,190,232,422,Monday
2014,2,3,1500,187,237,424,Monday
2014,2,3,1400,206,189,395,Monday
2014,2,3,1300,196,186,382,Monday
2014,2,3,1200,170,172,342,Monday
2014,2,3,1100,166,157,323,Monday
2014,2,3,1000,176,92,268,Monday
2014,2,3,900,165,78,243,Monday
2014,2,3,800,103,54,157,Monday
2014,2,3,700,58,29,87,Monday
2014,2,3,600,29,18,47,Monday
2014,2,3,500,14,14,28,Monday
2014,2,3,400,14,21,35,Monday
2014,2,3,300,11,15,26,Monday
2014,2,3,200,12,25,37,Monday
2014,2,3,100,18,39,57,Monday
2014,2,2,2400,29,42,71,Sunday
2014,2,2,2300,30,66,96,Sunday
2014,2,2,2200,47,105,152,Sunday
2014,2,2,2100,66,119,185,Sunday
2014,2,2,2000,63,241,304,Sunday
2014,2,2,1900,91,356,447,Sunday
2014,2,2,1800,123,639,762,Sunday
2014,2,2,1700,167,1160,1327,Sunday
2014,2,2,1600,225,784,1009,Sunday
2014,2,2,1500,200,715,915,Sunday
2014,2,2,1400,228,625,853,Sunday
2014,2,2,1300,261,525,786,Sunday
2014,2,2,1200,296,351,647,Sunday
2014,2,2,1100,297,214,511,Sunday
2014,2,2,1000,305,118,423,Sunday
2014,2,2,900,455,66,521,Sunday
2014,2,2,800,187,30,217,Sunday
2014,2,2,700,39,20,59,Sunday
2014,2,2,600,23,10,33,Sunday
2014,2,2,500,13,18,31,Sunday
2014,2,2,400,14,14,28,Sunday
2014,2,2,300,7,12,19,Sunday
2014,2,2,200,16,18,34,Sunday
2014,2,2,100,25,20,45,Sunday
2014,2,1,2400,22,46,68,Saturday
2014,2,1,2300,35,39,74,Saturday
2014,2,1,2200,46,75,121,Saturday
2014,2,1,2100,72,114,186,Saturday
2014,2,1,2000,93,163,256,Saturday
2014,2,1,1900,99,252,351,Saturday
2014,2,1,1800,140,759,899,Saturday
2014,2,1,1700,162,768,930,Saturday
2014,2,1,1600,246,459,705,Saturday
2014,2,1,1500,274,310,584,Saturday
2014,2,1,1400,306,273,579,Saturday
2014,2,1,1300,320,185,505,Saturday
2014,2,1,1200,368,172,540,Saturday
2014,2,1,1100,377,130,507,Saturday
2014,2,1,1000,611,103,714,Saturday
2014,2,1,900,679,69,748,Saturday
2014,2,1,800,261,31,292,Saturday
2014,2,1,700,59,25,84,Saturday
2014,2,1,600,33,27,60,Saturday
2014,2,1,500,18,23,41,Saturday
2014,2,1,400,20,13,33,Saturday
2014,2,1,300,27,12,39,Saturday
2014,2,1,200,22,18,40,Saturday
2014,2,1,100,42,37,79,Saturday
2014,1,31,2400,64,32,96,Friday
2014,1,31,2300,111,53,164,Friday
2014,1,31,2200,200,84,284,Friday
2014,1,31,2100,197,114,311,Friday
2014,1,31,2000,304,128,432,Friday
2014,1,31,1900,388,163,551,Friday
2014,1,31,1800,478,382,860,Friday
2014,1,31,1700,417,457,874,Friday
2014,1,31,1600,424,266,690,Friday
2014,1,31,1500,385,233,618,Friday
2014,1,31,1400,342,184,526,Friday
2014,1,31,1300,303,174,477,Friday
2014,1,31,1200,354,165,519,Friday
2014,1,31,1100,376,129,505,Friday
2014,1,31,1000,389,88,477,Friday
2014,1,31,900,351,65,416,Friday
2014,1,31,800,165,53,218,Friday
2014,1,31,700,68,46,114,Friday
2014,1,31,600,32,31,63,Friday
2014,1,31,500,20,26,46,Friday
2014,1,31,400,26,24,50,Friday
2014,1,31,300,19,23,42,Friday
2014,1,31,200,30,35,65,Friday
2014,1,31,100,36,52,88,Friday
2014,1,30,2400,59,81,140,Thursday
2014,1,30,2300,105,52,157,Thursday
2014,1,30,2200,111,93,204,Thursday
2014,1,30,2100,165,91,256,Thursday
2014,1,30,2000,157,99,256,Thursday
2014,1,30,1900,192,113,305,Thursday
2014,1,30,1800,227,263,490,Thursday
2014,1,30,1700,252,314,566,Thursday
2014,1,30,1600,238,245,483,Thursday
2014,1,30,1500,196,233,429,Thursday
2014,1,30,1400,217,170,387,Thursday
2014,1,30,1300,203,155,358,Thursday
2014,1,30,1200,182,136,318,Thursday
2014,1,30,1100,217,117,334,Thursday
2014,1,30,1000,252,95,347,Thursday
2014,1,30,900,251,67,318,Thursday
2014,1,30,800,112,55,167,Thursday
2014,1,30,700,49,29,78,Thursday
2014,1,30,600,27,33,60,Thursday
2014,1,30,500,15,16,31,Thursday
2014,1,30,400,25,30,55,Thursday
2014,1,30,300,16,22,38,Thursday
2014,1,30,200,24,33,57,Thursday
2014,1,30,100,28,45,73,Thursday
2014,1,29,2400,55,52,107,Wednesday
2014,1,29,2300,66,207,273,Wednesday
2014,1,29,2200,88,20,108,Wednesday
2014,1,29,2100,123,50,173,Wednesday
2014,1,29,2000,106,55,161,Wednesday
2014,1,29,1900,95,88,183,Wednesday
2014,1,29,1800,145,237,382,Wednesday
2014,1,29,1700,141,256,397,Wednesday
2014,1,29,1600,208,260,468,Wednesday
2014,1,29,1500,152,194,346,Wednesday
2014,1,29,1400,157,157,314,Wednesday
2014,1,29,1300,169,139,308,Wednesday
2014,1,29,1200,182,133,315,Wednesday
2014,1,29,1100,196,124,320,Wednesday
2014,1,29,1000,205,86,291,Wednesday
2014,1,29,900,182,82,264,Wednesday
2014,1,29,800,106,55,161,Wednesday
2014,1,29,700,57,29,86,Wednesday
2014,1,29,600,27,21,48,Wednesday
2014,1,29,500,18,25,43,Wednesday
2014,1,29,400,20,23,43,Wednesday
2014,1,29,300,22,23,45,Wednesday
2014,1,29,200,25,31,56,Wednesday
2014,1,29,100,34,34,68,Wednesday
2014,1,28,2400,53,52,105,Tuesday
2014,1,28,2300,57,54,111,Tuesday
2014,1,28,2200,73,71,144,Tuesday
2014,1,28,2100,102,87,189,Tuesday
2014,1,28,2000,94,120,214,Tuesday
2014,1,28,1900,102,192,294,Tuesday
2014,1,28,1800,137,251,388,Tuesday
2014,1,28,1700,136,283,419,Tuesday
2014,1,28,1600,176,231,407,Tuesday
2014,1,28,1500,157,190,347,Tuesday
2014,1,28,1400,172,185,357,Tuesday
2014,1,28,1300,181,144,325,Tuesday
2014,1,28,1200,234,149,383,Tuesday
2014,1,28,1100,220,123,343,Tuesday
2014,1,28,1000,209,107,316,Tuesday
2014,1,28,900,176,89,265,Tuesday
2014,1,28,800,117,53,170,Tuesday
2014,1,28,700,56,24,80,Tuesday
2014,1,28,600,36,28,64,Tuesday
2014,1,28,500,18,22,40,Tuesday
2014,1,28,400,30,21,51,Tuesday
2014,1,28,300,28,35,63,Tuesday
2014,1,28,200,34,33,67,Tuesday
2014,1,28,100,40,29,69,Tuesday
2014,1,27,2400,51,54,105,Monday
2014,1,27,2300,58,64,122,Monday
2014,1,27,2200,50,78,128,Monday
2014,1,27,2100,85,94,179,Monday
2014,1,27,2000,94,106,200,Monday
2014,1,27,1900,83,165,248,Monday
2014,1,27,1800,120,314,434,Monday
2014,1,27,1700,175,330,505,Monday
2014,1,27,1600,161,238,399,Monday
2014,1,27,1500,177,239,416,Monday
2014,1,27,1400,172,198,370,Monday
2014,1,27,1300,198,204,402,Monday
2014,1,27,1200,219,150,369,Monday
2014,1,27,1100,201,128,329,Monday
2014,1,27,1000,202,101,303,Monday
2014,1,27,900,192,58,250,Monday
2014,1,27,800,97,47,144,Monday
2014,1,27,700,55,30,85,Monday
2014,1,27,600,22,26,48,Monday
2014,1,27,500,28,23,51,Monday
2014,1,27,400,25,17,42,Monday
2014,1,27,300,14,22,36,Monday
2014,1,27,200,23,25,48,Monday
2014,1,27,100,33,38,71,Monday
2014,1,26,2400,34,46,80,Sunday
2014,1,26,2300,36,69,105,Sunday
2014,1,26,2200,45,99,144,Sunday
2014,1,26,2100,56,224,280,Sunday
2014,1,26,2000,63,272,335,Sunday
2014,1,26,1900,91,493,584,Sunday
2014,1,26,1800,125,975,1100,Sunday
2014,1,26,1700,169,1194,1363,Sunday
2014,1,26,1600,199,913,1112,Sunday
2014,1,26,1500,308,740,1048,Sunday
2014,1,26,1400,342,570,912,Sunday
2014,1,26,1300,399,461,860,Sunday
2014,1,26,1200,472,338,810,Sunday
2014,1,26,1100,399,180,579,Sunday
2014,1,26,1000,472,105,577,Sunday
2014,1,26,900,508,50,558,Sunday
2014,1,26,800,160,15,175,Sunday
2014,1,26,700,41,16,57,Sunday
2014,1,26,600,10,12,22,Sunday
2014,1,26,500,11,20,31,Sunday
2014,1,26,400,3,7,10,Sunday
2014,1,26,300,13,16,29,Sunday
2014,1,26,200,17,16,33,Sunday
2014,1,26,100,26,24,50,Sunday
2014,1,25,2400,32,39,71,Saturday
2014,1,25,2300,46,41,87,Saturday
2014,1,25,2200,57,72,129,Saturday
2014,1,25,2100,75,89,164,Saturday
2014,1,25,2000,75,217,292,Saturday
2014,1,25,1900,101,447,548,Saturday
2014,1,25,1800,169,1177,1346,Saturday
2014,1,25,1700,255,1180,1435,Saturday
2014,1,25,1600,307,720,1027,Saturday
2014,1,25,1500,391,607,998,Saturday
2014,1,25,1400,523,385,908,Saturday
2014,1,25,1300,626,271,897,Saturday
2014,1,25,1200,715,211,926,Saturday
2014,1,25,1100,723,119,842,Saturday
2014,1,25,1000,824,94,918,Saturday
2014,1,25,900,862,57,919,Saturday
2014,1,25,800,266,34,300,Saturday
2014,1,25,700,67,30,97,Saturday
2014,1,25,600,26,22,48,Saturday
2014,1,25,500,13,15,28,Saturday
2014,1,25,400,16,29,45,Saturday
2014,1,25,300,13,19,32,Saturday
2014,1,25,200,22,35,57,Saturday
2014,1,25,100,37,28,65,Saturday
2014,1,24,2400,65,42,107,Friday
2014,1,24,2300,113,44,157,Friday
2014,1,24,2200,165,58,223,Friday
2014,1,24,2100,242,88,330,Friday
2014,1,24,2000,383,113,496,Friday
2014,1,24,1900,389,203,592,Friday
2014,1,24,1800,424,338,762,Friday
2014,1,24,1700,398,442,840,Friday
2014,1,24,1600,406,315,721,Friday
2014,1,24,1500,388,280,668,Friday
2014,1,24,1400,332,262,594,Friday
2014,1,24,1300,314,169,483,Friday
2014,1,24,1200,341,131,472,Friday
2014,1,24,1100,290,125,415,Friday
2014,1,24,1000,330,96,426,Friday
2014,1,24,900,318,64,382,Friday
2014,1,24,800,151,61,212,Friday
2014,1,24,700,79,35,114,Friday
2014,1,24,600,28,30,58,Friday
2014,1,24,500,22,21,43,Friday
2014,1,24,400,22,24,46,Friday
2014,1,24,300,24,39,63,Friday
2014,1,24,200,24,38,62,Friday
2014,1,24,100,34,48,82,Friday
2014,1,23,2400,57,41,98,Thursday
2014,1,23,2300,94,53,147,Thursday
2014,1,23,2200,101,63,164,Thursday
2014,1,23,2100,134,104,238,Thursday
2014,1,23,2000,185,100,285,Thursday
2014,1,23,1900,160,138,298,Thursday
2014,1,23,1800,196,266,462,Thursday
2014,1,23,1700,231,353,584,Thursday
2014,1,23,1600,231,294,525,Thursday
2014,1,23,1500,241,201,442,Thursday
2014,1,23,1400,220,167,387,Thursday
2014,1,23,1300,226,134,360,Thursday
2014,1,23,1200,223,149,372,Thursday
2014,1,23,1100,248,120,368,Thursday
2014,1,23,1000,261,105,366,Thursday
2014,1,23,900,200,54,254,Thursday
2014,1,23,800,109,39,148,Thursday
2014,1,23,700,68,31,99,Thursday
2014,1,23,600,37,32,69,Thursday
2014,1,23,500,14,20,34,Thursday
2014,1,23,400,23,23,46,Thursday
2014,1,23,300,21,29,50,Thursday
2014,1,23,200,32,27,59,Thursday
2014,1,23,100,47,44,91,Thursday
2014,1,22,2400,45,55,100,Wednesday
2014,1,22,2300,67,55,122,Wednesday
2014,1,22,2200,79,68,147,Wednesday
2014,1,22,2100,107,72,179,Wednesday
2014,1,22,2000,115,109,224,Wednesday
2014,1,22,1900,117,171,288,Wednesday
2014,1,22,1800,143,246,389,Wednesday
2014,1,22,1700,169,288,457,Wednesday
2014,1,22,1600,177,230,407,Wednesday
2014,1,22,1500,178,219,397,Wednesday
2014,1,22,1400,159,174,333,Wednesday
2014,1,22,1300,188,134,322,Wednesday
2014,1,22,1200,187,131,318,Wednesday
2014,1,22,1100,201,99,300,Wednesday
2014,1,22,1000,206,79,285,Wednesday
2014,1,22,900,202,64,266,Wednesday
2014,1,22,800,83,41,124,Wednesday
2014,1,22,700,50,29,79,Wednesday
2014,1,22,600,29,30,59,Wednesday
2014,1,22,500,13,28,41,Wednesday
2014,1,22,400,16,35,51,Wednesday
2014,1,22,300,22,28,50,Wednesday
2014,1,22,200,32,28,60,Wednesday
2014,1,22,100,27,31,58,Wednesday
2014,1,21,2400,52,37,89,Tuesday
2014,1,21,2300,59,59,118,Tuesday
2014,1,21,2200,91,64,155,Tuesday
2014,1,21,2100,76,75,151,Tuesday
2014,1,21,2000,69,128,197,Tuesday
2014,1,21,1900,92,164,256,Tuesday
2014,1,21,1800,129,230,359,Tuesday
2014,1,21,1700,140,302,442,Tuesday
2014,1,21,1600,149,228,377,Tuesday
2014,1,21,1500,171,199,370,Tuesday
2014,1,21,1400,166,199,365,Tuesday
2014,1,21,1300,166,151,317,Tuesday
2014,1,21,1200,234,136,370,Tuesday
2014,1,21,1100,181,141,322,Tuesday
2014,1,21,1000,237,94,331,Tuesday
2014,1,21,900,170,83,253,Tuesday
2014,1,21,800,100,41,141,Tuesday
2014,1,21,700,53,45,98,Tuesday
2014,1,21,600,22,31,53,Tuesday
2014,1,21,500,21,32,53,Tuesday
2014,1,21,400,16,29,45,Tuesday
2014,1,21,300,24,29,53,Tuesday
2014,1,21,200,19,26,45,Tuesday
2014,1,21,100,34,23,57,Tuesday
2014,1,20,2400,44,42,86,Monday
2014,1,20,2300,54,60,114,Monday
2014,1,20,2200,69,71,140,Monday
2014,1,20,2100,82,86,168,Monday
2014,1,20,2000,107,100,207,Monday
2014,1,20,1900,104,155,259,Monday
2014,1,20,1800,124,282,406,Monday
2014,1,20,1700,149,388,537,Monday
2014,1,20,1600,153,305,458,Monday
2014,1,20,1500,173,276,449,Monday
2014,1,20,1400,200,191,391,Monday
2014,1,20,1300,241,187,428,Monday
2014,1,20,1200,243,159,402,Monday
2014,1,20,1100,253,128,381,Monday
2014,1,20,1000,223,117,340,Monday
2014,1,20,900,199,70,269,Monday
2014,1,20,800,113,44,157,Monday
2014,1,20,700,59,31,90,Monday
2014,1,20,600,23,18,41,Monday
2014,1,20,500,8,15,23,Monday
2014,1,20,400,17,17,34,Monday
2014,1,20,300,12,13,25,Monday
2014,1,20,200,15,20,35,Monday
2014,1,20,100,25,51,76,Monday
2014,1,19,2400,26,51,77,Sunday
2014,1,19,2300,39,93,132,Sunday
2014,1,19,2200,54,146,200,Sunday
2014,1,19,2100,73,159,232,Sunday
2014,1,19,2000,83,374,457,Sunday
2014,1,19,1900,108,563,671,Sunday
2014,1,19,1800,118,1202,1320,Sunday
2014,1,19,1700,172,1383,1555,Sunday
2014,1,19,1600,250,1053,1303,Sunday
2014,1,19,1500,330,888,1218,Sunday
2014,1,19,1400,392,718,1110,Sunday
2014,1,19,1300,547,580,1127,Sunday
2014,1,19,1200,625,384,1009,Sunday
2014,1,19,1100,639,177,816,Sunday
2014,1,19,1000,653,107,760,Sunday
2014,1,19,900,686,60,746,Sunday
2014,1,19,800,236,24,260,Sunday
2014,1,19,700,29,14,43,Sunday
2014,1,19,600,17,12,29,Sunday
2014,1,19,500,14,16,30,Sunday
2014,1,19,400,14,10,24,Sunday
2014,1,19,300,15,10,25,Sunday
2014,1,19,200,9,22,31,Sunday
2014,1,19,100,15,19,34,Sunday
2014,1,18,2400,25,34,59,Saturday
2014,1,18,2300,35,51,86,Saturday
2014,1,18,2200,52,79,131,Saturday
2014,1,18,2100,73,133,206,Saturday
2014,1,18,2000,81,190,271,Saturday
2014,1,18,1900,106,554,660,Saturday
2014,1,18,1800,169,1178,1347,Saturday
2014,1,18,1700,228,1291,1519,Saturday
2014,1,18,1600,290,859,1149,Saturday
2014,1,18,1500,438,518,956,Saturday
2014,1,18,1400,551,382,933,Saturday
2014,1,18,1300,701,248,949,Saturday
2014,1,18,1200,675,181,856,Saturday
2014,1,18,1100,690,106,796,Saturday
2014,1,18,1000,861,96,957,Saturday
2014,1,18,900,1019,54,1073,Saturday
2014,1,18,800,332,38,370,Saturday
2014,1,18,700,73,32,105,Saturday
2014,1,18,600,23,24,47,Saturday
2014,1,18,500,10,19,29,Saturday
2014,1,18,400,17,18,35,Saturday
2014,1,18,300,15,28,43,Saturday
2014,1,18,200,33,19,52,Saturday
2014,1,18,100,40,25,65,Saturday
2014,1,17,2400,46,38,84,Friday
2014,1,17,2300,82,55,137,Friday
2014,1,17,2200,150,88,238,Friday
2014,1,17,2100,260,93,353,Friday
2014,1,17,2000,390,90,480,Friday
2014,1,17,1900,432,171,603,Friday
2014,1,17,1800,437,387,824,Friday
2014,1,17,1700,448,507,955,Friday
2014,1,17,1600,399,357,756,Friday
2014,1,17,1500,436,248,684,Friday
2014,1,17,1400,328,186,514,Friday
2014,1,17,1300,307,170,477,Friday
2014,1,17,1200,303,157,460,Friday
2014,1,17,1100,331,120,451,Friday
2014,1,17,1000,364,108,472,Friday
2014,1,17,900,353,63,416,Friday
2014,1,17,800,164,48,212,Friday
2014,1,17,700,84,34,118,Friday
2014,1,17,600,43,29,72,Friday
2014,1,17,500,29,27,56,Friday
2014,1,17,400,28,38,66,Friday
2014,1,17,300,20,31,51,Friday
2014,1,17,200,25,37,62,Friday
2014,1,17,100,29,49,78,Friday
2014,1,16,2400,48,56,104,Thursday
2014,1,16,2300,83,70,153,Thursday
2014,1,16,2200,103,71,174,Thursday
2014,1,16,2100,123,104,227,Thursday
2014,1,16,2000,184,139,323,Thursday
2014,1,16,1900,188,180,368,Thursday
2014,1,16,1800,208,283,491,Thursday
2014,1,16,1700,194,342,536,Thursday
2014,1,16,1600,224,247,471,Thursday
2014,1,16,1500,232,230,462,Thursday
2014,1,16,1400,171,196,367,Thursday
2014,1,16,1300,184,112,296,Thursday
2014,1,16,1200,207,113,320,Thursday
2014,1,16,1100,219,106,325,Thursday
2014,1,16,1000,275,90,365,Thursday
2014,1,16,900,247,74,321,Thursday
2014,1,16,800,133,52,185,Thursday
2014,1,16,700,65,28,93,Thursday
2014,1,16,600,29,21,50,Thursday
2014,1,16,500,22,27,49,Thursday
2014,1,16,400,16,18,34,Thursday
2014,1,16,300,23,30,53,Thursday
2014,1,16,200,18,33,51,Thursday
2014,1,16,100,28,40,68,Thursday
2014,1,15,2400,48,59,107,Wednesday
2014,1,15,2300,64,43,107,Wednesday
2014,1,15,2200,82,60,142,Wednesday
2014,1,15,2100,86,90,176,Wednesday
2014,1,15,2000,101,71,172,Wednesday
2014,1,15,1900,105,139,244,Wednesday
2014,1,15,1800,112,307,419,Wednesday
2014,1,15,1700,143,276,419,Wednesday
2014,1,15,1600,156,238,394,Wednesday
2014,1,15,1500,158,223,381,Wednesday
2014,1,15,1400,158,152,310,Wednesday
2014,1,15,1300,158,126,284,Wednesday
2014,1,15,1200,178,115,293,Wednesday
2014,1,15,1100,218,109,327,Wednesday
2014,1,15,1000,230,97,327,Wednesday
2014,1,15,900,258,96,354,Wednesday
2014,1,15,800,129,57,186,Wednesday
2014,1,15,700,71,34,105,Wednesday
2014,1,15,600,31,24,55,Wednesday
2014,1,15,500,12,27,39,Wednesday
2014,1,15,400,18,20,38,Wednesday
2014,1,15,300,22,21,43,Wednesday
2014,1,15,200,30,23,53,Wednesday
2014,1,15,100,19,22,41,Wednesday
2014,1,14,2400,56,40,96,Tuesday
2014,1,14,2300,57,50,107,Tuesday
2014,1,14,2200,71,66,137,Tuesday
2014,1,14,2100,71,110,181,Tuesday
2014,1,14,2000,95,112,207,Tuesday
2014,1,14,1900,86,151,237,Tuesday
2014,1,14,1800,94,255,349,Tuesday
2014,1,14,1700,136,312,448,Tuesday
2014,1,14,1600,142,308,450,Tuesday
2014,1,14,1500,160,255,415,Tuesday
2014,1,14,1400,135,336,471,Tuesday
2014,1,14,1300,162,108,270,Tuesday
2014,1,14,1200,152,122,274,Tuesday
2014,1,14,1100,183,99,282,Tuesday
2014,1,14,1000,287,69,356,Tuesday
2014,1,14,900,261,40,301,Tuesday
2014,1,14,800,93,41,134,Tuesday
2014,1,14,700,40,16,56,Tuesday
2014,1,14,600,19,18,37,Tuesday
2014,1,14,500,13,7,20,Tuesday
2014,1,14,400,13,32,45,Tuesday
2014,1,14,300,13,44,57,Tuesday
2014,1,14,200,14,60,74,Tuesday
2014,1,14,100,30,73,103,Tuesday
2014,1,13,2400,29,40,69,Monday
2014,1,13,2300,44,18,62,Monday
2014,1,13,2200,42,19,61,Monday
2014,1,13,2100,46,47,93,Monday
2014,1,13,2000,70,42,112,Monday
2014,1,13,1900,62,98,160,Monday
2014,1,13,1800,77,174,251,Monday
2014,1,13,1700,81,226,307,Monday
2014,1,13,1600,96,194,290,Monday
2014,1,13,1500,94,122,216,Monday
2014,1,13,1400,124,118,242,Monday
2014,1,13,1300,110,128,238,Monday
2014,1,13,1200,129,111,240,Monday
2014,1,13,1100,159,110,269,Monday
2014,1,13,1000,202,91,293,Monday
2014,1,13,900,256,61,317,Monday
2014,1,13,800,125,39,164,Monday
2014,1,13,700,53,21,74,Monday
2014,1,13,600,21,7,28,Monday
2014,1,13,500,18,18,36,Monday
2014,1,13,400,11,21,32,Monday
2014,1,13,300,16,23,39,Monday
2014,1,13,200,13,49,62,Monday
2014,1,13,100,26,46,72,Monday
2014,1,12,2400,24,56,80,Sunday
2014,1,12,2300,38,74,112,Sunday
2014,1,12,2200,73,138,211,Sunday
2014,1,12,2100,66,143,209,Sunday
2014,1,12,2000,71,203,274,Sunday
2014,1,12,1900,82,385,467,Sunday
2014,1,12,1800,128,1066,1194,Sunday
2014,1,12,1700,132,1130,1262,Sunday
2014,1,12,1600,159,762,921,Sunday
2014,1,12,1500,176,592,768,Sunday
2014,1,12,1400,197,424,621,Sunday
2014,1,12,1300,215,344,559,Sunday
2014,1,12,1200,268,270,538,Sunday
2014,1,12,1100,392,151,543,Sunday
2014,1,12,1000,656,91,747,Sunday
2014,1,12,900,792,40,832,Sunday
2014,1,12,800,288,27,315,Sunday
2014,1,12,700,42,23,65,Sunday
2014,1,12,600,12,10,22,Sunday
2014,1,12,500,13,10,23,Sunday
2014,1,12,400,4,17,21,Sunday
2014,1,12,300,12,15,27,Sunday
2014,1,12,200,15,21,36,Sunday
2014,1,12,100,20,25,45,Sunday
2014,1,11,2400,18,45,63,Saturday
2014,1,11,2300,36,94,130,Saturday
2014,1,11,2200,54,55,109,Saturday
2014,1,11,2100,64,121,185,Saturday
2014,1,11,2000,73,191,264,Saturday
2014,1,11,1900,86,242,328,Saturday
2014,1,11,1800,107,686,793,Saturday
2014,1,11,1700,133,660,793,Saturday
2014,1,11,1600,187,433,620,Saturday
2014,1,11,1500,171,233,404,Saturday
2014,1,11,1400,182,201,383,Saturday
2014,1,11,1300,171,146,317,Saturday
2014,1,11,1200,241,109,350,Saturday
2014,1,11,1100,484,89,573,Saturday
2014,1,11,1000,806,65,871,Saturday
2014,1,11,900,583,58,641,Saturday
2014,1,11,800,322,37,359,Saturday
2014,1,11,700,84,22,106,Saturday
2014,1,11,600,18,22,40,Saturday
2014,1,11,500,17,15,32,Saturday
2014,1,11,400,8,14,22,Saturday
2014,1,11,300,18,16,34,Saturday
2014,1,11,200,17,35,52,Saturday
2014,1,11,100,33,32,65,Saturday
2014,1,10,2400,57,53,110,Friday
2014,1,10,2300,100,63,163,Friday
2014,1,10,2200,149,70,219,Friday
2014,1,10,2100,197,98,295,Friday
2014,1,10,2000,355,158,513,Friday
2014,1,10,1900,376,305,681,Friday
2014,1,10,1800,356,263,619,Friday
2014,1,10,1700,368,342,710,Friday
2014,1,10,1600,311,231,542,Friday
2014,1,10,1500,249,175,424,Friday
2014,1,10,1400,244,153,397,Friday
2014,1,10,1300,206,127,333,Friday
2014,1,10,1200,244,94,338,Friday
2014,1,10,1100,210,89,299,Friday
2014,1,10,1000,254,113,367,Friday
2014,1,10,900,249,57,306,Friday
2014,1,10,800,178,49,227,Friday
2014,1,10,700,73,28,101,Friday
2014,1,10,600,32,22,54,Friday
2014,1,10,500,18,21,39,Friday
2014,1,10,400,21,24,45,Friday
2014,1,10,300,21,32,53,Friday
2014,1,10,200,30,28,58,Friday
2014,1,10,100,42,197,239,Friday
2014,1,9,2400,44,8,52,Thursday
2014,1,9,2300,66,10,76,Thursday
2014,1,9,2200,100,75,175,Thursday
2014,1,9,2100,101,59,160,Thursday
2014,1,9,2000,121,54,175,Thursday
2014,1,9,1900,110,180,290,Thursday
2014,1,9,1800,160,296,456,Thursday
2014,1,9,1700,175,318,493,Thursday
2014,1,9,1600,176,245,421,Thursday
2014,1,9,1500,188,204,392,Thursday
2014,1,9,1400,170,136,306,Thursday
2014,1,9,1300,162,143,305,Thursday
2014,1,9,1200,167,104,271,Thursday
2014,1,9,1100,212,104,316,Thursday
2014,1,9,1000,242,78,320,Thursday
2014,1,9,900,197,51,248,Thursday
2014,1,9,800,145,57,202,Thursday
2014,1,9,700,59,44,103,Thursday
2014,1,9,600,21,22,43,Thursday
2014,1,9,500,25,23,48,Thursday
2014,1,9,400,13,8,21,Thursday
2014,1,9,300,25,7,32,Thursday
2014,1,9,200,22,23,45,Thursday
2014,1,9,100,39,32,71,Thursday
2014,1,8,2400,47,46,93,Wednesday
2014,1,8,2300,47,50,97,Wednesday
2014,1,8,2200,72,55,127,Wednesday
2014,1,8,2100,80,88,168,Wednesday
2014,1,8,2000,86,108,194,Wednesday
2014,1,8,1900,106,158,264,Wednesday
2014,1,8,1800,133,255,388,Wednesday
2014,1,8,1700,159,295,454,Wednesday
2014,1,8,1600,158,236,394,Wednesday
2014,1,8,1500,140,210,350,Wednesday
2014,1,8,1400,153,160,313,Wednesday
2014,1,8,1300,175,164,339,Wednesday
2014,1,8,1200,185,131,316,Wednesday
2014,1,8,1100,229,108,337,Wednesday
2014,1,8,1000,228,97,325,Wednesday
2014,1,8,900,184,66,250,Wednesday
2014,1,8,800,142,52,194,Wednesday
2014,1,8,700,46,22,68,Wednesday
2014,1,8,600,25,34,59,Wednesday
2014,1,8,500,12,29,41,Wednesday
2014,1,8,400,16,20,36,Wednesday
2014,1,8,300,22,27,49,Wednesday
2014,1,8,200,31,22,53,Wednesday
2014,1,8,100,23,45,68,Wednesday
2014,1,7,2400,42,47,89,Tuesday
2014,1,7,2300,53,38,91,Tuesday
2014,1,7,2200,63,68,131,Tuesday
2014,1,7,2100,78,82,160,Tuesday
2014,1,7,2000,101,109,210,Tuesday
2014,1,7,1900,81,181,262,Tuesday
2014,1,7,1800,94,251,345,Tuesday
2014,1,7,1700,126,308,434,Tuesday
2014,1,7,1600,141,264,405,Tuesday
2014,1,7,1500,145,214,359,Tuesday
2014,1,7,1400,163,186,349,Tuesday
2014,1,7,1300,158,153,311,Tuesday
2014,1,7,1200,157,145,302,Tuesday
2014,1,7,1100,182,115,297,Tuesday
2014,1,7,1000,214,99,313,Tuesday
2014,1,7,900,149,69,218,Tuesday
2014,1,7,800,99,46,145,Tuesday
2014,1,7,700,42,29,71,Tuesday
2014,1,7,600,24,19,43,Tuesday
2014,1,7,500,14,28,42,Tuesday
2014,1,7,400,13,30,43,Tuesday
2014,1,7,300,20,19,39,Tuesday
2014,1,7,200,22,38,60,Tuesday
2014,1,7,100,32,40,72,Tuesday
2014,1,6,2400,44,58,102,Monday
2014,1,6,2300,48,60,108,Monday
2014,1,6,2200,61,69,130,Monday
2014,1,6,2100,94,82,176,Monday
2014,1,6,2000,92,112,204,Monday
2014,1,6,1900,102,192,294,Monday
2014,1,6,1800,122,314,436,Monday
2014,1,6,1700,142,378,520,Monday
2014,1,6,1600,170,279,449,Monday
2014,1,6,1500,160,293,453,Monday
2014,1,6,1400,188,191,379,Monday
2014,1,6,1300,174,244,418,Monday
2014,1,6,1200,207,102,309,Monday
2014,1,6,1100,211,129,340,Monday
2014,1,6,1000,230,92,322,Monday
2014,1,6,900,165,78,243,Monday
2014,1,6,800,91,41,132,Monday
2014,1,6,700,54,29,83,Monday
2014,1,6,600,16,18,34,Monday
2014,1,6,500,13,23,36,Monday
2014,1,6,400,11,18,29,Monday
2014,1,6,300,9,28,37,Monday
2014,1,6,200,14,28,42,Monday
2014,1,6,100,8,27,35,Monday
2014,1,5,2400,31,74,105,Sunday
2014,1,5,2300,29,111,140,Sunday
2014,1,5,2200,61,116,177,Sunday
2014,1,5,2100,56,151,207,Sunday
2014,1,5,2000,64,302,366,Sunday
2014,1,5,1900,63,358,421,Sunday
2014,1,5,1800,100,640,740,Sunday
2014,1,5,1700,151,820,971,Sunday
2014,1,5,1600,202,782,984,Sunday
2014,1,5,1500,180,692,872,Sunday
2014,1,5,1400,201,587,788,Sunday
2014,1,5,1300,230,527,757,Sunday
2014,1,5,1200,269,368,637,Sunday
2014,1,5,1100,207,235,442,Sunday
2014,1,5,1000,252,104,356,Sunday
2014,1,5,900,287,61,348,Sunday
2014,1,5,800,122,25,147,Sunday
2014,1,5,700,31,18,49,Sunday
2014,1,5,600,10,14,24,Sunday
2014,1,5,500,3,22,25,Sunday
2014,1,5,400,5,18,23,Sunday
2014,1,5,300,8,25,33,Sunday
2014,1,5,200,15,26,41,Sunday
2014,1,5,100,19,43,62,Sunday
2014,1,4,2400,30,52,82,Saturday
2014,1,4,2300,53,79,132,Saturday
2014,1,4,2200,60,149,209,Saturday
2014,1,4,2100,48,177,225,Saturday
2014,1,4,2000,85,270,355,Saturday
2014,1,4,1900,75,441,516,Saturday
2014,1,4,1800,122,1076,1198,Saturday
2014,1,4,1700,156,1370,1526,Saturday
2014,1,4,1600,194,823,1017,Saturday
2014,1,4,1500,199,686,885,Saturday
2014,1,4,1400,256,625,881,Saturday
2014,1,4,1300,314,518,832,Saturday
2014,1,4,1200,376,376,752,Saturday
2014,1,4,1100,432,193,625,Saturday
2014,1,4,1000,803,167,970,Saturday
2014,1,4,900,865,83,948,Saturday
2014,1,4,800,232,30,262,Saturday
2014,1,4,700,64,23,87,Saturday
2014,1,4,600,19,9,28,Saturday
2014,1,4,500,15,31,46,Saturday
2014,1,4,400,11,26,37,Saturday
2014,1,4,300,8,51,59,Saturday
2014,1,4,200,18,67,85,Saturday
2014,1,4,100,18,61,79,Saturday
2014,1,3,2400,35,122,157,Friday
2014,1,3,2300,60,241,301,Friday
2014,1,3,2200,72,254,326,Friday
2014,1,3,2100,95,419,514,Friday
2014,1,3,2000,141,296,437,Friday
2014,1,3,1900,146,310,456,Friday
2014,1,3,1800,197,690,887,Friday
2014,1,3,1700,211,743,954,Friday
2014,1,3,1600,246,472,718,Friday
2014,1,3,1500,261,443,704,Friday
2014,1,3,1400,229,384,613,Friday
2014,1,3,1300,278,389,667,Friday
2014,1,3,1200,324,264,588,Friday
2014,1,3,1100,322,153,475,Friday
2014,1,3,1000,626,87,713,Friday
2014,1,3,900,564,55,619,Friday
2014,1,3,800,188,24,212,Friday
2014,1,3,700,59,17,76,Friday
2014,1,3,600,18,7,25,Friday
2014,1,3,500,17,8,25,Friday
2014,1,3,400,10,10,20,Friday
2014,1,3,300,18,12,30,Friday
2014,1,3,200,14,16,30,Friday
2014,1,3,100,31,12,43,Friday
2014,1,2,2400,30,12,42,Thursday
2014,1,2,2300,65,42,107,Thursday
2014,1,2,2200,65,109,174,Thursday
2014,1,2,2100,104,159,263,Thursday
2014,1,2,2000,115,182,297,Thursday
2014,1,2,1900,142,368,510,Thursday
2014,1,2,1800,199,952,1151,Thursday
2014,1,2,1700,268,1038,1306,Thursday
2014,1,2,1600,327,820,1147,Thursday
2014,1,2,1500,368,657,1025,Thursday
2014,1,2,1400,363,654,1017,Thursday
2014,1,2,1300,399,570,969,Thursday
2014,1,2,1200,491,396,887,Thursday
2014,1,2,1100,461,246,707,Thursday
2014,1,2,1000,594,171,765,Thursday
2014,1,2,900,608,100,708,Thursday
2014,1,2,800,199,37,236,Thursday
2014,1,2,700,64,24,88,Thursday
2014,1,2,600,22,25,47,Thursday
2014,1,2,500,23,12,35,Thursday
2014,1,2,400,12,22,34,Thursday
2014,1,2,300,13,30,43,Thursday
2014,1,2,200,16,48,64,Thursday
2014,1,2,100,22,30,52,Thursday
2014,1,1,2400,26,53,79,Wednesday
2014,1,1,2300,34,84,118,Wednesday
2014,1,1,2200,62,123,185,Wednesday
2014,1,1,2100,65,200,265,Wednesday
2014,1,1,2000,99,289,388,Wednesday
2014,1,1,1900,93,539,632,Wednesday
2014,1,1,1800,160,912,1072,Wednesday
2014,1,1,1700,259,1325,1584,Wednesday
2014,1,1,1600,390,1126,1516,Wednesday
2014,1,1,1500,460,897,1357,Wednesday
2014,1,1,1400,496,801,1297,Wednesday
2014,1,1,1300,467,578,1045,Wednesday
2014,1,1,1200,446,358,804,Wednesday
2014,1,1,1100,380,174,554,Wednesday
2014,1,1,1000,413,101,514,Wednesday
2014,1,1,900,369,45,414,Wednesday
2014,1,1,800,116,29,145,Wednesday
2014,1,1,700,39,19,58,Wednesday
2014,1,1,600,12,10,22,Wednesday
2014,1,1,500,9,13,22,Wednesday
2014,1,1,400,8,11,19,Wednesday
2014,1,1,300,16,21,37,Wednesday
2014,1,1,200,21,24,45,Wednesday
